name, p1_points, p2_points, p1_contemplation_time, p2_contemplation_time,points_ratio
carcassonne-ucttuned0-vs-ucttuned170-1000its,365,884,1932.085391268,2169.28747027,-519
carcassonne-ucttuned0-vs-ucttuned390-1000its,421,903,2088.765199038,2248.397989498,-482
carcassonne-ucttuned0-vs-ucttuned10-1000its,368,845,1963.274862287,2152.827405648,-477
carcassonne-uct0-vs-uct380-1000its,381,846,2015.698553802,2189.093313604,-465
carcassonne-uct0-vs-uct205-1000its,367,829,2074.014752216,2213.594538532,-462
carcassonne-ucttuned0-vs-ucttuned335-1000its,372,825,1983.931300757,2168.922887164,-453
carcassonne-uct0-vs-uct440-1000its,421,873,2028.752276273,2167.444378474,-452
carcassonne-ucttuned0-vs-ucttuned15-1000its,403,850,1991.521729488,2214.362230796,-447
carcassonne-ucttuned0-vs-ucttuned20-1000its,382,826,2038.518110211,2204.777262361,-444
carcassonne-ucttuned0-vs-ucttuned145-1000its,343,780,2011.975745767,2155.843499258,-437
carcassonne-uct0-vs-uct460-1000its,361,797,1994.96360942,2156.467870529,-436
carcassonne-ucttuned0-vs-ucttuned55-1000its,385,821,2101.310262162,2329.806243521,-436
carcassonne-uct0-vs-uct10-1000its,384,819,2017.86519157,2209.758379876,-435
carcassonne-ucttuned0-vs-ucttuned370-1000its,408,843,2022.329425881,2190.759684703,-435
carcassonne-uct0-vs-uct375-1000its,379,807,2089.682736557,2212.1060247,-428
carcassonne-ucttuned0-vs-ucttuned350-1000its,425,850,1979.902087783,2168.724982908,-425
carcassonne-ucttuned0-vs-ucttuned115-1000its,399,822,2150.083524933,2269.459615153,-423
carcassonne-ucttuned0-vs-ucttuned5-1000its,430,851,2015.045587327,2192.453843967,-421
carcassonne-uct0-vs-uct355-1000its,389,809,2047.309756187,2223.921996463,-420
carcassonne-ucttuned0-vs-ucttuned495-1000its,401,821,2096.912113955,2276.592527598,-420
carcassonne-uct0-vs-uct50-1000its,387,800,1990.583843541,2164.650188756,-413
carcassonne-uct0-vs-uct245-1000its,429,841,2020.028065715,2223.748785109,-412
carcassonne-ucttuned0-vs-ucttuned315-1000its,379,787,2024.185192069,2214.1530955,-408
carcassonne-ucttuned0-vs-ucttuned95-1000its,419,827,2074.953946577,2207.896582353,-408
carcassonne-uct0-vs-uct415-1000its,437,844,2071.640732707,2205.224890501,-407
carcassonne-ucttuned0-vs-ucttuned205-1000its,382,788,2004.015267659,2187.978141061,-406
carcassonne-ucttuned0-vs-ucttuned210-1000its,328,732,2068.694667107,2248.146770831,-404
carcassonne-uct0-vs-uct475-1000its,365,769,2061.649979795,2212.206879671,-404
carcassonne-ucttuned0-vs-ucttuned135-1000its,380,784,2028.424020979,2176.487114265,-404
carcassonne-uct0-vs-uct200-1000its,383,787,1943.102850271,2163.21016146,-404
carcassonne-uct0-vs-uct80-1000its,385,788,1979.23420408,2130.146574674,-403
carcassonne-ucttuned0-vs-ucttuned255-1000its,393,796,2071.222600006,2202.707225934,-403
carcassonne-uct0-vs-uct65-1000its,362,764,2078.919737628,2270.703522374,-402
carcassonne-ucttuned0-vs-ucttuned225-1000its,393,794,2026.716823993,2228.905919279,-401
carcassonne-uct0-vs-uct105-1000its,397,798,2009.976139036,2163.552900752,-401
carcassonne-ucttuned0-vs-ucttuned280-1000its,400,801,2024.220000129,2203.191840247,-401
carcassonne-uct0-vs-uct250-1000its,415,815,2061.915498912,2210.037945278,-400
carcassonne-uct0-vs-uct370-1000its,391,790,2076.166685157,2153.127143096,-399
carcassonne-ucttuned0-vs-ucttuned420-1000its,407,805,1962.53445193,2111.554668042,-398
carcassonne-ucttuned0-vs-ucttuned165-1000its,457,854,2108.400360477,2243.655721438,-397
carcassonne-uct0-vs-uct190-1000its,408,804,2047.003798733,2187.09875997,-396
carcassonne-uct0-vs-uct30-1000its,414,807,2100.891526123,2263.332626975,-393
carcassonne-ucttuned0-vs-ucttuned490-1000its,364,752,2064.242019546,2254.084305933,-388
carcassonne-uct0-vs-uct425-1000its,378,766,1985.112758954,2154.973820101,-388
carcassonne-ucttuned0-vs-ucttuned275-1000its,368,755,1977.045081161,2140.983324622,-387
carcassonne-ucttuned0-vs-ucttuned235-1000its,379,766,2081.589768828,2228.677956631,-387
carcassonne-uct0-vs-uct385-1000its,394,778,2079.572555331,2245.367425624,-384
carcassonne-uct0-vs-uct435-1000its,389,771,2032.819770557,2178.323328276,-382
carcassonne-uct0-vs-uct170-1000its,413,795,2010.825762994,2160.573366813,-382
carcassonne-ucttuned0-vs-ucttuned340-1000its,389,770,2008.644737269,2130.840819584,-381
carcassonne-ucttuned0-vs-ucttuned310-1000its,362,742,2029.452770037,2172.178963766,-380
carcassonne-uct0-vs-uct175-1000its,367,746,1975.793463833,2185.719120206,-379
carcassonne-ucttuned0-vs-ucttuned360-1000its,386,762,2091.446151111,2280.605695101,-376
carcassonne-ucttuned0-vs-ucttuned195-1000its,406,781,2083.329130956,2195.787333295,-375
carcassonne-uct0-vs-uct490-1000its,495,870,2040.297596402,2183.558832775,-375
carcassonne-uct0-vs-uct330-1000its,398,772,2006.596682529,2184.18020904,-374
carcassonne-ucttuned0-vs-ucttuned440-1000its,398,772,2022.141157726,2221.079479918,-374
carcassonne-ucttuned0-vs-ucttuned35-1000its,357,730,1933.070787256,2141.353124447,-373
carcassonne-uct0-vs-uct430-1000its,411,784,2053.54383176,2253.864200319,-373
carcassonne-uct0-vs-uct390-1000its,388,760,2062.969069365,2232.318614069,-372
carcassonne-uct0-vs-uct40-1000its,391,763,2011.74074501,2214.829433017,-372
carcassonne-uct0-vs-uct195-1000its,400,772,2001.744023291,2206.427814841,-372
carcassonne-ucttuned0-vs-ucttuned125-1000its,412,784,1996.878193793,2206.597774312,-372
carcassonne-ucttuned0-vs-ucttuned150-1000its,376,747,2013.494931392,2176.013002801,-371
carcassonne-uct0-vs-uct325-1000its,383,754,2043.354034225,2252.092482299,-371
carcassonne-ucttuned0-vs-ucttuned185-1000its,420,790,2034.214071079,2227.867629412,-370
carcassonne-uct0-vs-uct230-1000its,350,719,1999.500146925,2149.212159538,-369
carcassonne-ucttuned0-vs-ucttuned380-1000its,451,820,1985.532579296,2180.869107196,-369
carcassonne-ucttuned0-vs-ucttuned470-1000its,366,734,2051.866941082,2211.863260828,-368
carcassonne-ucttuned0-vs-ucttuned160-1000its,382,750,2016.777433482,2152.729613072,-368
carcassonne-ucttuned0-vs-ucttuned65-1000its,438,806,2016.353199129,2228.699645239,-368
carcassonne-ucttuned0-vs-ucttuned70-1000its,375,741,2065.267442555,2248.201283109,-366
carcassonne-uct0-vs-uct345-1000its,411,777,2118.792062074,2282.24709906,-366
carcassonne-ucttuned0-vs-ucttuned175-1000its,406,770,2085.355329137,2239.564811655,-364
carcassonne-uct0-vs-uct285-1000its,362,724,2010.846880184,2200.836476317,-362
carcassonne-ucttuned0-vs-ucttuned220-1000its,380,742,2083.654619846,2298.388007329,-362
carcassonne-uct0-vs-uct210-1000its,386,748,1988.357644733,2163.06985866,-362
carcassonne-ucttuned0-vs-ucttuned290-1000its,394,756,2052.583161108,2192.523487858,-362
carcassonne-uct0-vs-uct315-1000its,417,779,2002.881583874,2237.406045021,-362
carcassonne-ucttuned0-vs-ucttuned270-1000its,415,775,2000.576480622,2218.057591945,-360
carcassonne-ucttuned0-vs-ucttuned395-1000its,404,763,2100.827447346,2292.396371432,-359
carcassonne-uct0-vs-uct450-1000its,422,781,1980.274621877,2183.624557538,-359
carcassonne-ucttuned0-vs-ucttuned430-1000its,432,791,1992.812127701,2164.744198086,-359
carcassonne-ucttuned0-vs-ucttuned295-1000its,419,777,2091.76911151,2226.704252817,-358
carcassonne-ucttuned0-vs-ucttuned465-1000its,443,801,1994.64095469,2200.200673234,-358
carcassonne-uct0-vs-uct260-1000its,423,779,2114.440649444,2253.051443278,-356
carcassonne-uct0-vs-uct20-1000its,376,731,1979.471199982,2199.42071991,-355
carcassonne-ucttuned0-vs-ucttuned475-1000its,390,745,2010.841080806,2181.050933896,-355
carcassonne-uct0-vs-uct220-1000its,413,768,2093.205261957,2290.552066464,-355
carcassonne-ucttuned0-vs-ucttuned375-1000its,413,768,1958.191743944,2140.840599856,-355
carcassonne-ucttuned0-vs-ucttuned435-1000its,427,782,1965.903352693,2174.627407975,-355
carcassonne-uct0-vs-uct75-1000its,431,786,2020.635960962,2176.231146262,-355
carcassonne-ucttuned0-vs-ucttuned120-1000its,398,752,2041.741652341,2252.180321447,-354
carcassonne-uct0-vs-uct130-1000its,435,786,2031.608364572,2169.496254414,-351
carcassonne-uct0-vs-uct135-1000its,390,740,2084.674227,2281.833088417,-350
carcassonne-uct0-vs-uct300-1000its,393,743,1968.689433622,2169.293098808,-350
carcassonne-ucttuned0-vs-ucttuned230-1000its,394,744,2072.373755573,2235.959921406,-350
carcassonne-ucttuned0-vs-ucttuned250-1000its,397,747,2055.595597476,2259.633496268,-350
carcassonne-uct0-vs-uct270-1000its,437,784,2070.286734582,2194.530874171,-347
carcassonne-uct0-vs-uct405-1000its,385,731,1985.92580746,2170.061674164,-346
carcassonne-ucttuned0-vs-ucttuned155-1000its,419,764,2011.269553202,2178.629990469,-345
carcassonne-ucttuned0-vs-ucttuned365-1000its,419,763,2013.664913645,2221.072092441,-344
carcassonne-ucttuned0-vs-ucttuned425-1000its,400,743,2053.407782955,2183.863209708,-343
carcassonne-ucttuned0-vs-ucttuned80-1000its,499,842,2085.51974106,2237.172396988,-343
carcassonne-uct0-vs-uct445-1000its,386,728,1986.918359437,2179.351778322,-342
carcassonne-ucttuned0-vs-ucttuned385-1000its,402,744,2054.811441479,2239.607412141,-342
carcassonne-ucttuned0-vs-ucttuned60-1000its,448,790,1997.267529585,2139.695587611,-342
carcassonne-uct0-vs-uct470-1000its,466,808,2046.73201128,2176.052540849,-342
carcassonne-uct0-vs-uct110-1000its,418,759,1977.261263322,2202.263831319,-341
carcassonne-uct0-vs-uct5-1000its,441,782,2029.436615361,2195.703758676,-341
carcassonne-ucttuned0-vs-ucttuned30-1000its,420,759,2000.981563727,2177.011629429,-339
carcassonne-uct0-vs-uct290-1000its,449,788,2096.450350276,2242.242238868,-339
carcassonne-uct0-vs-uct215-1000its,413,751,2046.501060069,2247.67588908,-338
carcassonne-ucttuned0-vs-ucttuned445-1000its,397,734,1998.261323538,2172.790871719,-337
carcassonne-uct0-vs-uct140-1000its,385,721,2023.523543897,2163.688769484,-336
carcassonne-ucttuned0-vs-ucttuned450-1000its,386,722,2056.211240949,2238.680217157,-336
carcassonne-ucttuned0-vs-ucttuned455-1000its,407,743,2011.474136394,2234.248934211,-336
carcassonne-uct0-vs-uct310-1000its,393,728,2036.721711313,2216.539107976,-335
carcassonne-ucttuned0-vs-ucttuned90-1000its,429,764,2078.283303986,2256.303379934,-335
carcassonne-uct0-vs-uct225-1000its,430,765,2083.418211214,2265.294105033,-335
carcassonne-uct0-vs-uct145-1000its,453,785,2019.706792832,2204.678642897,-332
carcassonne-uct0-vs-uct55-1000its,441,772,2046.020326772,2244.803528571,-331
carcassonne-uct0-vs-uct410-1000its,418,747,2105.03619578,2274.422770811,-329
carcassonne-uct0-vs-uct95-1000its,425,754,2119.779678209,2280.28753471,-329
carcassonne-ucttuned0-vs-ucttuned400-1000its,425,754,1982.648458695,2166.54443026,-329
carcassonne-ucttuned0-vs-ucttuned215-1000its,442,771,2053.646752776,2209.563416019,-329
carcassonne-ucttuned0-vs-ucttuned100-1000its,451,780,2057.469627456,2251.470731361,-329
carcassonne-ucttuned0-vs-ucttuned485-1000its,397,725,2030.659605298,2245.717431765,-328
carcassonne-ucttuned0-vs-ucttuned200-1000its,414,741,2011.407098776,2193.658587806,-327
carcassonne-uct0-vs-uct100-1000its,423,750,2038.742068123,2205.059184562,-327
carcassonne-ucttuned0-vs-ucttuned480-1000its,413,739,2017.820641523,2178.243771151,-326
carcassonne-uct0-vs-uct365-1000its,449,775,2043.642467123,2190.011809886,-326
carcassonne-uct0-vs-uct150-1000its,392,717,2062.575463181,2225.617788475,-325
carcassonne-uct0-vs-uct360-1000its,398,723,2067.770126678,2221.051578542,-325
carcassonne-ucttuned0-vs-ucttuned285-1000its,406,731,2089.523378254,2239.657491499,-325
carcassonne-uct0-vs-uct125-1000its,424,749,2049.168268201,2169.744049502,-325
carcassonne-uct0-vs-uct235-1000its,480,805,2046.685862313,2178.931517469,-325
carcassonne-uct0-vs-uct70-1000its,423,746,1981.489096288,2176.430772769,-323
carcassonne-ucttuned0-vs-ucttuned305-1000its,426,749,2051.917531706,2225.067948078,-323
carcassonne-uct0-vs-uct280-1000its,472,795,2108.503602645,2256.045992173,-323
carcassonne-ucttuned0-vs-ucttuned300-1000its,446,768,2052.558878292,2211.65079601,-322
carcassonne-uct0-vs-uct115-1000its,463,785,1993.25656863,2185.879495729,-322
carcassonne-uct0-vs-uct90-1000its,417,738,1981.131224422,2155.167402442,-321
carcassonne-uct0-vs-uct160-1000its,405,725,2000.722985417,2152.177200201,-320
carcassonne-ucttuned0-vs-ucttuned260-1000its,453,773,2027.861661159,2202.069926233,-320
carcassonne-ucttuned0-vs-ucttuned330-1000its,399,718,2012.783028885,2223.816352335,-319
carcassonne-uct0-vs-uct165-1000its,433,752,2084.897660458,2228.746486966,-319
carcassonne-ucttuned0-vs-ucttuned130-1000its,444,763,2006.437651704,2143.545114587,-319
carcassonne-uct0-vs-uct60-1000its,439,757,2062.278806748,2248.447318063,-318
carcassonne-uct0-vs-uct485-1000its,388,705,2099.39310118,2305.848894425,-317
carcassonne-ucttuned0-vs-ucttuned460-1000its,439,756,2034.345036826,2168.482924676,-317
carcassonne-uct0-vs-uct25-1000its,413,729,2103.594291293,2289.425026178,-316
carcassonne-ucttuned0-vs-ucttuned190-1000its,436,750,2091.926973311,2275.658082415,-314
carcassonne-uct0-vs-uct340-1000its,435,747,2081.100704419,2236.181949331,-312
carcassonne-uct0-vs-uct480-1000its,395,706,2122.924178318,2248.110822045,-311
carcassonne-uct0-vs-uct400-1000its,464,771,2075.645659203,2217.149115692,-307
carcassonne-ucttuned0-vs-ucttuned105-1000its,446,752,2089.143507269,2217.410769627,-306
carcassonne-ucttuned0-vs-ucttuned25-1000its,476,782,2039.922084158,2177.840008458,-306
carcassonne-uct0-vs-uct465-1000its,444,749,2075.099743607,2222.373597039,-305
carcassonne-uct0-vs-uct335-1000its,407,711,2005.274023009,2183.718275144,-304
carcassonne-uct0-vs-uct15-1000its,447,750,2003.420446803,2198.550945555,-303
carcassonne-uct0-vs-uct255-1000its,397,699,2021.204442884,2193.73430683,-302
carcassonne-ucttuned370-vs-ucttuned30-1000its,640,941,2217.163244597,2216.359335201,-301
carcassonne-uct0-vs-uct240-1000its,450,750,2025.614139135,2220.570448487,-300
carcassonne-ucttuned420-vs-ucttuned30-1000its,636,936,2201.119283141,2169.280546617,-300
carcassonne-uct0-vs-uct180-1000its,442,741,2121.402106411,2274.662448854,-299
carcassonne-ucttuned0-vs-ucttuned405-1000its,477,775,2046.636438819,2209.074683338,-298
carcassonne-uct0-vs-uct295-1000its,380,676,2041.081323704,2200.364761079,-296
carcassonne-uct0-vs-uct305-1000its,412,708,2097.02369108,2261.400652517,-296
carcassonne-uct0-vs-uct395-1000its,447,743,2142.049814746,2308.813324575,-296
carcassonne-uct0-vs-uct455-1000its,471,764,2102.575643901,2223.70274158,-293
carcassonne-boltzmann220-vs-boltzmann155-1000its,709,1002,2273.339122279,2230.301031069,-293
carcassonne-ucttuned0-vs-ucttuned45-1000its,437,727,2048.480165881,2236.173772392,-290
carcassonne-ucttuned0-vs-ucttuned50-1000its,388,677,1966.291435936,2157.164345971,-289
carcassonne-ucttuned0-vs-ucttuned240-1000its,435,720,2056.813324258,2207.691123631,-285
carcassonne-uct0-vs-uct350-1000its,439,724,2043.542461105,2173.629895772,-285
carcassonne-ucttuned0-vs-ucttuned355-1000its,345,629,1614.089072059,1751.163391764,-284
carcassonne-ucttuned0-vs-ucttuned245-1000its,458,742,2005.090812494,2112.315075215,-284
carcassonne-boltzmann235-vs-boltzmann395-1000its,591,875,2123.948311288,2161.290674202,-284
carcassonne-uct0-vs-uct85-1000its,446,728,2022.38857296,2195.015895652,-282
carcassonne-uct0-vs-uct265-1000its,487,769,2076.868824859,2245.59364241,-282
carcassonne-ucttuned0-vs-ucttuned140-1000its,494,773,2081.015728652,2244.869665096,-279
carcassonne-uct0-vs-uct320-1000its,406,682,2119.951727091,2273.893819879,-276
carcassonne-uct0-vs-uct120-1000its,432,708,2066.189518586,2212.798967731,-276
carcassonne-ucttuned0-vs-ucttuned110-1000its,468,743,2104.268876857,2285.673731048,-275
carcassonne-uct300-vs-uct275-1000its,651,926,2238.392116203,2223.011143324,-275
carcassonne-boltzmann270-vs-boltzmann5-1000its,608,879,2279.355858212,2241.926926534,-271
carcassonne-uct0-vs-uct155-1000its,444,713,2027.636948974,2208.920404821,-269
carcassonne-ucttuned155-vs-ucttuned415-1000its,674,942,2207.42395171,2181.193809215,-268
carcassonne-uct0-vs-uct275-1000its,431,698,2070.606950771,2208.559992668,-267
carcassonne-uct195-vs-uct210-1000its,626,893,2202.723822232,2145.293585782,-267
carcassonne-ucttuned0-vs-ucttuned325-1000its,496,761,1994.105753973,2153.425000987,-265
carcassonne-ucttuned220-vs-ucttuned325-1000its,720,985,2221.005846162,2122.127951345,-265
carcassonne-ucttuned0-vs-ucttuned320-1000its,445,708,2057.535199609,2234.797815677,-263
carcassonne-uct0-vs-uct420-1000its,448,710,2048.046766825,2217.588500893,-262
carcassonne-ucttuned0-vs-ucttuned180-1000its,495,754,2035.63971143,2227.464132955,-259
carcassonne-ucttuned405-vs-ucttuned455-1000its,671,929,2208.292239076,2159.316438522,-258
carcassonne-ucttuned0-vs-ucttuned40-1000its,452,704,2068.264812163,2236.267715287,-252
carcassonne-ucttuned0-vs-ucttuned85-1000its,496,745,2035.871041943,2202.214382884,-249
carcassonne-ucttuned450-vs-ucttuned485-1000its,659,908,2205.476284367,2157.405458582,-249
carcassonne-uct255-vs-uct360-1000its,688,936,2177.505222792,2183.359498515,-248
carcassonne-boltzmann185-vs-boltzmann25-1000its,649,896,2192.037625839,2125.72385271,-247
carcassonne-uct475-vs-uct100-1000its,735,982,2203.87234258,2137.841750167,-247
carcassonne-ucttuned0-vs-ucttuned75-1000its,417,663,2121.398264184,2229.311586889,-246
carcassonne-boltzmann370-vs-boltzmann495-1000its,617,862,2238.253017626,2191.510933824,-245
carcassonne-ucttuned395-vs-ucttuned30-1000its,700,945,2201.285947944,2163.980472511,-245
carcassonne-boltzmann480-vs-boltzmann145-1000its,651,894,2192.40797297,2153.402250638,-243
carcassonne-boltzmann110-vs-boltzmann15-1000its,605,847,2141.123943254,2132.432325301,-242
carcassonne-boltzmann365-vs-boltzmann275-1000its,651,893,2213.788626722,2158.163266574,-242
carcassonne-boltzmann285-vs-boltzmann470-1000its,581,822,2154.150423263,2128.499475957,-241
carcassonne-uct435-vs-uct95-1000its,700,941,2139.218035955,2114.926242791,-241
carcassonne-uct0-vs-uct35-1000its,343,583,1652.482668752,1740.087042009,-240
carcassonne-boltzmann190-vs-boltzmann460-1000its,696,936,2212.231760988,2175.122522439,-240
carcassonne-ucttuned0-vs-ucttuned265-1000its,463,700,2061.889156856,2257.926023422,-237
carcassonne-ucttuned0-vs-ucttuned415-1000its,510,747,2063.291635816,2214.139950445,-237
carcassonne-uct295-vs-uct245-1000its,650,887,2197.590136985,2151.460888179,-237
carcassonne-uct240-vs-uct150-1000its,680,917,2162.568966531,2136.543409346,-237
carcassonne-uct0-vs-uct45-1000its,483,719,2011.902796142,2220.400396295,-236
carcassonne-boltzmann180-vs-boltzmann50-1000its,681,917,2209.898838488,2106.715181877,-236
carcassonne-ucttuned0-vs-ucttuned410-1000its,476,710,2038.913035359,2217.939525059,-234
carcassonne-ucttuned245-vs-ucttuned315-1000its,675,906,2226.896639132,2140.257061637,-231
carcassonne-uct50-vs-uct305-1000its,721,950,2231.063671464,2140.030065071,-229
carcassonne-boltzmann120-vs-boltzmann210-1000its,659,887,2094.120096688,2066.751952443,-228
carcassonne-boltzmann110-vs-boltzmann20-1000its,633,860,2245.492022827,2189.649266206,-227
carcassonne-ucttuned25-vs-ucttuned245-1000its,683,908,2114.515390822,2070.41853191,-225
carcassonne-boltzmann265-vs-boltzmann220-1000its,662,886,2206.72401892,2149.528407459,-224
carcassonne-uct5-vs-uct370-1000its,704,926,2227.654916579,2161.705291818,-222
carcassonne-boltzmann105-vs-boltzmann135-1000its,709,931,2168.994346252,2144.888391207,-222
carcassonne-ucttuned150-vs-ucttuned225-1000its,710,931,2243.132594091,2186.037854978,-221
carcassonne-boltzmann425-vs-boltzmann415-1000its,658,878,2197.49040746,2150.837033856,-220
carcassonne-boltzmann80-vs-boltzmann95-1000its,672,892,2220.37913794,2185.48909866,-220
carcassonne-ucttuned420-vs-ucttuned75-1000its,694,914,2263.563469,2242.615228588,-220
carcassonne-uct0-vs-uct185-1000its,444,663,2023.592604941,2177.657101711,-219
carcassonne-boltzmann265-vs-boltzmann105-1000its,689,907,2152.264542322,2099.356712454,-218
carcassonne-ucttuned385-vs-ucttuned360-1000its,736,954,2172.160937495,2142.878415574,-218
carcassonne-boltzmann380-vs-boltzmann45-1000its,590,807,2172.44803563,2112.925556479,-217
carcassonne-uct35-vs-uct400-1000its,700,917,2164.547300267,2107.823095193,-217
carcassonne-boltzmann15-vs-boltzmann110-1000its,701,918,2250.766936633,2229.219961455,-217
carcassonne-uct90-vs-uct5-1000its,707,924,2222.671383319,2205.672579759,-217
carcassonne-ucttuned300-vs-ucttuned120-1000its,711,928,2136.343340016,2087.572440942,-217
carcassonne-ucttuned260-vs-ucttuned10-1000its,768,985,2136.633773259,2114.09028229,-217
carcassonne-uct240-vs-uct15-1000its,672,888,2143.726635161,2133.465816341,-216
carcassonne-ucttuned415-vs-ucttuned280-1000its,686,902,2203.487619971,2134.680869492,-216
carcassonne-ucttuned415-vs-ucttuned180-1000its,689,905,2199.197950699,2170.293467376,-216
carcassonne-boltzmann290-vs-boltzmann455-1000its,666,881,2187.654143551,2184.493965419,-215
carcassonne-uct155-vs-uct405-1000its,667,882,2206.059223871,2150.305867809,-215
carcassonne-boltzmann410-vs-boltzmann10-1000its,697,912,2217.679383796,2222.906734681,-215
carcassonne-uct130-vs-uct455-1000its,708,923,2207.479280322,2116.373743794,-215
carcassonne-uct265-vs-uct70-1000its,698,912,2214.586586035,2150.888030682,-214
carcassonne-boltzmann490-vs-boltzmann125-1000its,634,847,2216.088578501,2154.864170786,-213
carcassonne-uct425-vs-uct25-1000its,705,918,2162.544596302,2135.822873623,-213
carcassonne-boltzmann50-vs-boltzmann100-1000its,642,853,2207.507267078,2156.283891537,-211
carcassonne-boltzmann395-vs-boltzmann295-1000its,648,859,2195.804483508,2166.513685558,-211
carcassonne-boltzmann370-vs-boltzmann235-1000its,657,868,2128.811610808,2088.986317896,-211
carcassonne-uct485-vs-uct20-1000its,674,885,2261.791252932,2195.630421375,-211
carcassonne-uct165-vs-uct80-1000its,675,886,2230.791276511,2203.000730691,-211
carcassonne-ucttuned85-vs-ucttuned10-1000its,728,939,2127.315356211,2092.155323643,-211
carcassonne-boltzmann220-vs-boltzmann40-1000its,696,906,2165.726610167,2119.432081949,-210
carcassonne-ucttuned0-vs-ucttuned345-1000its,398,607,2067.156923228,2242.734388045,-209
carcassonne-boltzmann90-vs-boltzmann130-1000its,680,889,2175.272435474,2125.927629211,-209
carcassonne-uct315-vs-uct190-1000its,697,906,2175.720155565,2166.077646367,-209
carcassonne-boltzmann355-vs-boltzmann110-1000its,731,940,2201.440044184,2156.984535632,-209
carcassonne-ucttuned310-vs-ucttuned115-1000its,646,854,2207.068720832,2153.669900261,-208
carcassonne-ucttuned235-vs-ucttuned480-1000its,699,907,2154.603363604,2128.848349673,-208
carcassonne-ucttuned380-vs-ucttuned25-1000its,702,910,2169.623048387,2116.10295459,-208
carcassonne-boltzmann45-vs-boltzmann360-1000its,667,874,2186.155657379,2148.091450308,-207
carcassonne-uct370-vs-uct385-1000its,680,887,2271.739873057,2208.482994326,-207
carcassonne-ucttuned280-vs-ucttuned270-1000its,663,869,2239.677582169,2163.297865811,-206
carcassonne-boltzmann100-vs-boltzmann215-1000its,682,888,2187.788698551,2167.57670468,-206
carcassonne-uct480-vs-uct50-1000its,676,881,2192.367391332,2190.104113438,-205
carcassonne-ucttuned130-vs-ucttuned240-1000its,626,830,2328.580499585,2236.159432759,-204
carcassonne-ucttuned475-vs-ucttuned385-1000its,648,852,2169.580645932,2158.189660302,-204
carcassonne-uct115-vs-uct10-1000its,712,916,2176.125207666,2114.201948126,-204
carcassonne-uct255-vs-uct15-1000its,590,793,2214.930020321,2158.240953112,-203
carcassonne-boltzmann385-vs-boltzmann345-1000its,641,844,2244.814880879,2239.56020015,-203
carcassonne-uct305-vs-uct200-1000its,660,862,2200.314283825,2142.884806682,-202
carcassonne-ucttuned185-vs-ucttuned495-1000its,692,894,2278.386979505,2186.495191371,-202
carcassonne-boltzmann105-vs-boltzmann145-1000its,633,834,2226.815156701,2151.69772201,-201
carcassonne-uct460-vs-uct175-1000its,692,893,2148.357220925,2121.975122587,-201
carcassonne-uct245-vs-uct295-1000its,732,933,2203.943276057,2191.254685573,-201
carcassonne-ucttuned290-vs-ucttuned25-1000its,635,835,2133.087816208,2114.020904881,-200
carcassonne-boltzmann395-vs-boltzmann360-1000its,719,919,2228.349259871,2176.191618287,-200
carcassonne-uct235-vs-uct20-1000its,664,863,2302.425943662,2231.660939068,-199
carcassonne-ucttuned490-vs-ucttuned230-1000its,673,872,2214.732112751,2194.955552913,-199
carcassonne-boltzmann225-vs-boltzmann315-1000its,698,897,2174.01298179,2146.676451966,-199
carcassonne-boltzmann160-vs-boltzmann30-1000its,636,834,2165.586067846,2100.065914588,-198
carcassonne-ucttuned140-vs-ucttuned90-1000its,663,861,2138.016258182,2088.277844806,-198
carcassonne-ucttuned360-vs-ucttuned455-1000its,669,867,2221.506017749,2189.851984247,-198
carcassonne-boltzmann170-vs-boltzmann5-1000its,686,884,2250.580649372,2230.694055139,-198
carcassonne-uct430-vs-uct20-1000its,734,932,2215.620523555,2143.023223524,-198
carcassonne-ucttuned205-vs-ucttuned95-1000its,639,836,2201.340451179,2178.630986533,-197
carcassonne-boltzmann375-vs-boltzmann270-1000its,649,846,2187.156332085,2156.84073952,-197
carcassonne-uct485-vs-uct380-1000its,662,859,2203.29814266,2134.75458008,-197
carcassonne-uct445-vs-uct80-1000its,677,874,2221.475888752,2180.451794649,-197
carcassonne-boltzmann245-vs-boltzmann330-1000its,703,900,2187.883567686,2190.778602766,-197
carcassonne-uct365-vs-uct80-1000its,710,907,2210.672520326,2183.706183286,-197
carcassonne-ucttuned200-vs-ucttuned70-1000its,750,947,2246.612081932,2233.557275473,-197
carcassonne-ucttuned140-vs-ucttuned30-1000its,642,838,2190.035001042,2157.683956799,-196
carcassonne-boltzmann360-vs-boltzmann125-1000its,650,846,2136.586980974,2115.462885468,-196
carcassonne-boltzmann290-vs-boltzmann190-1000its,666,862,2152.197912016,2094.50078174,-196
carcassonne-boltzmann230-vs-boltzmann70-1000its,672,868,2187.939409153,2123.948548441,-196
carcassonne-ucttuned410-vs-ucttuned455-1000its,673,869,2241.838475306,2201.477618103,-196
carcassonne-ucttuned200-vs-ucttuned20-1000its,806,1002,2211.650816643,2157.587111946,-196
carcassonne-ucttuned170-vs-ucttuned5-1000its,828,1024,2210.661695789,2149.828689063,-196
carcassonne-uct175-vs-uct370-1000its,669,864,2158.913451816,2130.358520922,-195
carcassonne-ucttuned415-vs-ucttuned460-1000its,675,870,2173.976010711,2141.591711515,-195
carcassonne-uct410-vs-uct175-1000its,700,895,2172.57209615,2096.515471152,-195
carcassonne-uct55-vs-uct70-1000its,720,915,2151.665247278,2137.183533103,-195
carcassonne-boltzmann115-vs-boltzmann260-1000its,721,916,2185.381488029,2191.188347549,-195
carcassonne-boltzmann345-vs-boltzmann275-1000its,655,849,2175.733251775,2109.471249369,-194
carcassonne-boltzmann400-vs-boltzmann5-1000its,674,868,2208.842327336,2177.021029533,-194
carcassonne-uct330-vs-uct160-1000its,691,885,2241.182758054,2193.676359202,-194
carcassonne-boltzmann240-vs-boltzmann10-1000its,712,906,2241.637456069,2197.111586466,-194
carcassonne-uct255-vs-uct175-1000its,648,841,2144.649076737,2105.359722586,-193
carcassonne-boltzmann490-vs-boltzmann255-1000its,651,844,2182.389600303,2131.666881487,-193
carcassonne-boltzmann170-vs-boltzmann175-1000its,655,848,2197.04513205,2127.628389236,-193
carcassonne-ucttuned135-vs-ucttuned405-1000its,660,853,2274.71165804,2227.462153665,-193
carcassonne-uct415-vs-uct335-1000its,673,866,2167.835553546,2099.292111809,-193
carcassonne-uct95-vs-uct395-1000its,679,872,2140.558916669,2110.330806908,-193
carcassonne-ucttuned260-vs-ucttuned205-1000its,692,885,2155.035584589,2110.360338608,-193
carcassonne-boltzmann95-vs-boltzmann430-1000its,707,900,2192.039014019,2194.164548763,-193
carcassonne-ucttuned315-vs-ucttuned230-1000its,710,903,2156.024302062,2123.169493493,-193
carcassonne-uct300-vs-uct10-1000its,728,921,2182.895018836,2167.143543621,-193
carcassonne-boltzmann35-vs-boltzmann20-1000its,739,932,2110.609956723,2084.84233177,-193
carcassonne-ucttuned355-vs-ucttuned405-1000its,769,962,2179.071312407,2176.041582645,-193
carcassonne-ucttuned370-vs-ucttuned10-1000its,811,1004,2171.124223543,2115.39136934,-193
carcassonne-uct110-vs-uct165-1000its,657,849,2264.612165279,2177.014109052,-192
carcassonne-uct325-vs-uct495-1000its,731,923,2144.568423053,2105.15662736,-192
carcassonne-ucttuned410-vs-ucttuned60-1000its,654,845,2179.762401099,2105.121034342,-191
carcassonne-ucttuned245-vs-ucttuned190-1000its,662,853,2240.773650447,2165.821469454,-191
carcassonne-boltzmann320-vs-boltzmann255-1000its,669,860,2167.703091445,2175.515369918,-191
carcassonne-uct255-vs-uct420-1000its,673,864,2195.630936104,2125.71365106,-191
carcassonne-ucttuned235-vs-ucttuned105-1000its,761,952,2199.747482642,2135.988866728,-191
carcassonne-uct25-vs-uct475-1000its,645,835,2201.161335061,2145.838542576,-190
carcassonne-boltzmann320-vs-boltzmann25-1000its,663,853,2142.460054797,2096.662806695,-190
carcassonne-ucttuned205-vs-ucttuned20-1000its,715,905,2164.061001988,2077.135396154,-190
carcassonne-boltzmann100-vs-boltzmann230-1000its,717,907,2192.18475656,2137.564192258,-190
carcassonne-ucttuned255-vs-ucttuned15-1000its,732,922,2250.858881412,2200.128795022,-190
carcassonne-ucttuned145-vs-ucttuned180-1000its,756,946,2122.344849477,2103.509485342,-190
carcassonne-uct205-vs-uct125-1000its,632,821,2280.069448746,2236.812930969,-189
carcassonne-boltzmann25-vs-boltzmann180-1000its,681,870,2210.785740514,2176.318932814,-189
carcassonne-uct120-vs-uct75-1000its,752,941,2163.446009549,2079.727079624,-189
carcassonne-boltzmann315-vs-boltzmann345-1000its,650,838,2242.953760849,2223.466858686,-188
carcassonne-uct30-vs-uct210-1000its,669,857,2180.013868966,2116.540553674,-188
carcassonne-boltzmann430-vs-boltzmann125-1000its,699,887,2211.239612697,2165.088905062,-188
carcassonne-uct255-vs-uct275-1000its,713,901,2180.53459177,2132.659385877,-188
carcassonne-boltzmann55-vs-boltzmann165-1000its,719,907,2167.836292111,2123.740996615,-188
carcassonne-ucttuned355-vs-ucttuned490-1000its,724,912,2234.82688683,2192.394977322,-188
carcassonne-uct350-vs-uct205-1000its,728,916,2214.052156623,2161.713616536,-188
carcassonne-uct165-vs-uct360-1000its,729,917,2240.818319637,2199.848615356,-188
carcassonne-uct145-vs-uct205-1000its,757,945,2184.029050345,2143.400458229,-188
carcassonne-uct120-vs-uct330-1000its,652,839,2239.633161101,2202.703337519,-187
carcassonne-boltzmann290-vs-boltzmann275-1000its,676,863,2191.60035975,2146.696943145,-187
carcassonne-ucttuned470-vs-ucttuned100-1000its,677,864,2199.895468842,2176.168689656,-187
carcassonne-boltzmann440-vs-boltzmann280-1000its,695,882,2192.043732681,2162.328949975,-187
carcassonne-uct225-vs-uct235-1000its,696,883,2246.16559824,2227.619961138,-187
carcassonne-ucttuned275-vs-ucttuned280-1000its,720,907,2208.454670934,2149.253019956,-187
carcassonne-uct110-vs-uct55-1000its,734,921,2140.290864001,2153.433830198,-187
carcassonne-boltzmann210-vs-boltzmann370-1000its,763,950,2114.379010322,2080.265902312,-187
carcassonne-uct355-vs-uct390-1000its,656,842,2230.522104818,2172.774070174,-186
carcassonne-ucttuned265-vs-ucttuned335-1000its,665,851,2229.788182628,2166.632823791,-186
carcassonne-boltzmann460-vs-boltzmann125-1000its,667,853,2243.962491442,2187.883894248,-186
carcassonne-boltzmann345-vs-boltzmann420-1000its,694,880,2213.386096064,2195.193762657,-186
carcassonne-ucttuned310-vs-ucttuned50-1000its,749,935,2227.92078667,2178.170900517,-186
carcassonne-ucttuned275-vs-ucttuned470-1000its,773,959,2215.202992559,2174.055468216,-186
carcassonne-ucttuned390-vs-ucttuned480-1000its,828,1014,2170.863654246,2117.640695493,-186
carcassonne-uct140-vs-uct70-1000its,671,856,2216.911434993,2162.978821838,-185
carcassonne-boltzmann430-vs-boltzmann230-1000its,676,861,2192.563434369,2150.436635889,-185
carcassonne-ucttuned380-vs-ucttuned20-1000its,759,944,2242.098129849,2233.341660391,-185
carcassonne-uct225-vs-uct85-1000its,784,969,2153.801713687,2090.395403822,-185
carcassonne-uct130-vs-uct315-1000its,677,861,2204.024843265,2157.686755965,-184
carcassonne-ucttuned360-vs-ucttuned65-1000its,699,883,2147.655523401,2100.440078389,-184
carcassonne-ucttuned465-vs-ucttuned50-1000its,721,905,2222.332151478,2171.358723727,-184
carcassonne-uct205-vs-uct50-1000its,727,911,2247.339551262,2233.51305136,-184
carcassonne-ucttuned310-vs-ucttuned405-1000its,738,922,2193.093010308,2141.449783418,-184
carcassonne-boltzmann205-vs-boltzmann35-1000its,789,973,2134.675539496,2107.989794019,-184
carcassonne-boltzmann200-vs-boltzmann270-1000its,686,869,2139.102810603,2079.08713586,-183
carcassonne-ucttuned395-vs-ucttuned255-1000its,780,963,2172.274424118,2119.411278057,-183
carcassonne-ucttuned175-vs-ucttuned265-1000its,665,847,2177.44810663,2120.180836537,-182
carcassonne-uct215-vs-uct10-1000its,723,905,2188.822887058,2134.125644633,-182
carcassonne-boltzmann250-vs-boltzmann280-1000its,738,920,2155.104468952,2166.289478052,-182
carcassonne-uct300-vs-uct410-1000its,604,785,2123.489271887,2070.670755449,-181
carcassonne-boltzmann380-vs-boltzmann315-1000its,641,822,2160.847061808,2151.884138175,-181
carcassonne-ucttuned100-vs-ucttuned75-1000its,641,822,2223.377247552,2164.176594537,-181
carcassonne-ucttuned180-vs-ucttuned420-1000its,643,824,2220.43985955,2163.60556052,-181
carcassonne-uct140-vs-uct255-1000its,693,874,2184.664404039,2144.579192492,-181
carcassonne-uct455-vs-uct185-1000its,704,885,2237.798828701,2144.910884871,-181
carcassonne-ucttuned300-vs-ucttuned15-1000its,735,916,2211.395967966,2167.25680569,-181
carcassonne-ucttuned280-vs-ucttuned20-1000its,752,933,2279.447774086,2236.531735675,-181
carcassonne-boltzmann175-vs-boltzmann335-1000its,672,852,2256.771503847,2212.595836247,-180
carcassonne-boltzmann60-vs-boltzmann390-1000its,678,858,2179.496987625,2121.957270477,-180
carcassonne-uct90-vs-uct300-1000its,705,885,2080.862307687,2080.403377272,-180
carcassonne-boltzmann400-vs-boltzmann315-1000its,728,908,2184.609622576,2114.129859213,-180
carcassonne-ucttuned280-vs-ucttuned185-1000its,731,911,2116.02766701,2084.400400251,-180
carcassonne-ucttuned235-vs-ucttuned40-1000its,740,920,2213.171683298,2173.449291007,-180
carcassonne-ucttuned35-vs-ucttuned10-1000its,741,921,2178.59433264,2164.488632936,-180
carcassonne-uct265-vs-uct35-1000its,764,944,2204.216101126,2173.935157997,-180
carcassonne-ucttuned155-vs-ucttuned45-1000its,662,841,2225.091550536,2210.621781972,-179
carcassonne-uct305-vs-uct220-1000its,675,854,2151.455452599,2130.305402944,-179
carcassonne-boltzmann210-vs-boltzmann5-1000its,708,887,2129.647865349,2098.997414989,-179
carcassonne-boltzmann450-vs-boltzmann485-1000its,711,890,2139.359073469,2089.943625805,-179
carcassonne-ucttuned155-vs-ucttuned170-1000its,874,1053,2215.494824564,2186.107738599,-179
carcassonne-boltzmann210-vs-boltzmann100-1000its,642,820,2201.408826725,2176.257845789,-178
carcassonne-ucttuned45-vs-ucttuned65-1000its,703,881,2183.394742172,2136.675590538,-178
carcassonne-uct100-vs-uct320-1000its,718,896,2148.604554873,2142.587956426,-178
carcassonne-ucttuned495-vs-ucttuned275-1000its,726,904,2148.319739788,2100.565670847,-178
carcassonne-boltzmann400-vs-boltzmann230-1000its,655,832,2128.702445197,2081.066530589,-177
carcassonne-uct365-vs-uct390-1000its,679,856,2172.210523266,2155.919938112,-177
carcassonne-boltzmann465-vs-boltzmann135-1000its,686,863,2151.989851631,2085.414615999,-177
carcassonne-boltzmann235-vs-boltzmann165-1000its,708,885,2230.694747539,2205.359757161,-177
carcassonne-ucttuned485-vs-ucttuned230-1000its,710,887,2230.729909029,2197.597575256,-177
carcassonne-boltzmann310-vs-boltzmann50-1000its,719,896,2200.215646732,2138.057154883,-177
carcassonne-uct430-vs-uct480-1000its,740,917,2214.182498443,2163.835577901,-177
carcassonne-boltzmann225-vs-boltzmann200-1000its,766,943,2224.577426551,2173.459127394,-177
carcassonne-boltzmann155-vs-boltzmann185-1000its,815,992,2280.46937249,2240.20703229,-177
carcassonne-boltzmann65-vs-boltzmann235-1000its,700,876,2234.430891083,2200.560246021,-176
carcassonne-uct230-vs-uct480-1000its,711,887,2184.190970572,2147.974839933,-176
carcassonne-boltzmann445-vs-boltzmann285-1000its,728,904,2182.17686699,2159.282758412,-176
carcassonne-boltzmann40-vs-boltzmann75-1000its,734,910,2321.807396897,2274.807620574,-176
carcassonne-ucttuned30-vs-ucttuned330-1000its,794,970,2191.974779647,2182.97151198,-176
carcassonne-ucttuned255-vs-ucttuned285-1000its,650,825,2201.644831899,2185.40954025,-175
carcassonne-uct380-vs-uct40-1000its,658,833,2188.07726057,2152.029905052,-175
carcassonne-uct210-vs-uct380-1000its,674,849,2161.564358279,2120.922123439,-175
carcassonne-uct425-vs-uct210-1000its,678,853,2124.911464648,2093.850816343,-175
carcassonne-ucttuned345-vs-ucttuned315-1000its,691,866,2150.728518706,2098.925017941,-175
carcassonne-boltzmann330-vs-boltzmann190-1000its,723,898,2199.814463572,2135.58015869,-175
carcassonne-uct250-vs-uct355-1000its,744,919,2163.926179518,2159.841787871,-175
carcassonne-uct45-vs-uct445-1000its,747,922,2256.531198987,2185.310374478,-175
carcassonne-ucttuned180-vs-ucttuned260-1000its,767,942,2193.319724403,2140.123915949,-175
carcassonne-ucttuned55-vs-ucttuned360-1000its,664,838,2200.993062541,2110.328362144,-174
carcassonne-uct160-vs-uct65-1000its,667,841,2128.247556423,2066.844250357,-174
carcassonne-boltzmann270-vs-boltzmann215-1000its,670,844,2125.293100973,2048.105672152,-174
carcassonne-ucttuned450-vs-ucttuned345-1000its,674,848,2178.687475507,2118.011528102,-174
carcassonne-boltzmann380-vs-boltzmann450-1000its,689,863,2219.536913866,2163.356534465,-174
carcassonne-boltzmann105-vs-boltzmann475-1000its,694,868,2234.431578608,2148.981551021,-174
carcassonne-boltzmann45-vs-boltzmann355-1000its,696,870,2135.156644645,2067.767767844,-174
carcassonne-ucttuned370-vs-ucttuned290-1000its,701,875,2169.595172176,2142.259877553,-174
carcassonne-boltzmann20-vs-boltzmann10-1000its,702,876,2176.440825107,2149.931060901,-174
carcassonne-ucttuned465-vs-ucttuned300-1000its,702,876,2224.362941791,2211.896753463,-174
carcassonne-boltzmann145-vs-boltzmann190-1000its,724,898,2240.215720128,2215.967586204,-174
carcassonne-ucttuned390-vs-ucttuned25-1000its,733,907,2227.093491099,2212.421808955,-174
carcassonne-boltzmann375-vs-boltzmann305-1000its,742,916,2238.404044865,2152.391065285,-174
carcassonne-ucttuned140-vs-ucttuned450-1000its,667,840,2267.624175775,2259.52790015,-173
carcassonne-ucttuned405-vs-ucttuned80-1000its,682,855,2231.63573062,2212.761161033,-173
carcassonne-uct80-vs-uct240-1000its,701,874,2196.728510296,2193.930590471,-173
carcassonne-boltzmann410-vs-boltzmann20-1000its,724,897,2131.939642346,2080.415550501,-173
carcassonne-boltzmann415-vs-boltzmann345-1000its,727,900,2201.176950883,2135.099505785,-173
carcassonne-uct290-vs-uct245-1000its,731,904,2156.459077898,2137.83547735,-173
carcassonne-boltzmann290-vs-boltzmann25-1000its,739,912,2269.036891101,2226.438238188,-173
carcassonne-ucttuned325-vs-ucttuned265-1000its,537,709,1752.587814104,1759.228458797,-172
carcassonne-ucttuned430-vs-ucttuned285-1000its,595,767,1818.254255091,1779.972508959,-172
carcassonne-boltzmann415-vs-boltzmann470-1000its,615,787,2197.572123934,2100.612462167,-172
carcassonne-boltzmann305-vs-boltzmann170-1000its,691,863,2231.91728173,2169.922851132,-172
carcassonne-ucttuned470-vs-ucttuned85-1000its,696,868,2238.105349147,2206.547670581,-172
carcassonne-boltzmann35-vs-boltzmann55-1000its,735,907,2151.810805634,2142.081679554,-172
carcassonne-ucttuned430-vs-ucttuned325-1000its,751,923,2163.63221038,2145.968212149,-172
carcassonne-ucttuned235-vs-ucttuned45-1000its,752,924,2088.922254551,2045.931044744,-172
carcassonne-uct210-vs-uct180-1000its,759,931,2134.337599008,2111.236685067,-172
carcassonne-boltzmann155-vs-boltzmann385-1000its,671,842,2194.459483429,2150.024036419,-171
carcassonne-boltzmann325-vs-boltzmann395-1000its,702,873,2170.314317274,2136.148998657,-171
carcassonne-boltzmann335-vs-boltzmann160-1000its,705,876,2200.969598819,2166.88612339,-171
carcassonne-uct65-vs-uct390-1000its,709,880,2232.458658733,2187.919819557,-171
carcassonne-uct150-vs-uct25-1000its,524,694,1727.629392108,1704.725911965,-170
carcassonne-uct410-vs-uct60-1000its,651,821,2216.676686392,2162.019159817,-170
carcassonne-uct55-vs-uct395-1000its,662,832,2161.02254779,2116.356579764,-170
carcassonne-boltzmann15-vs-boltzmann435-1000its,684,854,2191.856192478,2172.420451913,-170
carcassonne-uct365-vs-uct415-1000its,693,863,2220.483718807,2171.253877562,-170
carcassonne-ucttuned465-vs-ucttuned335-1000its,700,870,2186.685785556,2180.872671222,-170
carcassonne-ucttuned290-vs-ucttuned50-1000its,726,896,2154.208268811,2120.769527438,-170
carcassonne-boltzmann280-vs-boltzmann390-1000its,744,914,2105.192864573,2075.67808325,-170
carcassonne-boltzmann395-vs-boltzmann335-1000its,748,918,2197.644163569,2108.658623547,-170
carcassonne-boltzmann70-vs-boltzmann220-1000its,760,930,2231.225634772,2199.140070499,-170
carcassonne-uct270-vs-uct480-1000its,670,839,2204.133383923,2142.192538956,-169
carcassonne-uct70-vs-uct5-1000its,698,867,2226.533716222,2207.493479693,-169
carcassonne-ucttuned295-vs-ucttuned80-1000its,717,886,2231.159731765,2231.396703755,-169
carcassonne-uct415-vs-uct115-1000its,763,932,2192.917642321,2143.856331432,-169
carcassonne-boltzmann290-vs-boltzmann45-1000its,767,936,2176.416803888,2133.296025774,-169
carcassonne-ucttuned435-vs-ucttuned25-1000its,790,959,2216.968648491,2232.452392995,-169
carcassonne-ucttuned185-vs-ucttuned340-1000its,678,846,2249.474358802,2205.230457704,-168
carcassonne-boltzmann95-vs-boltzmann355-1000its,686,854,2154.616860635,2093.144704149,-168
carcassonne-uct350-vs-uct415-1000its,696,864,2231.038367521,2183.055231566,-168
carcassonne-ucttuned355-vs-ucttuned395-1000its,699,867,2208.897542841,2156.443439013,-168
carcassonne-uct360-vs-uct145-1000its,713,881,2241.557082876,2218.16890208,-168
carcassonne-uct360-vs-uct245-1000its,716,884,2180.387883162,2111.864323976,-168
carcassonne-uct395-vs-uct90-1000its,717,885,2193.23913213,2191.875104816,-168
carcassonne-ucttuned485-vs-ucttuned190-1000its,730,898,2320.81439081,2315.058137984,-168
carcassonne-uct185-vs-uct310-1000its,732,900,2225.188462865,2204.824482219,-168
carcassonne-ucttuned475-vs-ucttuned5-1000its,732,900,2225.863716049,2163.125891585,-168
carcassonne-uct380-vs-uct460-1000its,736,904,2193.004216235,2120.322777555,-168
carcassonne-ucttuned55-vs-ucttuned255-1000its,741,909,2250.911725707,2192.034549614,-168
carcassonne-boltzmann480-vs-boltzmann235-1000its,650,817,2201.227795242,2118.245870344,-167
carcassonne-uct325-vs-uct485-1000its,686,853,2266.681888629,2241.93294601,-167
carcassonne-boltzmann495-vs-boltzmann345-1000its,694,861,2165.374696675,2127.284242515,-167
carcassonne-ucttuned55-vs-ucttuned395-1000its,694,861,2148.930870742,2145.589935245,-167
carcassonne-uct210-vs-uct435-1000its,704,871,2204.729695726,2157.377297452,-167
carcassonne-boltzmann90-vs-boltzmann25-1000its,728,895,2237.129379708,2153.929385922,-167
carcassonne-ucttuned285-vs-ucttuned30-1000its,735,902,2223.571684497,2161.8869094,-167
carcassonne-uct405-vs-uct60-1000its,739,906,2229.087927725,2203.033363546,-167
carcassonne-ucttuned180-vs-ucttuned95-1000its,741,908,2164.648916238,2138.132894757,-167
carcassonne-uct370-vs-uct405-1000its,742,909,2197.344115863,2135.364259457,-167
carcassonne-uct260-vs-uct415-1000its,754,921,2225.626835896,2158.554159678,-167
carcassonne-ucttuned450-vs-ucttuned110-1000its,777,944,2246.302826067,2214.16525864,-167
carcassonne-uct285-vs-uct230-1000its,656,822,2240.169589257,2152.606949773,-166
carcassonne-boltzmann200-vs-boltzmann10-1000its,720,886,2188.856630313,2163.009339477,-166
carcassonne-boltzmann280-vs-boltzmann315-1000its,722,888,2224.133003298,2167.896709464,-166
carcassonne-ucttuned405-vs-ucttuned255-1000its,738,904,2181.560343949,2128.625415005,-166
carcassonne-ucttuned445-vs-ucttuned75-1000its,753,919,2223.753537984,2178.648322032,-166
carcassonne-uct310-vs-uct460-1000its,763,929,2221.219003699,2140.852995262,-166
carcassonne-uct120-vs-uct5-1000its,780,946,2188.609478817,2153.16665024,-166
carcassonne-boltzmann315-vs-boltzmann355-1000its,683,848,2199.999847169,2165.300275816,-165
carcassonne-boltzmann185-vs-boltzmann10-1000its,698,863,2167.070388295,2125.852055593,-165
carcassonne-boltzmann465-vs-boltzmann130-1000its,713,878,2164.316239986,2134.322397083,-165
carcassonne-uct240-vs-uct380-1000its,728,893,2197.885722361,2140.394639753,-165
carcassonne-uct355-vs-uct145-1000its,742,907,2168.194783389,2158.883616943,-165
carcassonne-boltzmann335-vs-boltzmann345-1000its,746,911,2185.297549756,2190.760096099,-165
carcassonne-boltzmann445-vs-boltzmann75-1000its,746,911,2189.06746817,2111.863225647,-165
carcassonne-uct170-vs-uct30-1000its,769,934,2160.000970669,2128.980743539,-165
carcassonne-boltzmann355-vs-boltzmann25-1000its,676,840,2205.862695241,2191.993546332,-164
carcassonne-ucttuned450-vs-ucttuned405-1000its,691,855,2233.779842602,2156.921404792,-164
carcassonne-boltzmann385-vs-boltzmann245-1000its,695,859,2243.293016618,2215.198867206,-164
carcassonne-uct135-vs-uct15-1000its,697,861,2142.002574109,2070.317757907,-164
carcassonne-uct20-vs-uct410-1000its,699,863,2080.209493825,2081.16261277,-164
carcassonne-boltzmann150-vs-boltzmann80-1000its,704,868,2211.501277409,2133.22939188,-164
carcassonne-ucttuned210-vs-ucttuned470-1000its,705,869,2206.530143414,2173.900420267,-164
carcassonne-boltzmann315-vs-boltzmann40-1000its,710,874,2172.531723532,2108.09258603,-164
carcassonne-ucttuned455-vs-ucttuned355-1000its,712,876,2197.176706611,2168.899959468,-164
carcassonne-boltzmann330-vs-boltzmann425-1000its,726,890,2210.755641973,2134.562330551,-164
carcassonne-uct235-vs-uct45-1000its,728,892,2203.077768815,2114.908832088,-164
carcassonne-ucttuned320-vs-ucttuned185-1000its,738,902,2093.666693595,2041.661674534,-164
carcassonne-uct125-vs-uct5-1000its,745,909,2245.998772265,2239.926080577,-164
carcassonne-boltzmann170-vs-boltzmann335-1000its,746,910,2173.500028717,2131.609947217,-164
carcassonne-boltzmann315-vs-boltzmann25-1000its,751,915,2151.238973316,2131.897746607,-164
carcassonne-uct55-vs-uct125-1000its,785,949,2231.912831632,2162.3086401,-164
carcassonne-uct135-vs-uct265-1000its,676,839,2135.288492007,2104.939232861,-163
carcassonne-uct425-vs-uct45-1000its,678,841,2179.946313496,2150.281960139,-163
carcassonne-uct135-vs-uct60-1000its,710,873,2179.145687716,2139.542738396,-163
carcassonne-uct415-vs-uct220-1000its,717,880,2209.594457694,2173.117587024,-163
carcassonne-ucttuned135-vs-ucttuned445-1000its,733,896,2319.009393003,2259.123935933,-163
carcassonne-ucttuned200-vs-ucttuned275-1000its,742,905,2188.368976923,2141.947461745,-163
carcassonne-boltzmann115-vs-boltzmann175-1000its,748,911,2181.405421839,2141.453702494,-163
carcassonne-uct450-vs-uct175-1000its,759,922,2186.052163614,2190.639453409,-163
carcassonne-boltzmann465-vs-boltzmann30-1000its,670,832,2208.274589153,2239.42271238,-162
carcassonne-boltzmann310-vs-boltzmann300-1000its,675,837,2267.41655386,2226.99086181,-162
carcassonne-boltzmann80-vs-boltzmann480-1000its,681,843,2176.295351044,2149.661947425,-162
carcassonne-boltzmann310-vs-boltzmann160-1000its,705,867,2192.430436859,2144.376107941,-162
carcassonne-ucttuned480-vs-ucttuned275-1000its,708,870,2165.953097515,2121.454749648,-162
carcassonne-uct60-vs-uct215-1000its,714,876,2137.75571774,2102.876045156,-162
carcassonne-ucttuned305-vs-ucttuned95-1000its,735,897,2182.126580384,2145.039457131,-162
carcassonne-ucttuned250-vs-ucttuned15-1000its,770,932,2099.712781811,2040.953981175,-162
carcassonne-uct335-vs-uct460-1000its,676,837,2159.741689191,2102.499027941,-161
carcassonne-boltzmann410-vs-boltzmann175-1000its,684,845,2140.216389678,2115.285656153,-161
carcassonne-boltzmann345-vs-boltzmann465-1000its,687,848,2195.859954912,2166.888973229,-161
carcassonne-uct285-vs-uct170-1000its,694,855,2175.229862869,2124.142344428,-161
carcassonne-uct270-vs-uct10-1000its,708,869,2304.209918637,2244.88304882,-161
carcassonne-uct230-vs-uct170-1000its,723,884,2149.77599513,2103.560518994,-161
carcassonne-ucttuned495-vs-ucttuned100-1000its,724,885,2198.637899808,2157.465627833,-161
carcassonne-uct185-vs-uct325-1000its,732,893,2192.755818937,2126.303146473,-161
carcassonne-uct120-vs-uct230-1000its,747,908,2213.343466021,2157.638360948,-161
carcassonne-boltzmann50-vs-boltzmann30-1000its,760,921,2146.968101441,2142.925855966,-161
carcassonne-boltzmann80-vs-boltzmann65-1000its,763,924,2190.754391478,2175.610730145,-161
carcassonne-uct340-vs-uct315-1000its,769,930,2135.29054393,2093.2580975,-161
carcassonne-boltzmann315-vs-boltzmann435-1000its,639,799,2195.057742185,2186.28879981,-160
carcassonne-boltzmann310-vs-boltzmann225-1000its,676,836,2240.103987229,2199.216735327,-160
carcassonne-uct70-vs-uct460-1000its,695,855,2204.173154448,2186.029486462,-160
carcassonne-boltzmann435-vs-boltzmann105-1000its,696,856,2269.455347284,2232.597584997,-160
carcassonne-boltzmann140-vs-boltzmann190-1000its,722,882,2230.898156886,2221.178434087,-160
carcassonne-boltzmann355-vs-boltzmann180-1000its,732,892,2194.97901422,2194.44779755,-160
carcassonne-uct125-vs-uct360-1000its,735,895,2185.281000749,2128.840389726,-160
carcassonne-ucttuned220-vs-ucttuned195-1000its,740,900,2264.775428448,2231.531868182,-160
carcassonne-boltzmann235-vs-boltzmann245-1000its,747,907,2216.70214375,2154.899672314,-160
carcassonne-uct375-vs-uct95-1000its,760,920,2262.310418607,2215.210213356,-160
carcassonne-ucttuned170-vs-ucttuned10-1000its,824,984,2176.736848318,2177.687707842,-160
carcassonne-boltzmann100-vs-boltzmann135-1000its,646,805,2151.705698663,2101.632485962,-159
carcassonne-ucttuned300-vs-ucttuned130-1000its,666,825,2238.918148466,2172.464614716,-159
carcassonne-uct475-vs-uct325-1000its,682,841,2228.896559276,2190.214009397,-159
carcassonne-uct20-vs-uct325-1000its,697,856,2226.067819104,2151.543148234,-159
carcassonne-boltzmann280-vs-boltzmann105-1000its,699,858,2201.218679774,2110.340987773,-159
carcassonne-ucttuned210-vs-ucttuned120-1000its,699,858,2242.138193027,2218.717851419,-159
carcassonne-boltzmann180-vs-boltzmann85-1000its,707,866,2254.522933393,2195.497395833,-159
carcassonne-ucttuned460-vs-ucttuned430-1000its,730,889,2174.702326327,2126.840254822,-159
carcassonne-boltzmann25-vs-boltzmann490-1000its,731,890,2182.015880105,2132.879194617,-159
carcassonne-boltzmann155-vs-boltzmann285-1000its,732,891,2136.337679951,2137.6184035,-159
carcassonne-ucttuned20-vs-ucttuned5-1000its,733,892,2166.713423314,2134.371837407,-159
carcassonne-boltzmann445-vs-boltzmann135-1000its,757,916,2168.28643177,2071.228731917,-159
carcassonne-uct455-vs-uct30-1000its,760,919,2254.901303376,2232.424695144,-159
carcassonne-ucttuned85-vs-ucttuned290-1000its,797,956,2249.618306073,2246.144806333,-159
carcassonne-uct345-vs-uct305-1000its,671,829,2274.75266607,2287.177545211,-158
carcassonne-ucttuned230-vs-ucttuned70-1000its,684,842,2219.011418953,2208.73438929,-158
carcassonne-ucttuned490-vs-ucttuned485-1000its,694,852,2194.459005644,2128.186057232,-158
carcassonne-uct275-vs-uct195-1000its,695,853,2219.455764482,2176.371480308,-158
carcassonne-uct245-vs-uct65-1000its,720,878,2157.331580242,2097.272487421,-158
carcassonne-boltzmann260-vs-boltzmann400-1000its,742,900,2150.531630828,2143.034935476,-158
carcassonne-ucttuned240-vs-ucttuned35-1000its,746,904,2160.564592595,2130.605939119,-158
carcassonne-ucttuned140-vs-ucttuned480-1000its,749,907,2196.639700155,2185.992259241,-158
carcassonne-uct165-vs-uct110-1000its,763,921,2156.407028206,2130.260204194,-158
carcassonne-ucttuned350-vs-ucttuned110-1000its,792,950,2172.830593355,2165.860030918,-158
carcassonne-ucttuned195-vs-ucttuned20-1000its,809,967,2195.853392022,2124.074123763,-158
carcassonne-boltzmann435-vs-boltzmann140-1000its,654,811,2161.781392033,2111.184753949,-157
carcassonne-uct65-vs-uct75-1000its,655,812,2213.718895971,2205.970726692,-157
carcassonne-ucttuned290-vs-ucttuned105-1000its,657,814,2198.073524205,2191.215249524,-157
carcassonne-uct475-vs-uct180-1000its,670,827,2194.348493783,2161.819845011,-157
carcassonne-uct160-vs-uct90-1000its,678,835,2214.593218673,2139.497608788,-157
carcassonne-boltzmann190-vs-boltzmann150-1000its,697,854,2240.387224169,2188.086844065,-157
carcassonne-boltzmann385-vs-boltzmann220-1000its,698,855,2158.696128737,2134.92330917,-157
carcassonne-uct165-vs-uct95-1000its,700,857,2245.444473007,2202.111564069,-157
carcassonne-boltzmann295-vs-boltzmann230-1000its,717,874,2232.985857195,2154.131081659,-157
carcassonne-boltzmann320-vs-boltzmann165-1000its,719,876,2118.779602303,2083.778115812,-157
carcassonne-uct135-vs-uct385-1000its,719,876,2214.852707582,2147.461050394,-157
carcassonne-boltzmann265-vs-boltzmann30-1000its,726,883,2220.588479364,2170.79186201,-157
carcassonne-ucttuned335-vs-ucttuned180-1000its,755,912,2165.734650251,2123.5949749,-157
carcassonne-ucttuned105-vs-ucttuned200-1000its,756,913,2215.502943267,2150.938772753,-157
carcassonne-boltzmann220-vs-boltzmann385-1000its,757,914,2185.150731218,2191.135442469,-157
carcassonne-boltzmann265-vs-boltzmann5-1000its,761,918,2186.253631692,2207.254383832,-157
carcassonne-ucttuned250-vs-ucttuned80-1000its,772,929,2206.387032505,2160.483772032,-157
carcassonne-uct0-vs-uct495-1000its,538,694,2030.691684138,2180.624543676,-156
carcassonne-boltzmann190-vs-boltzmann100-1000its,669,825,2231.758292178,2206.280064845,-156
carcassonne-uct495-vs-uct40-1000its,697,853,2174.979024597,2146.618294242,-156
carcassonne-ucttuned270-vs-ucttuned130-1000its,702,858,2229.320344144,2132.711646866,-156
carcassonne-ucttuned360-vs-ucttuned20-1000its,703,859,2231.482758698,2185.080877529,-156
carcassonne-uct465-vs-uct415-1000its,707,863,2276.722496865,2248.401715663,-156
carcassonne-uct190-vs-uct220-1000its,709,865,2229.605306573,2166.883427573,-156
carcassonne-boltzmann305-vs-boltzmann25-1000its,723,879,2231.155910221,2177.537994783,-156
carcassonne-uct420-vs-uct230-1000its,724,880,2274.473309319,2215.901159415,-156
carcassonne-boltzmann410-vs-boltzmann455-1000its,730,886,2252.748538676,2197.562817578,-156
carcassonne-ucttuned50-vs-ucttuned230-1000its,735,891,2174.05462428,2146.809398498,-156
carcassonne-uct465-vs-uct275-1000its,737,893,2182.31209333,2196.353166783,-156
carcassonne-uct45-vs-uct80-1000its,748,904,2212.778852981,2147.860821661,-156
carcassonne-uct100-vs-uct15-1000its,757,913,2186.647966047,2147.197529317,-156
carcassonne-uct115-vs-uct240-1000its,760,916,2266.661402091,2216.112591336,-156
carcassonne-boltzmann120-vs-boltzmann75-1000its,764,920,2200.160352848,2151.835889595,-156
carcassonne-uct330-vs-uct420-1000its,772,928,2187.574984072,2154.141963557,-156
carcassonne-uct170-vs-uct5-1000its,790,946,2212.300901696,2195.287565083,-156
carcassonne-boltzmann195-vs-boltzmann335-1000its,677,832,2257.767045696,2195.390804236,-155
carcassonne-boltzmann420-vs-boltzmann140-1000its,687,842,2263.196623744,2185.361108719,-155
carcassonne-ucttuned295-vs-ucttuned325-1000its,688,843,2159.104969983,2109.316956936,-155
carcassonne-boltzmann270-vs-boltzmann30-1000its,690,845,2184.352113052,2148.331782579,-155
carcassonne-ucttuned225-vs-ucttuned470-1000its,693,848,2187.746488654,2135.962592982,-155
carcassonne-uct230-vs-uct345-1000its,708,863,2174.302927405,2113.999144248,-155
carcassonne-uct150-vs-uct475-1000its,723,878,2163.587858659,2146.509697463,-155
carcassonne-ucttuned435-vs-ucttuned225-1000its,724,879,2207.235021582,2198.054753104,-155
carcassonne-ucttuned285-vs-ucttuned10-1000its,725,880,2180.559248765,2136.557843541,-155
carcassonne-ucttuned440-vs-ucttuned70-1000its,726,881,2198.429063497,2184.612884093,-155
carcassonne-boltzmann70-vs-boltzmann120-1000its,728,883,2156.773972471,2142.554323193,-155
carcassonne-boltzmann60-vs-boltzmann330-1000its,742,897,2205.385344731,2141.947930227,-155
carcassonne-uct40-vs-uct180-1000its,769,924,2284.326930284,2269.963899014,-155
carcassonne-ucttuned275-vs-ucttuned5-1000its,796,951,2149.181540776,2093.549299469,-155
carcassonne-ucttuned195-vs-ucttuned95-1000its,798,953,2152.484579653,2116.113928715,-155
carcassonne-boltzmann340-vs-boltzmann220-1000its,665,819,2148.943438309,2081.174891618,-154
carcassonne-uct290-vs-uct420-1000its,670,824,2133.18144196,2065.051839883,-154
carcassonne-uct385-vs-uct275-1000its,678,832,2181.19510155,2159.07897844,-154
carcassonne-boltzmann405-vs-boltzmann455-1000its,697,851,2272.754499396,2199.900004497,-154
carcassonne-boltzmann150-vs-boltzmann325-1000its,712,866,2186.913378385,2139.285145157,-154
carcassonne-ucttuned145-vs-ucttuned65-1000its,725,879,2165.406811639,2132.230800036,-154
carcassonne-boltzmann360-vs-boltzmann245-1000its,730,884,2192.410737646,2141.347646525,-154
carcassonne-boltzmann40-vs-boltzmann45-1000its,742,896,2225.056336047,2211.777831129,-154
carcassonne-boltzmann110-vs-boltzmann125-1000its,760,914,2118.829348094,2094.772882331,-154
carcassonne-boltzmann70-vs-boltzmann245-1000its,763,917,2151.104674182,2123.496246446,-154
carcassonne-uct260-vs-uct315-1000its,778,932,2229.065056937,2158.928299007,-154
carcassonne-uct370-vs-uct260-1000its,667,820,2182.336523965,2152.806125175,-153
carcassonne-boltzmann465-vs-boltzmann470-1000its,672,825,2154.260925102,2140.499448598,-153
carcassonne-boltzmann430-vs-boltzmann460-1000its,680,833,2246.64959372,2162.011413027,-153
carcassonne-ucttuned430-vs-ucttuned115-1000its,691,844,2218.404639356,2215.134320522,-153
carcassonne-ucttuned300-vs-ucttuned270-1000its,700,853,2224.475411698,2146.062910552,-153
carcassonne-ucttuned470-vs-ucttuned315-1000its,706,859,2262.014732854,2258.557631675,-153
carcassonne-uct305-vs-uct405-1000its,719,872,2256.963831698,2174.577524966,-153
carcassonne-boltzmann255-vs-boltzmann180-1000its,722,875,2160.631992738,2114.920791249,-153
carcassonne-ucttuned145-vs-ucttuned150-1000its,733,886,2166.064380188,2122.87771271,-153
carcassonne-uct245-vs-uct150-1000its,758,911,2202.110841758,2153.955053229,-153
carcassonne-uct460-vs-uct215-1000its,761,914,2145.339222923,2134.425975689,-153
carcassonne-uct355-vs-uct215-1000its,762,915,2184.234664703,2150.031549746,-153
carcassonne-ucttuned150-vs-ucttuned5-1000its,771,924,2139.155256279,2083.10132573,-153
carcassonne-uct175-vs-uct5-1000its,772,925,2304.781725559,2254.278021775,-153
carcassonne-uct210-vs-uct475-1000its,798,951,2306.405100628,2255.470816308,-153
carcassonne-uct60-vs-uct105-1000its,802,955,2192.778715469,2149.029966669,-153
carcassonne-uct455-vs-uct135-1000its,617,769,2147.111748222,2130.737761429,-152
carcassonne-ucttuned455-vs-ucttuned265-1000its,657,809,2187.600036923,2183.856090977,-152
carcassonne-ucttuned120-vs-ucttuned60-1000its,667,819,2202.489000704,2173.083646146,-152
carcassonne-boltzmann170-vs-boltzmann255-1000its,675,827,2224.781906669,2163.227422831,-152
carcassonne-boltzmann80-vs-boltzmann160-1000its,688,840,2261.533858989,2215.124214391,-152
carcassonne-ucttuned170-vs-ucttuned340-1000its,695,847,2165.251247418,2167.89174788,-152
carcassonne-ucttuned390-vs-ucttuned135-1000its,701,853,2289.467003781,2285.283692688,-152
carcassonne-ucttuned365-vs-ucttuned75-1000its,702,854,2155.152498076,2113.16531071,-152
carcassonne-uct110-vs-uct130-1000its,709,861,2204.805050511,2173.822752857,-152
carcassonne-ucttuned150-vs-ucttuned15-1000its,711,863,2121.599469966,2084.308631456,-152
carcassonne-uct145-vs-uct295-1000its,731,883,2308.953200964,2281.43612992,-152
carcassonne-uct125-vs-uct480-1000its,735,887,2143.395004956,2087.383021729,-152
carcassonne-uct450-vs-uct185-1000its,740,892,2208.919395373,2182.216359847,-152
carcassonne-uct470-vs-uct5-1000its,744,896,2185.176334539,2178.893446978,-152
carcassonne-uct495-vs-uct320-1000its,746,898,2189.713634036,2126.332772734,-152
carcassonne-ucttuned85-vs-ucttuned50-1000its,752,904,2163.317889173,2145.311756709,-152
carcassonne-uct350-vs-uct80-1000its,756,908,2226.638442868,2165.166125491,-152
carcassonne-uct210-vs-uct225-1000its,778,930,2197.717258387,2149.44407219,-152
carcassonne-ucttuned140-vs-ucttuned100-1000its,781,933,2188.76229059,2194.141592739,-152
carcassonne-boltzmann175-vs-boltzmann75-1000its,825,977,2164.851475081,2118.585769114,-152
carcassonne-ucttuned435-vs-ucttuned145-1000its,622,773,2201.263597188,2173.009730295,-151
carcassonne-boltzmann440-vs-boltzmann290-1000its,682,833,2205.668164696,2087.69622446,-151
carcassonne-boltzmann275-vs-boltzmann20-1000its,688,839,2186.576911818,2174.434088712,-151
carcassonne-boltzmann270-vs-boltzmann190-1000its,700,851,2209.060085206,2170.229803948,-151
carcassonne-ucttuned425-vs-ucttuned260-1000its,704,855,2197.347855071,2158.762509795,-151
carcassonne-ucttuned130-vs-ucttuned370-1000its,705,856,2159.105696994,2135.360693548,-151
carcassonne-ucttuned300-vs-ucttuned285-1000its,705,856,2220.56866422,2163.215918499,-151
carcassonne-uct100-vs-uct5-1000its,706,857,2173.695550702,2170.116206123,-151
carcassonne-uct495-vs-uct410-1000its,709,860,2194.413005076,2181.814098032,-151
carcassonne-ucttuned475-vs-ucttuned400-1000its,709,860,2232.396462561,2192.17325651,-151
carcassonne-uct335-vs-uct230-1000its,714,865,2214.287092214,2142.215433094,-151
carcassonne-boltzmann45-vs-boltzmann25-1000its,718,869,2168.505911522,2128.660403733,-151
carcassonne-uct390-vs-uct375-1000its,722,873,2123.649335348,2081.647228807,-151
carcassonne-ucttuned145-vs-ucttuned215-1000its,731,882,2198.529049217,2162.432145645,-151
carcassonne-boltzmann295-vs-boltzmann220-1000its,736,887,2189.47335769,2149.221634322,-151
carcassonne-ucttuned305-vs-ucttuned45-1000its,744,895,2207.951599296,2138.882007949,-151
carcassonne-uct425-vs-uct420-1000its,756,907,2189.394199947,2128.535808602,-151
carcassonne-uct140-vs-uct90-1000its,764,915,2179.590275995,2129.552635126,-151
carcassonne-ucttuned440-vs-ucttuned5-1000its,778,929,2200.678724657,2175.6299896,-151
carcassonne-ucttuned455-vs-ucttuned220-1000its,780,931,2170.918930007,2164.832333104,-151
carcassonne-boltzmann300-vs-boltzmann155-1000its,641,791,2169.055515982,2139.70549909,-150
carcassonne-uct210-vs-uct125-1000its,660,810,2205.134626047,2197.040059297,-150
carcassonne-boltzmann40-vs-boltzmann245-1000its,682,832,2158.772551974,2117.31573934,-150
carcassonne-uct385-vs-uct490-1000its,683,833,2141.236709193,2076.083847221,-150
carcassonne-uct235-vs-uct385-1000its,684,834,2157.034002943,2097.167067201,-150
carcassonne-uct320-vs-uct445-1000its,684,834,2202.166127156,2153.40868692,-150
carcassonne-boltzmann370-vs-boltzmann75-1000its,688,838,2161.945507532,2167.565495354,-150
carcassonne-uct25-vs-uct125-1000its,694,844,2201.627343378,2144.262596276,-150
carcassonne-uct400-vs-uct165-1000its,694,844,2152.304198944,2119.848456898,-150
carcassonne-boltzmann470-vs-boltzmann100-1000its,698,848,2148.329167494,2134.414874126,-150
carcassonne-uct415-vs-uct135-1000its,699,849,2227.480085318,2180.693067049,-150
carcassonne-uct190-vs-uct5-1000its,712,862,2165.093290753,2159.808155889,-150
carcassonne-boltzmann120-vs-boltzmann325-1000its,719,869,2208.71052442,2171.555765353,-150
carcassonne-boltzmann465-vs-boltzmann200-1000its,729,879,2290.817858151,2242.261216914,-150
carcassonne-uct190-vs-uct215-1000its,731,881,2158.326589204,2118.290625497,-150
carcassonne-ucttuned220-vs-ucttuned360-1000its,736,886,2176.982302268,2141.467497143,-150
carcassonne-uct150-vs-uct180-1000its,738,888,2173.769636395,2104.538852628,-150
carcassonne-ucttuned450-vs-ucttuned55-1000its,740,890,2147.148920427,2091.737096629,-150
carcassonne-uct85-vs-uct410-1000its,742,892,2098.430278859,2107.296368754,-150
carcassonne-boltzmann380-vs-boltzmann390-1000its,760,910,2203.131108651,2150.077391244,-150
carcassonne-boltzmann475-vs-boltzmann375-1000its,760,910,2210.226967702,2158.341124949,-150
carcassonne-ucttuned425-vs-ucttuned365-1000its,764,914,2193.511777655,2149.429653599,-150
carcassonne-uct365-vs-uct155-1000its,769,919,2216.173388853,2217.005667245,-150
carcassonne-ucttuned210-vs-ucttuned5-1000its,775,925,2180.185992154,2151.887415962,-150
carcassonne-boltzmann405-vs-boltzmann240-1000its,674,823,2173.366743953,2124.129691618,-149
carcassonne-uct110-vs-uct195-1000its,678,827,2129.855407082,2081.942452864,-149
carcassonne-boltzmann150-vs-boltzmann470-1000its,693,842,2161.314145676,2097.722640126,-149
carcassonne-ucttuned435-vs-ucttuned180-1000its,694,843,2187.31000264,2128.380418392,-149
carcassonne-boltzmann330-vs-boltzmann450-1000its,702,851,2241.578252916,2206.446712911,-149
carcassonne-boltzmann340-vs-boltzmann140-1000its,713,862,2216.106348949,2177.678757939,-149
carcassonne-uct270-vs-uct250-1000its,720,869,2262.059126112,2194.830850377,-149
carcassonne-ucttuned85-vs-ucttuned60-1000its,730,879,2216.638559726,2166.347929484,-149
carcassonne-ucttuned295-vs-ucttuned20-1000its,732,881,2224.06807794,2195.680064121,-149
carcassonne-boltzmann120-vs-boltzmann5-1000its,733,882,2268.772526043,2206.615500997,-149
carcassonne-ucttuned270-vs-ucttuned140-1000its,733,882,2183.612370463,2129.729191326,-149
carcassonne-boltzmann160-vs-boltzmann165-1000its,744,893,2177.189152605,2173.854593234,-149
carcassonne-ucttuned405-vs-ucttuned450-1000its,746,895,2166.391486235,2118.961582967,-149
carcassonne-boltzmann440-vs-boltzmann155-1000its,751,900,2167.95708959,2166.491888963,-149
carcassonne-uct25-vs-uct5-1000its,759,908,2207.049225144,2183.123751562,-149
carcassonne-uct450-vs-uct440-1000its,772,921,2179.518467541,2169.216259188,-149
carcassonne-uct340-vs-uct235-1000its,775,924,2203.065504336,2156.092737315,-149
carcassonne-uct15-vs-uct40-1000its,778,927,2151.418748341,2143.835835136,-149
carcassonne-ucttuned205-vs-ucttuned15-1000its,652,800,2160.359228905,2125.542901464,-148
carcassonne-ucttuned450-vs-ucttuned190-1000its,685,833,2180.436655422,2103.773101202,-148
carcassonne-ucttuned80-vs-ucttuned125-1000its,692,840,2140.167565529,2102.917041838,-148
carcassonne-boltzmann185-vs-boltzmann110-1000its,694,842,2176.449581346,2085.682837064,-148
carcassonne-boltzmann190-vs-boltzmann60-1000its,700,848,2223.11290513,2167.718064583,-148
carcassonne-ucttuned390-vs-ucttuned305-1000its,710,858,2205.272686856,2118.074440799,-148
carcassonne-uct260-vs-uct245-1000its,725,873,2220.80285053,2188.327126707,-148
carcassonne-ucttuned455-vs-ucttuned490-1000its,732,880,2220.534794555,2205.957408033,-148
carcassonne-boltzmann215-vs-boltzmann390-1000its,737,885,2236.816756166,2201.571921418,-148
carcassonne-boltzmann430-vs-boltzmann335-1000its,740,888,2179.414938179,2137.906059659,-148
carcassonne-ucttuned405-vs-ucttuned440-1000its,740,888,2103.876106646,2101.391673221,-148
carcassonne-uct445-vs-uct40-1000its,744,892,2193.253176473,2141.422802254,-148
carcassonne-boltzmann420-vs-boltzmann345-1000its,764,912,2164.610480156,2100.433482022,-148
carcassonne-ucttuned185-vs-ucttuned40-1000its,773,921,2209.248218572,2132.665125896,-148
carcassonne-ucttuned365-vs-ucttuned20-1000its,775,923,2088.230027526,2082.31653405,-148
carcassonne-uct410-vs-uct400-1000its,795,943,2301.208656905,2223.972061281,-148
carcassonne-uct155-vs-uct140-1000its,654,801,2181.920280118,2163.551412014,-147
carcassonne-uct230-vs-uct235-1000its,672,819,2162.171462997,2099.854910611,-147
carcassonne-uct435-vs-uct145-1000its,686,833,2213.620843332,2152.814548243,-147
carcassonne-uct55-vs-uct110-1000its,687,834,2192.154990118,2107.657897037,-147
carcassonne-uct40-vs-uct365-1000its,705,852,2199.70348961,2126.113484797,-147
carcassonne-uct220-vs-uct165-1000its,709,856,2166.251112563,2140.470482643,-147
carcassonne-boltzmann260-vs-boltzmann275-1000its,711,858,2228.65554684,2168.888750034,-147
carcassonne-boltzmann185-vs-boltzmann470-1000its,715,862,2152.095741067,2110.218813516,-147
carcassonne-ucttuned425-vs-ucttuned70-1000its,718,865,2211.967541935,2164.373552137,-147
carcassonne-ucttuned90-vs-ucttuned275-1000its,718,865,2174.745885115,2110.835830042,-147
carcassonne-boltzmann180-vs-boltzmann470-1000its,724,871,2169.633347078,2170.230582333,-147
carcassonne-uct320-vs-uct60-1000its,724,871,2211.885571379,2174.626379823,-147
carcassonne-uct300-vs-uct350-1000its,729,876,2246.698792852,2175.100627533,-147
carcassonne-ucttuned10-vs-ucttuned370-1000its,732,879,2127.413979784,2133.094286196,-147
carcassonne-boltzmann25-vs-boltzmann230-1000its,756,903,2234.978946727,2168.489044644,-147
carcassonne-uct195-vs-uct255-1000its,767,914,2186.766067524,2151.18672407,-147
carcassonne-boltzmann325-vs-boltzmann20-1000its,792,939,2198.710519531,2134.941009528,-147
carcassonne-boltzmann120-vs-boltzmann395-1000its,644,790,2231.192561249,2190.119266567,-146
carcassonne-uct110-vs-uct405-1000its,675,821,2214.779486702,2150.687436269,-146
carcassonne-uct370-vs-uct230-1000its,694,840,2211.999503154,2146.855918546,-146
carcassonne-uct150-vs-uct115-1000its,702,848,2175.232914451,2133.026279657,-146
carcassonne-uct110-vs-uct5-1000its,703,849,2238.565484944,2182.573131831,-146
carcassonne-boltzmann155-vs-boltzmann315-1000its,705,851,2213.782120203,2143.595048781,-146
carcassonne-boltzmann45-vs-boltzmann490-1000its,714,860,2186.790804002,2129.217821659,-146
carcassonne-boltzmann250-vs-boltzmann285-1000its,716,862,2203.80030879,2108.398622836,-146
carcassonne-uct15-vs-uct395-1000its,731,877,2172.866661653,2125.027749336,-146
carcassonne-boltzmann425-vs-boltzmann225-1000its,742,888,2124.656888075,2096.107899224,-146
carcassonne-boltzmann300-vs-boltzmann290-1000its,746,892,2213.881138899,2156.803084354,-146
carcassonne-boltzmann245-vs-boltzmann185-1000its,750,896,2166.04965772,2132.112940583,-146
carcassonne-boltzmann75-vs-boltzmann150-1000its,751,897,2156.421749705,2132.194571861,-146
carcassonne-ucttuned250-vs-ucttuned295-1000its,751,897,2172.241027188,2120.125179753,-146
carcassonne-uct485-vs-uct60-1000its,764,910,2249.651633714,2228.663333647,-146
carcassonne-uct100-vs-uct60-1000its,780,926,2231.286053014,2157.756483928,-146
carcassonne-uct80-vs-uct5-1000its,798,944,2152.257479663,2147.119647639,-146
carcassonne-ucttuned100-vs-ucttuned305-1000its,805,951,2205.231908389,2179.03854775,-146
carcassonne-boltzmann105-vs-boltzmann50-1000its,636,781,2225.421561628,2184.753546319,-145
carcassonne-boltzmann25-vs-boltzmann375-1000its,671,816,2211.99284649,2182.049034346,-145
carcassonne-ucttuned220-vs-ucttuned280-1000its,675,820,2210.59128859,2149.829430181,-145
carcassonne-boltzmann370-vs-boltzmann300-1000its,679,824,2197.808354078,2137.177400972,-145
carcassonne-boltzmann150-vs-boltzmann235-1000its,708,853,2253.451456939,2163.67555456,-145
carcassonne-uct160-vs-uct210-1000its,710,855,2198.966674162,2151.374046359,-145
carcassonne-uct465-vs-uct195-1000its,723,868,2208.582802179,2138.719073564,-145
carcassonne-ucttuned160-vs-ucttuned5-1000its,725,870,2186.972398586,2186.647891351,-145
carcassonne-uct50-vs-uct450-1000its,726,871,2266.110827029,2180.31277985,-145
carcassonne-ucttuned265-vs-ucttuned40-1000its,730,875,2198.844286787,2148.667210228,-145
carcassonne-ucttuned65-vs-ucttuned430-1000its,732,877,2250.777507061,2178.805412267,-145
carcassonne-ucttuned490-vs-ucttuned410-1000its,736,881,2190.929762517,2115.867998101,-145
carcassonne-ucttuned370-vs-ucttuned480-1000its,738,883,2194.053974732,2131.044883417,-145
carcassonne-ucttuned85-vs-ucttuned460-1000its,741,886,2187.537357184,2181.762190578,-145
carcassonne-uct125-vs-uct395-1000its,746,891,2131.335181658,2101.584263116,-145
carcassonne-ucttuned145-vs-ucttuned410-1000its,746,891,2269.899496047,2229.332098225,-145
carcassonne-uct255-vs-uct220-1000its,761,906,2175.33272749,2119.90291952,-145
carcassonne-uct140-vs-uct495-1000its,788,933,2095.447996303,2076.700762558,-145
carcassonne-ucttuned300-vs-ucttuned305-1000its,808,953,2151.051816204,2141.219144465,-145
carcassonne-uct485-vs-uct425-1000its,673,817,2139.531095501,2064.038911349,-144
carcassonne-boltzmann445-vs-boltzmann20-1000its,686,830,2235.216285453,2189.534087222,-144
carcassonne-ucttuned225-vs-ucttuned380-1000its,701,845,2156.778441769,2120.959685184,-144
carcassonne-ucttuned485-vs-ucttuned380-1000its,718,862,2219.170653703,2179.316847471,-144
carcassonne-uct350-vs-uct20-1000its,720,864,2290.802650919,2225.954492914,-144
carcassonne-ucttuned370-vs-ucttuned265-1000its,721,865,2174.460806802,2157.020252868,-144
carcassonne-uct25-vs-uct335-1000its,725,869,2237.104686643,2204.058585473,-144
carcassonne-boltzmann330-vs-boltzmann155-1000its,737,881,2211.987492703,2147.746522558,-144
carcassonne-ucttuned150-vs-ucttuned270-1000its,738,882,2178.707130939,2158.817762201,-144
carcassonne-uct160-vs-uct275-1000its,741,885,2164.836503319,2136.209726625,-144
carcassonne-ucttuned180-vs-ucttuned155-1000its,744,888,2203.822646521,2153.873804031,-144
carcassonne-ucttuned435-vs-ucttuned235-1000its,746,890,2155.721282703,2145.31499095,-144
carcassonne-uct465-vs-uct15-1000its,747,891,2207.222854733,2170.130486679,-144
carcassonne-ucttuned480-vs-ucttuned415-1000its,754,898,2229.118705958,2178.124542266,-144
carcassonne-uct30-vs-uct150-1000its,757,901,2222.348765878,2148.734463042,-144
carcassonne-uct350-vs-uct140-1000its,770,914,2222.807663794,2158.190254991,-144
carcassonne-uct425-vs-uct70-1000its,776,920,2224.498538664,2146.339325345,-144
carcassonne-ucttuned260-vs-ucttuned220-1000its,803,947,2198.554001985,2129.403132502,-144
carcassonne-boltzmann280-vs-boltzmann260-1000its,640,783,2217.306968187,2191.663623732,-143
carcassonne-uct95-vs-uct375-1000its,661,804,2153.960373766,2125.614202453,-143
carcassonne-uct135-vs-uct495-1000its,679,822,2265.078896416,2237.980214824,-143
carcassonne-uct65-vs-uct420-1000its,688,831,2175.869299125,2168.590834443,-143
carcassonne-ucttuned335-vs-ucttuned430-1000its,688,831,2130.607753619,2101.63361229,-143
carcassonne-uct400-vs-uct100-1000its,692,835,2298.240014807,2197.893595832,-143
carcassonne-uct85-vs-uct70-1000its,700,843,2087.399771872,2066.558958256,-143
carcassonne-boltzmann395-vs-boltzmann25-1000its,705,848,2195.781240553,2183.565403358,-143
carcassonne-boltzmann385-vs-boltzmann135-1000its,710,853,2186.726125091,2153.134059129,-143
carcassonne-boltzmann55-vs-boltzmann325-1000its,711,854,2191.255944558,2151.482575065,-143
carcassonne-uct290-vs-uct260-1000its,713,856,2146.161158775,2130.151806283,-143
carcassonne-boltzmann115-vs-boltzmann275-1000its,718,861,2212.433559943,2185.662830117,-143
carcassonne-uct140-vs-uct345-1000its,720,863,2197.455240674,2205.46411353,-143
carcassonne-uct125-vs-uct65-1000its,731,874,2202.794829413,2090.155422379,-143
carcassonne-ucttuned290-vs-ucttuned445-1000its,737,880,2138.146932442,2109.357621488,-143
carcassonne-boltzmann450-vs-boltzmann435-1000its,745,888,2211.373210756,2155.024975117,-143
carcassonne-uct210-vs-uct5-1000its,749,892,2162.415214209,2138.275256496,-143
carcassonne-ucttuned175-vs-ucttuned415-1000its,754,897,2122.1941126,2080.72434245,-143
carcassonne-uct400-vs-uct10-1000its,757,900,2153.402139066,2141.595556559,-143
carcassonne-boltzmann295-vs-boltzmann45-1000its,763,906,2158.965677078,2139.106074415,-143
carcassonne-uct280-vs-uct70-1000its,766,909,2180.509246436,2127.900804841,-143
carcassonne-uct155-vs-uct50-1000its,786,929,2214.386128845,2157.325274215,-143
carcassonne-ucttuned150-vs-ucttuned130-1000its,786,929,2223.02832068,2150.119837669,-143
carcassonne-ucttuned315-vs-ucttuned15-1000its,826,969,2173.390936458,2137.833721479,-143
carcassonne-boltzmann200-vs-boltzmann330-1000its,670,812,2153.128991902,2118.548339828,-142
carcassonne-boltzmann135-vs-boltzmann310-1000its,677,819,2238.349941527,2201.609931411,-142
carcassonne-uct140-vs-uct440-1000its,677,819,2158.16130151,2105.948270422,-142
carcassonne-boltzmann125-vs-boltzmann10-1000its,689,831,2107.424158465,2090.427460393,-142
carcassonne-uct320-vs-uct425-1000its,694,836,2259.573545111,2124.050689825,-142
carcassonne-ucttuned140-vs-ucttuned50-1000its,697,839,2128.874409637,2126.872814565,-142
carcassonne-boltzmann175-vs-boltzmann130-1000its,706,848,2193.007660469,2139.084884137,-142
carcassonne-ucttuned280-vs-ucttuned305-1000its,709,851,2249.22629355,2188.438550272,-142
carcassonne-boltzmann410-vs-boltzmann395-1000its,710,852,2228.96700526,2154.967276451,-142
carcassonne-uct160-vs-uct295-1000its,710,852,2301.036228062,2235.149155387,-142
carcassonne-boltzmann475-vs-boltzmann305-1000its,713,855,2225.965876349,2206.233511532,-142
carcassonne-boltzmann195-vs-boltzmann190-1000its,719,861,2265.291821191,2226.694481784,-142
carcassonne-boltzmann55-vs-boltzmann75-1000its,723,865,2180.725426398,2144.310600325,-142
carcassonne-boltzmann25-vs-boltzmann80-1000its,726,868,2187.815049133,2159.599956337,-142
carcassonne-ucttuned15-vs-ucttuned165-1000its,731,873,2154.422892536,2114.999672,-142
carcassonne-uct180-vs-uct40-1000its,733,875,2211.778532823,2148.331731821,-142
carcassonne-boltzmann375-vs-boltzmann180-1000its,756,898,2222.915396812,2164.804436193,-142
carcassonne-ucttuned165-vs-ucttuned245-1000its,761,903,2158.060067602,2144.218541372,-142
carcassonne-ucttuned315-vs-ucttuned260-1000its,767,909,2147.758275546,2128.581549694,-142
carcassonne-uct280-vs-uct60-1000its,772,914,2174.623402036,2152.4515523,-142
carcassonne-ucttuned310-vs-ucttuned280-1000its,814,956,2168.459563748,2153.314857047,-142
carcassonne-ucttuned300-vs-ucttuned210-1000its,660,801,2195.219165188,2175.876662132,-141
carcassonne-ucttuned445-vs-ucttuned335-1000its,664,805,2247.648963687,2145.601182407,-141
carcassonne-uct105-vs-uct215-1000its,680,821,2223.913220127,2197.891817491,-141
carcassonne-boltzmann385-vs-boltzmann115-1000its,681,822,2152.59081364,2128.877945448,-141
carcassonne-boltzmann360-vs-boltzmann255-1000its,702,843,2176.06018409,2145.193917028,-141
carcassonne-ucttuned425-vs-ucttuned420-1000its,707,848,2221.444113103,2150.285486926,-141
carcassonne-ucttuned360-vs-ucttuned25-1000its,708,849,2273.52344866,2161.620158892,-141
carcassonne-uct150-vs-uct200-1000its,725,866,2120.151559139,2104.470468343,-141
carcassonne-uct270-vs-uct445-1000its,731,872,2239.30351793,2161.724110021,-141
carcassonne-boltzmann60-vs-boltzmann85-1000its,734,875,2193.766384344,2143.902626882,-141
carcassonne-ucttuned20-vs-ucttuned155-1000its,734,875,2206.327924847,2167.934945943,-141
carcassonne-ucttuned100-vs-ucttuned220-1000its,736,877,2142.349407791,2095.433354146,-141
carcassonne-ucttuned375-vs-ucttuned485-1000its,740,881,2188.439440903,2138.483281293,-141
carcassonne-uct160-vs-uct460-1000its,743,884,2183.318907393,2104.993993294,-141
carcassonne-uct480-vs-uct190-1000its,746,887,2156.224197646,2106.36697223,-141
carcassonne-ucttuned215-vs-ucttuned245-1000its,747,888,2179.975845585,2122.787599262,-141
carcassonne-uct275-vs-uct75-1000its,748,889,2157.594568262,2100.320481222,-141
carcassonne-ucttuned435-vs-ucttuned40-1000its,749,890,2181.381458847,2170.569086618,-141
carcassonne-ucttuned470-vs-ucttuned390-1000its,753,894,2154.588308486,2112.22664192,-141
carcassonne-ucttuned490-vs-ucttuned145-1000its,753,894,2217.983788986,2187.206959893,-141
carcassonne-uct95-vs-uct370-1000its,755,896,2264.44873879,2222.236724661,-141
carcassonne-uct475-vs-uct65-1000its,760,901,2138.531296499,2141.248201377,-141
carcassonne-uct390-vs-uct175-1000its,761,902,2176.249625983,2166.729435809,-141
carcassonne-ucttuned375-vs-ucttuned195-1000its,771,912,2257.754340997,2214.7253741,-141
carcassonne-boltzmann425-vs-boltzmann405-1000its,788,929,2181.795446853,2177.412535655,-141
carcassonne-uct375-vs-uct235-1000its,789,930,2101.06554554,2095.800490602,-141
carcassonne-boltzmann290-vs-boltzmann445-1000its,837,978,2237.718997453,2202.843475911,-141
carcassonne-boltzmann175-vs-boltzmann400-1000its,680,820,2181.971709822,2111.426079306,-140
carcassonne-uct460-vs-uct140-1000its,696,836,2296.281796664,2213.972939702,-140
carcassonne-boltzmann465-vs-boltzmann75-1000its,697,837,2239.326045226,2214.882184782,-140
carcassonne-uct60-vs-uct355-1000its,700,840,2191.42905978,2144.587012498,-140
carcassonne-ucttuned460-vs-ucttuned45-1000its,708,848,2227.023444604,2147.602823169,-140
carcassonne-boltzmann235-vs-boltzmann325-1000its,709,849,2233.101746598,2140.403677768,-140
carcassonne-uct250-vs-uct215-1000its,713,853,2167.340841236,2150.197372146,-140
carcassonne-boltzmann90-vs-boltzmann425-1000its,715,855,2182.224882997,2136.083541831,-140
carcassonne-uct180-vs-uct435-1000its,722,862,2219.657477901,2188.958313944,-140
carcassonne-uct425-vs-uct50-1000its,724,864,2164.911325923,2131.632174044,-140
carcassonne-uct215-vs-uct255-1000its,726,866,2216.745892793,2228.4840788,-140
carcassonne-uct325-vs-uct225-1000its,741,881,2176.423545108,2121.091089328,-140
carcassonne-uct360-vs-uct70-1000its,748,888,2144.284909086,2145.668773287,-140
carcassonne-ucttuned375-vs-ucttuned50-1000its,773,913,2231.646001726,2238.545758406,-140
carcassonne-uct130-vs-uct435-1000its,777,917,2265.282681,2192.858192578,-140
carcassonne-boltzmann385-vs-boltzmann300-1000its,782,922,2256.531559812,2228.867502179,-140
carcassonne-uct10-vs-uct55-1000its,791,931,2172.557440978,2125.636609798,-140
carcassonne-uct160-vs-uct260-1000its,644,783,2282.324392893,2243.122351858,-139
carcassonne-boltzmann290-vs-boltzmann280-1000its,649,788,2209.203819946,2174.807253293,-139
carcassonne-boltzmann250-vs-boltzmann75-1000its,680,819,2214.259191258,2205.325048646,-139
carcassonne-ucttuned410-vs-ucttuned310-1000its,684,823,2186.497346105,2099.980615357,-139
carcassonne-boltzmann35-vs-boltzmann30-1000its,694,833,2176.553625585,2161.076873158,-139
carcassonne-ucttuned425-vs-ucttuned50-1000its,699,838,2153.829969313,2097.107967978,-139
carcassonne-uct395-vs-uct365-1000its,702,841,2182.390571546,2079.813096139,-139
carcassonne-boltzmann90-vs-boltzmann275-1000its,708,847,2193.735139236,2155.956820426,-139
carcassonne-boltzmann50-vs-boltzmann440-1000its,717,856,2195.262057741,2173.142549284,-139
carcassonne-ucttuned410-vs-ucttuned90-1000its,720,859,2179.464170715,2153.200223816,-139
carcassonne-uct410-vs-uct65-1000its,722,861,2166.845648934,2163.276310217,-139
carcassonne-uct315-vs-uct345-1000its,723,862,2239.813949469,2181.061459314,-139
carcassonne-boltzmann275-vs-boltzmann385-1000its,727,866,2218.566017757,2182.154383664,-139
carcassonne-boltzmann360-vs-boltzmann110-1000its,729,868,2237.028169899,2203.063183916,-139
carcassonne-ucttuned355-vs-ucttuned415-1000its,729,868,2165.913370108,2092.643719796,-139
carcassonne-ucttuned420-vs-ucttuned210-1000its,733,872,2163.930106525,2124.479679301,-139
carcassonne-uct95-vs-uct85-1000its,740,879,2177.893757222,2105.565614102,-139
carcassonne-ucttuned65-vs-ucttuned185-1000its,742,881,2166.367254528,2138.590454371,-139
carcassonne-uct180-vs-uct120-1000its,745,884,2241.796728948,2183.165401706,-139
carcassonne-ucttuned290-vs-ucttuned190-1000its,745,884,2258.27733858,2159.100909987,-139
carcassonne-boltzmann35-vs-boltzmann205-1000its,755,894,2171.006100953,2126.767526754,-139
carcassonne-uct390-vs-uct395-1000its,756,895,2228.520036909,2196.366016426,-139
carcassonne-ucttuned325-vs-ucttuned425-1000its,756,895,2119.396044367,2109.131013441,-139
carcassonne-boltzmann440-vs-boltzmann245-1000its,762,901,2286.59996244,2288.306119446,-139
carcassonne-ucttuned360-vs-ucttuned210-1000its,769,908,2225.388731252,2204.735892203,-139
carcassonne-boltzmann300-vs-boltzmann270-1000its,772,911,2265.16650122,2188.644332887,-139
carcassonne-boltzmann455-vs-boltzmann300-1000its,794,933,2138.941951736,2095.358695676,-139
carcassonne-uct215-vs-uct80-1000its,794,933,2209.240555219,2165.591581067,-139
carcassonne-uct5-vs-uct30-1000its,795,934,2266.031712846,2215.817197728,-139
carcassonne-uct190-vs-uct40-1000its,819,958,2173.26347697,2109.320100304,-139
carcassonne-uct195-vs-uct470-1000its,829,968,2218.556542235,2196.930965899,-139
carcassonne-uct200-vs-uct290-1000its,660,798,2263.842838259,2231.606427082,-138
carcassonne-boltzmann195-vs-boltzmann475-1000its,671,809,2182.065710396,2162.264787942,-138
carcassonne-uct310-vs-uct365-1000its,688,826,2188.456888674,2165.505014118,-138
carcassonne-boltzmann85-vs-boltzmann455-1000its,697,835,2165.893518943,2100.939296709,-138
carcassonne-uct445-vs-uct170-1000its,702,840,2203.483869785,2160.043304699,-138
carcassonne-boltzmann255-vs-boltzmann235-1000its,705,843,2139.308281289,2122.887859274,-138
carcassonne-ucttuned290-vs-ucttuned135-1000its,716,854,2191.554828615,2137.798105673,-138
carcassonne-uct365-vs-uct20-1000its,719,857,2164.715155517,2151.534629793,-138
carcassonne-ucttuned450-vs-ucttuned360-1000its,720,858,2145.275760648,2083.496172513,-138
carcassonne-uct95-vs-uct125-1000its,723,861,2240.103881204,2134.860633282,-138
carcassonne-ucttuned45-vs-ucttuned175-1000its,726,864,2179.761725915,2131.192060693,-138
carcassonne-ucttuned315-vs-ucttuned300-1000its,730,868,2144.52947533,2131.717376281,-138
carcassonne-uct90-vs-uct55-1000its,731,869,2190.118426953,2204.407976575,-138
carcassonne-ucttuned300-vs-ucttuned460-1000its,743,881,2216.460801933,2197.103273395,-138
carcassonne-uct95-vs-uct20-1000its,747,885,2199.270498234,2171.016849278,-138
carcassonne-ucttuned335-vs-ucttuned235-1000its,749,887,2208.217092463,2184.466151153,-138
carcassonne-boltzmann225-vs-boltzmann440-1000its,764,902,2145.045204142,2114.367494243,-138
carcassonne-ucttuned290-vs-ucttuned480-1000its,772,910,2192.5905933,2139.994922841,-138
carcassonne-boltzmann325-vs-boltzmann240-1000its,776,914,2162.962680947,2111.641460705,-138
carcassonne-uct160-vs-uct100-1000its,782,920,2259.788227203,2220.549107177,-138
carcassonne-uct45-vs-uct225-1000its,787,925,2214.428941951,2169.388860146,-138
carcassonne-boltzmann135-vs-boltzmann465-1000its,682,819,2245.890631158,2235.802082276,-137
carcassonne-boltzmann305-vs-boltzmann160-1000its,695,832,2115.601275219,2106.256839085,-137
carcassonne-uct410-vs-uct50-1000its,698,835,2174.01077041,2151.18675125,-137
carcassonne-uct130-vs-uct465-1000its,699,836,2188.314365361,2136.211798419,-137
carcassonne-ucttuned245-vs-ucttuned350-1000its,700,837,2137.713074183,2100.874308563,-137
carcassonne-uct425-vs-uct60-1000its,701,838,2139.011449991,2110.848973411,-137
carcassonne-boltzmann110-vs-boltzmann435-1000its,703,840,2147.005242356,2104.573789144,-137
carcassonne-ucttuned375-vs-ucttuned20-1000its,712,849,2197.979235924,2178.043623929,-137
carcassonne-boltzmann155-vs-boltzmann255-1000its,719,856,2248.443004775,2188.861721971,-137
carcassonne-ucttuned175-vs-ucttuned365-1000its,720,857,2141.788533343,2114.784559962,-137
carcassonne-ucttuned430-vs-ucttuned40-1000its,726,863,2193.228246517,2185.904862662,-137
carcassonne-uct50-vs-uct100-1000its,727,864,2183.288866377,2128.022824305,-137
carcassonne-boltzmann220-vs-boltzmann395-1000its,729,866,2151.930220914,2126.976784762,-137
carcassonne-ucttuned340-vs-ucttuned145-1000its,739,876,2256.627822623,2204.632125737,-137
carcassonne-boltzmann200-vs-boltzmann65-1000its,777,914,2238.563927106,2132.043905146,-137
carcassonne-ucttuned240-vs-ucttuned275-1000its,781,918,2241.656857713,2215.8355629,-137
carcassonne-ucttuned180-vs-ucttuned30-1000its,808,945,2205.652954966,2167.096025494,-137
carcassonne-ucttuned355-vs-ucttuned330-1000its,831,968,2245.051173424,2214.22417578,-137
carcassonne-boltzmann390-vs-boltzmann90-1000its,657,793,2217.137130696,2178.216818783,-136
carcassonne-boltzmann320-vs-boltzmann125-1000its,666,802,2250.817051943,2199.480371729,-136
carcassonne-boltzmann445-vs-boltzmann475-1000its,670,806,2207.214772381,2112.472604139,-136
carcassonne-ucttuned475-vs-ucttuned350-1000its,671,807,2175.731125559,2155.05902856,-136
carcassonne-ucttuned85-vs-ucttuned435-1000its,677,813,2161.564898407,2102.515620183,-136
carcassonne-uct495-vs-uct490-1000its,689,825,2264.168369554,2224.271009181,-136
carcassonne-boltzmann380-vs-boltzmann435-1000its,705,841,2188.180591295,2132.911622192,-136
carcassonne-boltzmann430-vs-boltzmann365-1000its,706,842,2232.399741734,2170.472550285,-136
carcassonne-ucttuned360-vs-ucttuned440-1000its,706,842,2212.736250567,2178.464052611,-136
carcassonne-uct455-vs-uct210-1000its,709,845,2220.441643039,2116.468504068,-136
carcassonne-ucttuned320-vs-ucttuned480-1000its,719,855,2200.53183702,2193.598001491,-136
carcassonne-uct305-vs-uct345-1000its,721,857,2244.207046032,2174.117513751,-136
carcassonne-uct30-vs-uct435-1000its,725,861,2195.292259132,2154.329609323,-136
carcassonne-boltzmann140-vs-boltzmann415-1000its,726,862,2170.440996545,2130.874742258,-136
carcassonne-uct85-vs-uct360-1000its,727,863,2217.009980104,2197.672412658,-136
carcassonne-uct455-vs-uct245-1000its,731,867,2182.298825903,2169.586992316,-136
carcassonne-uct160-vs-uct420-1000its,736,872,2102.380476135,2022.46380393,-136
carcassonne-uct465-vs-uct365-1000its,737,873,2231.54115388,2148.314116078,-136
carcassonne-uct110-vs-uct15-1000its,741,877,2163.790019495,2144.205463474,-136
carcassonne-ucttuned440-vs-ucttuned420-1000its,747,883,2181.101342704,2184.603207414,-136
carcassonne-boltzmann460-vs-boltzmann110-1000its,750,886,2229.997652519,2145.024151266,-136
carcassonne-uct85-vs-uct165-1000its,754,890,2184.70231134,2132.707837075,-136
carcassonne-ucttuned215-vs-ucttuned480-1000its,757,893,2217.600255356,2176.854574121,-136
carcassonne-uct375-vs-uct485-1000its,770,906,2257.256449889,2213.510595942,-136
carcassonne-boltzmann290-vs-boltzmann265-1000its,772,908,2225.261011285,2208.968474974,-136
carcassonne-boltzmann410-vs-boltzmann415-1000its,778,914,2129.588493735,2078.018734482,-136
carcassonne-ucttuned445-vs-ucttuned260-1000its,778,914,2139.678006705,2095.559765458,-136
carcassonne-ucttuned10-vs-ucttuned175-1000its,806,942,2174.582525474,2141.713469879,-136
carcassonne-boltzmann370-vs-boltzmann485-1000its,817,953,2145.973989971,2117.239327373,-136
carcassonne-uct420-vs-uct410-1000its,660,795,2186.246605024,2136.659412945,-135
carcassonne-ucttuned210-vs-ucttuned270-1000its,670,805,2170.42368873,2091.400179596,-135
carcassonne-ucttuned285-vs-ucttuned445-1000its,687,822,2208.689734488,2163.220624677,-135
carcassonne-uct485-vs-uct340-1000its,705,840,2247.875278069,2176.607228794,-135
carcassonne-uct180-vs-uct145-1000its,706,841,2165.854592196,2175.575045624,-135
carcassonne-uct270-vs-uct115-1000its,725,860,2300.201805371,2241.101278497,-135
carcassonne-ucttuned390-vs-ucttuned440-1000its,729,864,2180.91201299,2120.192756426,-135
carcassonne-ucttuned390-vs-ucttuned290-1000its,732,867,2213.224549066,2188.95164085,-135
carcassonne-uct345-vs-uct215-1000its,733,868,2185.996233744,2114.607329681,-135
carcassonne-uct365-vs-uct235-1000its,734,869,2230.167875599,2196.316372994,-135
carcassonne-ucttuned120-vs-ucttuned420-1000its,736,871,2189.09438637,2154.780188948,-135
carcassonne-ucttuned155-vs-ucttuned40-1000its,738,873,2161.233732833,2168.663174176,-135
carcassonne-uct445-vs-uct320-1000its,740,875,2170.418844207,2086.38234896,-135
carcassonne-ucttuned50-vs-ucttuned270-1000its,741,876,2165.61482502,2118.38701905,-135
carcassonne-boltzmann95-vs-boltzmann210-1000its,742,877,2136.458912347,2151.480717051,-135
carcassonne-uct130-vs-uct120-1000its,745,880,2241.774655939,2206.445495536,-135
carcassonne-uct105-vs-uct410-1000its,750,885,2202.271277413,2164.383906079,-135
carcassonne-uct450-vs-uct25-1000its,750,885,2276.108638018,2213.005337485,-135
carcassonne-uct145-vs-uct105-1000its,759,894,2240.692973353,2202.058934637,-135
carcassonne-ucttuned200-vs-ucttuned300-1000its,759,894,2192.817579869,2118.900843284,-135
carcassonne-uct360-vs-uct65-1000its,762,897,2202.666805314,2164.155349894,-135
carcassonne-ucttuned150-vs-ucttuned345-1000its,772,907,2193.659161566,2151.066476497,-135
carcassonne-ucttuned405-vs-ucttuned45-1000its,800,935,2235.590754692,2186.06863856,-135
carcassonne-ucttuned25-vs-ucttuned260-1000its,678,812,2169.912152258,2097.540711458,-134
carcassonne-ucttuned255-vs-ucttuned220-1000its,681,815,2153.312008804,2135.9672644,-134
carcassonne-boltzmann325-vs-boltzmann360-1000its,691,825,2193.390958495,2157.94311439,-134
carcassonne-ucttuned375-vs-ucttuned220-1000its,692,826,2199.397095831,2163.955983555,-134
carcassonne-ucttuned300-vs-ucttuned35-1000its,699,833,2199.485382352,2178.969962849,-134
carcassonne-uct90-vs-uct145-1000its,703,837,2200.942653533,2148.234716117,-134
carcassonne-ucttuned410-vs-ucttuned475-1000its,704,838,2244.369259876,2180.927568929,-134
carcassonne-ucttuned30-vs-ucttuned395-1000its,716,850,2259.40157861,2150.314276128,-134
carcassonne-uct420-vs-uct10-1000its,720,854,2190.446280549,2124.781582948,-134
carcassonne-boltzmann480-vs-boltzmann20-1000its,724,858,2222.275150945,2215.402772777,-134
carcassonne-boltzmann495-vs-boltzmann130-1000its,724,858,2246.452448862,2196.706029802,-134
carcassonne-boltzmann330-vs-boltzmann145-1000its,728,862,2239.864538957,2175.526111898,-134
carcassonne-boltzmann265-vs-boltzmann360-1000its,730,864,2253.627724025,2212.950796721,-134
carcassonne-boltzmann65-vs-boltzmann260-1000its,731,865,2240.934986824,2143.143177974,-134
carcassonne-boltzmann385-vs-boltzmann350-1000its,736,870,2255.043074209,2199.526198007,-134
carcassonne-ucttuned465-vs-ucttuned15-1000its,736,870,2174.502795311,2197.306905583,-134
carcassonne-boltzmann215-vs-boltzmann10-1000its,740,874,2154.036359897,2122.800074166,-134
carcassonne-ucttuned55-vs-ucttuned50-1000its,740,874,2168.514136501,2118.770201946,-134
carcassonne-ucttuned95-vs-ucttuned75-1000its,743,877,2212.217319538,2170.675587899,-134
carcassonne-boltzmann180-vs-boltzmann495-1000its,744,878,2154.055202904,2089.824034459,-134
carcassonne-ucttuned425-vs-ucttuned110-1000its,764,898,2258.284148268,2184.716102919,-134
carcassonne-uct165-vs-uct180-1000its,769,903,2152.48290851,2118.131107021,-134
carcassonne-uct420-vs-uct285-1000its,772,906,2202.983709859,2150.180636318,-134
carcassonne-boltzmann405-vs-boltzmann415-1000its,782,916,2150.17807726,2118.052634536,-134
carcassonne-boltzmann290-vs-boltzmann450-1000its,794,928,2210.024391828,2175.449716232,-134
carcassonne-boltzmann60-vs-boltzmann395-1000its,826,960,2231.680893801,2200.511747568,-134
carcassonne-uct390-vs-uct490-1000its,672,805,2241.18055918,2189.089383143,-133
carcassonne-ucttuned375-vs-ucttuned480-1000its,680,813,2204.853040627,2195.13975253,-133
carcassonne-boltzmann325-vs-boltzmann260-1000its,691,824,2211.305559019,2182.237583758,-133
carcassonne-ucttuned480-vs-ucttuned170-1000its,703,836,2246.537664139,2169.668176598,-133
carcassonne-boltzmann435-vs-boltzmann380-1000its,706,839,2243.816541505,2207.13107447,-133
carcassonne-boltzmann295-vs-boltzmann155-1000its,708,841,2221.550295324,2167.746491456,-133
carcassonne-uct165-vs-uct65-1000its,716,849,2160.858783688,2108.779691968,-133
carcassonne-ucttuned80-vs-ucttuned445-1000its,723,856,2191.229652733,2152.53555378,-133
carcassonne-boltzmann245-vs-boltzmann85-1000its,730,863,2159.606251208,2093.655143445,-133
carcassonne-boltzmann365-vs-boltzmann295-1000its,732,865,2255.818030838,2186.295727988,-133
carcassonne-boltzmann310-vs-boltzmann285-1000its,738,871,2152.869368606,2098.505427369,-133
carcassonne-boltzmann15-vs-boltzmann345-1000its,740,873,2184.077864512,2148.661917489,-133
carcassonne-uct215-vs-uct455-1000its,745,878,2185.020097421,2123.271833186,-133
carcassonne-uct200-vs-uct310-1000its,750,883,2174.682818031,2117.328882912,-133
carcassonne-uct230-vs-uct145-1000its,752,885,2114.506994239,2094.320903659,-133
carcassonne-boltzmann315-vs-boltzmann155-1000its,754,887,2166.372779107,2149.95130183,-133
carcassonne-ucttuned470-vs-ucttuned230-1000its,754,887,2217.125389975,2163.965942075,-133
carcassonne-ucttuned185-vs-ucttuned5-1000its,756,889,2228.873721852,2201.419670344,-133
carcassonne-boltzmann75-vs-boltzmann200-1000its,786,919,2153.888117526,2127.245799549,-133
carcassonne-uct30-vs-uct5-1000its,804,937,2159.180225095,2152.672617464,-133
carcassonne-boltzmann155-vs-boltzmann420-1000its,660,792,2153.30986861,2082.452318467,-132
carcassonne-uct35-vs-uct305-1000its,720,852,2162.826149796,2180.994308554,-132
carcassonne-boltzmann410-vs-boltzmann120-1000its,722,854,2218.229701907,2167.828709972,-132
carcassonne-boltzmann480-vs-boltzmann75-1000its,730,862,2212.192973742,2126.281627121,-132
carcassonne-ucttuned225-vs-ucttuned65-1000its,731,863,2143.551156214,2118.393316292,-132
carcassonne-boltzmann325-vs-boltzmann355-1000its,736,868,2213.298236653,2189.330841374,-132
carcassonne-uct175-vs-uct270-1000its,738,870,2220.439385729,2169.927985708,-132
carcassonne-boltzmann325-vs-boltzmann90-1000its,742,874,2152.936164442,2087.823093866,-132
carcassonne-uct435-vs-uct295-1000its,745,877,2145.212535596,2127.233504091,-132
carcassonne-uct90-vs-uct120-1000its,747,879,2205.007229298,2189.01145701,-132
carcassonne-uct455-vs-uct100-1000its,749,881,2212.53480878,2183.044944579,-132
carcassonne-ucttuned220-vs-ucttuned135-1000its,749,881,2228.665244718,2182.314822635,-132
carcassonne-uct300-vs-uct265-1000its,753,885,2173.630564699,2136.641584898,-132
carcassonne-uct60-vs-uct330-1000its,772,904,2151.600094177,2140.770448981,-132
carcassonne-ucttuned330-vs-ucttuned140-1000its,774,906,2206.731364248,2160.021207901,-132
carcassonne-ucttuned215-vs-ucttuned150-1000its,775,907,2122.475092394,2114.599120969,-132
carcassonne-boltzmann260-vs-boltzmann10-1000its,807,939,2163.443654671,2178.441773428,-132
carcassonne-uct475-vs-uct310-1000its,811,943,2189.318966108,2123.356429606,-132
carcassonne-uct65-vs-uct35-1000its,818,950,2170.503444247,2114.267739682,-132
carcassonne-ucttuned460-vs-ucttuned180-1000its,833,965,2127.058725844,2073.305653941,-132
carcassonne-boltzmann300-vs-boltzmann40-1000its,672,803,2173.484219135,2166.94991856,-131
carcassonne-boltzmann330-vs-boltzmann245-1000its,692,823,2159.486802729,2138.527761767,-131
carcassonne-ucttuned110-vs-ucttuned195-1000its,696,827,2157.224766996,2130.724101318,-131
carcassonne-ucttuned440-vs-ucttuned25-1000its,702,833,2170.57039447,2157.339207223,-131
carcassonne-uct325-vs-uct135-1000its,707,838,2258.777169027,2182.838099971,-131
carcassonne-ucttuned230-vs-ucttuned320-1000its,708,839,2199.263263561,2124.793189528,-131
carcassonne-boltzmann260-vs-boltzmann220-1000its,712,843,2228.64438122,2245.101774642,-131
carcassonne-uct165-vs-uct265-1000its,714,845,2297.40127483,2283.730859052,-131
carcassonne-ucttuned430-vs-ucttuned55-1000its,721,852,2207.645732084,2179.770559468,-131
carcassonne-boltzmann480-vs-boltzmann285-1000its,723,854,2216.302924361,2164.259556703,-131
carcassonne-uct300-vs-uct195-1000its,730,861,2299.004512468,2267.253855362,-131
carcassonne-boltzmann360-vs-boltzmann230-1000its,734,865,2218.910215005,2170.56192172,-131
carcassonne-uct250-vs-uct75-1000its,741,872,2158.715685048,2115.656568479,-131
carcassonne-ucttuned105-vs-ucttuned90-1000its,746,877,2160.847559541,2134.459718424,-131
carcassonne-ucttuned490-vs-ucttuned370-1000its,746,877,2271.463571769,2213.91089132,-131
carcassonne-uct200-vs-uct35-1000its,747,878,2192.146323841,2135.327328561,-131
carcassonne-boltzmann280-vs-boltzmann125-1000its,756,887,2210.739173618,2162.793470178,-131
carcassonne-uct405-vs-uct120-1000its,756,887,2219.959290348,2164.184739606,-131
carcassonne-boltzmann210-vs-boltzmann405-1000its,761,892,2247.122186535,2206.626541435,-131
carcassonne-ucttuned30-vs-ucttuned355-1000its,764,895,2202.635153569,2124.788073507,-131
carcassonne-uct60-vs-uct240-1000its,773,904,2240.744971952,2193.982250121,-131
carcassonne-ucttuned460-vs-ucttuned365-1000its,773,904,2205.881307578,2140.153329524,-131
carcassonne-uct140-vs-uct20-1000its,775,906,2274.802167369,2195.850894621,-131
carcassonne-ucttuned405-vs-ucttuned375-1000its,780,911,2249.214279418,2219.919965732,-131
carcassonne-boltzmann395-vs-boltzmann30-1000its,793,924,2176.055908096,2125.460455272,-131
carcassonne-uct415-vs-uct235-1000its,648,778,2190.956822101,2124.342090753,-130
carcassonne-boltzmann190-vs-boltzmann420-1000its,671,801,2099.466761743,2101.820627387,-130
carcassonne-boltzmann250-vs-boltzmann415-1000its,683,813,2186.826617856,2141.356753909,-130
carcassonne-boltzmann155-vs-boltzmann415-1000its,684,814,2213.154076089,2142.477138573,-130
carcassonne-boltzmann360-vs-boltzmann240-1000its,687,817,2143.426795749,2109.226943191,-130
carcassonne-uct435-vs-uct225-1000its,687,817,2189.723589813,2152.156130665,-130
carcassonne-boltzmann160-vs-boltzmann25-1000its,691,821,2152.411796447,2119.342852225,-130
carcassonne-ucttuned70-vs-ucttuned5-1000its,695,825,2200.996199899,2096.819348514,-130
carcassonne-boltzmann470-vs-boltzmann495-1000its,698,828,2184.254554939,2149.971175764,-130
carcassonne-boltzmann395-vs-boltzmann210-1000its,704,834,2165.19548589,2156.863219029,-130
carcassonne-boltzmann5-vs-boltzmann385-1000its,707,837,2239.940858973,2195.647956048,-130
carcassonne-uct60-vs-uct350-1000its,709,839,2263.254203869,2218.178044058,-130
carcassonne-uct445-vs-uct265-1000its,712,842,2151.863285153,2041.680683263,-130
carcassonne-uct75-vs-uct495-1000its,728,858,2191.32369845,2110.883839642,-130
carcassonne-ucttuned315-vs-ucttuned240-1000its,729,859,2260.496741044,2236.448986702,-130
carcassonne-uct440-vs-uct165-1000its,734,864,2180.541249726,2174.14093649,-130
carcassonne-boltzmann60-vs-boltzmann370-1000its,736,866,2167.283577672,2140.515863831,-130
carcassonne-boltzmann305-vs-boltzmann100-1000its,742,872,2129.511092173,2094.786175148,-130
carcassonne-ucttuned175-vs-ucttuned350-1000its,748,878,2257.159545667,2242.328784391,-130
carcassonne-uct205-vs-uct495-1000its,753,883,2235.829360762,2203.694861574,-130
carcassonne-ucttuned120-vs-ucttuned350-1000its,754,884,2182.219864298,2143.56964059,-130
carcassonne-boltzmann365-vs-boltzmann300-1000its,757,887,2205.396651843,2161.222369369,-130
carcassonne-uct300-vs-uct60-1000its,760,890,2243.259353859,2170.110823841,-130
carcassonne-uct450-vs-uct235-1000its,768,898,2164.845977548,2106.520746568,-130
carcassonne-uct275-vs-uct265-1000its,771,901,2180.804916039,2117.617722965,-130
carcassonne-boltzmann15-vs-boltzmann190-1000its,776,906,2132.946575408,2102.417323737,-130
carcassonne-uct225-vs-uct380-1000its,787,917,2135.387017373,2110.538420359,-130
carcassonne-uct285-vs-uct435-1000its,801,931,2205.973293024,2139.350121901,-130
carcassonne-uct130-vs-uct240-1000its,653,782,2172.315426446,2160.955341238,-129
carcassonne-uct35-vs-uct60-1000its,657,786,2171.172172642,2130.858723104,-129
carcassonne-uct210-vs-uct85-1000its,679,808,2177.588009094,2138.311047471,-129
carcassonne-uct15-vs-uct495-1000its,705,834,2195.023453186,2152.924209433,-129
carcassonne-boltzmann85-vs-boltzmann90-1000its,710,839,2227.7125381,2215.926995387,-129
carcassonne-uct105-vs-uct150-1000its,714,843,2217.377607186,2201.348505512,-129
carcassonne-uct80-vs-uct30-1000its,721,850,2201.246934004,2183.641162799,-129
carcassonne-boltzmann310-vs-boltzmann85-1000its,723,852,2233.924186,2194.341884584,-129
carcassonne-uct120-vs-uct140-1000its,723,852,2201.468847611,2178.816659524,-129
carcassonne-ucttuned375-vs-ucttuned310-1000its,724,853,2215.503961031,2138.924987475,-129
carcassonne-boltzmann365-vs-boltzmann305-1000its,726,855,2168.966248038,2137.988076275,-129
carcassonne-uct405-vs-uct20-1000its,733,862,2202.668450233,2174.720136679,-129
carcassonne-boltzmann165-vs-boltzmann275-1000its,735,864,2204.687803444,2163.304451429,-129
carcassonne-boltzmann120-vs-boltzmann200-1000its,741,870,2185.824882519,2133.657525614,-129
carcassonne-uct430-vs-uct170-1000its,742,871,2138.974485979,2115.436203453,-129
carcassonne-ucttuned305-vs-ucttuned30-1000its,743,872,2152.295283347,2097.344172112,-129
carcassonne-uct475-vs-uct70-1000its,750,879,2224.514180026,2195.071055454,-129
carcassonne-uct350-vs-uct395-1000its,752,881,2166.732965412,2127.529900715,-129
carcassonne-boltzmann295-vs-boltzmann485-1000its,755,884,2218.251803961,2189.487550725,-129
carcassonne-boltzmann145-vs-boltzmann410-1000its,758,887,2184.509284129,2141.667662143,-129
carcassonne-uct310-vs-uct350-1000its,772,901,2191.901555974,2167.945804442,-129
carcassonne-boltzmann220-vs-boltzmann225-1000its,777,906,2206.869055962,2136.675154225,-129
carcassonne-uct135-vs-uct315-1000its,777,906,2185.935982183,2151.788298947,-129
carcassonne-ucttuned395-vs-ucttuned200-1000its,777,906,2114.818596029,2122.762409339,-129
carcassonne-uct425-vs-uct350-1000its,786,915,2192.884330617,2135.127066366,-129
carcassonne-ucttuned460-vs-ucttuned385-1000its,793,922,2162.334897281,2143.347866303,-129
carcassonne-ucttuned285-vs-ucttuned35-1000its,798,927,2257.314580332,2197.901330216,-129
carcassonne-uct415-vs-uct90-1000its,624,752,2226.678196366,2162.950937314,-128
carcassonne-uct145-vs-uct425-1000its,645,773,2217.223637371,2179.555899884,-128
carcassonne-ucttuned480-vs-ucttuned270-1000its,671,799,2114.984309998,2097.014802853,-128
carcassonne-ucttuned435-vs-ucttuned390-1000its,682,810,2220.852948575,2191.431000946,-128
carcassonne-ucttuned435-vs-ucttuned250-1000its,692,820,2155.497502145,2129.238883695,-128
carcassonne-boltzmann470-vs-boltzmann485-1000its,693,821,2177.443931588,2135.481274118,-128
carcassonne-boltzmann145-vs-boltzmann5-1000its,696,824,2130.26170194,2118.497557037,-128
carcassonne-uct245-vs-uct205-1000its,717,845,2201.576487349,2181.195098547,-128
carcassonne-boltzmann335-vs-boltzmann385-1000its,725,853,2312.243547954,2275.457795415,-128
carcassonne-ucttuned425-vs-ucttuned350-1000its,726,854,2208.443480123,2166.661982802,-128
carcassonne-uct440-vs-uct365-1000its,729,857,2194.685998478,2211.269345609,-128
carcassonne-ucttuned40-vs-ucttuned225-1000its,730,858,2237.288440642,2218.652549754,-128
carcassonne-boltzmann370-vs-boltzmann295-1000its,732,860,2239.365973658,2147.220612964,-128
carcassonne-uct115-vs-uct220-1000its,740,868,2198.775833817,2163.465055058,-128
carcassonne-boltzmann100-vs-boltzmann20-1000its,746,874,2222.871517935,2132.90388901,-128
carcassonne-ucttuned335-vs-ucttuned410-1000its,747,875,2242.15150447,2197.790780984,-128
carcassonne-boltzmann285-vs-boltzmann480-1000its,751,879,2237.471396296,2145.675119791,-128
carcassonne-uct65-vs-uct285-1000its,754,882,2274.749059423,2209.414746324,-128
carcassonne-ucttuned495-vs-ucttuned5-1000its,776,904,2167.77383331,2163.059940044,-128
carcassonne-uct100-vs-uct235-1000its,811,939,2199.535895103,2155.952312919,-128
carcassonne-ucttuned265-vs-ucttuned290-1000its,818,946,2184.038969176,2129.487068957,-128
carcassonne-uct160-vs-uct105-1000its,864,992,2213.823220086,2166.393089561,-128
carcassonne-uct395-vs-uct150-1000its,636,763,2150.796728068,2079.567829958,-127
carcassonne-uct330-vs-uct85-1000its,676,803,2182.649651938,2120.0715463,-127
carcassonne-ucttuned485-vs-ucttuned255-1000its,676,803,2162.983483638,2091.696149705,-127
carcassonne-ucttuned485-vs-ucttuned10-1000its,679,806,2162.838830194,2144.461341913,-127
carcassonne-boltzmann240-vs-boltzmann160-1000its,684,811,2168.806021317,2173.789904576,-127
carcassonne-boltzmann430-vs-boltzmann255-1000its,690,817,2249.175670426,2210.161708153,-127
carcassonne-ucttuned450-vs-ucttuned60-1000its,699,826,2173.817024284,2147.278484243,-127
carcassonne-ucttuned405-vs-ucttuned65-1000its,707,834,2202.451217044,2177.079893839,-127
carcassonne-ucttuned455-vs-ucttuned360-1000its,716,843,2190.032705182,2117.465431586,-127
carcassonne-uct225-vs-uct70-1000its,719,846,2148.208789341,2126.521823968,-127
carcassonne-boltzmann210-vs-boltzmann230-1000its,720,847,2214.123955138,2135.107400285,-127
carcassonne-boltzmann15-vs-boltzmann175-1000its,721,848,2116.340986792,2061.458215317,-127
carcassonne-boltzmann190-vs-boltzmann50-1000its,731,858,2202.484500313,2141.260457258,-127
carcassonne-uct135-vs-uct180-1000its,734,861,2230.361341282,2195.274696091,-127
carcassonne-uct370-vs-uct75-1000its,734,861,2163.587955253,2147.725958284,-127
carcassonne-ucttuned270-vs-ucttuned115-1000its,734,861,2238.380544135,2186.059586345,-127
carcassonne-ucttuned245-vs-ucttuned180-1000its,735,862,2112.378126518,2066.657749272,-127
carcassonne-uct450-vs-uct170-1000its,737,864,2206.682505636,2163.819009585,-127
carcassonne-uct475-vs-uct160-1000its,737,864,2163.775258373,2138.275973941,-127
carcassonne-uct160-vs-uct320-1000its,740,867,2167.910822659,2128.545605161,-127
carcassonne-boltzmann385-vs-boltzmann320-1000its,741,868,2201.625860467,2126.776159657,-127
carcassonne-boltzmann420-vs-boltzmann30-1000its,742,869,2250.870801886,2174.901026445,-127
carcassonne-boltzmann135-vs-boltzmann340-1000its,743,870,2190.871850836,2146.724321952,-127
carcassonne-ucttuned265-vs-ucttuned430-1000its,745,872,2184.301721222,2170.115072331,-127
carcassonne-uct430-vs-uct405-1000its,750,877,2237.960262082,2222.588521082,-127
carcassonne-boltzmann100-vs-boltzmann25-1000its,754,881,2233.890612778,2171.017190592,-127
carcassonne-boltzmann380-vs-boltzmann215-1000its,755,882,2164.846380171,2122.519800874,-127
carcassonne-ucttuned340-vs-ucttuned455-1000its,755,882,2242.181104047,2199.266862624,-127
carcassonne-uct185-vs-uct380-1000its,763,890,2190.752178848,2150.406079913,-127
carcassonne-uct30-vs-uct185-1000its,763,890,2268.202659659,2201.640879699,-127
carcassonne-boltzmann365-vs-boltzmann405-1000its,767,894,2234.337902565,2185.819348753,-127
carcassonne-uct305-vs-uct75-1000its,775,902,2228.943980111,2199.164693055,-127
carcassonne-ucttuned380-vs-ucttuned110-1000its,783,910,2159.386249528,2096.047720199,-127
carcassonne-boltzmann155-vs-boltzmann30-1000its,786,913,2213.216233165,2176.701431658,-127
carcassonne-ucttuned45-vs-ucttuned30-1000its,820,947,2182.269818703,2137.56800224,-127
carcassonne-ucttuned375-vs-ucttuned135-1000its,863,990,2180.507480642,2141.216802503,-127
carcassonne-boltzmann220-vs-boltzmann315-1000its,668,794,2123.787404469,2098.401594898,-126
carcassonne-uct285-vs-uct250-1000its,670,796,2219.133062875,2148.077938719,-126
carcassonne-boltzmann460-vs-boltzmann470-1000its,682,808,2168.637628235,2146.178174608,-126
carcassonne-boltzmann475-vs-boltzmann370-1000its,682,808,2201.428075304,2156.011265898,-126
carcassonne-boltzmann165-vs-boltzmann300-1000its,686,812,2172.756057605,2141.167212956,-126
carcassonne-boltzmann460-vs-boltzmann450-1000its,708,834,2225.825252984,2159.98930159,-126
carcassonne-uct130-vs-uct150-1000its,721,847,2177.741789993,2131.764093571,-126
carcassonne-uct420-vs-uct5-1000its,735,861,2189.865430466,2112.007864551,-126
carcassonne-uct400-vs-uct135-1000its,740,866,2151.611946244,2090.491849965,-126
carcassonne-ucttuned275-vs-ucttuned370-1000its,740,866,2112.717695646,2047.928540607,-126
carcassonne-boltzmann285-vs-boltzmann360-1000its,742,868,2154.088188184,2099.539140685,-126
carcassonne-ucttuned495-vs-ucttuned85-1000its,743,869,2142.056952916,2110.743384784,-126
carcassonne-uct225-vs-uct440-1000its,747,873,2162.79858822,2135.169808086,-126
carcassonne-ucttuned260-vs-ucttuned430-1000its,748,874,2229.682453636,2148.032020591,-126
carcassonne-ucttuned270-vs-ucttuned475-1000its,751,877,2220.324468315,2142.408367675,-126
carcassonne-uct95-vs-uct55-1000its,755,881,2202.573070175,2094.682112291,-126
carcassonne-boltzmann305-vs-boltzmann110-1000its,756,882,2212.221448992,2166.63640259,-126
carcassonne-ucttuned95-vs-ucttuned285-1000its,756,882,2166.729515328,2094.396469372,-126
carcassonne-ucttuned125-vs-ucttuned90-1000its,763,889,2229.504699951,2179.620943221,-126
carcassonne-uct170-vs-uct75-1000its,768,894,2236.918882405,2206.268794046,-126
carcassonne-boltzmann365-vs-boltzmann110-1000its,770,896,2234.673711487,2184.47804186,-126
carcassonne-ucttuned495-vs-ucttuned215-1000its,778,904,2172.679588242,2174.926788793,-126
carcassonne-ucttuned275-vs-ucttuned385-1000its,782,908,2142.160739585,2109.176392227,-126
carcassonne-uct190-vs-uct250-1000its,784,910,2186.153819004,2141.727396474,-126
carcassonne-ucttuned415-vs-ucttuned410-1000its,791,917,2284.160709999,2186.194711799,-126
carcassonne-ucttuned375-vs-ucttuned30-1000its,794,920,2259.109587017,2235.909223574,-126
carcassonne-uct130-vs-uct145-1000its,807,933,2161.590683449,2109.264670801,-126
carcassonne-ucttuned100-vs-ucttuned140-1000its,810,936,2235.438914565,2193.337656091,-126
carcassonne-ucttuned165-vs-ucttuned450-1000its,690,815,2221.904438161,2132.34642249,-125
carcassonne-ucttuned115-vs-ucttuned250-1000its,691,816,2195.881123269,2153.956782082,-125
carcassonne-boltzmann140-vs-boltzmann275-1000its,693,818,2202.454343256,2157.939316354,-125
carcassonne-ucttuned450-vs-ucttuned315-1000its,693,818,2139.844299869,2101.002742899,-125
carcassonne-uct125-vs-uct145-1000its,695,820,2246.124427704,2249.650753176,-125
carcassonne-uct265-vs-uct15-1000its,699,824,2167.891469,2148.923425861,-125
carcassonne-boltzmann375-vs-boltzmann475-1000its,700,825,2191.244981099,2083.100733875,-125
carcassonne-ucttuned170-vs-ucttuned405-1000its,701,826,2222.3347575,2165.462314475,-125
carcassonne-boltzmann115-vs-boltzmann420-1000its,709,834,2171.333178423,2077.202957952,-125
carcassonne-boltzmann320-vs-boltzmann410-1000its,710,835,2193.969096453,2188.730710588,-125
carcassonne-boltzmann395-vs-boltzmann240-1000its,712,837,2179.303526973,2124.4916446,-125
carcassonne-uct295-vs-uct20-1000its,713,838,2193.340759549,2144.999379254,-125
carcassonne-uct150-vs-uct110-1000its,720,845,2194.945020843,2196.38191005,-125
carcassonne-ucttuned340-vs-ucttuned400-1000its,721,846,2224.724019082,2154.730895855,-125
carcassonne-boltzmann160-vs-boltzmann5-1000its,727,852,2230.492510544,2187.338971036,-125
carcassonne-uct165-vs-uct425-1000its,736,861,2186.153530576,2129.997202316,-125
carcassonne-uct210-vs-uct325-1000its,741,866,2166.442356494,2112.975658426,-125
carcassonne-uct395-vs-uct410-1000its,741,866,2222.99146726,2185.978436816,-125
carcassonne-boltzmann125-vs-boltzmann295-1000its,743,868,2189.317269922,2153.769544425,-125
carcassonne-boltzmann410-vs-boltzmann75-1000its,744,869,2222.114499746,2164.673008438,-125
carcassonne-ucttuned445-vs-ucttuned115-1000its,745,870,2229.616971757,2195.824559077,-125
carcassonne-uct425-vs-uct400-1000its,748,873,2064.953560836,2060.798194019,-125
carcassonne-ucttuned415-vs-ucttuned15-1000its,748,873,2174.296002471,2159.467024206,-125
carcassonne-uct40-vs-uct20-1000its,756,881,2148.194098317,2093.250163126,-125
carcassonne-ucttuned455-vs-ucttuned225-1000its,756,881,2165.690804653,2146.961616589,-125
carcassonne-uct460-vs-uct145-1000its,763,888,2215.425501158,2160.062258977,-125
carcassonne-ucttuned110-vs-ucttuned20-1000its,767,892,2163.087234838,2127.853054422,-125
carcassonne-uct345-vs-uct380-1000its,769,894,2200.639612528,2191.126954043,-125
carcassonne-boltzmann350-vs-boltzmann30-1000its,772,897,2191.201217896,2167.129182433,-125
carcassonne-ucttuned135-vs-ucttuned5-1000its,781,906,2256.570138527,2197.276764682,-125
carcassonne-ucttuned160-vs-ucttuned235-1000its,794,919,2233.60313219,2204.163661641,-125
carcassonne-uct65-vs-uct350-1000its,813,938,2209.030843805,2133.16967862,-125
carcassonne-boltzmann440-vs-boltzmann125-1000its,826,951,2220.656072139,2141.461463321,-125
carcassonne-ucttuned460-vs-ucttuned340-1000its,647,771,2111.629409225,2093.293388462,-124
carcassonne-boltzmann465-vs-boltzmann325-1000its,655,779,2138.973814348,2077.137172625,-124
carcassonne-uct120-vs-uct35-1000its,676,800,2216.306376763,2159.800574308,-124
carcassonne-ucttuned200-vs-ucttuned255-1000its,679,803,2303.88236023,2164.608483231,-124
carcassonne-boltzmann50-vs-boltzmann190-1000its,692,816,2145.175805806,2125.781671405,-124
carcassonne-boltzmann230-vs-boltzmann370-1000its,712,836,2205.012406916,2131.991179736,-124
carcassonne-uct200-vs-uct435-1000its,713,837,2199.167537479,2132.084410575,-124
carcassonne-boltzmann485-vs-boltzmann195-1000its,723,847,2157.741667504,2130.410695814,-124
carcassonne-boltzmann415-vs-boltzmann465-1000its,727,851,2165.407497327,2148.231797118,-124
carcassonne-ucttuned245-vs-ucttuned90-1000its,728,852,2177.709583522,2176.558792893,-124
carcassonne-uct165-vs-uct40-1000its,729,853,2194.728415224,2134.720995216,-124
carcassonne-uct330-vs-uct485-1000its,743,867,2215.052743115,2206.379259053,-124
carcassonne-ucttuned265-vs-ucttuned470-1000its,743,867,2143.136490719,2111.420933279,-124
carcassonne-uct480-vs-uct230-1000its,749,873,2210.41909469,2207.08277826,-124
carcassonne-boltzmann355-vs-boltzmann300-1000its,754,878,2177.734339821,2131.980900155,-124
carcassonne-uct495-vs-uct425-1000its,754,878,2209.245451335,2218.90191286,-124
carcassonne-ucttuned480-vs-ucttuned60-1000its,754,878,2167.932258906,2144.074917219,-124
carcassonne-uct460-vs-uct85-1000its,766,890,2176.346519947,2142.672723378,-124
carcassonne-ucttuned490-vs-ucttuned45-1000its,772,896,2211.613560553,2182.648825326,-124
carcassonne-ucttuned490-vs-ucttuned300-1000its,773,897,2262.831383972,2182.773116264,-124
carcassonne-ucttuned85-vs-ucttuned155-1000its,776,900,2236.006069005,2180.939627823,-124
carcassonne-boltzmann210-vs-boltzmann110-1000its,783,907,2196.265639719,2157.689421675,-124
carcassonne-boltzmann270-vs-boltzmann280-1000its,792,916,2208.616014838,2159.847359996,-124
carcassonne-ucttuned410-vs-ucttuned250-1000its,792,916,2211.359140209,2179.712455862,-124
carcassonne-boltzmann405-vs-boltzmann285-1000its,796,920,2177.175644158,2126.025462636,-124
carcassonne-boltzmann410-vs-boltzmann145-1000its,803,927,2229.620722703,2166.727688469,-124
carcassonne-ucttuned270-vs-ucttuned15-1000its,877,1001,2119.261789579,2040.943675209,-124
carcassonne-uct250-vs-uct405-1000its,683,806,2139.27010022,2090.090934454,-123
carcassonne-boltzmann450-vs-boltzmann480-1000its,687,810,2113.55823636,2113.08013204,-123
carcassonne-boltzmann350-vs-boltzmann455-1000its,697,820,2181.348539718,2125.194020132,-123
carcassonne-uct235-vs-uct315-1000its,699,822,2255.001619575,2243.210044385,-123
carcassonne-boltzmann260-vs-boltzmann415-1000its,703,826,2252.791395946,2178.952788197,-123
carcassonne-uct240-vs-uct495-1000its,708,831,2254.499249695,2184.594590215,-123
carcassonne-ucttuned215-vs-ucttuned110-1000its,714,837,2274.201178839,2249.339025275,-123
carcassonne-boltzmann460-vs-boltzmann160-1000its,717,840,2160.013400201,2136.322182999,-123
carcassonne-ucttuned350-vs-ucttuned410-1000its,720,843,2205.845168838,2119.970216738,-123
carcassonne-boltzmann195-vs-boltzmann5-1000its,723,846,2186.765563747,2172.51537317,-123
carcassonne-uct370-vs-uct60-1000its,723,846,2199.565806923,2112.608428921,-123
carcassonne-uct420-vs-uct360-1000its,726,849,2125.993750197,2082.350208552,-123
carcassonne-boltzmann185-vs-boltzmann165-1000its,732,855,2182.793353587,2129.391418982,-123
carcassonne-uct495-vs-uct20-1000its,732,855,2151.448226739,2115.311317464,-123
carcassonne-boltzmann415-vs-boltzmann350-1000its,736,859,2168.682203256,2094.224077269,-123
carcassonne-uct75-vs-uct290-1000its,739,862,2178.64303445,2122.674631705,-123
carcassonne-boltzmann110-vs-boltzmann320-1000its,746,869,2131.316569615,2109.891150722,-123
carcassonne-ucttuned130-vs-ucttuned255-1000its,749,872,2214.639397648,2108.507577404,-123
carcassonne-uct295-vs-uct160-1000its,750,873,2178.136117931,2106.620670218,-123
carcassonne-boltzmann460-vs-boltzmann295-1000its,752,875,2211.204957509,2156.94373553,-123
carcassonne-uct380-vs-uct375-1000its,755,878,2237.048513864,2244.564155601,-123
carcassonne-ucttuned100-vs-ucttuned10-1000its,756,879,2217.10421915,2179.21349528,-123
carcassonne-boltzmann425-vs-boltzmann450-1000its,757,880,2228.762519599,2181.259590593,-123
carcassonne-ucttuned330-vs-ucttuned170-1000its,758,881,2191.202081552,2153.323307691,-123
carcassonne-ucttuned300-vs-ucttuned360-1000its,764,887,2187.686508444,2118.298809012,-123
carcassonne-uct480-vs-uct325-1000its,766,889,2198.148577623,2153.877138756,-123
carcassonne-boltzmann195-vs-boltzmann310-1000its,778,901,2145.741322577,2071.84679733,-123
carcassonne-ucttuned280-vs-ucttuned475-1000its,778,901,2173.879553392,2116.595266799,-123
carcassonne-uct190-vs-uct290-1000its,789,912,2133.472821597,2094.433703185,-123
carcassonne-boltzmann375-vs-boltzmann440-1000its,795,918,2218.665587012,2159.737426272,-123
carcassonne-ucttuned455-vs-ucttuned60-1000its,802,925,2177.72464106,2160.718919141,-123
carcassonne-boltzmann105-vs-boltzmann75-1000its,669,791,2176.957309785,2173.967230872,-122
carcassonne-boltzmann340-vs-boltzmann430-1000its,699,821,2188.696681679,2162.740984532,-122
carcassonne-boltzmann160-vs-boltzmann395-1000its,700,822,2181.754218613,2145.449549785,-122
carcassonne-uct310-vs-uct355-1000its,703,825,2184.838681845,2159.73357746,-122
carcassonne-boltzmann450-vs-boltzmann425-1000its,705,827,2167.202699152,2151.670034089,-122
carcassonne-ucttuned95-vs-ucttuned405-1000its,709,831,2150.074106236,2105.940832682,-122
carcassonne-boltzmann325-vs-boltzmann405-1000its,714,836,2170.650366041,2080.402670625,-122
carcassonne-uct390-vs-uct400-1000its,714,836,2196.25047714,2134.246022277,-122
carcassonne-boltzmann365-vs-boltzmann25-1000its,718,840,2175.2669678,2140.574180207,-122
carcassonne-uct355-vs-uct120-1000its,720,842,2223.910708363,2185.036794094,-122
carcassonne-ucttuned405-vs-ucttuned145-1000its,720,842,2219.822598696,2172.351957445,-122
carcassonne-ucttuned190-vs-ucttuned195-1000its,726,848,2175.850826087,2136.357599023,-122
carcassonne-boltzmann380-vs-boltzmann25-1000its,731,853,2205.285702773,2153.655834819,-122
carcassonne-ucttuned360-vs-ucttuned250-1000its,732,854,2227.775366946,2212.302151537,-122
carcassonne-ucttuned190-vs-ucttuned80-1000its,733,855,2171.937477029,2118.583808542,-122
carcassonne-uct95-vs-uct35-1000its,735,857,2225.539359232,2201.385657272,-122
carcassonne-ucttuned335-vs-ucttuned325-1000its,736,858,2205.395426508,2131.122965911,-122
carcassonne-uct320-vs-uct180-1000its,739,861,2272.971534977,2217.255050518,-122
carcassonne-ucttuned15-vs-ucttuned20-1000its,745,867,2210.937018017,2161.777523759,-122
carcassonne-boltzmann435-vs-boltzmann45-1000its,749,871,2212.456342206,2198.324499073,-122
carcassonne-ucttuned160-vs-ucttuned495-1000its,749,871,2264.189457423,2188.521616974,-122
carcassonne-ucttuned55-vs-ucttuned375-1000its,774,896,2235.671618757,2171.827463067,-122
carcassonne-uct390-vs-uct365-1000its,781,903,2207.807355869,2175.187077663,-122
carcassonne-boltzmann230-vs-boltzmann175-1000its,787,909,2149.232539116,2117.983026046,-122
carcassonne-boltzmann125-vs-boltzmann320-1000its,591,712,1751.320514448,1749.925041676,-121
carcassonne-boltzmann230-vs-boltzmann140-1000its,607,728,2206.012955672,2154.698410663,-121
carcassonne-boltzmann95-vs-boltzmann20-1000its,650,771,2137.224717414,2105.642147014,-121
carcassonne-boltzmann95-vs-boltzmann265-1000its,672,793,2197.854879709,2115.194611353,-121
carcassonne-boltzmann160-vs-boltzmann190-1000its,679,800,2197.244832941,2137.473674479,-121
carcassonne-ucttuned385-vs-ucttuned390-1000its,679,800,2204.314831613,2160.772376159,-121
carcassonne-boltzmann355-vs-boltzmann115-1000its,683,804,2151.518556587,2172.114784568,-121
carcassonne-boltzmann90-vs-boltzmann395-1000its,684,805,2216.368446985,2173.333112623,-121
carcassonne-boltzmann65-vs-boltzmann25-1000its,692,813,2103.857634087,2073.514746004,-121
carcassonne-uct470-vs-uct350-1000its,692,813,2173.666589471,2128.845973303,-121
carcassonne-ucttuned245-vs-ucttuned335-1000its,704,825,2167.432877314,2170.339236474,-121
carcassonne-boltzmann140-vs-boltzmann245-1000its,705,826,2203.435030444,2153.962500352,-121
carcassonne-uct455-vs-uct305-1000its,711,832,2205.298780884,2193.285354487,-121
carcassonne-ucttuned65-vs-ucttuned100-1000its,711,832,2232.711331598,2138.436317258,-121
carcassonne-uct495-vs-uct240-1000its,715,836,2265.0931785,2225.697197021,-121
carcassonne-uct305-vs-uct35-1000its,721,842,2213.121434168,2185.076891726,-121
carcassonne-boltzmann350-vs-boltzmann170-1000its,724,845,2085.742908314,2125.505022341,-121
carcassonne-boltzmann455-vs-boltzmann360-1000its,724,845,2261.170011857,2234.534914529,-121
carcassonne-ucttuned280-vs-ucttuned245-1000its,728,849,2211.923078622,2168.08636267,-121
carcassonne-boltzmann55-vs-boltzmann110-1000its,737,858,2131.374695784,2127.812223969,-121
carcassonne-ucttuned350-vs-ucttuned35-1000its,738,859,2148.446195207,2131.465920112,-121
carcassonne-boltzmann200-vs-boltzmann75-1000its,739,860,2164.807860506,2104.367836662,-121
carcassonne-ucttuned305-vs-ucttuned425-1000its,740,861,2210.691651087,2205.91578564,-121
carcassonne-boltzmann260-vs-boltzmann375-1000its,743,864,2210.162671923,2156.812486377,-121
carcassonne-boltzmann120-vs-boltzmann400-1000its,744,865,2200.995794507,2184.084136447,-121
carcassonne-boltzmann170-vs-boltzmann70-1000its,745,866,2252.059293803,2185.744749019,-121
carcassonne-ucttuned330-vs-ucttuned235-1000its,746,867,2173.904841998,2132.053795889,-121
carcassonne-ucttuned310-vs-ucttuned20-1000its,750,871,2148.460288091,2068.884724977,-121
carcassonne-uct140-vs-uct105-1000its,753,874,2180.010629434,2109.708409646,-121
carcassonne-boltzmann240-vs-boltzmann370-1000its,760,881,2164.64442911,2099.144861525,-121
carcassonne-ucttuned230-vs-ucttuned155-1000its,762,883,2264.177465886,2217.606976643,-121
carcassonne-ucttuned410-vs-ucttuned200-1000its,764,885,2210.970427417,2159.42552365,-121
carcassonne-uct370-vs-uct205-1000its,765,886,2234.038499263,2182.343852926,-121
carcassonne-uct170-vs-uct205-1000its,767,888,2209.725881229,2127.73791876,-121
carcassonne-uct320-vs-uct70-1000its,769,890,2210.997190857,2117.138335302,-121
carcassonne-uct430-vs-uct390-1000its,797,918,2204.69840162,2147.161618915,-121
carcassonne-boltzmann475-vs-boltzmann50-1000its,816,937,2235.725232871,2216.263234653,-121
carcassonne-ucttuned265-vs-ucttuned185-1000its,816,937,2226.471555694,2183.624042923,-121
carcassonne-ucttuned240-vs-ucttuned90-1000its,819,940,2212.705708,2149.310756096,-121
carcassonne-uct125-vs-uct210-1000its,822,943,2240.79629362,2225.043525094,-121
carcassonne-uct145-vs-uct320-1000its,837,958,2192.47986842,2111.297842183,-121
carcassonne-uct350-vs-uct225-1000its,655,775,2209.787035824,2166.897588155,-120
carcassonne-boltzmann150-vs-boltzmann85-1000its,664,784,2231.845699815,2206.700346033,-120
carcassonne-ucttuned85-vs-ucttuned160-1000its,677,797,2218.447319621,2207.464700473,-120
carcassonne-ucttuned240-vs-ucttuned10-1000its,683,803,2154.55630952,2084.543738099,-120
carcassonne-ucttuned155-vs-ucttuned440-1000its,691,811,2228.534598985,2138.073170327,-120
carcassonne-uct215-vs-uct460-1000its,692,812,2185.139516862,2132.065405297,-120
carcassonne-ucttuned5-vs-ucttuned210-1000its,696,816,2140.389045144,2116.249553157,-120
carcassonne-boltzmann70-vs-boltzmann335-1000its,698,818,2203.214086993,2145.681648894,-120
carcassonne-uct210-vs-uct465-1000its,708,828,2178.06719992,2086.949709694,-120
carcassonne-boltzmann455-vs-boltzmann490-1000its,709,829,2173.257750049,2155.185996679,-120
carcassonne-ucttuned455-vs-ucttuned255-1000its,714,834,2226.021871679,2174.660050911,-120
carcassonne-boltzmann285-vs-boltzmann430-1000its,719,839,2218.196709192,2141.149974229,-120
carcassonne-boltzmann240-vs-boltzmann400-1000its,720,840,2188.147707774,2148.010136664,-120
carcassonne-boltzmann355-vs-boltzmann415-1000its,720,840,2181.372228504,2197.702356035,-120
carcassonne-ucttuned65-vs-ucttuned135-1000its,721,841,2118.699482955,2061.260602775,-120
carcassonne-uct395-vs-uct210-1000its,723,843,2146.455872606,2141.119310722,-120
carcassonne-ucttuned320-vs-ucttuned355-1000its,724,844,2171.270721872,2111.162960705,-120
carcassonne-boltzmann50-vs-boltzmann85-1000its,733,853,2224.72595412,2160.511327176,-120
carcassonne-boltzmann195-vs-boltzmann355-1000its,742,862,2240.45744137,2218.866787116,-120
carcassonne-uct225-vs-uct190-1000its,747,867,2219.085748557,2153.60156601,-120
carcassonne-uct150-vs-uct5-1000its,753,873,2200.450338703,2113.260364623,-120
carcassonne-uct360-vs-uct25-1000its,758,878,2263.218754105,2236.176084701,-120
carcassonne-uct425-vs-uct465-1000its,759,879,2169.463365841,2125.335580649,-120
carcassonne-uct340-vs-uct305-1000its,776,896,2256.555974733,2217.656551033,-120
carcassonne-boltzmann330-vs-boltzmann80-1000its,792,912,2163.104746423,2120.578744284,-120
carcassonne-ucttuned305-vs-ucttuned105-1000its,798,918,2181.338125838,2180.493904076,-120
carcassonne-ucttuned320-vs-ucttuned85-1000its,798,918,2280.229817214,2249.227995013,-120
carcassonne-boltzmann165-vs-boltzmann265-1000its,661,780,2156.103077399,2082.911634753,-119
carcassonne-boltzmann465-vs-boltzmann80-1000its,670,789,2217.344792845,2147.881953598,-119
carcassonne-boltzmann170-vs-boltzmann30-1000its,680,799,2172.064442923,2122.86499308,-119
carcassonne-uct185-vs-uct60-1000its,684,803,2233.386946212,2160.384366878,-119
carcassonne-uct410-vs-uct125-1000its,688,807,2246.341239575,2177.272847537,-119
carcassonne-uct340-vs-uct465-1000its,692,811,2238.522444359,2215.212378335,-119
carcassonne-boltzmann90-vs-boltzmann55-1000its,703,822,2226.742002792,2165.404136039,-119
carcassonne-ucttuned100-vs-ucttuned45-1000its,712,831,2122.989586261,2106.421719796,-119
carcassonne-uct420-vs-uct450-1000its,717,836,2187.332771541,2134.931430751,-119
carcassonne-boltzmann255-vs-boltzmann490-1000its,720,839,2164.386994472,2131.058975364,-119
carcassonne-uct205-vs-uct155-1000its,720,839,2199.112325794,2167.52718488,-119
carcassonne-uct465-vs-uct270-1000its,720,839,2205.15749364,2185.404290476,-119
carcassonne-boltzmann235-vs-boltzmann195-1000its,723,842,2149.723809402,2105.016610489,-119
carcassonne-uct180-vs-uct415-1000its,739,858,2171.632512559,2147.495443833,-119
carcassonne-uct430-vs-uct75-1000its,739,858,2233.702427189,2177.366651154,-119
carcassonne-ucttuned140-vs-ucttuned445-1000its,740,859,2213.449828256,2149.197051385,-119
carcassonne-uct280-vs-uct460-1000its,741,860,2215.331141109,2181.099926699,-119
carcassonne-boltzmann310-vs-boltzmann220-1000its,742,861,2195.73953187,2186.323607419,-119
carcassonne-uct345-vs-uct415-1000its,743,862,2198.065913199,2231.374545635,-119
carcassonne-ucttuned180-vs-ucttuned15-1000its,743,862,2197.398256714,2141.374862515,-119
carcassonne-ucttuned165-vs-ucttuned320-1000its,744,863,2189.869917764,2159.235104734,-119
carcassonne-ucttuned245-vs-ucttuned145-1000its,745,864,2181.103047866,2155.762753643,-119
carcassonne-ucttuned240-vs-ucttuned5-1000its,747,866,2223.040975542,2171.35976359,-119
carcassonne-uct215-vs-uct440-1000its,750,869,2257.616108796,2235.672690944,-119
carcassonne-uct395-vs-uct345-1000its,751,870,2157.124989904,2097.68346875,-119
carcassonne-boltzmann240-vs-boltzmann260-1000its,752,871,2219.674727188,2180.485454417,-119
carcassonne-boltzmann100-vs-boltzmann360-1000its,754,873,2177.682176416,2185.058146037,-119
carcassonne-ucttuned180-vs-ucttuned470-1000its,754,873,2237.567330711,2149.106842348,-119
carcassonne-uct190-vs-uct325-1000its,756,875,2245.57665516,2204.199604805,-119
carcassonne-ucttuned130-vs-ucttuned320-1000its,767,886,2193.944160726,2166.871998115,-119
carcassonne-boltzmann205-vs-boltzmann465-1000its,769,888,2261.154426206,2223.3282242,-119
carcassonne-uct435-vs-uct385-1000its,769,888,2165.165275068,2102.131752621,-119
carcassonne-ucttuned180-vs-ucttuned190-1000its,770,889,2211.933742004,2156.942307732,-119
carcassonne-ucttuned450-vs-ucttuned155-1000its,770,889,2207.28452358,2164.956970199,-119
carcassonne-uct315-vs-uct10-1000its,771,890,2173.623831957,2111.445187367,-119
carcassonne-boltzmann115-vs-boltzmann190-1000its,779,898,2182.625920117,2095.486270632,-119
carcassonne-ucttuned155-vs-ucttuned175-1000its,783,902,2170.256235126,2130.395973343,-119
carcassonne-uct225-vs-uct15-1000its,785,904,2153.337303729,2098.410206748,-119
carcassonne-uct245-vs-uct5-1000its,797,916,2128.021233012,2092.167481047,-119
carcassonne-boltzmann270-vs-boltzmann95-1000its,814,933,2187.188909507,2131.00331716,-119
carcassonne-ucttuned200-vs-ucttuned390-1000its,840,959,2192.923860389,2128.681094219,-119
carcassonne-uct280-vs-uct105-1000its,663,781,2215.579119581,2228.941322838,-118
carcassonne-uct470-vs-uct180-1000its,663,781,2193.853974342,2146.717520836,-118
carcassonne-boltzmann415-vs-boltzmann200-1000its,668,786,2233.302250564,2200.215942156,-118
carcassonne-boltzmann250-vs-boltzmann80-1000its,686,804,2193.777272268,2187.137462689,-118
carcassonne-uct420-vs-uct425-1000its,694,812,2148.935363634,2145.711355315,-118
carcassonne-boltzmann140-vs-boltzmann60-1000its,696,814,2151.035175768,2162.345942069,-118
carcassonne-uct340-vs-uct170-1000its,698,816,2186.345356113,2167.293235181,-118
carcassonne-boltzmann495-vs-boltzmann390-1000its,702,820,2146.832755307,2160.143760032,-118
carcassonne-ucttuned265-vs-ucttuned285-1000its,712,830,2243.055431372,2187.351890742,-118
carcassonne-uct50-vs-uct5-1000its,718,836,2162.663974307,2148.231339248,-118
carcassonne-boltzmann255-vs-boltzmann265-1000its,725,843,2232.040703894,2150.354499178,-118
carcassonne-ucttuned40-vs-ucttuned320-1000its,731,849,2229.58666829,2124.363853253,-118
carcassonne-ucttuned325-vs-ucttuned365-1000its,732,850,2241.732381719,2184.666931721,-118
carcassonne-boltzmann260-vs-boltzmann335-1000its,733,851,2153.297991774,2108.742922027,-118
carcassonne-ucttuned180-vs-ucttuned140-1000its,733,851,2235.297466962,2214.468231745,-118
carcassonne-boltzmann20-vs-boltzmann195-1000its,738,856,2203.276935279,2150.961615896,-118
carcassonne-uct20-vs-uct295-1000its,740,858,2244.485669685,2164.547405189,-118
carcassonne-ucttuned435-vs-ucttuned375-1000its,745,863,2271.521887533,2188.599294043,-118
carcassonne-uct475-vs-uct175-1000its,748,866,2247.647060249,2169.033082177,-118
carcassonne-boltzmann255-vs-boltzmann420-1000its,750,868,2250.57171053,2208.641865859,-118
carcassonne-boltzmann250-vs-boltzmann320-1000its,751,869,2142.073768761,2136.717683179,-118
carcassonne-uct375-vs-uct250-1000its,753,871,2254.537695009,2192.887161501,-118
carcassonne-uct20-vs-uct195-1000its,755,873,2160.550877478,2138.62571453,-118
carcassonne-uct165-vs-uct400-1000its,761,879,2262.667702435,2185.06861533,-118
carcassonne-ucttuned165-vs-ucttuned310-1000its,765,883,2194.632074754,2146.22020397,-118
carcassonne-ucttuned10-vs-ucttuned45-1000its,766,884,2259.460436998,2223.878403823,-118
carcassonne-boltzmann450-vs-boltzmann245-1000its,768,886,2249.960057272,2133.184835884,-118
carcassonne-ucttuned235-vs-ucttuned260-1000its,777,895,2165.81723033,2148.466900326,-118
carcassonne-boltzmann420-vs-boltzmann230-1000its,784,902,2244.067126112,2190.554098046,-118
carcassonne-boltzmann460-vs-boltzmann5-1000its,793,911,2169.475480837,2177.930576193,-118
carcassonne-uct5-vs-uct105-1000its,808,926,2182.5328863,2095.767618594,-118
carcassonne-ucttuned120-vs-ucttuned220-1000its,689,806,2252.700258605,2184.358517338,-117
carcassonne-ucttuned145-vs-ucttuned395-1000its,698,815,2201.534409458,2165.827212215,-117
carcassonne-uct180-vs-uct490-1000its,706,823,2244.998095185,2148.203842313,-117
carcassonne-boltzmann265-vs-boltzmann405-1000its,708,825,2201.550688654,2106.993903348,-117
carcassonne-uct345-vs-uct140-1000its,714,831,2233.644404937,2152.631833141,-117
carcassonne-boltzmann20-vs-boltzmann325-1000its,716,833,2169.262928915,2095.509431663,-117
carcassonne-uct65-vs-uct135-1000its,717,834,2182.133067281,2163.465906581,-117
carcassonne-uct40-vs-uct190-1000its,721,838,2223.098547178,2202.484688896,-117
carcassonne-boltzmann25-vs-boltzmann250-1000its,725,842,2163.320101096,2173.120205555,-117
carcassonne-boltzmann275-vs-boltzmann310-1000its,726,843,2204.428106845,2144.188462251,-117
carcassonne-ucttuned315-vs-ucttuned410-1000its,727,844,2163.446988143,2131.838457413,-117
carcassonne-ucttuned330-vs-ucttuned490-1000its,728,845,2215.779624093,2187.6479617,-117
carcassonne-boltzmann330-vs-boltzmann390-1000its,729,846,2244.075356425,2197.172625105,-117
carcassonne-uct180-vs-uct230-1000its,731,848,2220.76967858,2176.897822658,-117
carcassonne-boltzmann275-vs-boltzmann295-1000its,733,850,2246.460065983,2167.7237993,-117
carcassonne-ucttuned420-vs-ucttuned185-1000its,733,850,2162.820394304,2149.545092013,-117
carcassonne-boltzmann365-vs-boltzmann120-1000its,737,854,2185.503269857,2131.358178194,-117
carcassonne-ucttuned115-vs-ucttuned95-1000its,741,858,2184.020943985,2111.318526674,-117
carcassonne-ucttuned280-vs-ucttuned425-1000its,741,858,2209.620653962,2193.602124332,-117
carcassonne-ucttuned425-vs-ucttuned145-1000its,741,858,2182.856023832,2157.901075461,-117
carcassonne-uct55-vs-uct225-1000its,744,861,2198.859064866,2190.271912103,-117
carcassonne-uct290-vs-uct220-1000its,745,862,2205.842732811,2146.34281808,-117
carcassonne-ucttuned440-vs-ucttuned455-1000its,745,862,2163.771997639,2129.000305173,-117
carcassonne-ucttuned415-vs-ucttuned240-1000its,748,865,2246.078351595,2153.281978003,-117
carcassonne-uct350-vs-uct15-1000its,755,872,2163.275570048,2120.589460744,-117
carcassonne-boltzmann140-vs-boltzmann410-1000its,757,874,2178.456926029,2078.559594304,-117
carcassonne-boltzmann280-vs-boltzmann420-1000its,763,880,2206.541111419,2163.940157974,-117
carcassonne-boltzmann275-vs-boltzmann235-1000its,764,881,2231.967697087,2176.047018358,-117
carcassonne-boltzmann105-vs-boltzmann175-1000its,766,883,2211.371368271,2178.527357716,-117
carcassonne-uct290-vs-uct380-1000its,776,893,2202.089340212,2113.258394776,-117
carcassonne-ucttuned135-vs-ucttuned260-1000its,778,895,2130.626276726,2113.581798409,-117
carcassonne-ucttuned190-vs-ucttuned260-1000its,778,895,2253.86492973,2214.925202347,-117
carcassonne-uct465-vs-uct280-1000its,789,906,2161.88429742,2158.181026069,-117
carcassonne-uct295-vs-uct215-1000its,794,911,2173.674683052,2147.860778437,-117
carcassonne-boltzmann495-vs-boltzmann70-1000its,850,967,2161.089861311,2100.571597949,-117
carcassonne-ucttuned130-vs-ucttuned95-1000its,691,807,2185.128842431,2130.244328683,-116
carcassonne-ucttuned250-vs-ucttuned145-1000its,702,818,2159.841275919,2119.076130021,-116
carcassonne-boltzmann365-vs-boltzmann340-1000its,703,819,2191.977042644,2134.438641885,-116
carcassonne-ucttuned175-vs-ucttuned60-1000its,707,823,2163.199437745,2144.172750131,-116
carcassonne-boltzmann120-vs-boltzmann265-1000its,709,825,2222.474035925,2152.71200752,-116
carcassonne-ucttuned205-vs-ucttuned430-1000its,716,832,2219.048977962,2150.436549752,-116
carcassonne-ucttuned140-vs-ucttuned210-1000its,718,834,2243.774096376,2161.614725929,-116
carcassonne-boltzmann240-vs-boltzmann380-1000its,719,835,2259.842437569,2204.561713148,-116
carcassonne-uct385-vs-uct395-1000its,726,842,2245.249544142,2211.931380249,-116
carcassonne-uct120-vs-uct165-1000its,727,843,2165.114064983,2126.821246856,-116
carcassonne-boltzmann425-vs-boltzmann410-1000its,728,844,2218.453435456,2207.361333811,-116
carcassonne-ucttuned400-vs-ucttuned75-1000its,729,845,2164.605862113,2094.152297312,-116
carcassonne-ucttuned410-vs-ucttuned320-1000its,729,845,2201.310930581,2133.59408102,-116
carcassonne-uct95-vs-uct120-1000its,731,847,2156.39261107,2099.791524885,-116
carcassonne-uct95-vs-uct450-1000its,731,847,2142.857762077,2115.925108865,-116
carcassonne-ucttuned460-vs-ucttuned475-1000its,735,851,2237.293757194,2218.617602708,-116
carcassonne-boltzmann25-vs-boltzmann370-1000its,737,853,2182.539580317,2101.276130964,-116
carcassonne-boltzmann350-vs-boltzmann185-1000its,738,854,2195.67208091,2142.004042571,-116
carcassonne-ucttuned305-vs-ucttuned325-1000its,742,858,2111.059254281,2136.034252167,-116
carcassonne-uct165-vs-uct15-1000its,747,863,2262.871914386,2182.740250064,-116
carcassonne-uct490-vs-uct175-1000its,747,863,2145.113138688,2158.311901986,-116
carcassonne-boltzmann445-vs-boltzmann40-1000its,748,864,2149.273746595,2111.674781545,-116
carcassonne-ucttuned320-vs-ucttuned475-1000its,748,864,2200.178066906,2136.542044602,-116
carcassonne-uct340-vs-uct335-1000its,752,868,2261.571557359,2185.805560685,-116
carcassonne-uct330-vs-uct310-1000its,755,871,2119.284609858,2094.986935131,-116
carcassonne-boltzmann295-vs-boltzmann325-1000its,758,874,2195.531995996,2169.843383251,-116
carcassonne-boltzmann180-vs-boltzmann115-1000its,765,881,2198.632862104,2124.878339384,-116
carcassonne-boltzmann395-vs-boltzmann260-1000its,767,883,2191.136447596,2134.929526651,-116
carcassonne-ucttuned140-vs-ucttuned70-1000its,770,886,2273.545237471,2271.392646694,-116
carcassonne-uct220-vs-uct200-1000its,775,891,2115.784322871,2107.549959915,-116
carcassonne-ucttuned365-vs-ucttuned105-1000its,779,895,2244.195127847,2208.634633921,-116
carcassonne-ucttuned75-vs-ucttuned320-1000its,782,898,2198.835662172,2146.719919374,-116
carcassonne-ucttuned25-vs-ucttuned5-1000its,783,899,2256.63675716,2172.853471477,-116
carcassonne-ucttuned260-vs-ucttuned40-1000its,785,901,2234.993846029,2195.466970739,-116
carcassonne-uct80-vs-uct15-1000its,792,908,2189.421794956,2172.028248871,-116
carcassonne-ucttuned25-vs-ucttuned150-1000its,794,910,2173.430446006,2107.581114955,-116
carcassonne-boltzmann185-vs-boltzmann175-1000its,809,925,2107.492712,2125.754670614,-116
carcassonne-uct300-vs-uct395-1000its,815,931,2142.862008374,2117.517726171,-116
carcassonne-uct430-vs-uct455-1000its,817,933,2197.041658369,2137.680090105,-116
carcassonne-boltzmann445-vs-boltzmann80-1000its,821,937,2156.996374095,2148.97966209,-116
carcassonne-ucttuned450-vs-ucttuned40-1000its,534,649,1787.151589595,1726.782170313,-115
carcassonne-uct20-vs-uct190-1000its,688,803,2168.083637939,2113.46145557,-115
carcassonne-boltzmann140-vs-boltzmann80-1000its,690,805,2228.595451842,2219.522019406,-115
carcassonne-boltzmann435-vs-boltzmann135-1000its,695,810,2222.810124463,2158.29556198,-115
carcassonne-ucttuned260-vs-ucttuned210-1000its,699,814,2136.501606263,2115.434063913,-115
carcassonne-boltzmann45-vs-boltzmann210-1000its,711,826,2199.946504139,2190.172992943,-115
carcassonne-uct155-vs-uct365-1000its,711,826,2245.583722947,2192.390298164,-115
carcassonne-boltzmann285-vs-boltzmann95-1000its,714,829,2229.993319741,2170.215278354,-115
carcassonne-uct25-vs-uct60-1000its,718,833,2208.806782171,2190.493777943,-115
carcassonne-boltzmann375-vs-boltzmann220-1000its,722,837,2185.264676339,2177.847701911,-115
carcassonne-boltzmann135-vs-boltzmann450-1000its,723,838,2184.110315538,2103.606531823,-115
carcassonne-boltzmann235-vs-boltzmann55-1000its,727,842,2228.435220402,2194.536965066,-115
carcassonne-uct255-vs-uct365-1000its,732,847,2208.94117304,2125.689366213,-115
carcassonne-uct100-vs-uct220-1000its,736,851,2209.977128657,2197.772080579,-115
carcassonne-ucttuned135-vs-ucttuned155-1000its,737,852,2166.87922497,2133.92349631,-115
carcassonne-ucttuned310-vs-ucttuned30-1000its,737,852,2158.98879272,2113.645064109,-115
carcassonne-ucttuned315-vs-ucttuned345-1000its,739,854,2178.015398306,2138.964599486,-115
carcassonne-uct255-vs-uct385-1000its,740,855,2165.852840273,2089.879786836,-115
carcassonne-uct355-vs-uct125-1000its,741,856,2228.126815469,2203.548948029,-115
carcassonne-boltzmann440-vs-boltzmann375-1000its,744,859,2149.564422538,2144.64044048,-115
carcassonne-boltzmann205-vs-boltzmann100-1000its,746,861,2222.404416218,2136.316163699,-115
carcassonne-uct230-vs-uct5-1000its,746,861,2145.802985308,2121.110029057,-115
carcassonne-boltzmann385-vs-boltzmann250-1000its,747,862,2185.745623052,2130.953127278,-115
carcassonne-uct150-vs-uct50-1000its,750,865,2177.218688203,2149.916971484,-115
carcassonne-ucttuned325-vs-ucttuned490-1000its,752,867,2159.587955214,2109.069953765,-115
carcassonne-boltzmann185-vs-boltzmann115-1000its,754,869,2141.069611826,2124.703568685,-115
carcassonne-ucttuned375-vs-ucttuned125-1000its,754,869,2217.760344399,2171.042074875,-115
carcassonne-ucttuned135-vs-ucttuned210-1000its,756,871,2219.227122652,2163.89918514,-115
carcassonne-ucttuned335-vs-ucttuned495-1000its,756,871,2189.909906237,2129.441288342,-115
carcassonne-uct475-vs-uct390-1000its,762,877,2172.323643374,2122.52189229,-115
carcassonne-uct185-vs-uct155-1000its,766,881,2140.796541765,2100.96943971,-115
carcassonne-ucttuned375-vs-ucttuned435-1000its,775,890,2179.208557942,2124.295898582,-115
carcassonne-uct390-vs-uct470-1000its,779,894,2178.119391052,2092.461822488,-115
carcassonne-ucttuned115-vs-ucttuned360-1000its,781,896,2199.220856796,2135.56915324,-115
carcassonne-uct65-vs-uct10-1000its,783,898,2189.7147749,2190.75038371,-115
carcassonne-boltzmann165-vs-boltzmann320-1000its,784,899,2084.606286877,2061.292736215,-115
carcassonne-uct345-vs-uct105-1000its,803,918,2277.580361076,2191.157839033,-115
carcassonne-ucttuned405-vs-ucttuned215-1000its,807,922,2171.988296487,2144.635482592,-115
carcassonne-boltzmann100-vs-boltzmann35-1000its,830,945,2223.060963394,2190.718287261,-115
carcassonne-boltzmann410-vs-boltzmann330-1000its,666,780,2201.689742804,2165.449164509,-114
carcassonne-uct310-vs-uct75-1000its,677,791,2217.636197959,2186.994057821,-114
carcassonne-ucttuned475-vs-ucttuned265-1000its,681,795,2234.372533948,2217.903885024,-114
carcassonne-uct445-vs-uct75-1000its,682,796,2236.561443627,2201.590137871,-114
carcassonne-ucttuned335-vs-ucttuned215-1000its,696,810,2131.363259132,2102.484523079,-114
carcassonne-boltzmann40-vs-boltzmann410-1000its,697,811,2152.0723502,2130.737052283,-114
carcassonne-ucttuned285-vs-ucttuned200-1000its,699,813,2236.571775777,2203.697728721,-114
carcassonne-boltzmann180-vs-boltzmann160-1000its,704,818,2241.395671121,2214.674721995,-114
carcassonne-ucttuned455-vs-ucttuned145-1000its,704,818,2165.603969227,2142.976106622,-114
carcassonne-boltzmann270-vs-boltzmann405-1000its,711,825,2218.81652375,2168.330805343,-114
carcassonne-uct155-vs-uct375-1000its,715,829,2223.545748043,2150.312254363,-114
carcassonne-uct190-vs-uct380-1000its,716,830,2140.195369211,2125.023798755,-114
carcassonne-uct405-vs-uct195-1000its,718,832,2242.317061684,2195.641859447,-114
carcassonne-boltzmann305-vs-boltzmann105-1000its,720,834,2156.832037989,2159.284149829,-114
carcassonne-uct450-vs-uct20-1000its,723,837,2236.803894888,2207.931600249,-114
carcassonne-boltzmann355-vs-boltzmann50-1000its,725,839,2214.670344591,2175.014462602,-114
carcassonne-boltzmann380-vs-boltzmann150-1000its,726,840,2173.776893321,2135.756277626,-114
carcassonne-ucttuned70-vs-ucttuned440-1000its,732,846,2192.743096125,2136.712471688,-114
carcassonne-uct300-vs-uct125-1000its,733,847,2184.519416067,2144.711629905,-114
carcassonne-ucttuned235-vs-ucttuned10-1000its,734,848,2188.580781982,2209.993175872,-114
carcassonne-ucttuned335-vs-ucttuned15-1000its,736,850,2209.994236515,2223.409148488,-114
carcassonne-boltzmann440-vs-boltzmann50-1000its,738,852,2202.877693243,2116.243034715,-114
carcassonne-boltzmann45-vs-boltzmann475-1000its,741,855,2187.677653177,2125.528194051,-114
carcassonne-ucttuned395-vs-ucttuned350-1000its,741,855,2264.556073257,2306.048421748,-114
carcassonne-uct335-vs-uct475-1000its,743,857,2215.846109804,2181.595050209,-114
carcassonne-ucttuned375-vs-ucttuned85-1000its,743,857,2134.758979857,2105.972539623,-114
carcassonne-uct125-vs-uct215-1000its,744,858,2255.672691916,2168.130827046,-114
carcassonne-uct380-vs-uct200-1000its,744,858,2142.363122653,2119.444012791,-114
carcassonne-ucttuned440-vs-ucttuned295-1000its,744,858,2204.079549344,2165.733583096,-114
carcassonne-boltzmann425-vs-boltzmann205-1000its,750,864,2140.127741995,2126.793007551,-114
carcassonne-uct165-vs-uct100-1000its,751,865,2210.366398426,2198.584542908,-114
carcassonne-boltzmann275-vs-boltzmann290-1000its,753,867,2198.187813584,2162.240995562,-114
carcassonne-boltzmann445-vs-boltzmann110-1000its,753,867,2175.275330477,2147.681729675,-114
carcassonne-uct230-vs-uct25-1000its,758,872,2233.834488303,2201.13482667,-114
carcassonne-ucttuned410-vs-ucttuned115-1000its,758,872,2154.175039119,2137.451631639,-114
carcassonne-ucttuned325-vs-ucttuned250-1000its,766,880,2197.617181901,2223.265959119,-114
carcassonne-uct130-vs-uct330-1000its,780,894,2124.573394791,2135.795361572,-114
carcassonne-uct340-vs-uct75-1000its,780,894,2284.08448157,2230.56481701,-114
carcassonne-ucttuned330-vs-ucttuned250-1000its,783,897,2232.275297889,2192.540480259,-114
carcassonne-boltzmann70-vs-boltzmann45-1000its,784,898,2178.115520314,2159.329544117,-114
carcassonne-uct435-vs-uct215-1000its,784,898,2160.681781476,2146.321195598,-114
carcassonne-uct135-vs-uct5-1000its,792,906,2186.305009422,2154.818475272,-114
carcassonne-uct280-vs-uct480-1000its,792,906,2174.825254965,2172.616632264,-114
carcassonne-ucttuned460-vs-ucttuned425-1000its,794,908,2166.647793459,2119.659119563,-114
carcassonne-ucttuned65-vs-ucttuned45-1000its,806,920,2254.219247207,2221.400178392,-114
carcassonne-uct200-vs-uct110-1000its,819,933,2175.615120241,2153.4634589,-114
carcassonne-boltzmann480-vs-boltzmann50-1000its,675,788,2178.401523805,2120.721355732,-113
carcassonne-boltzmann130-vs-boltzmann295-1000its,678,791,2220.389622092,2223.657273145,-113
carcassonne-boltzmann330-vs-boltzmann65-1000its,685,798,2206.06104646,2121.528039233,-113
carcassonne-ucttuned225-vs-ucttuned310-1000its,685,798,2157.278895061,2127.891463852,-113
carcassonne-uct230-vs-uct440-1000its,692,805,2214.019491825,2197.251583646,-113
carcassonne-boltzmann250-vs-boltzmann360-1000its,694,807,2151.307023738,2121.399205784,-113
carcassonne-ucttuned450-vs-ucttuned440-1000its,705,818,2218.910446731,2209.902462971,-113
carcassonne-boltzmann150-vs-boltzmann210-1000its,707,820,2232.159780178,2155.024807773,-113
carcassonne-uct95-vs-uct235-1000its,709,822,2285.92886721,2179.564301866,-113
carcassonne-boltzmann205-vs-boltzmann120-1000its,713,826,2150.585866584,2149.862501969,-113
carcassonne-boltzmann355-vs-boltzmann235-1000its,713,826,2141.553092778,2104.728142446,-113
carcassonne-boltzmann180-vs-boltzmann310-1000its,715,828,2265.269919607,2211.856931616,-113
carcassonne-boltzmann250-vs-boltzmann290-1000its,715,828,2136.936736388,2137.384140008,-113
carcassonne-uct120-vs-uct490-1000its,717,830,2249.636792532,2194.926499381,-113
carcassonne-ucttuned95-vs-ucttuned40-1000its,724,837,2112.577817136,2085.249774528,-113
carcassonne-boltzmann20-vs-boltzmann60-1000its,726,839,2265.627904931,2183.640122207,-113
carcassonne-uct350-vs-uct215-1000its,729,842,2231.573435401,2171.981504475,-113
carcassonne-uct455-vs-uct475-1000its,729,842,2185.184803107,2147.220121077,-113
carcassonne-boltzmann290-vs-boltzmann10-1000its,734,847,2115.282822984,2093.707367059,-113
carcassonne-boltzmann250-vs-boltzmann450-1000its,735,848,2260.610448949,2133.085933529,-113
carcassonne-ucttuned250-vs-ucttuned260-1000its,736,849,2155.521816027,2134.784098647,-113
carcassonne-uct480-vs-uct335-1000its,739,852,2232.082658355,2194.024233224,-113
carcassonne-uct170-vs-uct265-1000its,743,856,2269.803938423,2179.815190311,-113
carcassonne-boltzmann285-vs-boltzmann320-1000its,744,857,2198.31658426,2138.405164196,-113
carcassonne-uct335-vs-uct145-1000its,744,857,2230.002655386,2155.499219897,-113
carcassonne-uct240-vs-uct220-1000its,745,858,2178.260693965,2151.416944057,-113
carcassonne-uct180-vs-uct195-1000its,747,860,2205.349888591,2120.081142135,-113
carcassonne-boltzmann345-vs-boltzmann10-1000its,749,862,2187.186737148,2199.724132891,-113
carcassonne-ucttuned60-vs-ucttuned390-1000its,751,864,2158.172639823,2178.782087888,-113
carcassonne-uct60-vs-uct35-1000its,753,866,2236.349444888,2201.736712198,-113
carcassonne-ucttuned280-vs-ucttuned60-1000its,754,867,2241.091678157,2232.85705149,-113
carcassonne-uct225-vs-uct115-1000its,758,871,2299.466517782,2232.019564469,-113
carcassonne-uct195-vs-uct270-1000its,759,872,2115.540690578,2099.701170872,-113
carcassonne-uct45-vs-uct340-1000its,759,872,2215.632186184,2160.190744951,-113
carcassonne-boltzmann150-vs-boltzmann450-1000its,760,873,2244.230490974,2163.05712984,-113
carcassonne-uct470-vs-uct65-1000its,761,874,2190.847141483,2160.515749161,-113
carcassonne-ucttuned290-vs-ucttuned265-1000its,761,874,2267.059262311,2270.199155228,-113
carcassonne-uct55-vs-uct240-1000its,762,875,2160.111390882,2125.403782016,-113
carcassonne-uct480-vs-uct100-1000its,763,876,2142.769395798,2149.114444448,-113
carcassonne-boltzmann150-vs-boltzmann55-1000its,765,878,2208.377191808,2174.71562497,-113
carcassonne-uct365-vs-uct10-1000its,766,879,2128.293944708,2085.666413452,-113
carcassonne-uct255-vs-uct120-1000its,774,887,2227.446625148,2203.426689406,-113
carcassonne-ucttuned435-vs-ucttuned405-1000its,774,887,2234.051480901,2188.793412047,-113
carcassonne-uct305-vs-uct5-1000its,776,889,2134.290692399,2114.334528973,-113
carcassonne-uct50-vs-uct440-1000its,779,892,2154.170115418,2139.875737918,-113
carcassonne-ucttuned95-vs-ucttuned425-1000its,787,900,2286.144651469,2221.839490483,-113
carcassonne-ucttuned10-vs-ucttuned485-1000its,788,901,2183.939954283,2117.171751684,-113
carcassonne-boltzmann160-vs-boltzmann20-1000its,789,902,2158.240056508,2160.003721337,-113
carcassonne-uct245-vs-uct55-1000its,798,911,2226.528086982,2144.824718255,-113
carcassonne-ucttuned65-vs-ucttuned300-1000its,798,911,2134.765937146,2101.053220372,-113
carcassonne-uct215-vs-uct185-1000its,801,914,2194.536736123,2151.372693061,-113
carcassonne-uct255-vs-uct200-1000its,803,916,2275.917409799,2225.40871473,-113
carcassonne-ucttuned100-vs-ucttuned180-1000its,803,916,2159.361220645,2074.148162228,-113
carcassonne-uct310-vs-uct110-1000its,804,917,2161.147556317,2170.547372696,-113
carcassonne-boltzmann185-vs-boltzmann5-1000its,820,933,2179.734431945,2116.34171509,-113
carcassonne-boltzmann35-vs-boltzmann220-1000its,676,788,2126.743839621,2095.297040971,-112
carcassonne-boltzmann385-vs-boltzmann170-1000its,688,800,2176.391667191,2137.305807343,-112
carcassonne-boltzmann345-vs-boltzmann80-1000its,707,819,2197.641248436,2169.580116545,-112
carcassonne-ucttuned120-vs-ucttuned255-1000its,709,821,2202.670477456,2158.494903811,-112
carcassonne-boltzmann400-vs-boltzmann325-1000its,713,825,2157.475365894,2106.925682698,-112
carcassonne-ucttuned425-vs-ucttuned60-1000its,718,830,2247.93417019,2261.367201962,-112
carcassonne-ucttuned100-vs-ucttuned50-1000its,724,836,2232.930178554,2179.426429316,-112
carcassonne-ucttuned170-vs-ucttuned430-1000its,729,841,2249.025195215,2191.840103263,-112
carcassonne-boltzmann115-vs-boltzmann405-1000its,733,845,2181.05278857,2124.865889029,-112
carcassonne-uct35-vs-uct145-1000its,735,847,2210.300383019,2185.273673776,-112
carcassonne-uct100-vs-uct305-1000its,739,851,2199.435987477,2157.299428675,-112
carcassonne-uct270-vs-uct195-1000its,740,852,2206.345334964,2102.693414427,-112
carcassonne-ucttuned95-vs-ucttuned230-1000its,741,853,2184.894122805,2155.671725604,-112
carcassonne-boltzmann250-vs-boltzmann50-1000its,744,856,2262.016410054,2200.007297754,-112
carcassonne-boltzmann415-vs-boltzmann180-1000its,745,857,2164.863450233,2152.705103305,-112
carcassonne-uct155-vs-uct25-1000its,745,857,2197.88381749,2166.576418698,-112
carcassonne-boltzmann75-vs-boltzmann205-1000its,750,862,2252.695878352,2223.081272738,-112
carcassonne-ucttuned390-vs-ucttuned445-1000its,750,862,2160.687564621,2115.920166373,-112
carcassonne-uct120-vs-uct20-1000its,751,863,2182.33456596,2139.230938567,-112
carcassonne-boltzmann325-vs-boltzmann415-1000its,758,870,2202.081461119,2138.64044746,-112
carcassonne-uct310-vs-uct10-1000its,762,874,2195.952661227,2159.000522497,-112
carcassonne-boltzmann435-vs-boltzmann490-1000its,767,879,2185.688362266,2166.312540233,-112
carcassonne-uct360-vs-uct135-1000its,768,880,2202.882212445,2193.642053646,-112
carcassonne-boltzmann305-vs-boltzmann260-1000its,770,882,2161.999464539,2128.614115415,-112
carcassonne-boltzmann215-vs-boltzmann60-1000its,771,883,2151.88148874,2134.69416975,-112
carcassonne-ucttuned375-vs-ucttuned260-1000its,773,885,2311.495870657,2296.092593548,-112
carcassonne-uct215-vs-uct115-1000its,777,889,2173.16860768,2121.785294737,-112
carcassonne-ucttuned375-vs-ucttuned80-1000its,777,889,2221.54704285,2214.851553547,-112
carcassonne-uct285-vs-uct305-1000its,778,890,2204.368056268,2162.405577622,-112
carcassonne-ucttuned340-vs-ucttuned280-1000its,786,898,2281.146434466,2225.493953218,-112
carcassonne-ucttuned300-vs-ucttuned450-1000its,789,901,2139.066850849,2095.070463648,-112
carcassonne-uct175-vs-uct10-1000its,795,907,2214.318541013,2181.008175334,-112
carcassonne-ucttuned395-vs-ucttuned170-1000its,795,907,2232.149172611,2182.042308204,-112
carcassonne-ucttuned180-vs-ucttuned495-1000its,796,908,2198.019083088,2166.025928938,-112
carcassonne-ucttuned425-vs-ucttuned15-1000its,832,944,2128.357950477,2108.427591258,-112
carcassonne-boltzmann50-vs-boltzmann120-1000its,665,776,2155.937544104,2103.17160302,-111
carcassonne-boltzmann490-vs-boltzmann250-1000its,685,796,2147.529083411,2110.97631052,-111
carcassonne-ucttuned320-vs-ucttuned120-1000its,700,811,2226.784019606,2178.808698288,-111
carcassonne-boltzmann430-vs-boltzmann375-1000its,706,817,2288.979828933,2212.4627372,-111
carcassonne-boltzmann160-vs-boltzmann380-1000its,708,819,2163.81129697,2115.432840147,-111
carcassonne-uct230-vs-uct425-1000its,710,821,2305.474748824,2232.537025057,-111
carcassonne-ucttuned460-vs-ucttuned120-1000its,717,828,2195.358514571,2131.666932274,-111
carcassonne-ucttuned220-vs-ucttuned40-1000its,718,829,2204.050375658,2122.021170358,-111
carcassonne-boltzmann285-vs-boltzmann5-1000its,721,832,2175.826909066,2176.617421036,-111
carcassonne-uct95-vs-uct135-1000its,727,838,2237.804729451,2190.567141398,-111
carcassonne-ucttuned275-vs-ucttuned85-1000its,728,839,2211.504348993,2173.393657445,-111
carcassonne-boltzmann155-vs-boltzmann165-1000its,729,840,2172.886441645,2178.350975133,-111
carcassonne-boltzmann420-vs-boltzmann325-1000its,736,847,2173.782819896,2180.374758434,-111
carcassonne-ucttuned75-vs-ucttuned420-1000its,736,847,2138.789674766,2098.339825185,-111
carcassonne-boltzmann75-vs-boltzmann365-1000its,741,852,2158.954963679,2150.166140463,-111
carcassonne-uct395-vs-uct385-1000its,742,853,2198.454529349,2164.400600615,-111
carcassonne-ucttuned225-vs-ucttuned35-1000its,742,853,2175.375072569,2111.793999208,-111
carcassonne-ucttuned190-vs-ucttuned415-1000its,746,857,2192.302643844,2161.177649493,-111
carcassonne-boltzmann350-vs-boltzmann315-1000its,747,858,2171.131926699,2131.941546233,-111
carcassonne-ucttuned130-vs-ucttuned60-1000its,750,861,2191.961285475,2149.670709672,-111
carcassonne-uct415-vs-uct345-1000its,751,862,2189.033294257,2165.524136476,-111
carcassonne-uct115-vs-uct5-1000its,755,866,2242.437520582,2193.631470085,-111
carcassonne-ucttuned265-vs-ucttuned160-1000its,756,867,2199.905146796,2154.918649968,-111
carcassonne-ucttuned320-vs-ucttuned340-1000its,756,867,2235.081629358,2149.719043424,-111
carcassonne-boltzmann95-vs-boltzmann300-1000its,759,870,2152.689368366,2098.515770521,-111
carcassonne-uct375-vs-uct450-1000its,764,875,2220.94789317,2164.519585721,-111
carcassonne-uct275-vs-uct155-1000its,765,876,2137.634183987,2129.39966728,-111
carcassonne-boltzmann395-vs-boltzmann355-1000its,767,878,2169.266735231,2119.380818442,-111
carcassonne-uct60-vs-uct155-1000its,767,878,2253.662070122,2212.801278473,-111
carcassonne-uct400-vs-uct405-1000its,773,884,2185.454830829,2160.878657654,-111
carcassonne-uct350-vs-uct45-1000its,776,887,2158.276834855,2128.111360932,-111
carcassonne-boltzmann290-vs-boltzmann15-1000its,781,892,2274.27336161,2201.716902692,-111
carcassonne-uct245-vs-uct390-1000its,781,892,2153.317153695,2087.863514012,-111
carcassonne-ucttuned305-vs-ucttuned50-1000its,781,892,2177.132786177,2111.04165786,-111
carcassonne-ucttuned385-vs-ucttuned445-1000its,783,894,2225.724166261,2163.735482096,-111
carcassonne-boltzmann320-vs-boltzmann435-1000its,786,897,2183.252601094,2140.476069434,-111
carcassonne-ucttuned310-vs-ucttuned390-1000its,789,900,2247.766620077,2178.884146385,-111
carcassonne-ucttuned475-vs-ucttuned380-1000its,791,902,2213.285751237,2135.483470355,-111
carcassonne-boltzmann405-vs-boltzmann270-1000its,797,908,2212.249252395,2153.149281481,-111
carcassonne-ucttuned325-vs-ucttuned380-1000its,800,911,2220.985618677,2226.813899618,-111
carcassonne-uct405-vs-uct220-1000its,821,932,2142.195512958,2100.568808762,-111
carcassonne-uct175-vs-uct135-1000its,586,696,1809.699728658,1728.829610849,-110
carcassonne-uct295-vs-uct140-1000its,654,764,2223.414974205,2145.289067749,-110
carcassonne-uct165-vs-uct210-1000its,688,798,2247.151024509,2243.603797511,-110
carcassonne-uct245-vs-uct50-1000its,690,800,2183.581285149,2129.275317769,-110
carcassonne-boltzmann125-vs-boltzmann120-1000its,704,814,2217.909775899,2219.430830869,-110
carcassonne-boltzmann475-vs-boltzmann70-1000its,704,814,2197.545741793,2172.618247121,-110
carcassonne-uct285-vs-uct125-1000its,705,815,2178.051107651,2165.784347953,-110
carcassonne-uct195-vs-uct315-1000its,711,821,2248.635314183,2194.988730367,-110
carcassonne-uct440-vs-uct125-1000its,714,824,2234.623733656,2231.592630013,-110
carcassonne-uct220-vs-uct315-1000its,718,828,2223.008106774,2204.026713629,-110
carcassonne-uct130-vs-uct490-1000its,722,832,2217.561711618,2221.636176375,-110
carcassonne-uct125-vs-uct130-1000its,726,836,2160.719274694,2091.088903525,-110
carcassonne-uct340-vs-uct300-1000its,727,837,2203.731714815,2180.669133682,-110
carcassonne-uct370-vs-uct170-1000its,728,838,2161.583307079,2153.489171141,-110
carcassonne-uct370-vs-uct160-1000its,729,839,2186.595040478,2140.15549818,-110
carcassonne-boltzmann245-vs-boltzmann235-1000its,730,840,2240.064066421,2156.519049043,-110
carcassonne-uct70-vs-uct360-1000its,730,840,2149.382101403,2177.575208701,-110
carcassonne-boltzmann30-vs-boltzmann200-1000its,734,844,2227.428972288,2208.282724269,-110
carcassonne-ucttuned395-vs-ucttuned400-1000its,734,844,2211.341425514,2174.412333753,-110
carcassonne-boltzmann165-vs-boltzmann410-1000its,735,845,2171.26911389,2142.68535083,-110
carcassonne-uct305-vs-uct10-1000its,739,849,2229.785425178,2199.160603465,-110
carcassonne-ucttuned95-vs-ucttuned170-1000its,740,850,2221.289451489,2169.414906295,-110
carcassonne-boltzmann345-vs-boltzmann250-1000its,742,852,2195.601020909,2161.146481634,-110
carcassonne-boltzmann175-vs-boltzmann310-1000its,743,853,2230.606226443,2213.514704309,-110
carcassonne-boltzmann180-vs-boltzmann330-1000its,748,858,2188.578626629,2158.14483823,-110
carcassonne-boltzmann155-vs-boltzmann15-1000its,750,860,2178.014906195,2124.589258449,-110
carcassonne-uct480-vs-uct410-1000its,750,860,2168.30739667,2088.148700585,-110
carcassonne-ucttuned95-vs-ucttuned10-1000its,753,863,2187.687630615,2175.680471496,-110
carcassonne-uct380-vs-uct295-1000its,754,864,2205.858477453,2171.698522643,-110
carcassonne-ucttuned65-vs-ucttuned415-1000its,756,866,2141.471111535,2094.608945698,-110
carcassonne-uct475-vs-uct420-1000its,758,868,2239.053164943,2179.107927226,-110
carcassonne-uct55-vs-uct30-1000its,759,869,2211.89506871,2200.458558046,-110
carcassonne-uct425-vs-uct110-1000its,765,875,2212.505539026,2208.977353569,-110
carcassonne-boltzmann165-vs-boltzmann380-1000its,766,876,2174.687187085,2131.829227228,-110
carcassonne-uct115-vs-uct415-1000its,767,877,2125.534313656,2108.70961877,-110
carcassonne-boltzmann260-vs-boltzmann420-1000its,768,878,2218.159585655,2201.458850081,-110
carcassonne-ucttuned330-vs-ucttuned370-1000its,773,883,2214.460409492,2209.216416175,-110
carcassonne-ucttuned435-vs-ucttuned125-1000its,775,885,2125.740651343,2098.815402129,-110
carcassonne-uct410-vs-uct335-1000its,783,893,2226.87212382,2174.427825294,-110
carcassonne-boltzmann240-vs-boltzmann150-1000its,786,896,2230.617194229,2156.276388254,-110
carcassonne-ucttuned445-vs-ucttuned25-1000its,786,896,2302.509913174,2264.572323278,-110
carcassonne-ucttuned145-vs-ucttuned95-1000its,792,902,2186.002638542,2136.03256043,-110
carcassonne-boltzmann55-vs-boltzmann105-1000its,796,906,2251.204775693,2199.300980344,-110
carcassonne-ucttuned215-vs-ucttuned5-1000its,803,913,2096.508127381,2056.529682627,-110
carcassonne-ucttuned65-vs-ucttuned30-1000its,814,924,2193.774566851,2127.063554777,-110
carcassonne-boltzmann405-vs-boltzmann275-1000its,675,784,2125.818858541,2047.996963632,-109
carcassonne-boltzmann50-vs-boltzmann410-1000its,683,792,2212.678177833,2224.44046545,-109
carcassonne-ucttuned225-vs-ucttuned255-1000its,684,793,2174.468320505,2117.491761059,-109
carcassonne-ucttuned275-vs-ucttuned340-1000its,687,796,2211.463779891,2167.040710479,-109
carcassonne-boltzmann280-vs-boltzmann70-1000its,688,797,2210.909324061,2136.081732285,-109
carcassonne-uct80-vs-uct100-1000its,691,800,2218.205470836,2165.34303168,-109
carcassonne-uct290-vs-uct210-1000its,704,813,2254.237377064,2212.411184446,-109
carcassonne-uct195-vs-uct175-1000its,720,829,2173.21734485,2113.925322007,-109
carcassonne-boltzmann390-vs-boltzmann20-1000its,722,831,2112.580658179,2095.065398771,-109
carcassonne-ucttuned270-vs-ucttuned360-1000its,727,836,2214.911790901,2185.474502047,-109
carcassonne-uct455-vs-uct70-1000its,730,839,2245.720887822,2185.663648804,-109
carcassonne-uct460-vs-uct355-1000its,732,841,2172.873786023,2162.339292858,-109
carcassonne-uct495-vs-uct225-1000its,738,847,2255.324946499,2240.42459809,-109
carcassonne-ucttuned450-vs-ucttuned420-1000its,743,852,2226.500505631,2220.324832329,-109
carcassonne-ucttuned380-vs-ucttuned40-1000its,745,854,2183.105511059,2110.678769041,-109
carcassonne-uct320-vs-uct5-1000its,746,855,2214.38981277,2142.696914683,-109
carcassonne-uct210-vs-uct220-1000its,748,857,2191.488134992,2162.16339774,-109
carcassonne-uct475-vs-uct450-1000its,750,859,2273.186916239,2244.805186281,-109
carcassonne-ucttuned495-vs-ucttuned395-1000its,751,860,2160.600337859,2102.87221179,-109
carcassonne-ucttuned195-vs-ucttuned110-1000its,753,862,2179.026442107,2144.687225174,-109
carcassonne-boltzmann450-vs-boltzmann220-1000its,754,863,2254.786083759,2244.479356806,-109
carcassonne-ucttuned220-vs-ucttuned145-1000its,770,879,2208.533441563,2132.809950117,-109
carcassonne-boltzmann495-vs-boltzmann40-1000its,783,892,2241.610284705,2170.453065956,-109
carcassonne-ucttuned315-vs-ucttuned390-1000its,785,894,2239.764964339,2188.446823616,-109
carcassonne-ucttuned300-vs-ucttuned170-1000its,792,901,2281.96189081,2257.117065271,-109
carcassonne-ucttuned180-vs-ucttuned340-1000its,797,906,2180.178936384,2139.224428475,-109
carcassonne-ucttuned270-vs-ucttuned65-1000its,800,909,2254.445938745,2218.736978209,-109
carcassonne-boltzmann220-vs-boltzmann300-1000its,803,912,2199.375392195,2148.73367865,-109
carcassonne-uct110-vs-uct415-1000its,808,917,2268.581304345,2176.966871856,-109
carcassonne-ucttuned10-vs-ucttuned120-1000its,808,917,2261.968639998,2203.539459608,-109
carcassonne-ucttuned190-vs-ucttuned430-1000its,819,928,2171.404277189,2130.384509472,-109
carcassonne-uct230-vs-uct450-1000its,831,940,2206.280460102,2134.270090626,-109
carcassonne-ucttuned280-vs-ucttuned380-1000its,626,734,2243.173884635,2176.371615427,-108
carcassonne-boltzmann430-vs-boltzmann180-1000its,695,803,2229.057463076,2178.200699355,-108
carcassonne-uct370-vs-uct225-1000its,703,811,2206.173209384,2155.868362609,-108
carcassonne-boltzmann275-vs-boltzmann5-1000its,704,812,2181.720490778,2221.342245802,-108
carcassonne-uct40-vs-uct280-1000its,706,814,2206.549130933,2160.54419032,-108
carcassonne-uct410-vs-uct490-1000its,709,817,2186.389302096,2145.591555146,-108
carcassonne-boltzmann420-vs-boltzmann415-1000its,716,824,2266.268902727,2198.055783061,-108
carcassonne-uct455-vs-uct270-1000its,718,826,2221.514251962,2163.105387415,-108
carcassonne-ucttuned60-vs-ucttuned310-1000its,720,828,2192.254845723,2076.333448807,-108
carcassonne-ucttuned310-vs-ucttuned305-1000its,723,831,2204.647238661,2132.578721202,-108
carcassonne-boltzmann390-vs-boltzmann80-1000its,725,833,2193.341945346,2201.957274089,-108
carcassonne-uct340-vs-uct440-1000its,728,836,2209.548669583,2176.717764195,-108
carcassonne-boltzmann470-vs-boltzmann350-1000its,732,840,2194.894558139,2186.755551076,-108
carcassonne-boltzmann75-vs-boltzmann20-1000its,734,842,2178.2333605,2142.104877908,-108
carcassonne-ucttuned90-vs-ucttuned250-1000its,741,849,2122.99537982,2069.380565933,-108
carcassonne-boltzmann90-vs-boltzmann10-1000its,742,850,2207.239821059,2138.285019375,-108
carcassonne-uct50-vs-uct370-1000its,743,851,2215.450607407,2217.379666161,-108
carcassonne-ucttuned195-vs-ucttuned475-1000its,745,853,2191.100022613,2159.822168077,-108
carcassonne-ucttuned315-vs-ucttuned90-1000its,745,853,2180.470867696,2145.769859998,-108
carcassonne-boltzmann180-vs-boltzmann30-1000its,746,854,2216.220250191,2171.576685993,-108
carcassonne-boltzmann290-vs-boltzmann410-1000its,747,855,2172.939678902,2096.630111943,-108
carcassonne-boltzmann80-vs-boltzmann240-1000its,747,855,2252.580695222,2215.415373646,-108
carcassonne-uct300-vs-uct440-1000its,747,855,2189.447433395,2152.976645982,-108
carcassonne-uct495-vs-uct95-1000its,750,858,2142.855569436,2124.378425155,-108
carcassonne-ucttuned455-vs-ucttuned105-1000its,750,858,2210.733632092,2216.505113239,-108
carcassonne-uct290-vs-uct15-1000its,753,861,2176.391911543,2139.063951958,-108
carcassonne-boltzmann235-vs-boltzmann470-1000its,757,865,2239.556859442,2185.517541703,-108
carcassonne-uct430-vs-uct365-1000its,758,866,2251.297205811,2221.686410583,-108
carcassonne-uct490-vs-uct415-1000its,758,866,2211.447576314,2127.937216078,-108
carcassonne-ucttuned120-vs-ucttuned225-1000its,759,867,2255.580041504,2161.121013223,-108
carcassonne-boltzmann10-vs-boltzmann5-1000its,762,870,2213.224448495,2171.959554536,-108
carcassonne-uct415-vs-uct225-1000its,762,870,2292.3271478,2236.578794044,-108
carcassonne-ucttuned280-vs-ucttuned50-1000its,763,871,2163.266634503,2118.034142557,-108
carcassonne-uct480-vs-uct115-1000its,765,873,2171.906981362,2118.296994778,-108
carcassonne-boltzmann40-vs-boltzmann450-1000its,766,874,2291.060484481,2230.07941105,-108
carcassonne-ucttuned445-vs-ucttuned220-1000its,766,874,2161.398250206,2133.580564713,-108
carcassonne-ucttuned315-vs-ucttuned10-1000its,768,876,2219.626790104,2180.971763898,-108
carcassonne-uct160-vs-uct245-1000its,770,878,2159.406871272,2123.789771104,-108
carcassonne-boltzmann15-vs-boltzmann260-1000its,773,881,2227.23522786,2186.479770706,-108
carcassonne-uct240-vs-uct10-1000its,774,882,2164.083430572,2161.294363274,-108
carcassonne-uct195-vs-uct215-1000its,775,883,2119.498374252,2112.638031337,-108
carcassonne-ucttuned310-vs-ucttuned445-1000its,776,884,2279.50390636,2179.296738675,-108
carcassonne-boltzmann420-vs-boltzmann170-1000its,778,886,2154.502032879,2086.36695728,-108
carcassonne-uct295-vs-uct5-1000its,778,886,2227.174923135,2177.642636835,-108
carcassonne-uct225-vs-uct230-1000its,787,895,2223.526960162,2144.659234288,-108
carcassonne-boltzmann255-vs-boltzmann275-1000its,790,898,2238.60730582,2170.513928065,-108
carcassonne-ucttuned35-vs-ucttuned30-1000its,792,900,2158.505981439,2110.133064847,-108
carcassonne-boltzmann275-vs-boltzmann80-1000its,795,903,2176.724323958,2128.383286106,-108
carcassonne-ucttuned50-vs-ucttuned400-1000its,800,908,2185.461970803,2105.761400869,-108
carcassonne-uct165-vs-uct300-1000its,804,912,2214.084754193,2155.008943039,-108
carcassonne-uct250-vs-uct260-1000its,683,790,2117.522876698,2086.798284346,-107
carcassonne-uct480-vs-uct125-1000its,689,796,2111.133051584,2107.683827234,-107
carcassonne-ucttuned280-vs-ucttuned230-1000its,694,801,2184.916241523,2142.657225032,-107
carcassonne-uct120-vs-uct340-1000its,696,803,2192.779319215,2175.82406582,-107
carcassonne-ucttuned215-vs-ucttuned335-1000its,697,804,2217.056009981,2167.092844942,-107
carcassonne-ucttuned420-vs-ucttuned390-1000its,697,804,2177.095897644,2118.197094827,-107
carcassonne-boltzmann15-vs-boltzmann5-1000its,705,812,2188.364592673,2164.320857245,-107
carcassonne-boltzmann205-vs-boltzmann335-1000its,706,813,2199.93985101,2124.245087837,-107
carcassonne-uct430-vs-uct245-1000its,708,815,2190.722563174,2194.130009416,-107
carcassonne-boltzmann165-vs-boltzmann255-1000its,713,820,2194.886215405,2224.185504476,-107
carcassonne-boltzmann70-vs-boltzmann260-1000its,715,822,2234.11968629,2173.298200011,-107
carcassonne-ucttuned195-vs-ucttuned285-1000its,715,822,2251.672494294,2157.530109237,-107
carcassonne-uct335-vs-uct215-1000its,716,823,2226.409667425,2154.007391374,-107
carcassonne-ucttuned495-vs-ucttuned160-1000its,716,823,2176.686211465,2116.066100136,-107
carcassonne-boltzmann95-vs-boltzmann380-1000its,720,827,2158.428643977,2102.457874599,-107
carcassonne-ucttuned295-vs-ucttuned445-1000its,721,828,2166.993954867,2113.03029283,-107
carcassonne-boltzmann45-vs-boltzmann485-1000its,722,829,2173.048621654,2130.881005494,-107
carcassonne-boltzmann100-vs-boltzmann280-1000its,725,832,2172.444686202,2175.495929979,-107
carcassonne-uct415-vs-uct140-1000its,726,833,2262.679769376,2212.171777822,-107
carcassonne-ucttuned280-vs-ucttuned235-1000its,726,833,2224.109844638,2197.804715799,-107
carcassonne-ucttuned275-vs-ucttuned70-1000its,727,834,2199.898459027,2187.965632742,-107
carcassonne-uct210-vs-uct370-1000its,729,836,2190.033580294,2204.432639029,-107
carcassonne-uct470-vs-uct105-1000its,731,838,2217.761077,2206.167248825,-107
carcassonne-uct195-vs-uct345-1000its,733,840,2156.001080684,2095.129539504,-107
carcassonne-ucttuned200-vs-ucttuned375-1000its,733,840,2204.384186813,2138.162441575,-107
carcassonne-uct205-vs-uct425-1000its,736,843,2158.881931162,2073.579457022,-107
carcassonne-uct380-vs-uct25-1000its,738,845,2205.060188865,2177.378641964,-107
carcassonne-boltzmann280-vs-boltzmann455-1000its,739,846,2244.033711192,2191.005844617,-107
carcassonne-ucttuned435-vs-ucttuned30-1000its,739,846,2176.13551504,2155.847481825,-107
carcassonne-uct325-vs-uct455-1000its,741,848,2187.853592757,2154.440073995,-107
carcassonne-uct195-vs-uct310-1000its,743,850,2247.947350894,2130.615907498,-107
carcassonne-boltzmann280-vs-boltzmann80-1000its,754,861,2230.707326674,2139.596689268,-107
carcassonne-boltzmann265-vs-boltzmann300-1000its,755,862,2207.850952431,2183.225893082,-107
carcassonne-uct470-vs-uct425-1000its,756,863,2169.208696384,2124.364899547,-107
carcassonne-ucttuned290-vs-ucttuned400-1000its,757,864,2199.876441902,2123.015362077,-107
carcassonne-ucttuned440-vs-ucttuned230-1000its,759,866,2236.654615197,2198.793985851,-107
carcassonne-uct145-vs-uct40-1000its,760,867,2192.458871463,2191.187766845,-107
carcassonne-boltzmann60-vs-boltzmann160-1000its,762,869,2138.946514696,2107.382711254,-107
carcassonne-uct20-vs-uct365-1000its,763,870,2218.024616799,2130.954705655,-107
carcassonne-uct420-vs-uct110-1000its,765,872,2203.212582763,2153.667278605,-107
carcassonne-ucttuned365-vs-ucttuned120-1000its,766,873,2190.43061189,2136.713282631,-107
carcassonne-boltzmann405-vs-boltzmann180-1000its,771,878,2169.518463665,2112.045038373,-107
carcassonne-uct5-vs-uct65-1000its,771,878,2133.45810716,2072.857967228,-107
carcassonne-boltzmann30-vs-boltzmann75-1000its,775,882,2191.60633873,2124.665166175,-107
carcassonne-uct265-vs-uct50-1000its,775,882,2205.591386199,2149.457444694,-107
carcassonne-uct320-vs-uct280-1000its,780,887,2175.073146909,2136.533536265,-107
carcassonne-ucttuned155-vs-ucttuned150-1000its,783,890,2172.362006479,2136.63187158,-107
carcassonne-boltzmann315-vs-boltzmann100-1000its,792,899,2153.474090896,2127.44771714,-107
carcassonne-ucttuned110-vs-ucttuned230-1000its,819,926,2225.661603282,2207.242546971,-107
carcassonne-uct495-vs-uct295-1000its,834,941,2288.790998704,2270.543560373,-107
carcassonne-ucttuned350-vs-ucttuned165-1000its,855,962,2164.65833299,2151.17682961,-107
carcassonne-boltzmann495-vs-boltzmann380-1000its,660,766,2176.596915272,2092.697013771,-106
carcassonne-ucttuned340-vs-ucttuned460-1000its,666,772,2231.837656059,2178.660201246,-106
carcassonne-uct400-vs-uct190-1000its,692,798,2145.224131149,2105.147112147,-106
carcassonne-boltzmann450-vs-boltzmann290-1000its,697,803,2198.773480239,2182.957058175,-106
carcassonne-boltzmann240-vs-boltzmann25-1000its,699,805,2220.731386659,2182.911323471,-106
carcassonne-uct285-vs-uct185-1000its,715,821,2232.335210483,2239.108104263,-106
carcassonne-uct285-vs-uct465-1000its,722,828,2170.974695461,2122.670024136,-106
carcassonne-ucttuned275-vs-ucttuned20-1000its,725,831,2174.75232752,2106.730824032,-106
carcassonne-boltzmann200-vs-boltzmann460-1000its,726,832,2178.947476117,2125.703542051,-106
carcassonne-boltzmann30-vs-boltzmann110-1000its,734,840,2249.784074816,2171.469550782,-106
carcassonne-ucttuned120-vs-ucttuned170-1000its,740,846,2136.413261682,2128.28063361,-106
carcassonne-boltzmann395-vs-boltzmann320-1000its,743,849,2168.73327467,2086.133943736,-106
carcassonne-ucttuned315-vs-ucttuned5-1000its,743,849,2235.474038207,2164.485677648,-106
carcassonne-boltzmann255-vs-boltzmann205-1000its,753,859,2227.89735714,2179.069059305,-106
carcassonne-uct455-vs-uct480-1000its,753,859,2189.075973848,2157.679381305,-106
carcassonne-boltzmann155-vs-boltzmann300-1000its,757,863,2227.955605424,2241.723940397,-106
carcassonne-boltzmann455-vs-boltzmann495-1000its,758,864,2184.044545075,2162.514744634,-106
carcassonne-boltzmann115-vs-boltzmann135-1000its,760,866,2174.851138825,2083.169569866,-106
carcassonne-boltzmann150-vs-boltzmann180-1000its,761,867,2235.718103326,2191.852482978,-106
carcassonne-boltzmann300-vs-boltzmann265-1000its,761,867,2205.604655058,2189.799481074,-106
carcassonne-boltzmann80-vs-boltzmann455-1000its,764,870,2123.868075666,2078.40588415,-106
carcassonne-boltzmann275-vs-boltzmann410-1000its,765,871,2254.410879843,2256.326636851,-106
carcassonne-boltzmann370-vs-boltzmann470-1000its,773,879,2198.496534613,2159.022568906,-106
carcassonne-uct460-vs-uct415-1000its,774,880,2185.839152272,2149.142703965,-106
carcassonne-uct130-vs-uct440-1000its,775,881,2182.493878984,2156.366592327,-106
carcassonne-uct465-vs-uct35-1000its,775,881,2286.0622787,2195.924250549,-106
carcassonne-ucttuned260-vs-ucttuned230-1000its,780,886,2230.862068756,2142.998886409,-106
carcassonne-ucttuned365-vs-ucttuned85-1000its,782,888,2189.541062557,2158.188924549,-106
carcassonne-uct315-vs-uct20-1000its,785,891,2125.688220681,2105.732315828,-106
carcassonne-uct90-vs-uct205-1000its,785,891,2163.350982187,2107.05929336,-106
carcassonne-uct365-vs-uct310-1000its,790,896,2074.862903022,2072.049683275,-106
carcassonne-uct255-vs-uct335-1000its,793,899,2203.35883682,2150.191087232,-106
carcassonne-ucttuned80-vs-ucttuned180-1000its,798,904,2160.172492732,2120.582201102,-106
carcassonne-ucttuned15-vs-ucttuned30-1000its,799,905,2206.161751969,2142.504509036,-106
carcassonne-ucttuned255-vs-ucttuned10-1000its,802,908,2142.720327779,2108.447666205,-106
carcassonne-ucttuned490-vs-ucttuned225-1000its,815,921,2264.984899866,2217.767345553,-106
carcassonne-ucttuned420-vs-ucttuned365-1000its,816,922,2124.326911335,2077.985052919,-106
carcassonne-ucttuned470-vs-ucttuned5-1000its,824,930,2259.159410034,2151.94090681,-106
carcassonne-boltzmann375-vs-boltzmann155-1000its,836,942,2241.311678903,2162.795474951,-106
carcassonne-ucttuned370-vs-ucttuned60-1000its,553,658,1719.219383884,1716.410239371,-105
carcassonne-uct160-vs-uct385-1000its,671,776,2241.548842606,2209.38543722,-105
carcassonne-ucttuned175-vs-ucttuned320-1000its,680,785,2232.117838287,2235.400343288,-105
carcassonne-uct195-vs-uct125-1000its,685,790,2262.600465737,2170.650598153,-105
carcassonne-boltzmann310-vs-boltzmann5-1000its,688,793,2187.845415155,2161.606507768,-105
carcassonne-boltzmann470-vs-boltzmann285-1000its,691,796,2128.854172922,2116.460755762,-105
carcassonne-boltzmann290-vs-boltzmann175-1000its,694,799,2269.815941597,2250.859392326,-105
carcassonne-uct380-vs-uct135-1000its,695,800,2155.381123898,2129.753844994,-105
carcassonne-ucttuned260-vs-ucttuned485-1000its,700,805,2258.800550297,2179.163774981,-105
carcassonne-boltzmann460-vs-boltzmann320-1000its,701,806,2192.449062262,2154.94949505,-105
carcassonne-boltzmann360-vs-boltzmann405-1000its,702,807,2110.664949878,2049.099569203,-105
carcassonne-ucttuned390-vs-ucttuned235-1000its,703,808,2311.280801513,2258.562436639,-105
carcassonne-ucttuned430-vs-ucttuned310-1000its,705,810,2224.083666171,2181.069630052,-105
carcassonne-ucttuned495-vs-ucttuned410-1000its,705,810,2167.602942543,2102.797687413,-105
carcassonne-ucttuned55-vs-ucttuned165-1000its,707,812,2209.683654569,2161.25634212,-105
carcassonne-boltzmann140-vs-boltzmann495-1000its,715,820,2235.295070574,2169.339402969,-105
carcassonne-uct365-vs-uct200-1000its,716,821,2221.389039101,2197.816234765,-105
carcassonne-boltzmann260-vs-boltzmann370-1000its,717,822,2234.258820063,2190.671780253,-105
carcassonne-boltzmann455-vs-boltzmann320-1000its,721,826,2173.273594665,2123.414357764,-105
carcassonne-ucttuned185-vs-ucttuned275-1000its,721,826,2148.348117945,2101.446821765,-105
carcassonne-boltzmann90-vs-boltzmann330-1000its,730,835,2225.621619174,2186.045173374,-105
carcassonne-uct180-vs-uct125-1000its,730,835,2191.880259322,2186.430700323,-105
carcassonne-uct295-vs-uct45-1000its,735,840,2251.188644697,2198.996952081,-105
carcassonne-boltzmann20-vs-boltzmann45-1000its,736,841,2217.062669515,2206.342832444,-105
carcassonne-uct150-vs-uct225-1000its,737,842,2151.58651157,2104.813164862,-105
carcassonne-ucttuned415-vs-ucttuned285-1000its,740,845,2213.31114349,2094.3031212,-105
carcassonne-ucttuned210-vs-ucttuned45-1000its,741,846,2230.960804149,2189.316955238,-105
carcassonne-uct350-vs-uct450-1000its,743,848,2235.859500641,2154.737420477,-105
carcassonne-boltzmann85-vs-boltzmann65-1000its,744,849,2184.298794742,2161.122569121,-105
carcassonne-boltzmann120-vs-boltzmann80-1000its,748,853,2167.864507783,2103.216360902,-105
carcassonne-boltzmann435-vs-boltzmann20-1000its,748,853,2145.998463307,2122.003466255,-105
carcassonne-ucttuned165-vs-ucttuned30-1000its,751,856,2273.483381548,2211.188928767,-105
carcassonne-ucttuned85-vs-ucttuned420-1000its,752,857,2204.172257837,2142.542352337,-105
carcassonne-ucttuned310-vs-ucttuned180-1000its,753,858,2177.583701339,2163.880706405,-105
carcassonne-ucttuned475-vs-ucttuned35-1000its,754,859,2232.666355821,2225.956125082,-105
carcassonne-ucttuned375-vs-ucttuned205-1000its,758,863,2165.039440865,2107.135815435,-105
carcassonne-boltzmann485-vs-boltzmann365-1000its,759,864,2300.767903512,2261.639535437,-105
carcassonne-boltzmann185-vs-boltzmann375-1000its,762,867,2235.098201957,2192.838162339,-105
carcassonne-uct450-vs-uct250-1000its,765,870,2257.690951959,2178.956408736,-105
carcassonne-uct75-vs-uct285-1000its,765,870,2221.709809219,2159.072836162,-105
carcassonne-ucttuned400-vs-ucttuned20-1000its,774,879,2103.816041988,2076.061518553,-105
carcassonne-ucttuned15-vs-ucttuned385-1000its,784,889,2188.958070414,2108.351686252,-105
carcassonne-boltzmann465-vs-boltzmann95-1000its,790,895,2195.765441353,2165.177023298,-105
carcassonne-ucttuned315-vs-ucttuned170-1000its,794,899,2249.952450268,2204.410471154,-105
carcassonne-boltzmann50-vs-boltzmann40-1000its,816,921,2255.865780367,2162.31297826,-105
carcassonne-ucttuned50-vs-ucttuned305-1000its,822,927,2198.016993516,2160.055802945,-105
carcassonne-uct130-vs-uct5-1000its,833,938,2189.24071528,2143.571554654,-105
carcassonne-ucttuned295-vs-ucttuned130-1000its,856,961,2177.856770725,2096.868069874,-105
carcassonne-ucttuned225-vs-ucttuned455-1000its,632,736,2295.240594102,2237.842644286,-104
carcassonne-uct270-vs-uct15-1000its,668,772,2288.684629283,2289.531075567,-104
carcassonne-boltzmann265-vs-boltzmann345-1000its,677,781,2224.493534585,2153.934545229,-104
carcassonne-uct315-vs-uct400-1000its,681,785,2224.268305535,2130.090455512,-104
carcassonne-boltzmann20-vs-boltzmann435-1000its,692,796,2201.665234146,2178.527600783,-104
carcassonne-boltzmann165-vs-boltzmann65-1000its,702,806,2141.19705672,2131.306108865,-104
carcassonne-boltzmann60-vs-boltzmann310-1000its,709,813,2209.987532011,2166.919818349,-104
carcassonne-uct495-vs-uct210-1000its,710,814,2200.465778257,2204.119900747,-104
carcassonne-ucttuned355-vs-ucttuned310-1000its,710,814,2202.337829177,2179.180182473,-104
carcassonne-uct55-vs-uct140-1000its,712,816,2216.296813127,2155.334123768,-104
carcassonne-ucttuned75-vs-ucttuned400-1000its,714,818,2234.222632517,2209.767167567,-104
carcassonne-uct120-vs-uct200-1000its,719,823,2210.563349479,2204.282908147,-104
carcassonne-ucttuned110-vs-ucttuned40-1000its,726,830,2133.336369974,2065.223121302,-104
carcassonne-uct380-vs-uct255-1000its,729,833,2281.952983686,2210.119863489,-104
carcassonne-boltzmann415-vs-boltzmann395-1000its,737,841,2212.101059607,2130.262886672,-104
carcassonne-boltzmann145-vs-boltzmann385-1000its,739,843,2133.433515367,2070.124218245,-104
carcassonne-boltzmann30-vs-boltzmann10-1000its,742,846,2111.822691164,2089.528315955,-104
carcassonne-ucttuned455-vs-ucttuned390-1000its,745,849,2247.998106598,2224.400824535,-104
carcassonne-uct330-vs-uct440-1000its,747,851,2239.935614656,2171.680419547,-104
carcassonne-uct210-vs-uct135-1000its,749,853,2223.919864395,2144.462760103,-104
carcassonne-ucttuned340-vs-ucttuned385-1000its,749,853,2235.120634967,2166.538732132,-104
carcassonne-ucttuned385-vs-ucttuned25-1000its,749,853,2179.993293181,2129.085849243,-104
carcassonne-boltzmann300-vs-boltzmann260-1000its,750,854,2194.739691836,2152.119609347,-104
carcassonne-ucttuned350-vs-ucttuned330-1000its,755,859,2210.171479995,2132.486092558,-104
carcassonne-boltzmann440-vs-boltzmann185-1000its,758,862,2193.214283274,2176.167967771,-104
carcassonne-uct75-vs-uct10-1000its,760,864,2115.097295339,2068.455463186,-104
carcassonne-ucttuned260-vs-ucttuned15-1000its,760,864,2229.645348451,2199.750736101,-104
carcassonne-boltzmann310-vs-boltzmann415-1000its,763,867,2266.724262266,2191.600720004,-104
carcassonne-ucttuned50-vs-ucttuned80-1000its,763,867,2215.95246759,2130.399806088,-104
carcassonne-ucttuned465-vs-ucttuned250-1000its,765,869,2177.058558647,2137.450822569,-104
carcassonne-ucttuned70-vs-ucttuned210-1000its,767,871,2260.696255356,2217.835083691,-104
carcassonne-uct120-vs-uct25-1000its,771,875,2184.347673448,2125.840184862,-104
carcassonne-ucttuned210-vs-ucttuned410-1000its,771,875,2158.605921581,2115.122599501,-104
carcassonne-uct160-vs-uct350-1000its,774,878,2190.477789558,2167.56910132,-104
carcassonne-uct405-vs-uct335-1000its,781,885,2180.417754918,2158.001282174,-104
carcassonne-ucttuned305-vs-ucttuned235-1000its,786,890,2157.93633522,2081.426413731,-104
carcassonne-ucttuned50-vs-ucttuned380-1000its,795,899,2244.317613248,2175.440157071,-104
carcassonne-ucttuned135-vs-ucttuned55-1000its,826,930,2168.614460681,2091.332449138,-104
carcassonne-ucttuned275-vs-ucttuned105-1000its,835,939,2216.153586118,2190.726687088,-104
carcassonne-uct455-vs-uct320-1000its,840,944,2198.699085569,2138.512656391,-104
carcassonne-boltzmann335-vs-boltzmann30-1000its,672,775,2180.602206792,2150.639197448,-103
carcassonne-ucttuned320-vs-ucttuned270-1000its,673,776,2139.013643492,2108.46854444,-103
carcassonne-uct260-vs-uct40-1000its,680,783,2212.529391556,2156.824393944,-103
carcassonne-boltzmann355-vs-boltzmann280-1000its,682,785,2186.812180767,2151.139411017,-103
carcassonne-ucttuned310-vs-ucttuned25-1000its,685,788,2179.93173932,2157.211316502,-103
carcassonne-boltzmann255-vs-boltzmann55-1000its,687,790,2192.856667275,2169.80952209,-103
carcassonne-uct110-vs-uct440-1000its,694,797,2287.077886156,2223.50388133,-103
carcassonne-ucttuned320-vs-ucttuned250-1000its,697,800,2236.911015426,2206.036803695,-103
carcassonne-boltzmann35-vs-boltzmann365-1000its,700,803,2207.891494978,2191.784077035,-103
carcassonne-boltzmann85-vs-boltzmann155-1000its,701,804,2192.563457779,2181.659592897,-103
carcassonne-uct400-vs-uct300-1000its,702,805,2200.806618921,2151.264543514,-103
carcassonne-boltzmann390-vs-boltzmann305-1000its,704,807,2240.241959557,2162.78315558,-103
carcassonne-boltzmann50-vs-boltzmann335-1000its,712,815,2151.21364055,2088.468647505,-103
carcassonne-ucttuned350-vs-ucttuned325-1000its,715,818,2246.816344867,2148.019355468,-103
carcassonne-boltzmann50-vs-boltzmann470-1000its,717,820,2190.979619369,2160.171748389,-103
carcassonne-uct400-vs-uct395-1000its,725,828,2085.800672577,2061.874768792,-103
carcassonne-boltzmann110-vs-boltzmann430-1000its,727,830,2185.118615318,2148.133198031,-103
carcassonne-ucttuned80-vs-ucttuned415-1000its,728,831,2214.962045519,2111.513181918,-103
carcassonne-boltzmann495-vs-boltzmann80-1000its,729,832,2219.215392279,2213.820035346,-103
carcassonne-boltzmann190-vs-boltzmann330-1000its,730,833,2153.823872082,2086.844677064,-103
carcassonne-boltzmann285-vs-boltzmann135-1000its,731,834,2181.09230465,2118.298085214,-103
carcassonne-boltzmann325-vs-boltzmann290-1000its,731,834,2191.474955417,2140.797115291,-103
carcassonne-boltzmann450-vs-boltzmann415-1000its,732,835,2233.680779963,2233.77366868,-103
carcassonne-ucttuned210-vs-ucttuned245-1000its,736,839,2242.018826991,2226.978632308,-103
carcassonne-boltzmann415-vs-boltzmann45-1000its,739,842,2175.522931275,2135.13604775,-103
carcassonne-uct360-vs-uct220-1000its,740,843,2183.571854491,2166.014612312,-103
carcassonne-boltzmann330-vs-boltzmann15-1000its,742,845,2242.726138164,2196.553685653,-103
carcassonne-uct230-vs-uct130-1000its,742,845,2257.747793941,2172.779526673,-103
carcassonne-uct230-vs-uct245-1000its,742,845,2161.248709372,2110.855468848,-103
carcassonne-uct265-vs-uct370-1000its,744,847,2239.76402427,2184.082415377,-103
carcassonne-ucttuned310-vs-ucttuned395-1000its,744,847,2223.251774111,2192.265374921,-103
carcassonne-uct110-vs-uct280-1000its,745,848,2192.537083571,2150.900781615,-103
carcassonne-uct70-vs-uct105-1000its,745,848,2131.462202322,2109.82081223,-103
carcassonne-uct350-vs-uct175-1000its,748,851,2182.457469467,2137.127661253,-103
carcassonne-ucttuned370-vs-ucttuned190-1000its,748,851,2207.542662807,2154.480959594,-103
carcassonne-uct75-vs-uct135-1000its,753,856,2141.804356045,2136.115081895,-103
carcassonne-boltzmann235-vs-boltzmann230-1000its,754,857,2261.917430193,2172.490068328,-103
carcassonne-boltzmann145-vs-boltzmann170-1000its,757,860,2172.504619326,2157.513861791,-103
carcassonne-ucttuned425-vs-ucttuned80-1000its,757,860,2122.452890632,2092.982810926,-103
carcassonne-ucttuned250-vs-ucttuned30-1000its,758,861,2225.017333477,2127.60945921,-103
carcassonne-uct60-vs-uct360-1000its,759,862,2255.803651349,2195.719550059,-103
carcassonne-uct290-vs-uct130-1000its,760,863,2127.000371512,2107.120515874,-103
carcassonne-ucttuned265-vs-ucttuned80-1000its,761,864,2228.746628039,2161.483334893,-103
carcassonne-uct400-vs-uct360-1000its,763,866,2209.389637112,2168.612907218,-103
carcassonne-boltzmann355-vs-boltzmann495-1000its,766,869,2194.463547763,2154.605809076,-103
carcassonne-boltzmann295-vs-boltzmann315-1000its,769,872,2161.439735006,2098.145687783,-103
carcassonne-uct10-vs-uct145-1000its,769,872,2171.645656392,2125.834763484,-103
carcassonne-ucttuned230-vs-ucttuned370-1000its,769,872,2279.003343038,2193.300235891,-103
carcassonne-ucttuned165-vs-ucttuned185-1000its,773,876,2167.029565416,2121.070334171,-103
carcassonne-ucttuned305-vs-ucttuned435-1000its,775,878,2165.772528902,2150.742117901,-103
carcassonne-ucttuned325-vs-ucttuned205-1000its,782,885,2247.983232544,2256.492371685,-103
carcassonne-uct305-vs-uct420-1000its,785,888,2283.388076749,2240.542051745,-103
carcassonne-uct50-vs-uct190-1000its,786,889,2236.879842126,2194.575227551,-103
carcassonne-uct300-vs-uct475-1000its,788,891,2212.960791828,2159.453500338,-103
carcassonne-boltzmann440-vs-boltzmann490-1000its,790,893,2196.827558205,2075.480200647,-103
carcassonne-ucttuned90-vs-ucttuned5-1000its,798,901,2227.325386795,2174.113394762,-103
carcassonne-ucttuned310-vs-ucttuned385-1000its,805,908,2303.190037368,2198.131446034,-103
carcassonne-ucttuned55-vs-ucttuned465-1000its,813,916,2175.191751826,2164.210283201,-103
carcassonne-ucttuned335-vs-ucttuned25-1000its,816,919,2137.386479713,2106.578042291,-103
carcassonne-ucttuned250-vs-ucttuned150-1000its,833,936,2234.447566866,2191.937617927,-103
carcassonne-ucttuned60-vs-ucttuned155-1000its,851,954,2251.19542472,2227.865341418,-103
carcassonne-ucttuned225-vs-ucttuned405-1000its,913,1016,2262.920931956,2196.72585593,-103
carcassonne-ucttuned180-vs-ucttuned265-1000its,710,812,2240.223785933,2185.986340136,-102
carcassonne-uct50-vs-uct400-1000its,717,819,2210.658599776,2188.413329722,-102
carcassonne-uct110-vs-uct20-1000its,722,824,2193.49125338,2181.267012306,-102
carcassonne-ucttuned40-vs-ucttuned430-1000its,723,825,2157.991941088,2156.536175366,-102
carcassonne-boltzmann65-vs-boltzmann315-1000its,725,827,2245.956664081,2182.400557693,-102
carcassonne-ucttuned465-vs-ucttuned225-1000its,725,827,2240.470388941,2209.812706412,-102
carcassonne-uct160-vs-uct85-1000its,726,828,2165.569017585,2122.785447409,-102
carcassonne-uct175-vs-uct190-1000its,726,828,2143.963402269,2106.316595174,-102
carcassonne-ucttuned210-vs-ucttuned80-1000its,727,829,2252.535473163,2194.282305952,-102
carcassonne-ucttuned295-vs-ucttuned280-1000its,729,831,2227.476026448,2181.530718605,-102
carcassonne-boltzmann265-vs-boltzmann480-1000its,735,837,2227.47155471,2162.186197282,-102
carcassonne-boltzmann450-vs-boltzmann50-1000its,735,837,2230.198710028,2186.083500209,-102
carcassonne-uct230-vs-uct335-1000its,735,837,2174.978698575,2131.680866304,-102
carcassonne-uct70-vs-uct365-1000its,740,842,2142.405051627,2098.229515532,-102
carcassonne-ucttuned70-vs-ucttuned50-1000its,740,842,2198.992975485,2168.230759357,-102
carcassonne-boltzmann170-vs-boltzmann95-1000its,741,843,2218.428412426,2149.106652635,-102
carcassonne-ucttuned290-vs-ucttuned405-1000its,741,843,2207.972299185,2154.12282061,-102
carcassonne-uct115-vs-uct460-1000its,742,844,2223.341188112,2180.835092975,-102
carcassonne-uct40-vs-uct90-1000its,742,844,2193.971623518,2191.313405604,-102
carcassonne-boltzmann230-vs-boltzmann320-1000its,744,846,2223.770512214,2173.420776659,-102
carcassonne-uct420-vs-uct395-1000its,747,849,2218.098632739,2177.828573695,-102
carcassonne-boltzmann255-vs-boltzmann165-1000its,748,850,2205.642994887,2178.188350985,-102
carcassonne-boltzmann125-vs-boltzmann260-1000its,749,851,2187.451680342,2124.739512803,-102
carcassonne-uct95-vs-uct460-1000its,750,852,2190.160523028,2150.035321926,-102
carcassonne-uct125-vs-uct265-1000its,751,853,2216.127075092,2170.210705634,-102
carcassonne-uct160-vs-uct140-1000its,753,855,2223.900632892,2187.977682191,-102
carcassonne-uct260-vs-uct405-1000its,753,855,2224.51200462,2174.554284976,-102
carcassonne-boltzmann90-vs-boltzmann435-1000its,754,856,2205.461159099,2128.040081667,-102
carcassonne-boltzmann95-vs-boltzmann485-1000its,754,856,2096.912768992,2093.175653313,-102
carcassonne-uct260-vs-uct495-1000its,754,856,2157.558962029,2144.973662647,-102
carcassonne-ucttuned435-vs-ucttuned365-1000its,756,858,2120.248872213,2111.387749458,-102
carcassonne-boltzmann490-vs-boltzmann385-1000its,757,859,2238.181290541,2215.99295675,-102
carcassonne-ucttuned175-vs-ucttuned425-1000its,758,860,2169.122559775,2155.040596628,-102
carcassonne-uct230-vs-uct95-1000its,759,861,2187.855756767,2187.035685283,-102
carcassonne-ucttuned340-vs-ucttuned50-1000its,760,862,2121.002345142,2124.01849719,-102
carcassonne-ucttuned475-vs-ucttuned70-1000its,760,862,2244.029057366,2201.429449112,-102
carcassonne-ucttuned85-vs-ucttuned370-1000its,760,862,2245.728168005,2221.352493852,-102
carcassonne-boltzmann130-vs-boltzmann220-1000its,765,867,2182.037823478,2157.507534174,-102
carcassonne-boltzmann70-vs-boltzmann460-1000its,768,870,2205.884344594,2167.786346052,-102
carcassonne-boltzmann495-vs-boltzmann90-1000its,769,871,2174.698674605,2156.361747688,-102
carcassonne-ucttuned380-vs-ucttuned205-1000its,769,871,2174.983835411,2122.679354914,-102
carcassonne-uct490-vs-uct485-1000its,771,873,2218.40915465,2197.401440549,-102
carcassonne-boltzmann10-vs-boltzmann415-1000its,774,876,2123.590102339,2073.266850894,-102
carcassonne-uct265-vs-uct310-1000its,775,877,2196.078188072,2196.160205589,-102
carcassonne-ucttuned260-vs-ucttuned465-1000its,776,878,2186.638565047,2152.194137773,-102
carcassonne-ucttuned365-vs-ucttuned205-1000its,776,878,2272.074526988,2242.063214206,-102
carcassonne-ucttuned45-vs-ucttuned295-1000its,790,892,2176.49132361,2088.719658929,-102
carcassonne-uct490-vs-uct400-1000its,794,896,2164.062160279,2120.560832554,-102
carcassonne-uct290-vs-uct295-1000its,802,904,2194.323404352,2195.237687078,-102
carcassonne-uct105-vs-uct5-1000its,804,906,2206.050171242,2170.850223149,-102
carcassonne-uct430-vs-uct100-1000its,808,910,2117.463764049,2066.140824417,-102
carcassonne-uct160-vs-uct20-1000its,814,916,2181.867919813,2153.866840399,-102
carcassonne-uct495-vs-uct395-1000its,826,928,2242.336667374,2183.479336395,-102
carcassonne-ucttuned265-vs-ucttuned5-1000its,839,941,2138.318407505,2136.75121692,-102
carcassonne-ucttuned50-vs-ucttuned110-1000its,856,958,2184.282422378,2159.844299233,-102
carcassonne-boltzmann65-vs-boltzmann165-1000its,881,983,2148.010049553,2106.983108679,-102
carcassonne-boltzmann350-vs-boltzmann460-1000its,514,615,1696.651625765,1674.910868991,-101
carcassonne-ucttuned395-vs-ucttuned75-1000its,679,780,2202.609991342,2163.997815516,-101
carcassonne-uct450-vs-uct325-1000its,685,786,2178.282192102,2126.46853262,-101
carcassonne-boltzmann100-vs-boltzmann425-1000its,694,795,2167.943872421,2154.147914389,-101
carcassonne-uct60-vs-uct5-1000its,717,818,2224.236605895,2173.664668287,-101
carcassonne-uct70-vs-uct50-1000its,720,821,2261.131614462,2204.506371906,-101
carcassonne-uct220-vs-uct395-1000its,725,826,2155.27319244,2100.02868262,-101
carcassonne-boltzmann285-vs-boltzmann155-1000its,726,827,2249.014071886,2155.411923712,-101
carcassonne-ucttuned430-vs-ucttuned25-1000its,730,831,2292.016482772,2248.532496204,-101
carcassonne-ucttuned425-vs-ucttuned120-1000its,731,832,2222.514341622,2198.735484191,-101
carcassonne-uct175-vs-uct195-1000its,733,834,2218.588424442,2160.461514762,-101
carcassonne-uct250-vs-uct190-1000its,734,835,2120.546017895,2082.578854381,-101
carcassonne-uct305-vs-uct385-1000its,735,836,2246.708898918,2183.524475808,-101
carcassonne-ucttuned295-vs-ucttuned250-1000its,738,839,2208.04536971,2124.5178281,-101
carcassonne-ucttuned200-vs-ucttuned185-1000its,740,841,2123.085664037,2076.994832031,-101
carcassonne-boltzmann80-vs-boltzmann110-1000its,743,844,2184.671012996,2137.555378676,-101
carcassonne-uct305-vs-uct470-1000its,743,844,2216.308552841,2163.664402318,-101
carcassonne-ucttuned320-vs-ucttuned425-1000its,743,844,2274.602219005,2179.915677597,-101
carcassonne-ucttuned400-vs-ucttuned300-1000its,745,846,2189.601005875,2180.445535797,-101
carcassonne-boltzmann385-vs-boltzmann190-1000its,749,850,2183.022354001,2157.472363744,-101
carcassonne-uct120-vs-uct360-1000its,749,850,2233.155539801,2167.993523309,-101
carcassonne-boltzmann195-vs-boltzmann390-1000its,751,852,2263.126108613,2224.99292213,-101
carcassonne-boltzmann300-vs-boltzmann330-1000its,752,853,2215.638218908,2124.878408127,-101
carcassonne-ucttuned95-vs-ucttuned225-1000its,759,860,2277.698811774,2202.659792835,-101
carcassonne-boltzmann70-vs-boltzmann125-1000its,761,862,2226.182642655,2175.350057633,-101
carcassonne-ucttuned285-vs-ucttuned230-1000its,762,863,2200.754076517,2144.695900198,-101
carcassonne-uct80-vs-uct345-1000its,765,866,2242.399162988,2195.37918871,-101
carcassonne-uct330-vs-uct10-1000its,767,868,2126.855705255,2127.848257461,-101
carcassonne-uct90-vs-uct330-1000its,767,868,2134.698217957,2103.026279128,-101
carcassonne-ucttuned325-vs-ucttuned360-1000its,768,869,2216.754562096,2160.022524425,-101
carcassonne-uct165-vs-uct50-1000its,769,870,2245.000208851,2166.453236764,-101
carcassonne-boltzmann245-vs-boltzmann105-1000its,771,872,2122.060788497,2090.647369026,-101
carcassonne-boltzmann160-vs-boltzmann460-1000its,774,875,2168.702686317,2140.200108982,-101
carcassonne-ucttuned195-vs-ucttuned10-1000its,778,879,2144.582507884,2082.459220008,-101
carcassonne-ucttuned40-vs-ucttuned385-1000its,780,881,2169.395170703,2134.183564583,-101
carcassonne-uct370-vs-uct90-1000its,784,885,2203.9535428,2120.195061823,-101
carcassonne-uct30-vs-uct160-1000its,785,886,2192.745863855,2144.235742086,-101
carcassonne-boltzmann70-vs-boltzmann75-1000its,787,888,2214.512332714,2168.885319201,-101
carcassonne-ucttuned145-vs-ucttuned490-1000its,788,889,2256.176730986,2186.72176163,-101
carcassonne-uct455-vs-uct260-1000its,790,891,2222.526591201,2148.816100906,-101
carcassonne-ucttuned95-vs-ucttuned65-1000its,790,891,2185.700724882,2112.709138009,-101
carcassonne-ucttuned350-vs-ucttuned200-1000its,791,892,2225.829121641,2210.91501956,-101
carcassonne-ucttuned255-vs-ucttuned360-1000its,793,894,2233.845898057,2150.61195348,-101
carcassonne-uct60-vs-uct25-1000its,797,898,2215.839707877,2159.046248361,-101
carcassonne-boltzmann490-vs-boltzmann345-1000its,802,903,2227.943677365,2178.85869717,-101
carcassonne-uct400-vs-uct295-1000its,809,910,2143.967421049,2131.300184869,-101
carcassonne-ucttuned205-vs-ucttuned230-1000its,822,923,2299.383151462,2238.989131693,-101
carcassonne-ucttuned20-vs-ucttuned60-1000its,832,933,2233.287729847,2201.110138334,-101
carcassonne-boltzmann395-vs-boltzmann190-1000its,554,654,1748.594502934,1712.316047205,-100
carcassonne-uct250-vs-uct470-1000its,661,761,2135.719488964,2109.582465835,-100
carcassonne-uct325-vs-uct335-1000its,672,772,2242.322654315,2185.701606289,-100
carcassonne-ucttuned80-vs-ucttuned145-1000its,686,786,2274.869702634,2230.536857399,-100
carcassonne-uct50-vs-uct270-1000its,687,787,2268.324407093,2234.278936348,-100
carcassonne-uct385-vs-uct30-1000its,691,791,2266.221033127,2229.434442914,-100
carcassonne-boltzmann365-vs-boltzmann20-1000its,693,793,2196.121641881,2155.176771881,-100
carcassonne-boltzmann440-vs-boltzmann295-1000its,700,800,2167.73578649,2138.848300571,-100
carcassonne-uct235-vs-uct435-1000its,702,802,2197.576449341,2119.389092404,-100
carcassonne-uct380-vs-uct195-1000its,704,804,2166.647433587,2110.858571657,-100
carcassonne-boltzmann240-vs-boltzmann245-1000its,711,811,2217.764701838,2193.499223564,-100
carcassonne-boltzmann305-vs-boltzmann45-1000its,717,817,2200.351351026,2172.931613548,-100
carcassonne-boltzmann120-vs-boltzmann490-1000its,723,823,2167.158831492,2130.230243455,-100
carcassonne-ucttuned350-vs-ucttuned315-1000its,727,827,2167.610785161,2147.310600156,-100
carcassonne-ucttuned330-vs-ucttuned295-1000its,728,828,2140.448943617,2037.010671492,-100
carcassonne-uct145-vs-uct225-1000its,735,835,2162.603048373,2129.325901794,-100
carcassonne-uct490-vs-uct160-1000its,735,835,2279.172404918,2204.300004022,-100
carcassonne-uct395-vs-uct220-1000its,738,838,2193.420595373,2179.655401154,-100
carcassonne-boltzmann135-vs-boltzmann390-1000its,740,840,2283.607913726,2208.819675982,-100
carcassonne-boltzmann25-vs-boltzmann295-1000its,741,841,2156.953070028,2144.422508797,-100
carcassonne-boltzmann270-vs-boltzmann340-1000its,741,841,2148.858388931,2119.513594178,-100
carcassonne-boltzmann440-vs-boltzmann455-1000its,743,843,2246.990040438,2231.923772629,-100
carcassonne-uct440-vs-uct65-1000its,743,843,2195.416804119,2160.080890552,-100
carcassonne-ucttuned125-vs-ucttuned295-1000its,743,843,2174.656251174,2097.231520838,-100
carcassonne-ucttuned340-vs-ucttuned450-1000its,744,844,2106.620937339,2084.503685121,-100
carcassonne-uct480-vs-uct5-1000its,745,845,2182.344514622,2149.074557358,-100
carcassonne-ucttuned105-vs-ucttuned210-1000its,745,845,2168.432828945,2127.450751994,-100
carcassonne-ucttuned370-vs-ucttuned485-1000its,746,846,2178.768422198,2103.093204143,-100
carcassonne-ucttuned370-vs-ucttuned490-1000its,746,846,2161.56509845,2169.434163039,-100
carcassonne-ucttuned215-vs-ucttuned235-1000its,747,847,2276.142771457,2251.835210238,-100
carcassonne-ucttuned350-vs-ucttuned225-1000its,749,849,2169.433076173,2123.045434137,-100
carcassonne-ucttuned225-vs-ucttuned235-1000its,750,850,2224.472279657,2203.642270257,-100
carcassonne-uct485-vs-uct170-1000its,751,851,2195.413321591,2146.3752013,-100
carcassonne-ucttuned95-vs-ucttuned300-1000its,752,852,2186.641221415,2136.388069839,-100
carcassonne-uct275-vs-uct465-1000its,756,856,2176.98429057,2120.082261219,-100
carcassonne-ucttuned390-vs-ucttuned65-1000its,758,858,2287.384170537,2244.500248487,-100
carcassonne-uct225-vs-uct160-1000its,762,862,2170.754376318,2127.421835643,-100
carcassonne-uct295-vs-uct180-1000its,762,862,2178.601002733,2097.41041188,-100
carcassonne-ucttuned140-vs-ucttuned395-1000its,762,862,2208.208230031,2209.204001869,-100
carcassonne-ucttuned105-vs-ucttuned240-1000its,769,869,2126.274399597,2036.580818942,-100
carcassonne-ucttuned175-vs-ucttuned435-1000its,769,869,2145.115481613,2109.342197274,-100
carcassonne-uct325-vs-uct50-1000its,772,872,2209.80768513,2180.023631852,-100
carcassonne-boltzmann260-vs-boltzmann80-1000its,775,875,2141.169084698,2104.091600035,-100
carcassonne-ucttuned430-vs-ucttuned275-1000its,775,875,2180.000608996,2129.317079396,-100
carcassonne-uct440-vs-uct450-1000its,777,877,2246.985547617,2219.17598811,-100
carcassonne-boltzmann105-vs-boltzmann465-1000its,778,878,2209.818036463,2135.991032878,-100
carcassonne-uct95-vs-uct390-1000its,781,881,2167.115984437,2087.365896686,-100
carcassonne-uct330-vs-uct275-1000its,782,882,2126.673863307,2086.441480517,-100
carcassonne-ucttuned265-vs-ucttuned35-1000its,782,882,2227.236931112,2154.08079071,-100
carcassonne-ucttuned380-vs-ucttuned15-1000its,783,883,2164.18213453,2144.213728725,-100
carcassonne-uct395-vs-uct5-1000its,786,886,2203.976242592,2154.871161191,-100
carcassonne-uct460-vs-uct225-1000its,788,888,2227.851958845,2181.558824806,-100
carcassonne-uct240-vs-uct185-1000its,789,889,2281.580301618,2231.466142154,-100
carcassonne-boltzmann55-vs-boltzmann450-1000its,801,901,2180.069901728,2176.191992448,-100
carcassonne-ucttuned295-vs-ucttuned340-1000its,801,901,2242.857310169,2185.556727545,-100
carcassonne-uct160-vs-uct5-1000its,807,907,2196.525370571,2136.38411074,-100
carcassonne-ucttuned470-vs-ucttuned170-1000its,812,912,2154.677527851,2129.78206192,-100
carcassonne-uct400-vs-uct285-1000its,822,922,2169.102156412,2152.585580497,-100
carcassonne-uct175-vs-uct60-1000its,873,973,2194.949124686,2204.023027351,-100
carcassonne-boltzmann405-vs-boltzmann55-1000its,682,781,2215.830462982,2146.758521357,-99
carcassonne-uct285-vs-uct300-1000its,684,783,2200.611499937,2171.528383983,-99
carcassonne-ucttuned185-vs-ucttuned445-1000its,690,789,2193.686222887,2122.332780152,-99
carcassonne-ucttuned395-vs-ucttuned325-1000its,695,794,2184.282756753,2124.573575642,-99
carcassonne-boltzmann400-vs-boltzmann70-1000its,700,799,2220.577326839,2189.956174498,-99
carcassonne-ucttuned435-vs-ucttuned185-1000its,706,805,2143.566136625,2149.908321432,-99
carcassonne-uct470-vs-uct185-1000its,707,806,2200.415464024,2182.145933466,-99
carcassonne-uct165-vs-uct160-1000its,712,811,2196.847137725,2176.215283624,-99
carcassonne-boltzmann230-vs-boltzmann400-1000its,715,814,2232.014186375,2204.557379327,-99
carcassonne-uct400-vs-uct480-1000its,718,817,2149.298704597,2083.632457568,-99
carcassonne-boltzmann100-vs-boltzmann65-1000its,720,819,2248.196040694,2210.850559549,-99
carcassonne-ucttuned95-vs-ucttuned55-1000its,723,822,2182.985706114,2147.821939873,-99
carcassonne-uct390-vs-uct350-1000its,730,829,2226.511129995,2149.462637119,-99
carcassonne-ucttuned345-vs-ucttuned325-1000its,732,831,2207.29999716,2127.702524709,-99
carcassonne-uct435-vs-uct200-1000its,735,834,2208.700443039,2181.509186046,-99
carcassonne-uct320-vs-uct455-1000its,736,835,2130.205895177,2095.179909022,-99
carcassonne-boltzmann300-vs-boltzmann205-1000its,737,836,2159.124240674,2133.198629515,-99
carcassonne-ucttuned60-vs-ucttuned205-1000its,737,836,2198.09665466,2161.776205191,-99
carcassonne-uct270-vs-uct355-1000its,738,837,2215.072365167,2113.403198455,-99
carcassonne-uct425-vs-uct155-1000its,739,838,2147.561767895,2102.126282174,-99
carcassonne-boltzmann50-vs-boltzmann130-1000its,741,840,2175.283542341,2133.222101651,-99
carcassonne-uct470-vs-uct480-1000its,741,840,2223.915650105,2151.706065461,-99
carcassonne-ucttuned210-vs-ucttuned480-1000its,742,841,2220.218259686,2173.56253366,-99
carcassonne-boltzmann375-vs-boltzmann450-1000its,744,843,2171.299613021,2125.446912976,-99
carcassonne-ucttuned220-vs-ucttuned260-1000its,747,846,2153.753465783,2144.941113033,-99
carcassonne-ucttuned95-vs-ucttuned270-1000its,751,850,2186.703335168,2182.753472243,-99
carcassonne-ucttuned460-vs-ucttuned285-1000its,753,852,2191.363260216,2124.548752924,-99
carcassonne-boltzmann300-vs-boltzmann485-1000its,757,856,2152.837866355,2119.80040388,-99
carcassonne-uct425-vs-uct225-1000its,759,858,2261.639674657,2201.702049389,-99
carcassonne-boltzmann255-vs-boltzmann65-1000its,761,860,2244.375051192,2201.874792439,-99
carcassonne-ucttuned430-vs-ucttuned400-1000its,766,865,2155.807755772,2139.782112107,-99
carcassonne-boltzmann495-vs-boltzmann50-1000its,774,873,2146.216543863,2143.032098533,-99
carcassonne-uct165-vs-uct5-1000its,774,873,2146.478640755,2140.480148467,-99
carcassonne-ucttuned120-vs-ucttuned245-1000its,774,873,2200.575823849,2155.484575024,-99
carcassonne-ucttuned185-vs-ucttuned90-1000its,776,875,2193.408340476,2171.34544326,-99
carcassonne-ucttuned240-vs-ucttuned140-1000its,777,876,2294.262959566,2257.228942809,-99
carcassonne-boltzmann345-vs-boltzmann30-1000its,780,879,2209.380065876,2206.626547317,-99
carcassonne-ucttuned430-vs-ucttuned435-1000its,781,880,2230.888451834,2177.368870093,-99
carcassonne-boltzmann70-vs-boltzmann300-1000its,782,881,2137.237198566,2079.310364746,-99
carcassonne-uct60-vs-uct180-1000its,790,889,2276.509939433,2172.104629543,-99
carcassonne-uct425-vs-uct15-1000its,794,893,2225.612447068,2209.060467819,-99
carcassonne-uct390-vs-uct20-1000its,800,899,2204.164165761,2174.14826927,-99
carcassonne-ucttuned245-vs-ucttuned345-1000its,800,899,2213.96049355,2146.95233333,-99
carcassonne-uct230-vs-uct445-1000its,802,901,2228.657884094,2169.907040383,-99
carcassonne-boltzmann385-vs-boltzmann85-1000its,804,903,2154.67780871,2122.154266933,-99
carcassonne-uct95-vs-uct270-1000its,805,904,2198.722191318,2173.41389445,-99
carcassonne-boltzmann95-vs-boltzmann165-1000its,815,914,2200.758952722,2190.443286198,-99
carcassonne-uct285-vs-uct335-1000its,827,926,2167.554476773,2130.357388707,-99
carcassonne-uct5-vs-uct215-1000its,833,932,2207.573798644,2156.035947468,-99
carcassonne-ucttuned350-vs-ucttuned115-1000its,836,935,2170.121742119,2100.23391055,-99
carcassonne-boltzmann215-vs-boltzmann415-1000its,840,939,2156.653944722,2127.66143674,-99
carcassonne-boltzmann35-vs-boltzmann490-1000its,842,941,2147.232275884,2121.788841852,-99
carcassonne-uct275-vs-uct45-1000its,881,980,2138.487575032,2091.533738489,-99
carcassonne-ucttuned260-vs-ucttuned165-1000its,664,762,2209.871881394,2139.916050241,-98
carcassonne-uct180-vs-uct340-1000its,671,769,2180.320684033,2143.561114625,-98
carcassonne-uct290-vs-uct430-1000its,671,769,2162.833728923,2180.394429149,-98
carcassonne-boltzmann480-vs-boltzmann25-1000its,696,794,2174.499880871,2162.129228282,-98
carcassonne-ucttuned340-vs-ucttuned480-1000its,701,799,2155.947416964,2121.89852096,-98
carcassonne-boltzmann395-vs-boltzmann250-1000its,704,802,2221.541839256,2164.939699727,-98
carcassonne-boltzmann445-vs-boltzmann410-1000its,704,802,2125.972327482,2094.173923132,-98
carcassonne-boltzmann145-vs-boltzmann45-1000its,707,805,2218.939914517,2156.927090044,-98
carcassonne-boltzmann125-vs-boltzmann145-1000its,714,812,2223.149497397,2172.679360367,-98
carcassonne-ucttuned375-vs-ucttuned325-1000its,715,813,2120.413075373,2076.057546212,-98
carcassonne-boltzmann105-vs-boltzmann10-1000its,717,815,2187.912975474,2182.54536034,-98
carcassonne-boltzmann415-vs-boltzmann190-1000its,717,815,2144.211695598,2020.639476068,-98
carcassonne-ucttuned285-vs-ucttuned110-1000its,720,818,2195.781529916,2153.786327348,-98
carcassonne-uct310-vs-uct70-1000its,728,826,2164.621232344,2083.901537675,-98
carcassonne-boltzmann100-vs-boltzmann165-1000its,737,835,2259.372026345,2216.423777089,-98
carcassonne-ucttuned315-vs-ucttuned275-1000its,737,835,2174.475255524,2143.536635669,-98
carcassonne-boltzmann130-vs-boltzmann300-1000its,740,838,2207.147736376,2121.396484698,-98
carcassonne-boltzmann330-vs-boltzmann55-1000its,742,840,2192.579389188,2132.984784386,-98
carcassonne-uct375-vs-uct120-1000its,742,840,2211.476310014,2183.609092331,-98
carcassonne-uct375-vs-uct20-1000its,745,843,2147.65860574,2102.767622977,-98
carcassonne-uct340-vs-uct30-1000its,746,844,2216.007906192,2160.392199888,-98
carcassonne-uct370-vs-uct40-1000its,748,846,2208.059296934,2165.981805299,-98
carcassonne-boltzmann490-vs-boltzmann60-1000its,751,849,2262.526968342,2230.342945832,-98
carcassonne-boltzmann70-vs-boltzmann15-1000its,752,850,2254.91874042,2174.206996012,-98
carcassonne-uct475-vs-uct10-1000its,758,856,2219.933099039,2192.529152272,-98
carcassonne-boltzmann460-vs-boltzmann425-1000its,760,858,2230.028563905,2160.022172375,-98
carcassonne-boltzmann485-vs-boltzmann25-1000its,761,859,2151.873866607,2110.736257057,-98
carcassonne-boltzmann100-vs-boltzmann105-1000its,763,861,2162.209112803,2105.328608789,-98
carcassonne-uct40-vs-uct435-1000its,763,861,2190.260561968,2091.756314116,-98
carcassonne-uct155-vs-uct95-1000its,765,863,2163.568350606,2104.821179825,-98
carcassonne-boltzmann100-vs-boltzmann5-1000its,767,865,2144.304992336,2124.968257412,-98
carcassonne-ucttuned35-vs-ucttuned180-1000its,771,869,2114.753599147,2126.096123447,-98
carcassonne-uct485-vs-uct65-1000its,772,870,2194.031963549,2164.629540406,-98
carcassonne-uct270-vs-uct325-1000its,777,875,2149.16720796,2151.671980598,-98
carcassonne-boltzmann140-vs-boltzmann455-1000its,778,876,2200.843369139,2157.200996453,-98
carcassonne-boltzmann315-vs-boltzmann10-1000its,787,885,2145.588554546,2101.84031931,-98
carcassonne-boltzmann160-vs-boltzmann55-1000its,793,891,2227.191011043,2181.529920565,-98
carcassonne-uct225-vs-uct10-1000its,793,891,2209.232635583,2210.227248607,-98
carcassonne-uct365-vs-uct225-1000its,793,891,2174.028895155,2176.619651038,-98
carcassonne-ucttuned195-vs-ucttuned350-1000its,793,891,2190.319009222,2193.118543131,-98
carcassonne-boltzmann200-vs-boltzmann300-1000its,803,901,2155.995740025,2129.893552477,-98
carcassonne-ucttuned350-vs-ucttuned160-1000its,803,901,2190.231141904,2113.842519265,-98
carcassonne-ucttuned15-vs-ucttuned435-1000its,804,902,2198.558303943,2135.353894224,-98
carcassonne-uct405-vs-uct85-1000its,809,907,2305.297083967,2233.598109361,-98
carcassonne-boltzmann35-vs-boltzmann355-1000its,810,908,2185.100178979,2101.129864893,-98
carcassonne-ucttuned60-vs-ucttuned495-1000its,810,908,2180.58178885,2144.511830159,-98
carcassonne-ucttuned220-vs-ucttuned75-1000its,652,749,2256.719376328,2214.687726475,-97
carcassonne-uct300-vs-uct460-1000its,690,787,2183.580195651,2163.291616488,-97
carcassonne-boltzmann325-vs-boltzmann420-1000its,692,789,2193.89226801,2127.620604688,-97
carcassonne-uct215-vs-uct245-1000its,697,794,2185.745726078,2166.216437822,-97
carcassonne-boltzmann195-vs-boltzmann10-1000its,703,800,2195.851107094,2138.010282981,-97
carcassonne-boltzmann415-vs-boltzmann20-1000its,710,807,2214.927958293,2148.194830858,-97
carcassonne-boltzmann390-vs-boltzmann35-1000its,711,808,2212.778913884,2130.268096404,-97
carcassonne-boltzmann200-vs-boltzmann90-1000its,714,811,2179.021036429,2167.209979441,-97
carcassonne-uct120-vs-uct295-1000its,720,817,2178.309344287,2135.026058187,-97
carcassonne-boltzmann275-vs-boltzmann340-1000its,725,822,2162.832771017,2143.09556128,-97
carcassonne-uct85-vs-uct265-1000its,729,826,2201.546577337,2146.12748118,-97
carcassonne-boltzmann5-vs-boltzmann285-1000its,730,827,2210.485902642,2198.520832552,-97
carcassonne-uct115-vs-uct435-1000its,732,829,2180.859644457,2142.61170049,-97
carcassonne-boltzmann335-vs-boltzmann420-1000its,733,830,2232.397917767,2191.900405413,-97
carcassonne-ucttuned200-vs-ucttuned195-1000its,736,833,2189.198355283,2096.949678993,-97
carcassonne-ucttuned375-vs-ucttuned40-1000its,739,836,2141.671055798,2097.254562214,-97
carcassonne-boltzmann190-vs-boltzmann110-1000its,740,837,2153.282960164,2136.170476757,-97
carcassonne-ucttuned480-vs-ucttuned320-1000its,740,837,2236.876347371,2185.932977197,-97
carcassonne-ucttuned440-vs-ucttuned205-1000its,741,838,2168.942050275,2138.020618398,-97
carcassonne-ucttuned455-vs-ucttuned160-1000its,752,849,2209.601708498,2146.71724428,-97
carcassonne-uct145-vs-uct5-1000its,759,856,2130.544222556,2131.888402082,-97
carcassonne-uct110-vs-uct70-1000its,760,857,2197.695689187,2131.324763685,-97
carcassonne-ucttuned5-vs-ucttuned85-1000its,762,859,2218.096652636,2172.343406299,-97
carcassonne-ucttuned495-vs-ucttuned120-1000its,765,862,2190.950398487,2187.700678423,-97
carcassonne-uct190-vs-uct315-1000its,773,870,2257.299645456,2240.629164684,-97
carcassonne-uct305-vs-uct290-1000its,776,873,2168.093062529,2137.615190814,-97
carcassonne-ucttuned315-vs-ucttuned195-1000its,777,874,2165.88788155,2100.420836921,-97
carcassonne-uct430-vs-uct270-1000its,781,878,2137.968499634,2106.126169483,-97
carcassonne-ucttuned110-vs-ucttuned160-1000its,783,880,2168.117537943,2181.51787389,-97
carcassonne-uct90-vs-uct95-1000its,784,881,2284.819061714,2277.877897147,-97
carcassonne-ucttuned145-vs-ucttuned30-1000its,787,884,2196.801885033,2190.200276841,-97
carcassonne-uct195-vs-uct240-1000its,792,889,2189.935062746,2141.516073985,-97
carcassonne-boltzmann50-vs-boltzmann20-1000its,794,891,2204.898319528,2150.537506317,-97
carcassonne-boltzmann260-vs-boltzmann230-1000its,798,895,2210.732910241,2175.656917618,-97
carcassonne-boltzmann85-vs-boltzmann170-1000its,803,900,2271.828424933,2250.270247847,-97
carcassonne-boltzmann375-vs-boltzmann365-1000its,806,903,2176.727575703,2151.776052321,-97
carcassonne-uct275-vs-uct175-1000its,813,910,2194.721194966,2164.709588859,-97
carcassonne-ucttuned370-vs-ucttuned40-1000its,820,917,2176.818682404,2162.735204721,-97
carcassonne-ucttuned140-vs-ucttuned400-1000its,826,923,2168.010347654,2100.292967295,-97
carcassonne-ucttuned140-vs-ucttuned85-1000its,849,946,2156.619258567,2126.356241736,-97
carcassonne-ucttuned255-vs-ucttuned305-1000its,585,681,1751.817315473,1751.81496773,-96
carcassonne-uct455-vs-uct435-1000its,642,738,2213.391404329,2180.648520881,-96
carcassonne-ucttuned355-vs-ucttuned455-1000its,674,770,2217.650207649,2178.129847046,-96
carcassonne-boltzmann450-vs-boltzmann390-1000its,689,785,2191.564375512,2115.825425945,-96
carcassonne-uct165-vs-uct45-1000its,695,791,2211.307539092,2160.06450103,-96
carcassonne-boltzmann235-vs-boltzmann70-1000its,699,795,2247.893042795,2163.505558692,-96
carcassonne-uct465-vs-uct120-1000its,712,808,2227.196422999,2166.071925771,-96
carcassonne-ucttuned330-vs-ucttuned190-1000its,724,820,2160.612794309,2123.996163059,-96
carcassonne-ucttuned385-vs-ucttuned325-1000its,724,820,2269.176898237,2204.402489553,-96
carcassonne-ucttuned475-vs-ucttuned435-1000its,724,820,2173.32140822,2157.048641178,-96
carcassonne-uct420-vs-uct125-1000its,727,823,2142.170851248,2067.861351697,-96
carcassonne-boltzmann365-vs-boltzmann150-1000its,731,827,2218.488114148,2194.454647986,-96
carcassonne-ucttuned130-vs-ucttuned330-1000its,733,829,2167.587096553,2170.5850956,-96
carcassonne-uct350-vs-uct40-1000its,737,833,2106.531911045,2073.813998783,-96
carcassonne-ucttuned455-vs-ucttuned330-1000its,745,841,2228.999506764,2199.175765474,-96
carcassonne-ucttuned365-vs-ucttuned295-1000its,751,847,2175.698427265,2138.402483853,-96
carcassonne-ucttuned475-vs-ucttuned30-1000its,753,849,2208.479402752,2154.998843729,-96
carcassonne-ucttuned120-vs-ucttuned235-1000its,756,852,2173.009750101,2152.01192638,-96
carcassonne-ucttuned420-vs-ucttuned230-1000its,756,852,2193.773357058,2150.643010269,-96
carcassonne-boltzmann105-vs-boltzmann305-1000its,758,854,2282.069162613,2211.604959878,-96
carcassonne-uct440-vs-uct325-1000its,758,854,2189.137135749,2112.597503648,-96
carcassonne-boltzmann320-vs-boltzmann230-1000its,760,856,2177.016725949,2106.214717867,-96
carcassonne-boltzmann425-vs-boltzmann300-1000its,765,861,2102.819390711,2090.395441491,-96
carcassonne-boltzmann265-vs-boltzmann425-1000its,766,862,2233.226234576,2194.368123261,-96
carcassonne-uct425-vs-uct35-1000its,773,869,2198.999531874,2188.696725929,-96
carcassonne-ucttuned230-vs-ucttuned270-1000its,774,870,2185.187569866,2157.924274116,-96
carcassonne-ucttuned495-vs-ucttuned415-1000its,780,876,2183.412877102,2107.421594749,-96
carcassonne-uct355-vs-uct205-1000its,781,877,2214.775741315,2163.93497729,-96
carcassonne-uct25-vs-uct140-1000its,785,881,2143.952518099,2096.655629645,-96
carcassonne-uct390-vs-uct190-1000its,788,884,2228.586912212,2147.262640722,-96
carcassonne-boltzmann325-vs-boltzmann15-1000its,791,887,2169.757809342,2133.921175956,-96
carcassonne-uct345-vs-uct360-1000its,792,888,2222.259603694,2138.85932111,-96
carcassonne-uct170-vs-uct300-1000its,793,889,2195.077473397,2139.832224971,-96
carcassonne-boltzmann195-vs-boltzmann485-1000its,795,891,2206.375433359,2156.499785358,-96
carcassonne-boltzmann45-vs-boltzmann450-1000its,795,891,2188.709681008,2118.000115291,-96
carcassonne-boltzmann180-vs-boltzmann365-1000its,796,892,2161.41594796,2134.558796762,-96
carcassonne-uct410-vs-uct75-1000its,796,892,2207.630404263,2200.276468087,-96
carcassonne-ucttuned460-vs-ucttuned485-1000its,797,893,2178.038876428,2166.513921011,-96
carcassonne-boltzmann310-vs-boltzmann425-1000its,802,898,2225.029294994,2193.503338127,-96
carcassonne-uct450-vs-uct85-1000its,802,898,2167.021479138,2163.921838412,-96
carcassonne-uct285-vs-uct100-1000its,804,900,2286.86458407,2227.898763919,-96
carcassonne-ucttuned330-vs-ucttuned315-1000its,806,902,2189.346317098,2157.723110212,-96
carcassonne-boltzmann300-vs-boltzmann150-1000its,815,911,2164.034517074,2175.322013638,-96
carcassonne-ucttuned220-vs-ucttuned130-1000its,835,931,2174.714043591,2140.183057274,-96
carcassonne-ucttuned430-vs-ucttuned170-1000its,869,965,2131.336799774,2096.387393454,-96
carcassonne-ucttuned35-vs-ucttuned285-1000its,608,703,1773.313555124,1715.807055607,-95
carcassonne-ucttuned385-vs-ucttuned215-1000its,659,754,2293.222976195,2223.593024829,-95
carcassonne-ucttuned265-vs-ucttuned215-1000its,684,779,2120.972142455,2032.216509128,-95
carcassonne-boltzmann350-vs-boltzmann120-1000its,697,792,2162.937039919,2085.870220236,-95
carcassonne-uct35-vs-uct70-1000its,697,792,2260.786827635,2164.578715006,-95
carcassonne-boltzmann405-vs-boltzmann50-1000its,698,793,2258.51403777,2142.92768911,-95
carcassonne-uct340-vs-uct40-1000its,703,798,2173.375621107,2130.207386067,-95
carcassonne-boltzmann135-vs-boltzmann125-1000its,704,799,2256.814931693,2186.560824331,-95
carcassonne-uct175-vs-uct95-1000its,709,804,2217.785612011,2223.221871914,-95
carcassonne-uct165-vs-uct415-1000its,710,805,2172.171833036,2156.624105607,-95
carcassonne-uct325-vs-uct20-1000its,711,806,2218.514205325,2181.465028075,-95
carcassonne-uct300-vs-uct50-1000its,714,809,2296.371071622,2272.114759819,-95
carcassonne-ucttuned80-vs-ucttuned10-1000its,714,809,2145.018283487,2097.177926686,-95
carcassonne-boltzmann435-vs-boltzmann470-1000its,717,812,2182.926841001,2148.076437205,-95
carcassonne-ucttuned180-vs-ucttuned490-1000its,721,816,2280.440120987,2238.887151817,-95
carcassonne-uct400-vs-uct310-1000its,722,817,2172.249921684,2138.223390972,-95
carcassonne-boltzmann95-vs-boltzmann65-1000its,727,822,2206.374971592,2179.295228133,-95
carcassonne-boltzmann205-vs-boltzmann235-1000its,734,829,2197.015705375,2152.053401749,-95
carcassonne-uct480-vs-uct390-1000its,734,829,2165.809665299,2107.624964204,-95
carcassonne-uct90-vs-uct80-1000its,734,829,2201.219411231,2182.398829977,-95
carcassonne-uct325-vs-uct25-1000its,741,836,2232.888803629,2225.641871045,-95
carcassonne-ucttuned345-vs-ucttuned35-1000its,741,836,2201.24054614,2182.053276426,-95
carcassonne-ucttuned200-vs-ucttuned265-1000its,744,839,2221.219334383,2163.66034469,-95
carcassonne-boltzmann80-vs-boltzmann75-1000its,745,840,2249.548402233,2221.698149438,-95
carcassonne-ucttuned310-vs-ucttuned120-1000its,745,840,2262.028020409,2234.654397099,-95
carcassonne-boltzmann65-vs-boltzmann85-1000its,749,844,2233.917670634,2192.354417941,-95
carcassonne-ucttuned300-vs-ucttuned220-1000its,749,844,2165.423790529,2110.450784896,-95
carcassonne-boltzmann280-vs-boltzmann225-1000its,750,845,2116.212971479,2091.709888676,-95
carcassonne-boltzmann315-vs-boltzmann270-1000its,751,846,2165.568774342,2147.161005634,-95
carcassonne-ucttuned110-vs-ucttuned450-1000its,751,846,2282.842190344,2261.949577609,-95
carcassonne-boltzmann260-vs-boltzmann70-1000its,754,849,2209.67181037,2170.398764968,-95
carcassonne-ucttuned250-vs-ucttuned435-1000its,755,850,2187.251925812,2175.213089151,-95
carcassonne-ucttuned375-vs-ucttuned255-1000its,756,851,2125.823346363,2101.58878161,-95
carcassonne-ucttuned305-vs-ucttuned465-1000its,757,852,2103.593353622,2093.814652846,-95
carcassonne-ucttuned260-vs-ucttuned90-1000its,770,865,2166.680390291,2104.800656846,-95
carcassonne-uct255-vs-uct165-1000its,777,872,2147.097542542,2126.679896079,-95
carcassonne-uct400-vs-uct30-1000its,777,872,2228.228331899,2137.740709521,-95
carcassonne-ucttuned375-vs-ucttuned465-1000its,778,873,2181.858496395,2141.981570539,-95
carcassonne-uct380-vs-uct420-1000its,781,876,2272.645184666,2207.042182917,-95
carcassonne-ucttuned205-vs-ucttuned35-1000its,781,876,2191.255295799,2141.107611227,-95
carcassonne-boltzmann25-vs-boltzmann445-1000its,783,878,2221.641610216,2151.331526104,-95
carcassonne-uct120-vs-uct470-1000its,785,880,2181.949304844,2119.334252423,-95
carcassonne-ucttuned240-vs-ucttuned130-1000its,785,880,2240.035272132,2191.934268988,-95
carcassonne-boltzmann170-vs-boltzmann210-1000its,786,881,2264.19086538,2215.671024433,-95
carcassonne-boltzmann160-vs-boltzmann280-1000its,787,882,2276.344043922,2195.265701696,-95
carcassonne-boltzmann285-vs-boltzmann280-1000its,787,882,2114.589408748,2108.304419491,-95
carcassonne-boltzmann85-vs-boltzmann370-1000its,790,885,2101.987954779,2081.492524012,-95
carcassonne-ucttuned450-vs-ucttuned120-1000its,792,887,2145.021366799,2115.324990648,-95
carcassonne-ucttuned55-vs-ucttuned140-1000its,793,888,2177.590515816,2142.415263255,-95
carcassonne-uct220-vs-uct390-1000its,795,890,2182.138091629,2151.414832824,-95
carcassonne-ucttuned465-vs-ucttuned415-1000its,795,890,2277.199734133,2217.488359302,-95
carcassonne-uct135-vs-uct165-1000its,800,895,2231.24892207,2128.554891943,-95
carcassonne-uct405-vs-uct5-1000its,801,896,2197.330988776,2167.708426744,-95
carcassonne-ucttuned155-vs-ucttuned140-1000its,801,896,2224.215566191,2179.121937405,-95
carcassonne-uct185-vs-uct145-1000its,803,898,2196.119300455,2161.945211174,-95
carcassonne-ucttuned410-vs-ucttuned460-1000its,803,898,2161.795932675,2163.223713029,-95
carcassonne-uct105-vs-uct490-1000its,804,899,2208.123563829,2122.919530552,-95
carcassonne-uct50-vs-uct135-1000its,813,908,2212.164700871,2213.288898723,-95
carcassonne-uct175-vs-uct75-1000its,816,911,2290.109934363,2272.847102385,-95
carcassonne-ucttuned300-vs-ucttuned55-1000its,819,914,2247.335019505,2200.728064459,-95
carcassonne-ucttuned45-vs-ucttuned330-1000its,819,914,2163.082651092,2111.352758409,-95
carcassonne-ucttuned310-vs-ucttuned230-1000its,820,915,2294.818402768,2224.732858337,-95
carcassonne-ucttuned450-vs-ucttuned15-1000its,831,926,2227.554056465,2205.150234645,-95
carcassonne-uct70-vs-uct140-1000its,832,927,2216.8086798,2183.393912199,-95
carcassonne-ucttuned285-vs-ucttuned370-1000its,837,932,2231.436507565,2160.702466857,-95
carcassonne-uct330-vs-uct180-1000its,850,945,2246.139143459,2238.41664594,-95
carcassonne-ucttuned205-vs-ucttuned380-1000its,656,750,2220.910879992,2189.738464024,-94
carcassonne-ucttuned270-vs-ucttuned345-1000its,688,782,2222.151477887,2215.959923298,-94
carcassonne-ucttuned225-vs-ucttuned130-1000its,695,789,2295.699117351,2212.092525377,-94
carcassonne-ucttuned280-vs-ucttuned120-1000its,705,799,2212.587169559,2184.424199241,-94
carcassonne-ucttuned435-vs-ucttuned395-1000its,710,804,2158.269793091,2149.869682566,-94
carcassonne-boltzmann345-vs-boltzmann115-1000its,712,806,2243.408497645,2204.813707332,-94
carcassonne-boltzmann460-vs-boltzmann420-1000its,712,806,2143.162588055,2128.870919076,-94
carcassonne-boltzmann220-vs-boltzmann455-1000its,717,811,2184.915012161,2157.215162857,-94
carcassonne-ucttuned485-vs-ucttuned40-1000its,719,813,2176.254830448,2130.648999199,-94
carcassonne-boltzmann200-vs-boltzmann160-1000its,720,814,2184.300149458,2153.072601399,-94
carcassonne-boltzmann140-vs-boltzmann445-1000its,726,820,2187.96548667,2130.832971524,-94
carcassonne-ucttuned280-vs-ucttuned250-1000its,727,821,2139.335509061,2114.864506575,-94
carcassonne-ucttuned385-vs-ucttuned205-1000its,727,821,2228.345126159,2135.177634732,-94
carcassonne-uct325-vs-uct200-1000its,729,823,2140.664752084,2099.008399674,-94
carcassonne-ucttuned15-vs-ucttuned265-1000its,731,825,2234.000420266,2144.845686944,-94
carcassonne-ucttuned495-vs-ucttuned340-1000its,731,825,2233.527095602,2162.505377934,-94
carcassonne-uct300-vs-uct100-1000its,732,826,2150.63891877,2157.280889137,-94
carcassonne-uct135-vs-uct250-1000its,733,827,2256.278128028,2200.088086499,-94
carcassonne-ucttuned265-vs-ucttuned145-1000its,733,827,2220.521041609,2175.964530909,-94
carcassonne-ucttuned315-vs-ucttuned180-1000its,733,827,2180.355358217,2087.43675084,-94
carcassonne-ucttuned285-vs-ucttuned400-1000its,736,830,2236.815035397,2144.345094254,-94
carcassonne-uct180-vs-uct365-1000its,737,831,2121.253452565,2098.717659971,-94
carcassonne-ucttuned240-vs-ucttuned495-1000its,737,831,2192.285238965,2173.772265152,-94
carcassonne-uct100-vs-uct470-1000its,738,832,2222.655257627,2191.849550267,-94
carcassonne-boltzmann225-vs-boltzmann405-1000its,739,833,2119.11840644,2073.74720954,-94
carcassonne-boltzmann255-vs-boltzmann220-1000its,741,835,2182.68689371,2160.008570329,-94
carcassonne-boltzmann275-vs-boltzmann435-1000its,741,835,2194.118053257,2163.555390377,-94
carcassonne-boltzmann375-vs-boltzmann465-1000its,741,835,2167.23068526,2147.701751849,-94
carcassonne-boltzmann475-vs-boltzmann335-1000its,744,838,2149.453720305,2132.872323455,-94
carcassonne-boltzmann80-vs-boltzmann235-1000its,747,841,2172.593600959,2117.15325297,-94
carcassonne-uct355-vs-uct430-1000its,749,843,2206.036305609,2146.491342254,-94
carcassonne-boltzmann185-vs-boltzmann105-1000its,754,848,2193.015235858,2179.62138847,-94
carcassonne-uct100-vs-uct355-1000its,754,848,2220.933478359,2151.56276639,-94
carcassonne-uct245-vs-uct85-1000its,755,849,2178.229343837,2128.98896107,-94
carcassonne-uct270-vs-uct275-1000its,758,852,2221.606430242,2182.105335236,-94
carcassonne-uct65-vs-uct190-1000its,762,856,2252.300299739,2179.170163423,-94
carcassonne-boltzmann360-vs-boltzmann310-1000its,764,858,2130.433818415,2124.648441207,-94
carcassonne-ucttuned255-vs-ucttuned35-1000its,764,858,2247.179619965,2207.429375807,-94
carcassonne-boltzmann475-vs-boltzmann130-1000its,767,861,2106.90853158,2084.110788005,-94
carcassonne-ucttuned345-vs-ucttuned60-1000its,768,862,2240.437163175,2233.975369938,-94
carcassonne-ucttuned10-vs-ucttuned20-1000its,769,863,2195.091888684,2147.13717743,-94
carcassonne-boltzmann15-vs-boltzmann75-1000its,775,869,2240.267684102,2160.57800779,-94
carcassonne-uct415-vs-uct10-1000its,778,872,2148.272036043,2133.054957992,-94
carcassonne-ucttuned215-vs-ucttuned285-1000its,778,872,2239.789792103,2171.774260057,-94
carcassonne-ucttuned280-vs-ucttuned485-1000its,779,873,2194.634423286,2123.449166667,-94
carcassonne-ucttuned65-vs-ucttuned470-1000its,779,873,2165.721124947,2141.626413007,-94
carcassonne-ucttuned390-vs-ucttuned20-1000its,780,874,2179.364374855,2139.693053256,-94
carcassonne-ucttuned455-vs-ucttuned40-1000its,782,876,2224.763245589,2196.772992833,-94
carcassonne-ucttuned465-vs-ucttuned365-1000its,782,876,2175.285646036,2154.150179824,-94
carcassonne-uct145-vs-uct385-1000its,785,879,2148.713434371,2123.487947926,-94
carcassonne-ucttuned490-vs-ucttuned10-1000its,788,882,2143.303203043,2111.029751132,-94
carcassonne-boltzmann275-vs-boltzmann120-1000its,790,884,2181.849857887,2168.337587264,-94
carcassonne-boltzmann180-vs-boltzmann210-1000its,803,897,2135.685731697,2113.481225683,-94
carcassonne-ucttuned210-vs-ucttuned255-1000its,807,901,2270.489315417,2209.618576101,-94
carcassonne-uct155-vs-uct495-1000its,809,903,2238.581300446,2181.908588107,-94
carcassonne-uct480-vs-uct240-1000its,810,904,2214.178795914,2156.925383145,-94
carcassonne-uct230-vs-uct315-1000its,811,905,2178.383484554,2114.494585794,-94
carcassonne-ucttuned410-vs-ucttuned235-1000its,811,905,2220.364504758,2223.028174033,-94
carcassonne-boltzmann175-vs-boltzmann435-1000its,812,906,2193.823907524,2154.83726517,-94
carcassonne-boltzmann360-vs-boltzmann465-1000its,814,908,2243.522847343,2184.064144713,-94
carcassonne-uct85-vs-uct465-1000its,816,910,2193.173519839,2131.511691329,-94
carcassonne-ucttuned300-vs-ucttuned10-1000its,819,913,2212.304167949,2191.672230527,-94
carcassonne-uct435-vs-uct5-1000its,828,922,2130.536855409,2096.492461392,-94
carcassonne-boltzmann205-vs-boltzmann60-1000its,831,925,2195.50458806,2167.721237449,-94
carcassonne-uct105-vs-uct55-1000its,648,741,2195.254707708,2186.912108363,-93
carcassonne-uct360-vs-uct400-1000its,700,793,2182.34595613,2109.106129044,-93
carcassonne-uct450-vs-uct300-1000its,700,793,2187.991067821,2149.888377299,-93
carcassonne-ucttuned240-vs-ucttuned105-1000its,707,800,2231.896182129,2182.7203493,-93
carcassonne-boltzmann245-vs-boltzmann335-1000its,710,803,2206.832348584,2186.403281562,-93
carcassonne-uct105-vs-uct245-1000its,713,806,2250.499400261,2203.390853922,-93
carcassonne-uct400-vs-uct60-1000its,713,806,2213.091639494,2196.370981284,-93
carcassonne-boltzmann110-vs-boltzmann210-1000its,718,811,2209.620476824,2141.671696681,-93
carcassonne-boltzmann290-vs-boltzmann250-1000its,725,818,2228.95537281,2197.18848734,-93
carcassonne-boltzmann430-vs-boltzmann100-1000its,726,819,2129.845440089,2098.481830243,-93
carcassonne-boltzmann160-vs-boltzmann185-1000its,727,820,2168.670388095,2126.06494143,-93
carcassonne-ucttuned360-vs-ucttuned305-1000its,727,820,2118.236600815,2074.460520828,-93
carcassonne-ucttuned390-vs-ucttuned310-1000its,727,820,2168.158029528,2100.691546931,-93
carcassonne-ucttuned315-vs-ucttuned280-1000its,728,821,2104.245904137,2062.61296909,-93
carcassonne-boltzmann405-vs-boltzmann110-1000its,732,825,2209.674861293,2135.267422096,-93
carcassonne-ucttuned120-vs-ucttuned325-1000its,735,828,2205.915087606,2177.82063358,-93
carcassonne-uct455-vs-uct315-1000its,736,829,2199.19652908,2179.54032929,-93
carcassonne-uct205-vs-uct145-1000its,739,832,2188.224392841,2147.658029777,-93
carcassonne-ucttuned415-vs-ucttuned25-1000its,742,835,2256.797819298,2168.456883021,-93
carcassonne-ucttuned55-vs-ucttuned110-1000its,747,840,2156.914745586,2119.579257311,-93
carcassonne-boltzmann425-vs-boltzmann140-1000its,749,842,2215.233748909,2171.008818912,-93
carcassonne-uct400-vs-uct105-1000its,750,843,2146.246721264,2161.426714548,-93
carcassonne-boltzmann320-vs-boltzmann40-1000its,751,844,2141.850985121,2085.752586353,-93
carcassonne-boltzmann470-vs-boltzmann165-1000its,751,844,2167.817715593,2152.559301218,-93
carcassonne-boltzmann405-vs-boltzmann95-1000its,752,845,2199.438588398,2127.001776517,-93
carcassonne-uct175-vs-uct275-1000its,752,845,2192.223921688,2169.596699972,-93
carcassonne-uct65-vs-uct245-1000its,752,845,2268.01641306,2173.106034203,-93
carcassonne-uct225-vs-uct45-1000its,753,846,2237.637109519,2205.285685033,-93
carcassonne-ucttuned230-vs-ucttuned190-1000its,753,846,2181.119542342,2149.173593706,-93
carcassonne-boltzmann395-vs-boltzmann160-1000its,755,848,2262.613856818,2216.732715707,-93
carcassonne-ucttuned325-vs-ucttuned430-1000its,755,848,2131.93510888,2038.6130943,-93
carcassonne-ucttuned250-vs-ucttuned280-1000its,757,850,2236.337030147,2186.379188157,-93
carcassonne-ucttuned355-vs-ucttuned160-1000its,757,850,2159.141291055,2097.922408797,-93
carcassonne-uct275-vs-uct385-1000its,761,854,2212.979294669,2199.961272199,-93
carcassonne-uct470-vs-uct385-1000its,764,857,2221.756048602,2180.194111881,-93
carcassonne-ucttuned120-vs-ucttuned20-1000its,767,860,2097.250489182,2090.718000234,-93
carcassonne-ucttuned280-vs-ucttuned345-1000its,768,861,2166.532563795,2098.469184823,-93
carcassonne-boltzmann155-vs-boltzmann90-1000its,770,863,2170.109272199,2121.509515055,-93
carcassonne-uct90-vs-uct160-1000its,773,866,2146.12450682,2096.824303866,-93
carcassonne-uct450-vs-uct195-1000its,774,867,2126.57781609,2123.31878682,-93
carcassonne-ucttuned305-vs-ucttuned55-1000its,774,867,2217.207484854,2212.565710337,-93
carcassonne-boltzmann130-vs-boltzmann320-1000its,790,883,2118.339214377,2142.390676427,-93
carcassonne-uct445-vs-uct250-1000its,790,883,2162.712018072,2094.099427318,-93
carcassonne-uct370-vs-uct330-1000its,794,887,2151.675573822,2132.797492551,-93
carcassonne-ucttuned355-vs-ucttuned45-1000its,799,892,2217.252833812,2135.285085712,-93
carcassonne-boltzmann445-vs-boltzmann355-1000its,801,894,2183.647382146,2194.493206898,-93
carcassonne-boltzmann135-vs-boltzmann160-1000its,802,895,2371.032263368,2302.619812102,-93
carcassonne-uct275-vs-uct145-1000its,802,895,2268.321922525,2222.582843754,-93
carcassonne-ucttuned230-vs-ucttuned235-1000its,802,895,2273.026854933,2236.573522917,-93
carcassonne-boltzmann100-vs-boltzmann260-1000its,804,897,2141.353269521,2147.848600492,-93
carcassonne-boltzmann450-vs-boltzmann235-1000its,818,911,2229.335506689,2169.134045227,-93
carcassonne-ucttuned405-vs-ucttuned275-1000its,820,913,2144.91126806,2156.688332664,-93
carcassonne-ucttuned250-vs-ucttuned50-1000its,628,720,1762.664613097,1728.121303621,-92
carcassonne-uct350-vs-uct130-1000its,634,726,1795.524055015,1746.89815688,-92
carcassonne-uct80-vs-uct350-1000its,664,756,2137.752544451,2098.334053276,-92
carcassonne-uct475-vs-uct270-1000its,685,777,2168.759716378,2147.793994243,-92
carcassonne-boltzmann450-vs-boltzmann230-1000its,699,791,2231.47761149,2123.428912852,-92
carcassonne-uct405-vs-uct205-1000its,699,791,2239.642580015,2240.541183669,-92
carcassonne-ucttuned310-vs-ucttuned100-1000its,700,792,2183.090599788,2180.483267708,-92
carcassonne-boltzmann400-vs-boltzmann460-1000its,701,793,2205.141297454,2134.38053892,-92
carcassonne-uct15-vs-uct475-1000its,702,794,2156.157667451,2105.454862798,-92
carcassonne-ucttuned265-vs-ucttuned175-1000its,707,799,2129.244334539,2126.753718655,-92
carcassonne-ucttuned285-vs-ucttuned455-1000its,711,803,2139.116710167,2091.866610834,-92
carcassonne-ucttuned475-vs-ucttuned135-1000its,711,803,2187.639719039,2156.793438101,-92
carcassonne-uct450-vs-uct115-1000its,712,804,2203.678995953,2137.081515584,-92
carcassonne-boltzmann110-vs-boltzmann55-1000its,714,806,2118.309289161,2104.174180041,-92
carcassonne-boltzmann210-vs-boltzmann200-1000its,715,807,2262.372642063,2227.098970832,-92
carcassonne-boltzmann360-vs-boltzmann495-1000its,716,808,2247.089707676,2212.536268362,-92
carcassonne-uct160-vs-uct145-1000its,719,811,2202.663904095,2192.811577694,-92
carcassonne-boltzmann50-vs-boltzmann115-1000its,726,818,2221.741478558,2146.058331931,-92
carcassonne-uct50-vs-uct25-1000its,727,819,2218.582093246,2198.67648345,-92
carcassonne-boltzmann370-vs-boltzmann20-1000its,728,820,2206.954832854,2178.982847737,-92
carcassonne-boltzmann385-vs-boltzmann55-1000its,729,821,2206.496244924,2168.179816043,-92
carcassonne-uct200-vs-uct185-1000its,731,823,2182.267882163,2130.055963511,-92
carcassonne-uct440-vs-uct485-1000its,731,823,2183.433932036,2157.665271002,-92
carcassonne-uct145-vs-uct375-1000its,735,827,2244.546163704,2189.103130041,-92
carcassonne-uct55-vs-uct410-1000its,737,829,2157.72301259,2103.40883522,-92
carcassonne-ucttuned445-vs-ucttuned55-1000its,738,830,2169.930409596,2127.13143246,-92
carcassonne-uct140-vs-uct250-1000its,741,833,2225.9247771,2175.181356232,-92
carcassonne-ucttuned45-vs-ucttuned350-1000its,741,833,2265.426580219,2199.026429069,-92
carcassonne-ucttuned170-vs-ucttuned445-1000its,744,836,2145.607313242,2127.060383153,-92
carcassonne-ucttuned335-vs-ucttuned155-1000its,744,836,2208.377116583,2210.890984124,-92
carcassonne-boltzmann310-vs-boltzmann455-1000its,747,839,2247.165166891,2168.819343634,-92
carcassonne-ucttuned130-vs-ucttuned435-1000its,747,839,2199.536072891,2153.189784551,-92
carcassonne-ucttuned370-vs-ucttuned120-1000its,747,839,2205.600746545,2205.633549712,-92
carcassonne-boltzmann360-vs-boltzmann150-1000its,748,840,2154.330682267,2134.241575429,-92
carcassonne-ucttuned350-vs-ucttuned75-1000its,748,840,2171.349924485,2144.834410589,-92
carcassonne-boltzmann255-vs-boltzmann350-1000its,752,844,2189.681677803,2124.290118726,-92
carcassonne-uct375-vs-uct330-1000its,753,845,2223.738604263,2160.380264143,-92
carcassonne-uct430-vs-uct50-1000its,754,846,2248.232604209,2213.090312095,-92
carcassonne-uct370-vs-uct150-1000its,761,853,2157.139789035,2144.719808052,-92
carcassonne-boltzmann140-vs-boltzmann365-1000its,762,854,2181.458905424,2161.155338489,-92
carcassonne-uct200-vs-uct470-1000its,766,858,2216.273465114,2127.884280632,-92
carcassonne-boltzmann380-vs-boltzmann145-1000its,771,863,2224.418613238,2142.35093678,-92
carcassonne-ucttuned190-vs-ucttuned100-1000its,775,867,2251.544396003,2183.462197562,-92
carcassonne-ucttuned280-vs-ucttuned10-1000its,776,868,2192.497752708,2161.840124455,-92
carcassonne-ucttuned335-vs-ucttuned115-1000its,776,868,2244.322842524,2222.258944604,-92
carcassonne-boltzmann205-vs-boltzmann330-1000its,779,871,2271.109646815,2184.571625458,-92
carcassonne-uct210-vs-uct190-1000its,779,871,2156.062185847,2107.745140345,-92
carcassonne-ucttuned220-vs-ucttuned190-1000its,779,871,2187.19062889,2175.018130925,-92
carcassonne-boltzmann460-vs-boltzmann140-1000its,783,875,2228.043243881,2179.482899705,-92
carcassonne-uct125-vs-uct25-1000its,783,875,2186.683911191,2136.084572476,-92
carcassonne-ucttuned370-vs-ucttuned260-1000its,784,876,2181.780347146,2148.854510969,-92
carcassonne-uct310-vs-uct155-1000its,788,880,2180.214316508,2197.666997997,-92
carcassonne-uct65-vs-uct140-1000its,788,880,2276.153750552,2190.008005277,-92
carcassonne-ucttuned80-vs-ucttuned495-1000its,789,881,2268.716626267,2218.330060356,-92
carcassonne-uct295-vs-uct100-1000its,790,882,2253.80773622,2188.544278713,-92
carcassonne-ucttuned175-vs-ucttuned410-1000its,792,884,2204.691329595,2146.223091781,-92
carcassonne-boltzmann175-vs-boltzmann470-1000its,793,885,2178.393184754,2133.373975194,-92
carcassonne-uct225-vs-uct385-1000its,795,887,2143.955724916,2128.033388476,-92
carcassonne-uct70-vs-uct410-1000its,797,889,2168.348422151,2104.19230571,-92
carcassonne-ucttuned20-vs-ucttuned40-1000its,798,890,2187.285048242,2102.598088499,-92
carcassonne-boltzmann335-vs-boltzmann480-1000its,800,892,2232.812294574,2202.83398097,-92
carcassonne-ucttuned380-vs-ucttuned295-1000its,801,893,2122.245840755,2071.984332545,-92
carcassonne-uct240-vs-uct5-1000its,810,902,2112.070484709,2095.911309691,-92
carcassonne-ucttuned275-vs-ucttuned150-1000its,811,903,2195.474950712,2102.276771025,-92
carcassonne-uct380-vs-uct485-1000its,817,909,2175.655708429,2124.908470118,-92
carcassonne-ucttuned365-vs-ucttuned390-1000its,818,910,2181.354217592,2124.394680269,-92
carcassonne-uct395-vs-uct390-1000its,821,913,2203.625335707,2122.221269861,-92
carcassonne-uct250-vs-uct330-1000its,823,915,2124.900477696,2105.62255867,-92
carcassonne-ucttuned345-vs-ucttuned465-1000its,826,918,2212.168231763,2158.150758518,-92
carcassonne-ucttuned145-vs-ucttuned60-1000its,858,950,2188.404663194,2140.535841674,-92
carcassonne-uct130-vs-uct285-1000its,668,759,2222.071920535,2223.142060022,-91
carcassonne-boltzmann395-vs-boltzmann275-1000its,683,774,2226.45498206,2169.828300775,-91
carcassonne-uct225-vs-uct405-1000its,688,779,2220.922156343,2152.490830687,-91
carcassonne-uct460-vs-uct465-1000its,702,793,2203.743382249,2121.203557485,-91
carcassonne-boltzmann250-vs-boltzmann215-1000its,707,798,2187.786736983,2162.320257114,-91
carcassonne-uct360-vs-uct395-1000its,709,800,2161.407960082,2092.855654235,-91
carcassonne-ucttuned130-vs-ucttuned285-1000its,709,800,2188.712448616,2107.384469174,-91
carcassonne-boltzmann330-vs-boltzmann205-1000its,715,806,2262.905884428,2178.666162152,-91
carcassonne-ucttuned300-vs-ucttuned405-1000its,715,806,2230.538755102,2220.676860052,-91
carcassonne-ucttuned315-vs-ucttuned155-1000its,720,811,2167.341745155,2129.138626535,-91
carcassonne-boltzmann425-vs-boltzmann45-1000its,726,817,2215.460078002,2194.35429057,-91
carcassonne-uct195-vs-uct10-1000its,729,820,2148.399318079,2078.591345245,-91
carcassonne-boltzmann195-vs-boltzmann65-1000its,737,828,2186.183287736,2143.342852197,-91
carcassonne-boltzmann350-vs-boltzmann45-1000its,739,830,2175.270385657,2118.177043015,-91
carcassonne-uct480-vs-uct210-1000its,739,830,2188.154608381,2145.758186953,-91
carcassonne-ucttuned180-vs-ucttuned195-1000its,739,830,2165.980635497,2134.380884491,-91
carcassonne-uct295-vs-uct335-1000its,742,833,2121.687538728,2120.476207798,-91
carcassonne-uct140-vs-uct165-1000its,743,834,2207.711875516,2161.457161304,-91
carcassonne-uct190-vs-uct370-1000its,746,837,2309.530888124,2247.484980743,-91
carcassonne-ucttuned240-vs-ucttuned320-1000its,749,840,2160.976447818,2111.898161379,-91
carcassonne-boltzmann65-vs-boltzmann160-1000its,751,842,2185.461778015,2145.470196134,-91
carcassonne-ucttuned215-vs-ucttuned145-1000its,752,843,2221.159769085,2159.586357906,-91
carcassonne-boltzmann295-vs-boltzmann280-1000its,754,845,2151.228027221,2125.952974729,-91
carcassonne-boltzmann145-vs-boltzmann160-1000its,756,847,2240.349245219,2198.097839132,-91
carcassonne-uct340-vs-uct110-1000its,758,849,2201.086110716,2161.323331875,-91
carcassonne-uct445-vs-uct350-1000its,759,850,2140.295835702,2100.332038807,-91
carcassonne-uct355-vs-uct185-1000its,760,851,2212.014018903,2151.65977438,-91
carcassonne-boltzmann375-vs-boltzmann25-1000its,763,854,2203.915667843,2118.742705678,-91
carcassonne-ucttuned360-vs-ucttuned120-1000its,763,854,2213.096667376,2124.940504646,-91
carcassonne-boltzmann5-vs-boltzmann110-1000its,769,860,2298.407764589,2200.652454526,-91
carcassonne-uct105-vs-uct185-1000its,771,862,2235.627330422,2177.214795534,-91
carcassonne-uct205-vs-uct180-1000its,773,864,2192.133784442,2139.518506601,-91
carcassonne-uct320-vs-uct440-1000its,774,865,2244.127712631,2149.626299977,-91
carcassonne-ucttuned155-vs-ucttuned90-1000its,777,868,2196.92211961,2154.439069027,-91
carcassonne-ucttuned475-vs-ucttuned315-1000its,777,868,2280.762073262,2239.096445786,-91
carcassonne-ucttuned170-vs-ucttuned125-1000its,778,869,2170.481349866,2145.52319831,-91
carcassonne-ucttuned480-vs-ucttuned420-1000its,781,872,2146.382888149,2123.959074441,-91
carcassonne-boltzmann390-vs-boltzmann245-1000its,782,873,2231.023499257,2194.579541955,-91
carcassonne-ucttuned170-vs-ucttuned80-1000its,782,873,2139.41314816,2108.401913603,-91
carcassonne-boltzmann380-vs-boltzmann80-1000its,785,876,2216.745473187,2170.343747971,-91
carcassonne-ucttuned60-vs-ucttuned255-1000its,785,876,2221.384570437,2122.202669692,-91
carcassonne-ucttuned90-vs-ucttuned470-1000its,785,876,2183.770588696,2132.580204287,-91
carcassonne-uct325-vs-uct155-1000its,788,879,2178.958837384,2146.187349435,-91
carcassonne-boltzmann120-vs-boltzmann25-1000its,790,881,2242.157686336,2164.753335097,-91
carcassonne-uct380-vs-uct245-1000its,790,881,2135.735813031,2122.560373925,-91
carcassonne-ucttuned300-vs-ucttuned235-1000its,793,884,2177.715674601,2142.833075395,-91
carcassonne-boltzmann15-vs-boltzmann455-1000its,794,885,2219.002604075,2152.811100753,-91
carcassonne-boltzmann220-vs-boltzmann5-1000its,797,888,2201.103223494,2198.707823233,-91
carcassonne-uct420-vs-uct215-1000its,797,888,2153.06758916,2134.237155191,-91
carcassonne-ucttuned295-vs-ucttuned440-1000its,798,889,2182.737670134,2119.48622481,-91
carcassonne-uct200-vs-uct365-1000its,810,901,2226.408676406,2201.256592297,-91
carcassonne-uct140-vs-uct85-1000its,814,905,2200.838014314,2136.182397667,-91
carcassonne-ucttuned260-vs-ucttuned185-1000its,818,909,2267.999386352,2208.042966121,-91
carcassonne-ucttuned85-vs-ucttuned25-1000its,842,933,2184.414077892,2137.53843963,-91
carcassonne-ucttuned195-vs-ucttuned50-1000its,859,950,2244.576262153,2185.951909873,-91
carcassonne-boltzmann140-vs-boltzmann95-1000its,682,772,2114.735667809,2104.783708331,-90
carcassonne-boltzmann365-vs-boltzmann420-1000its,683,773,2193.082940126,2116.393800537,-90
carcassonne-uct385-vs-uct205-1000its,689,779,2179.69378253,2106.720893548,-90
carcassonne-uct150-vs-uct10-1000its,691,781,2158.769875445,2115.50903094,-90
carcassonne-boltzmann185-vs-boltzmann275-1000its,696,786,2188.559779496,2156.909276544,-90
carcassonne-boltzmann410-vs-boltzmann445-1000its,701,791,2153.449504863,2116.690870554,-90
carcassonne-uct185-vs-uct20-1000its,702,792,2251.426549601,2178.766255584,-90
carcassonne-boltzmann270-vs-boltzmann335-1000its,713,803,2163.853019168,2103.992385194,-90
carcassonne-ucttuned75-vs-ucttuned485-1000its,713,803,2235.683246348,2177.727233006,-90
carcassonne-boltzmann290-vs-boltzmann460-1000its,717,807,2220.034041505,2200.410329365,-90
carcassonne-uct400-vs-uct5-1000its,720,810,2322.218188092,2295.972865665,-90
carcassonne-ucttuned130-vs-ucttuned10-1000its,722,812,2212.474460366,2207.579813486,-90
carcassonne-ucttuned170-vs-ucttuned425-1000its,722,812,2238.111494262,2196.190152182,-90
carcassonne-uct340-vs-uct105-1000its,724,814,2150.937244294,2132.953533192,-90
carcassonne-ucttuned445-vs-ucttuned270-1000its,727,817,2152.931863733,2133.707459148,-90
carcassonne-uct330-vs-uct45-1000its,736,826,2220.318085484,2167.005467349,-90
carcassonne-ucttuned355-vs-ucttuned150-1000its,739,829,2222.055066032,2142.771218812,-90
carcassonne-boltzmann45-vs-boltzmann275-1000its,740,830,2236.343754251,2165.680392548,-90
carcassonne-boltzmann105-vs-boltzmann180-1000its,741,831,2199.064880787,2190.134638991,-90
carcassonne-boltzmann145-vs-boltzmann440-1000its,742,832,2189.526700531,2163.980630136,-90
carcassonne-uct70-vs-uct220-1000its,743,833,2235.404772162,2142.326595827,-90
carcassonne-boltzmann280-vs-boltzmann395-1000its,745,835,2178.009522334,2077.722373215,-90
carcassonne-boltzmann65-vs-boltzmann480-1000its,745,835,2159.034559003,2117.983380098,-90
carcassonne-ucttuned465-vs-ucttuned405-1000its,746,836,2140.075468753,2095.942719611,-90
carcassonne-uct170-vs-uct150-1000its,747,837,2143.342443759,2116.383372003,-90
carcassonne-uct370-vs-uct25-1000its,747,837,2193.894209477,2109.141271934,-90
carcassonne-uct405-vs-uct495-1000its,749,839,2174.809337454,2137.98146281,-90
carcassonne-uct170-vs-uct140-1000its,751,841,2167.772133245,2138.565034401,-90
carcassonne-uct110-vs-uct305-1000its,752,842,2230.115661919,2204.053462758,-90
carcassonne-uct445-vs-uct255-1000its,752,842,2201.237981043,2172.740032706,-90
carcassonne-uct125-vs-uct90-1000its,754,844,2240.209539665,2187.669003502,-90
carcassonne-uct130-vs-uct340-1000its,755,845,2241.304980256,2194.451125327,-90
carcassonne-uct125-vs-uct120-1000its,756,846,2142.811623274,2093.140131423,-90
carcassonne-uct325-vs-uct35-1000its,758,848,2243.610512022,2172.597144063,-90
carcassonne-ucttuned400-vs-ucttuned125-1000its,761,851,2189.330605071,2150.201839642,-90
carcassonne-boltzmann275-vs-boltzmann495-1000its,762,852,2167.366547453,2121.246701875,-90
carcassonne-uct335-vs-uct325-1000its,762,852,2252.330573403,2192.052967073,-90
carcassonne-uct395-vs-uct455-1000its,766,856,2182.369032742,2114.623777832,-90
carcassonne-uct30-vs-uct350-1000its,768,858,2220.17918038,2207.459999219,-90
carcassonne-boltzmann315-vs-boltzmann170-1000its,771,861,2203.637578366,2150.731526945,-90
carcassonne-uct255-vs-uct440-1000its,777,867,2214.101041492,2133.191481589,-90
carcassonne-boltzmann335-vs-boltzmann115-1000its,778,868,2240.37563103,2179.88737069,-90
carcassonne-ucttuned285-vs-ucttuned450-1000its,781,871,2252.635877813,2206.144118018,-90
carcassonne-ucttuned365-vs-ucttuned30-1000its,783,873,2185.098096153,2144.569049753,-90
carcassonne-uct140-vs-uct300-1000its,789,879,2217.420123851,2191.700946843,-90
carcassonne-uct65-vs-uct25-1000its,790,880,2200.453343666,2171.059872533,-90
carcassonne-uct430-vs-uct10-1000its,793,883,2148.587171763,2168.721671155,-90
carcassonne-uct140-vs-uct195-1000its,795,885,2140.551360382,2125.808584866,-90
carcassonne-uct35-vs-uct405-1000its,795,885,2201.270858262,2142.882400739,-90
carcassonne-ucttuned45-vs-ucttuned320-1000its,806,896,2273.666390225,2203.721081203,-90
carcassonne-ucttuned35-vs-ucttuned215-1000its,807,897,2231.171934422,2179.955833356,-90
carcassonne-boltzmann300-vs-boltzmann405-1000its,815,905,2227.76098296,2179.180880276,-90
carcassonne-uct105-vs-uct415-1000its,821,911,2161.472668514,2099.088523081,-90
carcassonne-uct250-vs-uct105-1000its,825,915,2202.599501342,2210.045075369,-90
carcassonne-boltzmann70-vs-boltzmann190-1000its,844,934,2179.395803406,2144.282207482,-90
carcassonne-ucttuned350-vs-ucttuned150-1000its,853,943,2205.366111911,2186.414858093,-90
carcassonne-boltzmann255-vs-boltzmann215-1000its,855,945,2211.946538922,2170.074233813,-90
carcassonne-boltzmann200-vs-boltzmann105-1000its,682,771,2189.691590361,2151.850496186,-89
carcassonne-uct55-vs-uct60-1000its,685,774,2150.707340969,2145.224687398,-89
carcassonne-uct435-vs-uct155-1000its,693,782,2262.03303605,2175.123504543,-89
carcassonne-uct310-vs-uct150-1000its,696,785,2123.497292933,2100.535974394,-89
carcassonne-boltzmann370-vs-boltzmann270-1000its,709,798,2119.374466259,2103.514515126,-89
carcassonne-ucttuned40-vs-ucttuned185-1000its,709,798,2161.52318218,2108.494569311,-89
carcassonne-boltzmann70-vs-boltzmann340-1000its,711,800,2178.330568047,2130.863246505,-89
carcassonne-ucttuned265-vs-ucttuned345-1000its,712,801,2277.605490698,2212.451923323,-89
carcassonne-boltzmann230-vs-boltzmann80-1000its,716,805,2168.926311654,2133.748601412,-89
carcassonne-boltzmann430-vs-boltzmann315-1000its,717,806,2138.46430967,2070.97317217,-89
carcassonne-uct355-vs-uct415-1000its,720,809,2213.281998616,2175.424751018,-89
carcassonne-ucttuned475-vs-ucttuned485-1000its,720,809,2142.766603145,2121.646335833,-89
carcassonne-boltzmann370-vs-boltzmann465-1000its,721,810,2219.114336171,2132.330898836,-89
carcassonne-ucttuned90-vs-ucttuned315-1000its,721,810,2233.823212062,2202.929446726,-89
carcassonne-uct385-vs-uct50-1000its,724,813,2169.375129792,2078.700476644,-89
carcassonne-boltzmann205-vs-boltzmann105-1000its,728,817,2193.232161018,2153.475576848,-89
carcassonne-boltzmann165-vs-boltzmann435-1000its,729,818,2153.154595225,2110.259461615,-89
carcassonne-uct190-vs-uct465-1000its,732,821,2273.66877905,2175.351763779,-89
carcassonne-boltzmann175-vs-boltzmann450-1000its,738,827,2239.278457231,2168.501364697,-89
carcassonne-uct160-vs-uct345-1000its,738,827,2195.438235365,2146.092314645,-89
carcassonne-uct135-vs-uct425-1000its,743,832,2233.448401753,2211.055853956,-89
carcassonne-boltzmann375-vs-boltzmann350-1000its,747,836,2089.442504192,2097.490002408,-89
carcassonne-ucttuned145-vs-ucttuned70-1000its,748,837,2125.50779234,2092.2538409,-89
carcassonne-boltzmann430-vs-boltzmann440-1000its,750,839,2157.13589299,2126.184065642,-89
carcassonne-boltzmann300-vs-boltzmann105-1000its,753,842,2158.429942077,2091.227605607,-89
carcassonne-uct45-vs-uct40-1000its,754,843,2193.573258463,2179.68977199,-89
carcassonne-ucttuned125-vs-ucttuned65-1000its,754,843,2163.868679887,2143.048955701,-89
carcassonne-ucttuned160-vs-ucttuned90-1000its,755,844,2171.062017328,2128.206469308,-89
carcassonne-ucttuned345-vs-ucttuned445-1000its,756,845,2241.123987538,2223.121691842,-89
carcassonne-uct350-vs-uct125-1000its,758,847,2226.008114449,2141.334207416,-89
carcassonne-ucttuned440-vs-ucttuned45-1000its,758,847,2139.413980055,2095.317390729,-89
carcassonne-ucttuned455-vs-ucttuned335-1000its,758,847,2258.880505397,2177.686691142,-89
carcassonne-uct265-vs-uct255-1000its,759,848,2164.445631721,2109.649368827,-89
carcassonne-ucttuned300-vs-ucttuned260-1000its,760,849,2202.902195383,2100.481504247,-89
carcassonne-boltzmann410-vs-boltzmann185-1000its,761,850,2179.380973532,2157.24223072,-89
carcassonne-uct220-vs-uct385-1000its,761,850,2216.95436436,2145.487561387,-89
carcassonne-ucttuned385-vs-ucttuned20-1000its,761,850,2178.288363696,2158.547392956,-89
carcassonne-uct440-vs-uct140-1000its,762,851,2210.428802689,2142.053319387,-89
carcassonne-ucttuned15-vs-ucttuned465-1000its,765,854,2186.485532513,2081.241769076,-89
carcassonne-uct235-vs-uct10-1000its,768,857,2199.914024399,2159.355481106,-89
carcassonne-uct75-vs-uct330-1000its,771,860,2198.212554874,2142.164511787,-89
carcassonne-boltzmann255-vs-boltzmann225-1000its,775,864,2190.043809219,2147.786220957,-89
carcassonne-uct245-vs-uct235-1000its,776,865,2258.753160816,2195.014603711,-89
carcassonne-uct460-vs-uct450-1000its,777,866,2151.967063952,2126.481829876,-89
carcassonne-uct110-vs-uct420-1000its,784,873,2191.872303865,2115.625981903,-89
carcassonne-uct195-vs-uct300-1000its,784,873,2218.779367897,2177.628628922,-89
carcassonne-ucttuned200-vs-ucttuned485-1000its,784,873,2284.201252197,2202.299434131,-89
carcassonne-boltzmann335-vs-boltzmann125-1000its,785,874,2173.357311557,2137.959533231,-89
carcassonne-ucttuned40-vs-ucttuned380-1000its,785,874,2186.043792292,2127.341204113,-89
carcassonne-ucttuned125-vs-ucttuned330-1000its,787,876,2185.883653724,2190.190623509,-89
carcassonne-uct390-vs-uct245-1000its,788,877,2157.451675465,2113.214702273,-89
carcassonne-ucttuned475-vs-ucttuned160-1000its,789,878,2213.205033641,2193.759660497,-89
carcassonne-ucttuned150-vs-ucttuned80-1000its,790,879,2155.46519606,2086.594831161,-89
carcassonne-uct365-vs-uct420-1000its,797,886,2187.044288449,2129.519513307,-89
carcassonne-ucttuned405-vs-ucttuned135-1000its,800,889,2211.228527028,2126.935455007,-89
carcassonne-ucttuned495-vs-ucttuned180-1000its,800,889,2272.518471357,2208.871541175,-89
carcassonne-boltzmann135-vs-boltzmann185-1000its,801,890,2146.290037022,2113.747206216,-89
carcassonne-ucttuned350-vs-ucttuned415-1000its,802,891,2163.674414102,2127.767084835,-89
carcassonne-ucttuned405-vs-ucttuned30-1000its,802,891,2156.287002169,2122.809393286,-89
carcassonne-uct10-vs-uct245-1000its,805,894,2239.980378366,2158.123904499,-89
carcassonne-boltzmann440-vs-boltzmann95-1000its,806,895,2215.749643921,2152.353093884,-89
carcassonne-uct485-vs-uct40-1000its,809,898,2253.845055033,2146.19864056,-89
carcassonne-ucttuned230-vs-ucttuned20-1000its,810,899,2216.593117965,2174.865630166,-89
carcassonne-uct365-vs-uct285-1000its,811,900,2183.553245363,2155.58676734,-89
carcassonne-ucttuned90-vs-ucttuned160-1000its,813,902,2157.68843987,2078.396491411,-89
carcassonne-ucttuned425-vs-ucttuned290-1000its,816,905,2202.075251827,2175.412718544,-89
carcassonne-boltzmann285-vs-boltzmann40-1000its,818,907,2165.123863417,2091.488093831,-89
carcassonne-boltzmann345-vs-boltzmann50-1000its,821,910,2122.396782019,2083.586843834,-89
carcassonne-uct20-vs-uct285-1000its,826,915,2246.654005026,2211.334152026,-89
carcassonne-boltzmann360-vs-boltzmann190-1000its,828,917,2193.329140917,2164.407232939,-89
carcassonne-uct205-vs-uct450-1000its,828,917,2262.265621696,2207.906841514,-89
carcassonne-ucttuned55-vs-ucttuned485-1000its,840,929,2263.594309666,2203.286206749,-89
carcassonne-ucttuned325-vs-ucttuned10-1000its,851,940,2180.895601437,2149.279294721,-89
carcassonne-uct395-vs-uct495-1000its,682,770,2222.373139002,2177.469322007,-88
carcassonne-uct495-vs-uct135-1000its,683,771,2253.35239939,2185.15998295,-88
carcassonne-boltzmann135-vs-boltzmann65-1000its,687,775,2152.901516489,2091.226964577,-88
carcassonne-uct435-vs-uct485-1000its,702,790,2262.449069698,2184.083360358,-88
carcassonne-boltzmann285-vs-boltzmann45-1000its,708,796,2151.920993721,2149.887015922,-88
carcassonne-boltzmann140-vs-boltzmann185-1000its,710,798,2171.74182838,2110.057811094,-88
carcassonne-boltzmann310-vs-boltzmann140-1000its,714,802,2250.723472314,2239.993907488,-88
carcassonne-boltzmann50-vs-boltzmann25-1000its,717,805,2146.966642011,2122.794360448,-88
carcassonne-ucttuned170-vs-ucttuned410-1000its,718,806,2194.541110219,2163.370222205,-88
carcassonne-boltzmann340-vs-boltzmann255-1000its,721,809,2267.212559714,2233.672595325,-88
carcassonne-uct145-vs-uct45-1000its,722,810,2152.887353862,2111.583978212,-88
carcassonne-uct45-vs-uct245-1000its,722,810,2239.418313174,2234.723542939,-88
carcassonne-uct170-vs-uct475-1000its,723,811,2205.496494586,2210.701084758,-88
carcassonne-boltzmann440-vs-boltzmann135-1000its,724,812,2144.653536762,2096.152709991,-88
carcassonne-boltzmann480-vs-boltzmann130-1000its,726,814,2157.311721714,2127.956389019,-88
carcassonne-ucttuned210-vs-ucttuned65-1000its,726,814,2151.416853557,2110.583234832,-88
carcassonne-uct115-vs-uct205-1000its,727,815,2228.032664453,2162.709097323,-88
carcassonne-ucttuned75-vs-ucttuned50-1000its,727,815,2275.820899521,2199.908013463,-88
carcassonne-uct110-vs-uct215-1000its,728,816,2234.30057082,2187.543716887,-88
carcassonne-ucttuned375-vs-ucttuned230-1000its,728,816,2186.189892316,2128.239954529,-88
carcassonne-boltzmann165-vs-boltzmann280-1000its,729,817,2172.910768351,2138.690614236,-88
carcassonne-boltzmann285-vs-boltzmann230-1000its,729,817,2178.256669771,2158.899222123,-88
carcassonne-uct20-vs-uct490-1000its,729,817,2122.108897374,2079.788680067,-88
carcassonne-ucttuned325-vs-ucttuned80-1000its,730,818,2202.626956979,2159.463139259,-88
carcassonne-boltzmann115-vs-boltzmann495-1000its,731,819,2217.416452908,2177.13801209,-88
carcassonne-uct305-vs-uct90-1000its,731,819,2142.15400162,2124.1114568,-88
carcassonne-uct175-vs-uct180-1000its,734,822,2191.736160635,2151.569890697,-88
carcassonne-boltzmann230-vs-boltzmann345-1000its,736,824,2226.182731572,2191.63900681,-88
carcassonne-ucttuned320-vs-ucttuned470-1000its,738,826,2196.162761441,2132.517670924,-88
carcassonne-boltzmann60-vs-boltzmann5-1000its,740,828,2238.26540798,2194.614344676,-88
carcassonne-uct345-vs-uct475-1000its,740,828,2113.313847701,2130.381534117,-88
carcassonne-ucttuned110-vs-ucttuned410-1000its,743,831,2282.426486211,2286.201978552,-88
carcassonne-boltzmann50-vs-boltzmann10-1000its,746,834,2251.804343454,2190.507470001,-88
carcassonne-uct100-vs-uct230-1000its,746,834,2208.326460104,2186.521548275,-88
carcassonne-boltzmann240-vs-boltzmann415-1000its,747,835,2229.412747698,2201.340916952,-88
carcassonne-ucttuned180-vs-ucttuned430-1000its,747,835,2186.093141251,2110.549962435,-88
carcassonne-boltzmann165-vs-boltzmann250-1000its,748,836,2237.020755068,2217.706689823,-88
carcassonne-boltzmann320-vs-boltzmann60-1000its,750,838,2161.348338751,2114.468282206,-88
carcassonne-boltzmann90-vs-boltzmann240-1000its,750,838,2149.140865946,2103.554389251,-88
carcassonne-boltzmann390-vs-boltzmann255-1000its,754,842,2245.13647155,2217.472807307,-88
carcassonne-ucttuned150-vs-ucttuned45-1000its,754,842,2163.963080036,2157.45533583,-88
carcassonne-ucttuned440-vs-ucttuned80-1000its,754,842,2212.446661969,2201.245808562,-88
carcassonne-boltzmann225-vs-boltzmann420-1000its,757,845,2205.616587054,2121.306107232,-88
carcassonne-uct85-vs-uct155-1000its,758,846,2177.403483832,2194.42496433,-88
carcassonne-boltzmann400-vs-boltzmann195-1000its,759,847,2257.345186756,2231.429472362,-88
carcassonne-uct70-vs-uct465-1000its,760,848,2196.676928784,2129.829461629,-88
carcassonne-uct370-vs-uct30-1000its,764,852,2182.292542629,2173.400317262,-88
carcassonne-ucttuned395-vs-ucttuned115-1000its,765,853,2188.164965669,2164.015750146,-88
carcassonne-uct170-vs-uct115-1000its,767,855,2189.567220561,2129.338558749,-88
carcassonne-uct495-vs-uct465-1000its,770,858,2182.908756807,2094.417424241,-88
carcassonne-ucttuned320-vs-ucttuned175-1000its,771,859,2123.46406255,2097.545571941,-88
carcassonne-ucttuned185-vs-ucttuned250-1000its,774,862,2183.976883106,2121.428325599,-88
carcassonne-uct135-vs-uct100-1000its,776,864,2157.769690785,2143.893649886,-88
carcassonne-boltzmann40-vs-boltzmann315-1000its,777,865,2154.463121906,2087.236591616,-88
carcassonne-ucttuned80-vs-ucttuned160-1000its,782,870,2213.294578197,2163.35439805,-88
carcassonne-ucttuned350-vs-ucttuned455-1000its,784,872,2190.359135967,2133.228642468,-88
carcassonne-ucttuned270-vs-ucttuned145-1000its,785,873,2197.179408991,2100.146163517,-88
carcassonne-uct150-vs-uct185-1000its,788,876,2093.760889608,2075.131734544,-88
carcassonne-ucttuned390-vs-ucttuned225-1000its,791,879,2144.811643783,2098.894641642,-88
carcassonne-ucttuned40-vs-ucttuned245-1000its,791,879,2248.874221954,2152.013336465,-88
carcassonne-ucttuned360-vs-ucttuned225-1000its,792,880,2218.176489427,2155.524564405,-88
carcassonne-ucttuned495-vs-ucttuned190-1000its,796,884,2145.661790117,2133.411244342,-88
carcassonne-boltzmann345-vs-boltzmann200-1000its,797,885,2212.636527307,2136.692224336,-88
carcassonne-uct395-vs-uct445-1000its,799,887,2212.731831206,2202.838633439,-88
carcassonne-uct160-vs-uct450-1000its,800,888,2201.379436865,2215.355345357,-88
carcassonne-ucttuned160-vs-ucttuned200-1000its,807,895,2170.325685103,2150.541254353,-88
carcassonne-ucttuned480-vs-ucttuned45-1000its,808,896,2176.941839404,2177.596271196,-88
carcassonne-ucttuned310-vs-ucttuned10-1000its,809,897,2155.347145893,2106.408780599,-88
carcassonne-ucttuned485-vs-ucttuned175-1000its,814,902,2265.166667575,2246.790798583,-88
carcassonne-boltzmann395-vs-boltzmann80-1000its,815,903,2138.14491936,2112.408425317,-88
carcassonne-boltzmann395-vs-boltzmann40-1000its,818,906,2187.363391266,2215.94845328,-88
carcassonne-ucttuned90-vs-ucttuned310-1000its,822,910,2206.989964227,2133.729578014,-88
carcassonne-ucttuned455-vs-ucttuned400-1000its,824,912,2191.857488144,2160.430650478,-88
carcassonne-ucttuned475-vs-ucttuned295-1000its,825,913,2202.447454453,2176.469985338,-88
carcassonne-uct240-vs-uct40-1000its,845,933,2261.512747537,2202.22275162,-88
carcassonne-ucttuned155-vs-ucttuned70-1000its,866,954,2132.033033565,2111.945393801,-88
carcassonne-boltzmann445-vs-boltzmann360-1000its,683,770,2161.397733015,2132.175944806,-87
carcassonne-boltzmann475-vs-boltzmann490-1000its,695,782,2188.422303571,2148.944891964,-87
carcassonne-boltzmann120-vs-boltzmann215-1000its,703,790,2208.699594635,2195.363690069,-87
carcassonne-uct295-vs-uct440-1000its,703,790,2159.513375164,2156.306231771,-87
carcassonne-uct425-vs-uct295-1000its,709,796,2138.686907836,2134.588634437,-87
carcassonne-boltzmann265-vs-boltzmann190-1000its,710,797,2221.238201432,2178.150831779,-87
carcassonne-ucttuned330-vs-ucttuned350-1000its,710,797,2224.021451936,2177.659878942,-87
carcassonne-boltzmann455-vs-boltzmann405-1000its,714,801,2196.471503044,2158.937794136,-87
carcassonne-ucttuned345-vs-ucttuned160-1000its,718,805,2202.821876558,2145.870969979,-87
carcassonne-uct100-vs-uct250-1000its,721,808,2248.413505775,2189.17957817,-87
carcassonne-uct375-vs-uct210-1000its,721,808,2260.133654371,2211.573886057,-87
carcassonne-boltzmann395-vs-boltzmann165-1000its,730,817,2176.548786141,2161.424983496,-87
carcassonne-ucttuned155-vs-ucttuned320-1000its,730,817,2179.292021619,2161.757351178,-87
carcassonne-ucttuned470-vs-ucttuned405-1000its,730,817,2207.806479083,2182.301283096,-87
carcassonne-ucttuned365-vs-ucttuned95-1000its,731,818,2225.23388574,2188.246307756,-87
carcassonne-ucttuned360-vs-ucttuned395-1000its,732,819,2158.148846048,2112.79263127,-87
carcassonne-ucttuned110-vs-ucttuned65-1000its,733,820,2125.798237169,2083.37954808,-87
carcassonne-boltzmann230-vs-boltzmann45-1000its,734,821,2158.804265101,2169.244710536,-87
carcassonne-boltzmann310-vs-boltzmann125-1000its,734,821,2157.040816298,2068.635224008,-87
carcassonne-uct365-vs-uct110-1000its,736,823,2143.122125986,2102.908585512,-87
carcassonne-boltzmann320-vs-boltzmann250-1000its,737,824,2197.137230838,2140.181345922,-87
carcassonne-boltzmann260-vs-boltzmann140-1000its,738,825,2222.137832913,2167.402146179,-87
carcassonne-ucttuned140-vs-ucttuned455-1000its,742,829,2187.377449751,2117.774799839,-87
carcassonne-boltzmann330-vs-boltzmann20-1000its,749,836,2162.113616232,2160.064925146,-87
carcassonne-boltzmann60-vs-boltzmann90-1000its,749,836,2227.678918154,2227.875975088,-87
carcassonne-ucttuned70-vs-ucttuned110-1000its,749,836,2168.629879926,2102.925741096,-87
carcassonne-boltzmann25-vs-boltzmann245-1000its,750,837,2192.069272564,2110.150210796,-87
carcassonne-uct490-vs-uct325-1000its,752,839,2269.290829269,2242.979361485,-87
carcassonne-uct225-vs-uct105-1000its,753,840,2240.98875084,2184.3652284,-87
carcassonne-boltzmann290-vs-boltzmann260-1000its,756,843,2169.426204454,2152.529516919,-87
carcassonne-ucttuned480-vs-ucttuned5-1000its,756,843,2170.410696666,2135.388841251,-87
carcassonne-boltzmann20-vs-boltzmann400-1000its,759,846,2167.820896862,2094.842549495,-87
carcassonne-boltzmann200-vs-boltzmann120-1000its,760,847,2204.158485366,2166.239066291,-87
carcassonne-uct285-vs-uct55-1000its,760,847,2130.714597234,2143.204230172,-87
carcassonne-ucttuned490-vs-ucttuned150-1000its,761,848,2236.55526275,2223.446204803,-87
carcassonne-ucttuned105-vs-ucttuned480-1000its,762,849,2181.66560091,2180.456306515,-87
carcassonne-boltzmann430-vs-boltzmann260-1000its,764,851,2208.670686169,2142.492299955,-87
carcassonne-ucttuned395-vs-ucttuned5-1000its,764,851,2173.741416,2129.768817675,-87
carcassonne-ucttuned270-vs-ucttuned60-1000its,766,853,2219.882963926,2176.033531896,-87
carcassonne-uct365-vs-uct230-1000its,768,855,2243.299677943,2189.391677491,-87
carcassonne-uct180-vs-uct470-1000its,769,856,2122.858912009,2085.709420915,-87
carcassonne-uct455-vs-uct230-1000its,769,856,2270.609929748,2176.19586105,-87
carcassonne-ucttuned220-vs-ucttuned180-1000its,769,856,2263.37769671,2212.676560585,-87
carcassonne-boltzmann295-vs-boltzmann215-1000its,771,858,2166.29258814,2112.489024628,-87
carcassonne-ucttuned240-vs-ucttuned210-1000its,777,864,2217.586629228,2175.909247379,-87
carcassonne-boltzmann165-vs-boltzmann325-1000its,778,865,2163.233030308,2131.182931171,-87
carcassonne-uct125-vs-uct245-1000its,778,865,2278.095413645,2161.785002598,-87
carcassonne-uct380-vs-uct475-1000its,779,866,2271.430708888,2203.797466132,-87
carcassonne-boltzmann455-vs-boltzmann150-1000its,780,867,2271.067241878,2179.118227481,-87
carcassonne-ucttuned485-vs-ucttuned415-1000its,781,868,2107.602326839,2093.826681855,-87
carcassonne-uct405-vs-uct75-1000its,782,869,2204.246059686,2224.954140701,-87
carcassonne-ucttuned180-vs-ucttuned20-1000its,786,873,2123.632725811,2059.361350604,-87
carcassonne-ucttuned70-vs-ucttuned270-1000its,787,874,2220.426413258,2201.126527985,-87
carcassonne-uct60-vs-uct495-1000its,789,876,2222.440376319,2182.956967975,-87
carcassonne-uct150-vs-uct55-1000its,790,877,2118.149531491,2116.548177829,-87
carcassonne-ucttuned495-vs-ucttuned455-1000its,790,877,2162.516765422,2177.641850073,-87
carcassonne-boltzmann420-vs-boltzmann275-1000its,796,883,2296.338329938,2235.202125025,-87
carcassonne-boltzmann340-vs-boltzmann160-1000its,798,885,2219.823348772,2184.196083959,-87
carcassonne-ucttuned360-vs-ucttuned300-1000its,798,885,2198.549744937,2147.350923832,-87
carcassonne-ucttuned100-vs-ucttuned320-1000its,805,892,2123.42616853,2106.94836338,-87
carcassonne-ucttuned410-vs-ucttuned130-1000its,809,896,2169.672174499,2124.160670279,-87
carcassonne-ucttuned440-vs-ucttuned120-1000its,810,897,2164.572635025,2080.312855429,-87
carcassonne-ucttuned80-vs-ucttuned460-1000its,814,901,2207.675105089,2206.786855655,-87
carcassonne-boltzmann105-vs-boltzmann325-1000its,819,906,2225.260092093,2165.473944079,-87
carcassonne-boltzmann345-vs-boltzmann55-1000its,819,906,2219.02467892,2173.400609957,-87
carcassonne-uct460-vs-uct335-1000its,820,907,2218.391253131,2180.422879622,-87
carcassonne-uct375-vs-uct445-1000its,821,908,2263.835974971,2220.622599174,-87
carcassonne-ucttuned405-vs-ucttuned5-1000its,822,909,2163.901940125,2103.761181018,-87
carcassonne-ucttuned170-vs-ucttuned140-1000its,825,912,2076.842583273,2057.842419962,-87
carcassonne-boltzmann225-vs-boltzmann270-1000its,682,768,2215.372126116,2159.226280988,-86
carcassonne-boltzmann400-vs-boltzmann200-1000its,692,778,2258.316594466,2234.728103176,-86
carcassonne-boltzmann335-vs-boltzmann465-1000its,716,802,2153.786286778,2116.979264614,-86
carcassonne-ucttuned350-vs-ucttuned310-1000its,716,802,2243.997363732,2216.294877104,-86
carcassonne-uct40-vs-uct425-1000its,721,807,2211.421440785,2164.48698835,-86
carcassonne-boltzmann95-vs-boltzmann275-1000its,724,810,2243.247869095,2207.760450318,-86
carcassonne-ucttuned30-vs-ucttuned390-1000its,724,810,2261.576834584,2253.052354031,-86
carcassonne-boltzmann175-vs-boltzmann410-1000its,729,815,2157.213079573,2123.721483265,-86
carcassonne-boltzmann105-vs-boltzmann405-1000its,732,818,2163.960474856,2146.101961947,-86
carcassonne-boltzmann160-vs-boltzmann255-1000its,733,819,2244.14972191,2242.640908078,-86
carcassonne-boltzmann280-vs-boltzmann385-1000its,735,821,2163.1795244,2144.017397507,-86
carcassonne-ucttuned415-vs-ucttuned265-1000its,746,832,2148.137383462,2115.797465008,-86
carcassonne-ucttuned255-vs-ucttuned95-1000its,750,836,2163.012078058,2090.728705185,-86
carcassonne-ucttuned280-vs-ucttuned130-1000its,750,836,2194.275548704,2150.736220577,-86
carcassonne-boltzmann325-vs-boltzmann55-1000its,751,837,2158.648668816,2100.427464344,-86
carcassonne-boltzmann470-vs-boltzmann60-1000its,751,837,2153.308521851,2133.052642129,-86
carcassonne-ucttuned180-vs-ucttuned295-1000its,752,838,2162.72078913,2126.927270492,-86
carcassonne-boltzmann60-vs-boltzmann40-1000its,754,840,2152.690224678,2101.393891337,-86
carcassonne-boltzmann125-vs-boltzmann250-1000its,755,841,2224.587949648,2188.582236599,-86
carcassonne-boltzmann245-vs-boltzmann385-1000its,755,841,2134.953909968,2115.699019942,-86
carcassonne-uct90-vs-uct425-1000its,757,843,2144.990210745,2102.693516052,-86
carcassonne-ucttuned485-vs-ucttuned140-1000its,757,843,2180.025764109,2091.304857229,-86
carcassonne-boltzmann90-vs-boltzmann280-1000its,758,844,2161.850965473,2123.355280164,-86
carcassonne-ucttuned255-vs-ucttuned260-1000its,760,846,2141.83671845,2105.864699657,-86
carcassonne-boltzmann125-vs-boltzmann15-1000its,762,848,2201.241046871,2205.998402564,-86
carcassonne-uct15-vs-uct265-1000its,762,848,2239.211643904,2208.324402036,-86
carcassonne-uct455-vs-uct380-1000its,762,848,2128.556401812,2085.117860646,-86
carcassonne-uct80-vs-uct55-1000its,762,848,2185.664037545,2149.542697514,-86
carcassonne-uct155-vs-uct165-1000its,764,850,2187.975999324,2152.971795262,-86
carcassonne-ucttuned275-vs-ucttuned65-1000its,765,851,2219.830835471,2193.625697601,-86
carcassonne-boltzmann410-vs-boltzmann285-1000its,767,853,2187.623325111,2141.176087912,-86
carcassonne-boltzmann485-vs-boltzmann320-1000its,768,854,2233.451074937,2167.420495716,-86
carcassonne-boltzmann215-vs-boltzmann260-1000its,769,855,2080.925739234,2081.564922832,-86
carcassonne-ucttuned45-vs-ucttuned10-1000its,769,855,2172.648768341,2122.033602265,-86
carcassonne-uct205-vs-uct400-1000its,770,856,2204.304205371,2135.498372581,-86
carcassonne-uct255-vs-uct350-1000its,771,857,2231.198518318,2173.601628104,-86
carcassonne-uct215-vs-uct30-1000its,772,858,2138.372617785,2110.867382846,-86
carcassonne-uct20-vs-uct45-1000its,773,859,2227.838278627,2172.48415145,-86
carcassonne-boltzmann395-vs-boltzmann290-1000its,775,861,2105.662413682,2086.268792149,-86
carcassonne-ucttuned120-vs-ucttuned165-1000its,776,862,2141.611574162,2118.737852123,-86
carcassonne-uct485-vs-uct280-1000its,780,866,2178.500340287,2120.681703014,-86
carcassonne-ucttuned90-vs-ucttuned30-1000its,782,868,2147.465121163,2134.481739384,-86
carcassonne-boltzmann450-vs-boltzmann465-1000its,785,871,2195.310987684,2147.565776931,-86
carcassonne-uct340-vs-uct220-1000its,785,871,2175.397379006,2160.04633161,-86
carcassonne-boltzmann35-vs-boltzmann190-1000its,788,874,2194.834803756,2145.204700682,-86
carcassonne-uct140-vs-uct460-1000its,788,874,2203.186600813,2152.710166061,-86
carcassonne-ucttuned310-vs-ucttuned185-1000its,789,875,2160.535768545,2177.97818691,-86
carcassonne-uct220-vs-uct295-1000its,791,877,2240.919721853,2173.847751129,-86
carcassonne-uct470-vs-uct90-1000its,791,877,2203.571674165,2139.899732427,-86
carcassonne-boltzmann380-vs-boltzmann95-1000its,792,878,2188.735706388,2162.543902589,-86
carcassonne-uct205-vs-uct295-1000its,792,878,2196.275994689,2090.643304537,-86
carcassonne-uct340-vs-uct230-1000its,792,878,2268.242297215,2216.909729392,-86
carcassonne-uct460-vs-uct240-1000its,793,879,2202.127005441,2204.645520525,-86
carcassonne-ucttuned295-vs-ucttuned195-1000its,793,879,2155.729416481,2171.450297765,-86
carcassonne-ucttuned380-vs-ucttuned450-1000its,797,883,2238.0796381,2189.12492588,-86
carcassonne-ucttuned330-vs-ucttuned400-1000its,806,892,2254.5292584,2224.359511656,-86
carcassonne-boltzmann160-vs-boltzmann40-1000its,810,896,2087.169009452,2099.913219652,-86
carcassonne-ucttuned95-vs-ucttuned15-1000its,830,916,2215.712808182,2176.511645227,-86
carcassonne-ucttuned210-vs-ucttuned155-1000its,840,926,2286.837891003,2217.615224592,-86
carcassonne-ucttuned320-vs-ucttuned30-1000its,845,931,2198.087418623,2132.892996577,-86
carcassonne-uct30-vs-uct250-1000its,884,970,2185.19466181,2137.508444621,-86
carcassonne-boltzmann245-vs-boltzmann100-1000its,673,758,2171.711107176,2185.69159926,-85
carcassonne-uct445-vs-uct375-1000its,682,767,2192.205017837,2119.655158964,-85
carcassonne-boltzmann450-vs-boltzmann130-1000its,692,777,2127.687331078,2088.131497664,-85
carcassonne-boltzmann460-vs-boltzmann280-1000its,693,778,2147.034679085,2100.416051764,-85
carcassonne-ucttuned480-vs-ucttuned25-1000its,701,786,2196.726480054,2163.81027153,-85
carcassonne-uct215-vs-uct480-1000its,706,791,2178.067062956,2159.162703597,-85
carcassonne-ucttuned230-vs-ucttuned465-1000its,706,791,2153.769332259,2121.855113757,-85
carcassonne-ucttuned95-vs-ucttuned465-1000its,707,792,2159.223100147,2136.370006197,-85
carcassonne-boltzmann440-vs-boltzmann80-1000its,709,794,2147.71127763,2095.199611757,-85
carcassonne-ucttuned245-vs-ucttuned465-1000its,709,794,2143.397462483,2109.036605533,-85
carcassonne-uct405-vs-uct490-1000its,710,795,2198.687494392,2141.366016245,-85
carcassonne-ucttuned385-vs-ucttuned10-1000its,718,803,2153.909925426,2130.979291299,-85
carcassonne-uct210-vs-uct280-1000its,720,805,2222.573264755,2144.498025988,-85
carcassonne-boltzmann470-vs-boltzmann475-1000its,721,806,2177.343685305,2178.943564333,-85
carcassonne-uct365-vs-uct25-1000its,723,808,2136.9550593,2132.554294721,-85
carcassonne-ucttuned375-vs-ucttuned400-1000its,724,809,2229.209513777,2188.368383402,-85
carcassonne-boltzmann185-vs-boltzmann210-1000its,725,810,2214.942640321,2192.25748257,-85
carcassonne-boltzmann410-vs-boltzmann405-1000its,725,810,2170.029270877,2179.26699377,-85
carcassonne-uct405-vs-uct80-1000its,726,811,2185.585091151,2129.11201022,-85
carcassonne-ucttuned195-vs-ucttuned330-1000its,727,812,2273.843641806,2193.007636417,-85
carcassonne-boltzmann475-vs-boltzmann360-1000its,729,814,2208.174478774,2164.074043912,-85
carcassonne-ucttuned260-vs-ucttuned315-1000its,730,815,2173.855153976,2112.545897644,-85
carcassonne-uct325-vs-uct360-1000its,731,816,2195.350993581,2183.727243456,-85
carcassonne-boltzmann400-vs-boltzmann455-1000its,732,817,2220.407146263,2180.527391324,-85
carcassonne-uct30-vs-uct465-1000its,735,820,2180.865743859,2149.8099583,-85
carcassonne-uct90-vs-uct385-1000its,737,822,2139.494585539,2094.481511321,-85
carcassonne-boltzmann320-vs-boltzmann55-1000its,738,823,2170.521545751,2096.655911724,-85
carcassonne-ucttuned245-vs-ucttuned35-1000its,738,823,2133.097101888,2104.360508797,-85
carcassonne-boltzmann155-vs-boltzmann345-1000its,739,824,2221.508354241,2197.063431721,-85
carcassonne-boltzmann455-vs-boltzmann410-1000its,740,825,2253.239263552,2220.088214134,-85
carcassonne-ucttuned85-vs-ucttuned80-1000its,740,825,2166.229449365,2125.882956966,-85
carcassonne-boltzmann40-vs-boltzmann235-1000its,742,827,2194.371777876,2134.601176659,-85
carcassonne-boltzmann455-vs-boltzmann235-1000its,744,829,2175.097769109,2123.98110442,-85
carcassonne-uct445-vs-uct365-1000its,744,829,2243.565853473,2201.698327854,-85
carcassonne-uct115-vs-uct315-1000its,747,832,2137.308760322,2094.302771095,-85
carcassonne-uct195-vs-uct260-1000its,751,836,2207.130481844,2102.934688764,-85
carcassonne-ucttuned15-vs-ucttuned290-1000its,751,836,2225.378949142,2168.617562378,-85
carcassonne-ucttuned290-vs-ucttuned170-1000its,751,836,2258.677600644,2206.747940137,-85
carcassonne-uct485-vs-uct95-1000its,752,837,2190.257080014,2132.539264455,-85
carcassonne-boltzmann185-vs-boltzmann85-1000its,753,838,2144.778878543,2075.880205277,-85
carcassonne-boltzmann420-vs-boltzmann315-1000its,753,838,2224.734017281,2172.413438386,-85
carcassonne-uct405-vs-uct485-1000its,753,838,2276.122675309,2237.613871925,-85
carcassonne-boltzmann40-vs-boltzmann400-1000its,754,839,2173.450974996,2163.38612509,-85
carcassonne-uct290-vs-uct235-1000its,755,840,2191.401781216,2176.340248155,-85
carcassonne-ucttuned415-vs-ucttuned185-1000its,757,842,2202.053264394,2151.317029783,-85
carcassonne-boltzmann385-vs-boltzmann475-1000its,760,845,2201.943632522,2192.899972767,-85
carcassonne-ucttuned140-vs-ucttuned135-1000its,760,845,2194.140290575,2155.021739606,-85
carcassonne-uct480-vs-uct310-1000its,761,846,2199.322618383,2134.033223121,-85
carcassonne-ucttuned455-vs-ucttuned200-1000its,762,847,2234.855879948,2163.093807664,-85
carcassonne-ucttuned5-vs-ucttuned345-1000its,762,847,2222.411167086,2150.737459346,-85
carcassonne-boltzmann385-vs-boltzmann110-1000its,763,848,2122.875894084,2091.865358625,-85
carcassonne-ucttuned335-vs-ucttuned490-1000its,764,849,2233.403245184,2203.475147963,-85
carcassonne-ucttuned45-vs-ucttuned5-1000its,764,849,2124.740870501,2101.867666163,-85
carcassonne-boltzmann70-vs-boltzmann215-1000its,765,850,2288.093151514,2258.175737993,-85
carcassonne-ucttuned190-vs-ucttuned85-1000its,765,850,2142.320589056,2130.879030206,-85
carcassonne-uct130-vs-uct265-1000its,766,851,2226.024365939,2187.767067961,-85
carcassonne-ucttuned260-vs-ucttuned265-1000its,767,852,2141.909707643,2091.356926534,-85
carcassonne-boltzmann285-vs-boltzmann450-1000its,768,853,2154.425090553,2072.848131842,-85
carcassonne-ucttuned360-vs-ucttuned245-1000its,769,854,2203.047400503,2152.202774111,-85
carcassonne-ucttuned475-vs-ucttuned200-1000its,769,854,2225.846227925,2183.691513636,-85
carcassonne-boltzmann185-vs-boltzmann45-1000its,770,855,2194.055479839,2122.205828256,-85
carcassonne-boltzmann460-vs-boltzmann175-1000its,770,855,2158.05300002,2101.468964402,-85
carcassonne-ucttuned360-vs-ucttuned10-1000its,771,856,2189.578474444,2224.864492277,-85
carcassonne-boltzmann85-vs-boltzmann55-1000its,774,859,2228.688039899,2211.161848321,-85
carcassonne-uct265-vs-uct165-1000its,781,866,2206.342134983,2136.200356591,-85
carcassonne-boltzmann400-vs-boltzmann10-1000its,786,871,2157.580793475,2112.059140028,-85
carcassonne-ucttuned215-vs-ucttuned400-1000its,790,875,2293.837966931,2253.635586308,-85
carcassonne-boltzmann145-vs-boltzmann85-1000its,791,876,2284.260589638,2238.992638272,-85
carcassonne-boltzmann450-vs-boltzmann295-1000its,792,877,2224.612052483,2192.420041724,-85
carcassonne-boltzmann395-vs-boltzmann100-1000its,794,879,2199.812250172,2192.706055796,-85
carcassonne-ucttuned225-vs-ucttuned95-1000its,796,881,2191.754638848,2116.04245702,-85
carcassonne-uct300-vs-uct45-1000its,800,885,2171.129482565,2096.047836271,-85
carcassonne-boltzmann220-vs-boltzmann360-1000its,802,887,2145.019989663,2121.972660816,-85
carcassonne-uct310-vs-uct15-1000its,802,887,2177.851568554,2115.201917154,-85
carcassonne-boltzmann120-vs-boltzmann240-1000its,804,889,2226.977554497,2180.854722896,-85
carcassonne-ucttuned305-vs-ucttuned85-1000its,804,889,2214.831032136,2131.173347719,-85
carcassonne-boltzmann190-vs-boltzmann470-1000its,806,891,2229.193654917,2130.124554421,-85
carcassonne-uct260-vs-uct450-1000its,808,893,2214.570619287,2118.386031753,-85
carcassonne-ucttuned220-vs-ucttuned90-1000its,808,893,2176.372157084,2146.784116615,-85
carcassonne-uct50-vs-uct75-1000its,812,897,2162.902083142,2165.759312391,-85
carcassonne-boltzmann15-vs-boltzmann235-1000its,826,911,2169.599396062,2111.689656841,-85
carcassonne-boltzmann330-vs-boltzmann10-1000its,829,914,2278.937471768,2229.994737768,-85
carcassonne-boltzmann50-vs-boltzmann75-1000its,838,923,2210.311687724,2171.150264582,-85
carcassonne-ucttuned345-vs-ucttuned20-1000its,851,936,2232.722527035,2170.184660042,-85
carcassonne-uct215-vs-uct320-1000its,853,938,2264.552034199,2178.198553034,-85
carcassonne-uct360-vs-uct85-1000its,677,761,2210.082112119,2159.097655763,-84
carcassonne-boltzmann200-vs-boltzmann445-1000its,681,765,2182.952351164,2111.434292872,-84
carcassonne-uct190-vs-uct55-1000its,697,781,2143.754693041,2095.307106986,-84
carcassonne-uct400-vs-uct275-1000its,707,791,2177.891037841,2091.977837668,-84
carcassonne-boltzmann325-vs-boltzmann135-1000its,711,795,2270.820923458,2243.588231339,-84
carcassonne-boltzmann200-vs-boltzmann35-1000its,716,800,2156.614162707,2147.823370561,-84
carcassonne-uct465-vs-uct90-1000its,717,801,2185.753118794,2175.610583013,-84
carcassonne-ucttuned50-vs-ucttuned130-1000its,717,801,2180.219740854,2118.457443994,-84
carcassonne-boltzmann180-vs-boltzmann135-1000its,725,809,2252.602989299,2204.672447667,-84
carcassonne-boltzmann350-vs-boltzmann410-1000its,725,809,2272.839085911,2224.696487901,-84
carcassonne-ucttuned260-vs-ucttuned20-1000its,725,809,2153.490426596,2123.640300752,-84
carcassonne-uct75-vs-uct100-1000its,731,815,2173.878163925,2122.997680188,-84
carcassonne-boltzmann480-vs-boltzmann120-1000its,732,816,2153.157379388,2090.005420237,-84
carcassonne-uct290-vs-uct90-1000its,736,820,2154.667950042,2087.209573093,-84
carcassonne-ucttuned300-vs-ucttuned295-1000its,736,820,2197.257079438,2140.137203937,-84
carcassonne-uct470-vs-uct300-1000its,737,821,2217.74788378,2158.054007635,-84
carcassonne-uct285-vs-uct440-1000its,738,822,2169.234253777,2118.549545296,-84
carcassonne-uct30-vs-uct245-1000its,739,823,2218.787506209,2196.308230518,-84
carcassonne-ucttuned275-vs-ucttuned380-1000its,739,823,2168.102663545,2141.588688,-84
carcassonne-uct370-vs-uct110-1000its,741,825,2173.611163904,2149.208590706,-84
carcassonne-uct395-vs-uct55-1000its,743,827,2144.545145697,2065.519975858,-84
carcassonne-ucttuned310-vs-ucttuned145-1000its,745,829,2221.164712567,2194.46746663,-84
carcassonne-ucttuned370-vs-ucttuned170-1000its,746,830,2258.846038147,2201.879288989,-84
carcassonne-boltzmann45-vs-boltzmann325-1000its,748,832,2142.00827299,2138.965606758,-84
carcassonne-uct425-vs-uct450-1000its,753,837,2218.900925849,2120.107232262,-84
carcassonne-uct210-vs-uct445-1000its,754,838,2217.83054373,2190.317882621,-84
carcassonne-boltzmann10-vs-boltzmann60-1000its,755,839,2172.022805093,2134.435447678,-84
carcassonne-boltzmann220-vs-boltzmann75-1000its,755,839,2166.208208801,2095.746150411,-84
carcassonne-boltzmann280-vs-boltzmann185-1000its,756,840,2136.660647364,2129.640657899,-84
carcassonne-ucttuned310-vs-ucttuned5-1000its,756,840,2240.461536138,2226.958564852,-84
carcassonne-uct65-vs-uct440-1000its,757,841,2150.209108479,2151.788766866,-84
carcassonne-ucttuned300-vs-ucttuned125-1000its,758,842,2246.029496977,2223.288894901,-84
carcassonne-uct160-vs-uct70-1000its,760,844,2285.861058837,2201.246571661,-84
carcassonne-uct150-vs-uct335-1000its,761,845,2159.166660849,2148.148075418,-84
carcassonne-boltzmann300-vs-boltzmann20-1000its,762,846,2139.175048343,2122.83428063,-84
carcassonne-uct155-vs-uct115-1000its,763,847,2186.221614862,2178.578793089,-84
carcassonne-boltzmann50-vs-boltzmann5-1000its,766,850,2220.816719599,2176.425602307,-84
carcassonne-uct480-vs-uct455-1000its,768,852,2179.262492273,2107.387173234,-84
carcassonne-uct130-vs-uct475-1000its,774,858,2183.846759401,2130.720857957,-84
carcassonne-ucttuned135-vs-ucttuned370-1000its,775,859,2194.251922858,2188.168596615,-84
carcassonne-ucttuned235-vs-ucttuned315-1000its,776,860,2252.033929193,2215.523153078,-84
carcassonne-ucttuned75-vs-ucttuned55-1000its,777,861,2261.481164577,2207.124967464,-84
carcassonne-boltzmann215-vs-boltzmann155-1000its,778,862,2228.052439885,2204.985545316,-84
carcassonne-boltzmann285-vs-boltzmann485-1000its,778,862,2183.00785776,2185.003335615,-84
carcassonne-boltzmann310-vs-boltzmann105-1000its,778,862,2165.303206326,2143.678318866,-84
carcassonne-uct55-vs-uct25-1000its,778,862,2234.362239542,2192.033660175,-84
carcassonne-boltzmann235-vs-boltzmann420-1000its,779,863,2206.92407899,2179.5398281,-84
carcassonne-uct90-vs-uct140-1000its,779,863,2180.186332511,2109.550772229,-84
carcassonne-boltzmann180-vs-boltzmann80-1000its,781,865,2278.155334145,2224.068373154,-84
carcassonne-boltzmann225-vs-boltzmann410-1000its,783,867,2221.992582864,2160.485716578,-84
carcassonne-ucttuned185-vs-ucttuned125-1000its,783,867,2209.052738228,2189.372995811,-84
carcassonne-ucttuned85-vs-ucttuned170-1000its,783,867,2203.140142645,2106.550519371,-84
carcassonne-uct420-vs-uct200-1000its,786,870,2165.4532444,2120.960352471,-84
carcassonne-ucttuned260-vs-ucttuned380-1000its,787,871,2159.685385313,2132.120824883,-84
carcassonne-uct305-vs-uct15-1000its,790,874,2148.83710198,2093.812390638,-84
carcassonne-ucttuned40-vs-ucttuned200-1000its,791,875,2188.709299339,2109.025072631,-84
carcassonne-ucttuned415-vs-ucttuned10-1000its,792,876,2194.910464208,2132.818250959,-84
carcassonne-uct35-vs-uct435-1000its,795,879,2201.99116407,2175.574189727,-84
carcassonne-uct470-vs-uct10-1000its,798,882,2173.198627056,2135.404031327,-84
carcassonne-uct460-vs-uct300-1000its,800,884,2201.717898319,2117.638846588,-84
carcassonne-ucttuned340-vs-ucttuned255-1000its,800,884,2193.753699006,2149.460467163,-84
carcassonne-ucttuned40-vs-ucttuned495-1000its,801,885,2239.385475536,2228.810303238,-84
carcassonne-boltzmann495-vs-boltzmann95-1000its,805,889,2226.924698843,2203.35412099,-84
carcassonne-uct265-vs-uct305-1000its,808,892,2180.125456543,2111.475806832,-84
carcassonne-ucttuned130-vs-ucttuned225-1000its,812,896,2249.52246797,2178.268418574,-84
carcassonne-uct315-vs-uct330-1000its,816,900,2208.499773533,2137.604862546,-84
carcassonne-boltzmann20-vs-boltzmann335-1000its,821,905,2148.795049762,2092.623078183,-84
carcassonne-boltzmann415-vs-boltzmann155-1000its,826,910,2273.332847299,2236.120086886,-84
carcassonne-boltzmann470-vs-boltzmann175-1000its,833,917,2194.735920224,2108.022519538,-84
carcassonne-ucttuned45-vs-ucttuned15-1000its,836,920,2292.124717648,2176.889561604,-84
carcassonne-ucttuned285-vs-ucttuned220-1000its,838,922,2190.580784481,2121.67413732,-84
carcassonne-uct60-vs-uct170-1000its,845,929,2181.706434976,2143.219528735,-84
carcassonne-ucttuned285-vs-ucttuned135-1000its,871,955,2203.651793073,2134.612124559,-84
carcassonne-uct405-vs-uct265-1000its,880,964,2165.776256031,2157.995523187,-84
carcassonne-boltzmann330-vs-boltzmann280-1000its,710,793,2168.778492146,2122.307560299,-83
carcassonne-uct490-vs-uct310-1000its,710,793,2160.156993771,2138.550789769,-83
carcassonne-uct325-vs-uct120-1000its,713,796,2160.540123505,2094.478975916,-83
carcassonne-ucttuned410-vs-ucttuned165-1000its,715,798,2172.13970715,2120.993791963,-83
carcassonne-boltzmann120-vs-boltzmann425-1000its,720,803,2117.921964711,2096.996003265,-83
carcassonne-ucttuned375-vs-ucttuned185-1000its,721,804,2185.571021071,2137.891796529,-83
carcassonne-boltzmann385-vs-boltzmann25-1000its,723,806,2147.780936842,2095.23398879,-83
carcassonne-boltzmann230-vs-boltzmann415-1000its,725,808,2129.74509696,2103.699913147,-83
carcassonne-boltzmann175-vs-boltzmann140-1000its,727,810,2204.757518152,2122.921978735,-83
carcassonne-uct190-vs-uct495-1000its,727,810,2222.262850109,2166.838831238,-83
carcassonne-boltzmann195-vs-boltzmann425-1000its,730,813,2177.553107099,2125.12314345,-83
carcassonne-uct220-vs-uct485-1000its,730,813,2226.522822302,2187.067457368,-83
carcassonne-ucttuned260-vs-ucttuned30-1000its,730,813,2204.501798942,2177.623144346,-83
carcassonne-uct410-vs-uct55-1000its,732,815,2161.996752247,2106.151387061,-83
carcassonne-uct330-vs-uct260-1000its,733,816,2206.08417792,2124.894093984,-83
carcassonne-boltzmann260-vs-boltzmann365-1000its,735,818,2209.997781136,2184.083665916,-83
carcassonne-ucttuned335-vs-ucttuned300-1000its,737,820,2215.599767738,2177.572611166,-83
carcassonne-ucttuned350-vs-ucttuned420-1000its,738,821,2211.837159216,2135.014543966,-83
carcassonne-uct210-vs-uct410-1000its,740,823,2191.398332229,2172.929642995,-83
carcassonne-boltzmann450-vs-boltzmann265-1000its,741,824,2187.982231766,2159.792264873,-83
carcassonne-ucttuned355-vs-ucttuned130-1000its,742,825,2207.824996322,2162.381962544,-83
carcassonne-uct295-vs-uct235-1000its,745,828,2182.843442642,2165.499801106,-83
carcassonne-uct330-vs-uct55-1000its,745,828,2209.584893768,2148.884027653,-83
carcassonne-boltzmann110-vs-boltzmann195-1000its,746,829,2169.010272008,2143.465723658,-83
carcassonne-boltzmann410-vs-boltzmann170-1000its,746,829,2234.167291021,2210.134272511,-83
carcassonne-boltzmann425-vs-boltzmann215-1000its,746,829,2243.604232828,2213.337224225,-83
carcassonne-ucttuned230-vs-ucttuned105-1000its,751,834,2166.263510626,2129.887393714,-83
carcassonne-uct490-vs-uct430-1000its,752,835,2223.330913149,2205.715498216,-83
carcassonne-uct330-vs-uct135-1000its,753,836,2214.218038439,2152.938561696,-83
carcassonne-boltzmann305-vs-boltzmann425-1000its,754,837,2180.446875378,2145.25798576,-83
carcassonne-uct140-vs-uct415-1000its,755,838,2172.435057518,2112.918994103,-83
carcassonne-boltzmann345-vs-boltzmann330-1000its,757,840,2151.736933741,2110.307294587,-83
carcassonne-uct460-vs-uct475-1000its,757,840,2204.450860676,2166.589481935,-83
carcassonne-boltzmann85-vs-boltzmann125-1000its,758,841,2231.332547907,2195.19654965,-83
carcassonne-uct240-vs-uct345-1000its,758,841,2224.348926783,2174.883320728,-83
carcassonne-ucttuned170-vs-ucttuned180-1000its,759,842,2231.297224981,2149.53893413,-83
carcassonne-uct415-vs-uct240-1000its,762,845,2246.80473464,2238.690142567,-83
carcassonne-boltzmann300-vs-boltzmann410-1000its,763,846,2222.452005812,2166.355629354,-83
carcassonne-ucttuned110-vs-ucttuned60-1000its,764,847,2189.708704307,2134.814981952,-83
carcassonne-ucttuned70-vs-ucttuned20-1000its,764,847,2195.891676458,2149.100646239,-83
carcassonne-ucttuned230-vs-ucttuned5-1000its,766,849,2218.323035544,2167.26347722,-83
carcassonne-ucttuned405-vs-ucttuned35-1000its,767,850,2251.531217329,2229.619397332,-83
carcassonne-boltzmann280-vs-boltzmann150-1000its,768,851,2204.448266669,2146.942725158,-83
carcassonne-uct290-vs-uct330-1000its,769,852,2171.023794963,2173.305924873,-83
carcassonne-ucttuned390-vs-ucttuned455-1000its,769,852,2230.95716598,2235.207776102,-83
carcassonne-uct180-vs-uct410-1000its,770,853,2122.049988579,2076.242837047,-83
carcassonne-boltzmann225-vs-boltzmann55-1000its,772,855,2188.032365272,2161.363515556,-83
carcassonne-boltzmann425-vs-boltzmann460-1000its,774,857,2218.124492593,2178.157173021,-83
carcassonne-uct215-vs-uct400-1000its,774,857,2235.463100722,2173.184901896,-83
carcassonne-uct15-vs-uct130-1000its,775,858,2142.931945317,2151.988291991,-83
carcassonne-uct315-vs-uct230-1000its,776,859,2209.370429654,2170.58671699,-83
carcassonne-uct495-vs-uct155-1000its,781,864,2219.127910407,2191.503104253,-83
carcassonne-boltzmann115-vs-boltzmann280-1000its,783,866,2210.173173084,2168.217245088,-83
carcassonne-boltzmann240-vs-boltzmann185-1000its,783,866,2226.862829272,2164.069814101,-83
carcassonne-ucttuned285-vs-ucttuned55-1000its,784,867,2230.661279874,2154.615177495,-83
carcassonne-boltzmann90-vs-boltzmann85-1000its,789,872,2220.894927662,2160.97370007,-83
carcassonne-boltzmann65-vs-boltzmann330-1000its,792,875,2215.461160876,2157.63892502,-83
carcassonne-ucttuned375-vs-ucttuned100-1000its,794,877,2224.035755992,2191.730381705,-83
carcassonne-ucttuned330-vs-ucttuned35-1000its,796,879,2201.314732463,2183.882458387,-83
carcassonne-ucttuned325-vs-ucttuned470-1000its,804,887,2193.688096007,2150.972736618,-83
carcassonne-uct445-vs-uct15-1000its,807,890,2194.301403067,2163.715211292,-83
carcassonne-boltzmann90-vs-boltzmann260-1000its,808,891,2234.36338166,2169.538704122,-83
carcassonne-uct445-vs-uct175-1000its,809,892,2159.779974935,2084.804503769,-83
carcassonne-ucttuned155-vs-ucttuned280-1000its,810,893,2241.554018483,2188.017749667,-83
carcassonne-ucttuned435-vs-ucttuned15-1000its,811,894,2176.873203969,2137.149576809,-83
carcassonne-ucttuned275-vs-ucttuned95-1000its,816,899,2195.805086856,2153.784854245,-83
carcassonne-boltzmann425-vs-boltzmann385-1000its,829,912,2164.595907305,2128.956854965,-83
carcassonne-ucttuned370-vs-ucttuned25-1000its,832,915,2160.730255262,2178.650760833,-83
carcassonne-boltzmann115-vs-boltzmann105-1000its,834,917,2202.797312654,2172.350375624,-83
carcassonne-ucttuned230-vs-ucttuned145-1000its,834,917,2179.126137732,2108.016846047,-83
carcassonne-ucttuned5-vs-ucttuned45-1000its,834,917,2247.588256929,2194.532932842,-83
carcassonne-uct80-vs-uct315-1000its,835,918,2222.311088142,2191.955624873,-83
carcassonne-uct350-vs-uct95-1000its,854,937,2212.462802632,2136.680864858,-83
carcassonne-ucttuned350-vs-ucttuned130-1000its,858,941,2249.429627518,2245.65874418,-83
carcassonne-boltzmann465-vs-boltzmann440-1000its,680,762,2159.006603968,2108.217551317,-82
carcassonne-boltzmann40-vs-boltzmann415-1000its,685,767,2152.891813653,2104.324470707,-82
carcassonne-boltzmann115-vs-boltzmann425-1000its,701,783,2166.680225789,2120.534704823,-82
carcassonne-boltzmann145-vs-boltzmann460-1000its,711,793,2214.97242531,2148.542833421,-82
carcassonne-uct40-vs-uct50-1000its,716,798,2283.708969218,2281.971210481,-82
carcassonne-boltzmann315-vs-boltzmann320-1000its,719,801,2215.771422976,2129.815539255,-82
carcassonne-boltzmann210-vs-boltzmann320-1000its,720,802,2196.417608806,2146.59345968,-82
carcassonne-boltzmann250-vs-boltzmann385-1000its,720,802,2325.118295245,2281.684718181,-82
carcassonne-boltzmann335-vs-boltzmann390-1000its,720,802,2183.471840351,2134.598372482,-82
carcassonne-uct255-vs-uct5-1000its,725,807,2196.797891772,2132.491624859,-82
carcassonne-uct225-vs-uct375-1000its,727,809,2157.635559548,2067.783328419,-82
carcassonne-boltzmann170-vs-boltzmann100-1000its,728,810,2226.126653951,2133.011410442,-82
carcassonne-uct90-vs-uct20-1000its,728,810,2184.499343927,2127.510711379,-82
carcassonne-boltzmann105-vs-boltzmann160-1000its,729,811,2192.156740231,2192.750555575,-82
carcassonne-uct345-vs-uct285-1000its,730,812,2215.385241349,2174.642210353,-82
carcassonne-uct415-vs-uct160-1000its,731,813,2168.668272815,2092.98493527,-82
carcassonne-uct445-vs-uct300-1000its,734,816,2221.575426345,2208.875032059,-82
carcassonne-boltzmann295-vs-boltzmann10-1000its,735,817,2193.326719522,2148.34033799,-82
carcassonne-ucttuned290-vs-ucttuned5-1000its,735,817,2187.048312067,2193.559856639,-82
carcassonne-uct90-vs-uct225-1000its,736,818,2257.623978903,2201.453680082,-82
carcassonne-uct450-vs-uct105-1000its,737,819,2209.462423676,2183.95448606,-82
carcassonne-boltzmann95-vs-boltzmann25-1000its,740,822,2272.558207243,2229.896395168,-82
carcassonne-boltzmann115-vs-boltzmann130-1000its,746,828,2196.164179166,2176.0822238,-82
carcassonne-boltzmann75-vs-boltzmann215-1000its,752,834,2129.809576716,2095.985425889,-82
carcassonne-boltzmann300-vs-boltzmann120-1000its,753,835,2157.048574323,2086.430174864,-82
carcassonne-ucttuned260-vs-ucttuned70-1000its,753,835,2120.471426261,2083.038158491,-82
carcassonne-ucttuned160-vs-ucttuned320-1000its,754,836,2187.549826169,2146.4058569,-82
carcassonne-ucttuned60-vs-ucttuned200-1000its,759,841,2269.725076623,2186.478771565,-82
carcassonne-boltzmann190-vs-boltzmann45-1000its,760,842,2196.251906286,2136.394265938,-82
carcassonne-boltzmann95-vs-boltzmann5-1000its,761,843,2180.196055867,2105.037297483,-82
carcassonne-uct270-vs-uct485-1000its,761,843,2184.549114122,2143.588883874,-82
carcassonne-uct475-vs-uct115-1000its,762,844,2236.54806926,2175.409723531,-82
carcassonne-uct445-vs-uct440-1000its,765,847,2181.351414771,2119.102067815,-82
carcassonne-ucttuned265-vs-ucttuned455-1000its,769,851,2128.436964465,2137.973543208,-82
carcassonne-boltzmann235-vs-boltzmann225-1000its,771,853,2156.274682796,2090.522985503,-82
carcassonne-boltzmann330-vs-boltzmann415-1000its,775,857,2178.694944463,2144.294165034,-82
carcassonne-boltzmann160-vs-boltzmann425-1000its,778,860,2201.564937074,2131.655083916,-82
carcassonne-uct110-vs-uct30-1000its,778,860,2212.562303651,2134.739930495,-82
carcassonne-ucttuned55-vs-ucttuned225-1000its,778,860,2235.542394764,2159.090347772,-82
carcassonne-uct370-vs-uct145-1000its,779,861,2179.752748116,2188.698703757,-82
carcassonne-boltzmann290-vs-boltzmann155-1000its,780,862,2260.58370449,2171.524248735,-82
carcassonne-uct385-vs-uct345-1000its,782,864,2256.152155062,2207.284537343,-82
carcassonne-uct220-vs-uct215-1000its,783,865,2199.319369348,2188.826884332,-82
carcassonne-uct290-vs-uct120-1000its,783,865,2243.987765724,2185.115756505,-82
carcassonne-uct470-vs-uct175-1000its,786,868,2201.358281187,2162.414985462,-82
carcassonne-ucttuned320-vs-ucttuned225-1000its,787,869,2180.034636143,2110.085741194,-82
carcassonne-boltzmann190-vs-boltzmann125-1000its,788,870,2146.219892978,2114.420484681,-82
carcassonne-uct55-vs-uct350-1000its,788,870,2191.499043278,2194.449820901,-82
carcassonne-uct70-vs-uct280-1000its,788,870,2200.568301732,2168.951077144,-82
carcassonne-boltzmann380-vs-boltzmann10-1000its,790,872,2156.585526306,2129.451960255,-82
carcassonne-ucttuned335-vs-ucttuned135-1000its,790,872,2271.481320581,2247.597868555,-82
carcassonne-boltzmann195-vs-boltzmann260-1000its,791,873,2220.188697091,2124.502975177,-82
carcassonne-uct400-vs-uct20-1000its,791,873,2216.319528307,2200.647291831,-82
carcassonne-ucttuned210-vs-ucttuned385-1000its,791,873,2261.002899783,2210.983267121,-82
carcassonne-ucttuned255-vs-ucttuned105-1000its,792,874,2241.476845327,2126.818447037,-82
carcassonne-uct475-vs-uct225-1000its,794,876,2252.797790351,2226.153597214,-82
carcassonne-uct160-vs-uct440-1000its,797,879,2209.024918863,2148.500229614,-82
carcassonne-ucttuned430-vs-ucttuned15-1000its,797,879,2205.766025585,2144.712627489,-82
carcassonne-uct300-vs-uct220-1000its,803,885,2249.724385839,2223.148591047,-82
carcassonne-ucttuned290-vs-ucttuned15-1000its,803,885,2272.674792275,2225.069276979,-82
carcassonne-boltzmann300-vs-boltzmann435-1000its,805,887,2235.825212576,2224.586433125,-82
carcassonne-uct325-vs-uct350-1000its,805,887,2178.086924809,2161.366952859,-82
carcassonne-ucttuned205-vs-ucttuned395-1000its,806,888,2150.654716024,2136.254278018,-82
carcassonne-ucttuned235-vs-ucttuned355-1000its,808,890,2166.164673696,2116.045674474,-82
carcassonne-uct130-vs-uct20-1000its,809,891,2165.515940184,2145.64531551,-82
carcassonne-boltzmann125-vs-boltzmann55-1000its,810,892,2156.007384823,2142.306359572,-82
carcassonne-uct40-vs-uct260-1000its,812,894,2266.236992034,2228.541599381,-82
carcassonne-uct405-vs-uct40-1000its,812,894,2260.400643481,2198.843159045,-82
carcassonne-boltzmann130-vs-boltzmann180-1000its,817,899,2152.977612541,2107.775554286,-82
carcassonne-boltzmann300-vs-boltzmann465-1000its,820,902,2237.035981542,2227.869159563,-82
carcassonne-uct480-vs-uct415-1000its,820,902,2208.796074838,2144.023379497,-82
carcassonne-uct105-vs-uct180-1000its,821,903,2136.218479804,2141.588328836,-82
carcassonne-ucttuned215-vs-ucttuned300-1000its,826,908,2197.100838825,2201.881891685,-82
carcassonne-ucttuned255-vs-ucttuned20-1000its,826,908,2233.694455933,2156.819390048,-82
carcassonne-boltzmann485-vs-boltzmann50-1000its,839,921,2195.297263382,2125.186445167,-82
carcassonne-uct265-vs-uct5-1000its,848,930,2180.185907799,2108.118192208,-82
carcassonne-uct130-vs-uct10-1000its,694,775,2152.557823553,2137.490050797,-81
carcassonne-boltzmann380-vs-boltzmann225-1000its,705,786,2162.04217313,2129.270658664,-81
carcassonne-uct105-vs-uct250-1000its,705,786,2198.667547169,2099.410031052,-81
carcassonne-boltzmann215-vs-boltzmann85-1000its,708,789,2183.192114539,2147.849739343,-81
carcassonne-ucttuned490-vs-ucttuned290-1000its,712,793,2151.49728444,2102.47154366,-81
carcassonne-ucttuned125-vs-ucttuned210-1000its,713,794,2245.198369781,2160.401868684,-81
carcassonne-ucttuned180-vs-ucttuned440-1000its,715,796,2209.734152,2145.351424499,-81
carcassonne-boltzmann380-vs-boltzmann65-1000its,716,797,2186.27580298,2125.633750668,-81
carcassonne-boltzmann255-vs-boltzmann15-1000its,718,799,2193.374033016,2131.001763456,-81
carcassonne-boltzmann275-vs-boltzmann110-1000its,720,801,2220.302364776,2178.113798427,-81
carcassonne-ucttuned260-vs-ucttuned480-1000its,720,801,2129.391543346,2124.725154761,-81
carcassonne-boltzmann365-vs-boltzmann105-1000its,730,811,2219.591486766,2219.544862542,-81
carcassonne-ucttuned145-vs-ucttuned140-1000its,740,821,2162.536960908,2140.735996377,-81
carcassonne-ucttuned45-vs-ucttuned250-1000its,741,822,2213.139828804,2110.576333061,-81
carcassonne-ucttuned105-vs-ucttuned260-1000its,742,823,2158.768880109,2132.927558088,-81
carcassonne-ucttuned70-vs-ucttuned455-1000its,742,823,2232.328555222,2182.670935152,-81
carcassonne-boltzmann420-vs-boltzmann15-1000its,743,824,2197.374215197,2118.302719153,-81
carcassonne-uct270-vs-uct90-1000its,743,824,2172.620443568,2158.300639157,-81
carcassonne-boltzmann85-vs-boltzmann385-1000its,745,826,2195.790844342,2146.91975338,-81
carcassonne-boltzmann475-vs-boltzmann75-1000its,748,829,2185.641480493,2106.00486322,-81
carcassonne-boltzmann185-vs-boltzmann230-1000its,750,831,2209.325561941,2168.292032181,-81
carcassonne-ucttuned370-vs-ucttuned425-1000its,750,831,2212.480162083,2147.24662253,-81
carcassonne-ucttuned135-vs-ucttuned250-1000its,753,834,2161.644160301,2145.461482379,-81
carcassonne-uct170-vs-uct215-1000its,754,835,2212.248772764,2174.192724487,-81
carcassonne-uct185-vs-uct215-1000its,754,835,2193.420526847,2152.22668826,-81
carcassonne-ucttuned70-vs-ucttuned125-1000its,754,835,2203.693695333,2151.338537054,-81
carcassonne-boltzmann120-vs-boltzmann365-1000its,755,836,2231.71618663,2193.818608947,-81
carcassonne-uct270-vs-uct80-1000its,755,836,2151.107539039,2124.987004028,-81
carcassonne-boltzmann185-vs-boltzmann215-1000its,756,837,2235.490070663,2147.915637434,-81
carcassonne-uct230-vs-uct435-1000its,759,840,2227.932732479,2170.738341951,-81
carcassonne-boltzmann220-vs-boltzmann340-1000its,761,842,2289.112556715,2284.993472137,-81
carcassonne-ucttuned140-vs-ucttuned110-1000its,762,843,2199.200435591,2225.545003093,-81
carcassonne-ucttuned415-vs-ucttuned5-1000its,763,844,2226.551773627,2207.606649264,-81
carcassonne-uct70-vs-uct80-1000its,764,845,2200.355355581,2157.069080961,-81
carcassonne-uct430-vs-uct120-1000its,766,847,2190.667812613,2170.264586073,-81
carcassonne-boltzmann320-vs-boltzmann430-1000its,770,851,2209.137621133,2176.042921712,-81
carcassonne-uct470-vs-uct390-1000its,776,857,2250.578798055,2197.45081905,-81
carcassonne-ucttuned40-vs-ucttuned235-1000its,776,857,2259.026485232,2185.84940698,-81
carcassonne-boltzmann400-vs-boltzmann385-1000its,777,858,2220.975028669,2231.622587609,-81
carcassonne-uct285-vs-uct320-1000its,782,863,2169.570071425,2182.684238374,-81
carcassonne-uct265-vs-uct230-1000its,783,864,2168.323118778,2084.909665953,-81
carcassonne-boltzmann430-vs-boltzmann325-1000its,787,868,2187.295944024,2166.139331857,-81
carcassonne-boltzmann295-vs-boltzmann415-1000its,790,871,2231.354637765,2185.839203537,-81
carcassonne-uct60-vs-uct335-1000its,791,872,2207.345626054,2195.024034012,-81
carcassonne-boltzmann100-vs-boltzmann485-1000its,792,873,2189.70117199,2163.722805351,-81
carcassonne-boltzmann120-vs-boltzmann470-1000its,797,878,2208.017632083,2171.173078904,-81
carcassonne-ucttuned130-vs-ucttuned205-1000its,798,879,2172.672974391,2132.956108186,-81
carcassonne-ucttuned195-vs-ucttuned35-1000its,798,879,2134.798080224,2086.234692595,-81
carcassonne-uct45-vs-uct175-1000its,800,881,2168.809947648,2143.112643543,-81
carcassonne-boltzmann260-vs-boltzmann470-1000its,801,882,2182.359094579,2138.156499337,-81
carcassonne-uct155-vs-uct15-1000its,801,882,2185.984743219,2092.473226876,-81
carcassonne-uct20-vs-uct205-1000its,801,882,2106.318033978,2093.190742591,-81
carcassonne-ucttuned480-vs-ucttuned335-1000its,803,884,2238.153558446,2180.780371803,-81
carcassonne-ucttuned45-vs-ucttuned180-1000its,804,885,2122.608309854,2078.667760607,-81
carcassonne-uct330-vs-uct230-1000its,806,887,2229.286416558,2192.337673252,-81
carcassonne-boltzmann165-vs-boltzmann465-1000its,813,894,2174.373709257,2097.16444647,-81
carcassonne-boltzmann285-vs-boltzmann475-1000its,815,896,2137.989258206,2103.272634273,-81
carcassonne-uct340-vs-uct240-1000its,817,898,2221.888105898,2210.870830758,-81
carcassonne-ucttuned385-vs-ucttuned395-1000its,819,900,2127.059416557,2079.691699177,-81
carcassonne-boltzmann485-vs-boltzmann230-1000its,820,901,2208.432000574,2155.700297087,-81
carcassonne-boltzmann300-vs-boltzmann235-1000its,831,912,2213.9269823,2197.037848319,-81
carcassonne-ucttuned165-vs-ucttuned415-1000its,837,918,2216.21628066,2185.814133465,-81
carcassonne-ucttuned470-vs-ucttuned400-1000its,713,793,2260.347353253,2206.14633884,-80
carcassonne-boltzmann245-vs-boltzmann200-1000its,715,795,2233.578697277,2177.762527367,-80
carcassonne-ucttuned235-vs-ucttuned285-1000its,722,802,2203.710914658,2123.805731662,-80
carcassonne-boltzmann420-vs-boltzmann440-1000its,728,808,2295.388336543,2207.62321303,-80
carcassonne-uct315-vs-uct275-1000its,729,809,2208.040422626,2157.509348974,-80
carcassonne-ucttuned260-vs-ucttuned410-1000its,729,809,2220.865192391,2150.390713066,-80
carcassonne-ucttuned440-vs-ucttuned65-1000its,730,810,2190.444326513,2140.281397688,-80
carcassonne-boltzmann325-vs-boltzmann100-1000its,734,814,2095.092373998,2093.799340957,-80
carcassonne-boltzmann85-vs-boltzmann495-1000its,736,816,2149.990794045,2103.153263464,-80
carcassonne-boltzmann370-vs-boltzmann35-1000its,737,817,2198.644835372,2182.801373263,-80
carcassonne-uct185-vs-uct110-1000its,738,818,2221.263667534,2190.081644133,-80
carcassonne-ucttuned490-vs-ucttuned135-1000its,740,820,2235.432321165,2190.697312864,-80
carcassonne-boltzmann330-vs-boltzmann445-1000its,743,823,2267.772846762,2194.759758888,-80
carcassonne-uct140-vs-uct45-1000its,743,823,2218.806816764,2167.73921882,-80
carcassonne-boltzmann190-vs-boltzmann375-1000its,748,828,2218.24537046,2184.916055036,-80
carcassonne-boltzmann435-vs-boltzmann305-1000its,748,828,2239.489989445,2202.235109568,-80
carcassonne-boltzmann275-vs-boltzmann125-1000its,751,831,2198.826605463,2175.425852911,-80
carcassonne-boltzmann240-vs-boltzmann225-1000its,752,832,2218.388254818,2160.756081538,-80
carcassonne-ucttuned430-vs-ucttuned220-1000its,752,832,2134.148182287,2097.914795804,-80
carcassonne-ucttuned480-vs-ucttuned165-1000its,752,832,2238.477127507,2189.038611032,-80
carcassonne-uct115-vs-uct180-1000its,753,833,2274.766090083,2198.298023917,-80
carcassonne-boltzmann210-vs-boltzmann430-1000its,756,836,2236.551790278,2218.700990514,-80
carcassonne-uct25-vs-uct40-1000its,757,837,2188.051350239,2149.516072324,-80
carcassonne-boltzmann180-vs-boltzmann170-1000its,758,838,2256.496374469,2215.366246014,-80
carcassonne-ucttuned325-vs-ucttuned370-1000its,758,838,2165.642209047,2096.769290989,-80
carcassonne-ucttuned485-vs-ucttuned370-1000its,758,838,2144.954819264,2123.80355621,-80
carcassonne-boltzmann160-vs-boltzmann175-1000its,760,840,2200.533865536,2104.774260209,-80
carcassonne-uct410-vs-uct280-1000its,760,840,2187.638851184,2127.822907086,-80
carcassonne-boltzmann365-vs-boltzmann160-1000its,761,841,2188.074328725,2133.976275693,-80
carcassonne-uct260-vs-uct180-1000its,762,842,2299.103465224,2204.853114929,-80
carcassonne-boltzmann340-vs-boltzmann350-1000its,763,843,2210.474100087,2129.429416867,-80
carcassonne-boltzmann65-vs-boltzmann280-1000its,763,843,2172.7263127,2152.342849069,-80
carcassonne-uct280-vs-uct455-1000its,763,843,2212.558165478,2141.053084821,-80
carcassonne-ucttuned290-vs-ucttuned245-1000its,763,843,2228.496533679,2147.240195496,-80
carcassonne-uct280-vs-uct80-1000its,765,845,2234.458878787,2183.113221998,-80
carcassonne-boltzmann410-vs-boltzmann90-1000its,767,847,2154.628149148,2128.097911561,-80
carcassonne-boltzmann100-vs-boltzmann205-1000its,768,848,2197.773286469,2180.178624308,-80
carcassonne-boltzmann140-vs-boltzmann400-1000its,771,851,2172.796764495,2173.076418079,-80
carcassonne-boltzmann355-vs-boltzmann260-1000its,772,852,2106.014408848,2061.048885082,-80
carcassonne-ucttuned205-vs-ucttuned420-1000its,773,853,2241.270011629,2187.90963722,-80
carcassonne-boltzmann250-vs-boltzmann295-1000its,774,854,2186.689583136,2057.883415873,-80
carcassonne-uct440-vs-uct50-1000its,774,854,2227.491358555,2224.294344508,-80
carcassonne-boltzmann430-vs-boltzmann390-1000its,776,856,2133.68634584,2086.488232914,-80
carcassonne-uct95-vs-uct215-1000its,776,856,2264.980991701,2220.28619373,-80
carcassonne-ucttuned310-vs-ucttuned250-1000its,777,857,2231.225973308,2152.343298208,-80
carcassonne-uct245-vs-uct165-1000its,780,860,2213.679601923,2133.268557891,-80
carcassonne-ucttuned60-vs-ucttuned70-1000its,780,860,2264.839614044,2228.163573012,-80
carcassonne-ucttuned315-vs-ucttuned175-1000its,782,862,2155.607539656,2146.784281628,-80
carcassonne-ucttuned460-vs-ucttuned330-1000its,784,864,2251.529661518,2173.347000143,-80
carcassonne-boltzmann10-vs-boltzmann40-1000its,789,869,2258.327106506,2226.007227158,-80
carcassonne-uct15-vs-uct330-1000its,790,870,2214.417877541,2248.221747266,-80
carcassonne-ucttuned305-vs-ucttuned410-1000its,792,872,2205.591653555,2125.951714409,-80
carcassonne-ucttuned390-vs-ucttuned300-1000its,795,875,2159.797089375,2175.695583059,-80
carcassonne-uct265-vs-uct375-1000its,801,881,2235.61720185,2187.382457705,-80
carcassonne-ucttuned290-vs-ucttuned20-1000its,801,881,2194.209384823,2160.895759564,-80
carcassonne-uct240-vs-uct145-1000its,804,884,2109.746537455,2117.024720927,-80
carcassonne-uct205-vs-uct15-1000its,809,889,2226.817861433,2160.197869274,-80
carcassonne-ucttuned250-vs-ucttuned405-1000its,815,895,2216.874523643,2208.179956524,-80
carcassonne-ucttuned75-vs-ucttuned390-1000its,815,895,2235.842365412,2205.959193018,-80
carcassonne-uct90-vs-uct360-1000its,816,896,2197.358381664,2096.780244648,-80
carcassonne-uct80-vs-uct255-1000its,818,898,2233.698327333,2191.339230275,-80
carcassonne-boltzmann130-vs-boltzmann150-1000its,819,899,2242.921371922,2184.944892241,-80
carcassonne-ucttuned265-vs-ucttuned165-1000its,821,901,2183.159879425,2131.005933497,-80
carcassonne-ucttuned145-vs-ucttuned365-1000its,829,909,2312.039885526,2248.115216221,-80
carcassonne-ucttuned250-vs-ucttuned420-1000its,834,914,2257.836319622,2237.470598474,-80
carcassonne-ucttuned290-vs-ucttuned80-1000its,834,914,2189.95239641,2177.154733604,-80
carcassonne-uct275-vs-uct120-1000its,835,915,2144.999557872,2144.466873141,-80
carcassonne-boltzmann170-vs-boltzmann460-1000its,841,921,2182.105809748,2158.472769023,-80
carcassonne-uct5-vs-uct40-1000its,850,930,2251.869353827,2186.936605962,-80
carcassonne-ucttuned260-vs-ucttuned350-1000its,617,696,1734.858857293,1723.12700594,-79
carcassonne-boltzmann490-vs-boltzmann335-1000its,682,761,2218.113187257,2134.603111269,-79
carcassonne-boltzmann425-vs-boltzmann465-1000its,703,782,2205.225206979,2143.300246325,-79
carcassonne-ucttuned440-vs-ucttuned170-1000its,709,788,2204.23532019,2114.648844919,-79
carcassonne-ucttuned410-vs-ucttuned495-1000its,711,790,2226.800796092,2155.974740905,-79
carcassonne-boltzmann100-vs-boltzmann465-1000its,715,794,2227.290256098,2172.003049888,-79
carcassonne-uct140-vs-uct260-1000its,716,795,2225.768218589,2185.633912026,-79
carcassonne-ucttuned200-vs-ucttuned410-1000its,717,796,2140.253463515,2043.393225652,-79
carcassonne-boltzmann55-vs-boltzmann285-1000its,720,799,2190.545242981,2143.257594391,-79
carcassonne-boltzmann360-vs-boltzmann395-1000its,721,800,2209.558086162,2192.509628692,-79
carcassonne-uct475-vs-uct240-1000its,724,803,2239.310954966,2187.348472759,-79
carcassonne-ucttuned390-vs-ucttuned55-1000its,729,808,2214.347910161,2168.399617211,-79
carcassonne-boltzmann130-vs-boltzmann325-1000its,731,810,2224.007547213,2180.897664961,-79
carcassonne-egreedy-1div5-vs-egreedy-1div10-1000its,733,812,2075.884052652,2045.988670668,-79
carcassonne-boltzmann245-vs-boltzmann495-1000its,738,817,2163.183774164,2166.608287647,-79
carcassonne-uct55-vs-uct150-1000its,739,818,2266.352148772,2179.356901873,-79
carcassonne-ucttuned245-vs-ucttuned355-1000its,739,818,2215.098885543,2164.425960492,-79
carcassonne-ucttuned495-vs-ucttuned420-1000its,740,819,2196.501184153,2180.450397493,-79
carcassonne-ucttuned415-vs-ucttuned150-1000its,746,825,2172.441355555,2152.373314828,-79
carcassonne-ucttuned420-vs-ucttuned125-1000its,746,825,2136.328486278,2110.79740613,-79
carcassonne-boltzmann290-vs-boltzmann380-1000its,747,826,2193.73987338,2147.432087304,-79
carcassonne-boltzmann190-vs-boltzmann225-1000its,749,828,2220.733144416,2151.206369149,-79
carcassonne-boltzmann250-vs-boltzmann380-1000its,749,828,2270.769975387,2237.659751675,-79
carcassonne-uct425-vs-uct455-1000its,750,829,2214.058821324,2140.583659718,-79
carcassonne-uct435-vs-uct430-1000its,751,830,2193.248442691,2171.000901984,-79
carcassonne-ucttuned240-vs-ucttuned260-1000its,751,830,2211.754560753,2139.251654065,-79
carcassonne-boltzmann65-vs-boltzmann5-1000its,754,833,2137.765205092,2091.534840068,-79
carcassonne-boltzmann90-vs-boltzmann40-1000its,754,833,2145.345782721,2088.130928386,-79
carcassonne-boltzmann360-vs-boltzmann455-1000its,756,835,2151.184445838,2089.253576419,-79
carcassonne-ucttuned45-vs-ucttuned25-1000its,758,837,2210.451502373,2151.767830637,-79
carcassonne-uct50-vs-uct380-1000its,763,842,2163.089346534,2141.647632733,-79
carcassonne-boltzmann55-vs-boltzmann260-1000its,764,843,2185.343522711,2137.29839139,-79
carcassonne-boltzmann85-vs-boltzmann430-1000its,765,844,2182.745599488,2123.154421634,-79
carcassonne-uct155-vs-uct355-1000its,765,844,2202.146030017,2159.279838612,-79
carcassonne-boltzmann470-vs-boltzmann150-1000its,767,846,2216.799057557,2211.930088515,-79
carcassonne-ucttuned205-vs-ucttuned320-1000its,767,846,2177.757190331,2064.143638408,-79
carcassonne-boltzmann300-vs-boltzmann90-1000its,769,848,2150.121661265,2122.999533279,-79
carcassonne-boltzmann370-vs-boltzmann70-1000its,769,848,2183.72740142,2164.091649815,-79
carcassonne-ucttuned155-vs-ucttuned225-1000its,769,848,2198.504896242,2139.668913208,-79
carcassonne-boltzmann260-vs-boltzmann30-1000its,770,849,2217.950719543,2195.028879718,-79
carcassonne-boltzmann345-vs-boltzmann25-1000its,771,850,2177.706887605,2108.860399282,-79
carcassonne-uct140-vs-uct425-1000its,772,851,2129.598099331,2083.091771384,-79
carcassonne-uct230-vs-uct135-1000its,773,852,2201.121180373,2169.052632268,-79
carcassonne-uct470-vs-uct475-1000its,774,853,2168.332121747,2173.76170851,-79
carcassonne-uct110-vs-uct120-1000its,777,856,2212.547018505,2183.906400598,-79
carcassonne-boltzmann30-vs-boltzmann40-1000its,778,857,2264.965807526,2185.452158879,-79
carcassonne-ucttuned475-vs-ucttuned95-1000its,778,857,2115.396940239,2130.883139304,-79
carcassonne-ucttuned425-vs-ucttuned155-1000its,779,858,2193.819500049,2130.770367331,-79
carcassonne-ucttuned30-vs-ucttuned190-1000its,780,859,2268.156652319,2214.49009775,-79
carcassonne-ucttuned490-vs-ucttuned380-1000its,780,859,2153.199214818,2137.310042822,-79
carcassonne-ucttuned245-vs-ucttuned85-1000its,782,861,2218.479168135,2148.523433049,-79
carcassonne-ucttuned85-vs-ucttuned365-1000its,782,861,2215.667002733,2191.686551237,-79
carcassonne-boltzmann10-vs-boltzmann280-1000its,783,862,2207.661281395,2150.051034112,-79
carcassonne-boltzmann255-vs-boltzmann60-1000its,783,862,2197.59350753,2177.797009913,-79
carcassonne-ucttuned380-vs-ucttuned430-1000its,784,863,2248.116187115,2185.891532138,-79
carcassonne-boltzmann435-vs-boltzmann185-1000its,787,866,2336.242313709,2290.657055833,-79
carcassonne-ucttuned360-vs-ucttuned340-1000its,787,866,2181.375071837,2125.955153595,-79
carcassonne-ucttuned325-vs-ucttuned45-1000its,788,867,2156.876345536,2129.788335175,-79
carcassonne-uct240-vs-uct350-1000its,792,871,2154.879101793,2120.602778586,-79
carcassonne-boltzmann390-vs-boltzmann400-1000its,794,873,2261.315882251,2181.694010049,-79
carcassonne-boltzmann55-vs-boltzmann70-1000its,797,876,2211.475354373,2179.586939063,-79
carcassonne-uct180-vs-uct370-1000its,798,877,2156.308391869,2131.356619772,-79
carcassonne-ucttuned450-vs-ucttuned200-1000its,798,877,2228.857436278,2201.084507072,-79
carcassonne-uct140-vs-uct295-1000its,799,878,2157.93911418,2096.503482804,-79
carcassonne-uct340-vs-uct355-1000its,805,884,2250.655694397,2215.704644132,-79
carcassonne-ucttuned360-vs-ucttuned470-1000its,808,887,2147.23625603,2106.765479295,-79
carcassonne-uct370-vs-uct285-1000its,816,895,2219.515060764,2136.219499373,-79
carcassonne-uct165-vs-uct345-1000its,817,896,2159.038649891,2117.17007653,-79
carcassonne-uct35-vs-uct300-1000its,819,898,2247.05901868,2196.767707699,-79
carcassonne-ucttuned245-vs-ucttuned405-1000its,821,900,2236.530840898,2190.245865704,-79
carcassonne-boltzmann105-vs-boltzmann40-1000its,829,908,2258.362336491,2187.166552426,-79
carcassonne-boltzmann155-vs-boltzmann100-1000its,831,910,2212.692069639,2164.268855765,-79
carcassonne-boltzmann135-vs-boltzmann315-1000its,835,914,2232.342679626,2193.729314207,-79
carcassonne-uct375-vs-uct275-1000its,841,920,2206.013386374,2140.011393664,-79
carcassonne-ucttuned145-vs-ucttuned55-1000its,841,920,2160.518980743,2132.698859901,-79
carcassonne-ucttuned175-vs-ucttuned290-1000its,842,921,2173.563468518,2160.909989756,-79
carcassonne-ucttuned20-vs-ucttuned15-1000its,857,936,2152.486995771,2109.238957831,-79
carcassonne-uct270-vs-uct65-1000its,866,945,2127.34654421,2064.973808364,-79
carcassonne-uct125-vs-uct230-1000its,684,762,2227.578407834,2201.720737634,-78
carcassonne-uct185-vs-uct375-1000its,689,767,2206.278986586,2162.238525362,-78
carcassonne-ucttuned285-vs-ucttuned185-1000its,692,770,2190.022134935,2138.491823909,-78
carcassonne-ucttuned435-vs-ucttuned490-1000its,702,780,2229.803912788,2153.659825923,-78
carcassonne-ucttuned210-vs-ucttuned140-1000its,703,781,2156.736786988,2093.087054669,-78
carcassonne-ucttuned460-vs-ucttuned75-1000its,703,781,2141.057365678,2082.776982895,-78
carcassonne-ucttuned380-vs-ucttuned165-1000its,706,784,2197.779222167,2151.580332955,-78
carcassonne-ucttuned390-vs-ucttuned215-1000its,706,784,2216.259570361,2161.312365884,-78
carcassonne-boltzmann115-vs-boltzmann385-1000its,707,785,2188.868417425,2150.481920768,-78
carcassonne-uct200-vs-uct340-1000its,711,789,2250.077556648,2193.740538746,-78
carcassonne-uct180-vs-uct320-1000its,717,795,2138.878120165,2065.603778914,-78
carcassonne-uct285-vs-uct40-1000its,722,800,2227.178269189,2177.68229225,-78
carcassonne-ucttuned155-vs-ucttuned370-1000its,725,803,2201.568470824,2169.027185709,-78
carcassonne-ucttuned55-vs-ucttuned75-1000its,727,805,2229.118776489,2144.751208524,-78
carcassonne-ucttuned495-vs-ucttuned350-1000its,728,806,2241.202468581,2175.193193295,-78
carcassonne-ucttuned235-vs-ucttuned150-1000its,729,807,2203.773704415,2148.69716732,-78
carcassonne-ucttuned280-vs-ucttuned455-1000its,729,807,2238.623726549,2156.869372101,-78
carcassonne-ucttuned280-vs-ucttuned80-1000its,729,807,2166.782604894,2116.267972367,-78
carcassonne-boltzmann455-vs-boltzmann480-1000its,730,808,2146.812915314,2094.79931177,-78
carcassonne-ucttuned425-vs-ucttuned410-1000its,731,809,2164.784723985,2113.730780377,-78
carcassonne-ucttuned460-vs-ucttuned440-1000its,733,811,2128.033476796,2167.696323765,-78
carcassonne-uct290-vs-uct370-1000its,734,812,2207.752858416,2193.890017489,-78
carcassonne-boltzmann320-vs-boltzmann170-1000its,737,815,2298.292500965,2280.608473507,-78
carcassonne-boltzmann335-vs-boltzmann410-1000its,737,815,2244.605294492,2168.971840371,-78
carcassonne-ucttuned350-vs-ucttuned140-1000its,738,816,2282.383937552,2198.672131248,-78
carcassonne-uct495-vs-uct90-1000its,741,819,2179.220877889,2149.248180217,-78
carcassonne-boltzmann130-vs-boltzmann70-1000its,742,820,2253.162552404,2172.753187679,-78
carcassonne-boltzmann335-vs-boltzmann305-1000its,743,821,2269.378724995,2228.024788691,-78
carcassonne-uct280-vs-uct270-1000its,743,821,2153.466838784,2126.387596457,-78
carcassonne-boltzmann345-vs-boltzmann305-1000its,746,824,2176.370767636,2150.690762675,-78
carcassonne-boltzmann75-vs-boltzmann295-1000its,747,825,2167.578028249,2103.863585034,-78
carcassonne-boltzmann250-vs-boltzmann425-1000its,758,836,2220.89958966,2134.163827644,-78
carcassonne-uct125-vs-uct170-1000its,758,836,2147.784555437,2097.008267415,-78
carcassonne-uct320-vs-uct160-1000its,758,836,2131.205756788,2078.580464322,-78
carcassonne-uct315-vs-uct205-1000its,760,838,2238.685865197,2230.756114606,-78
carcassonne-uct425-vs-uct345-1000its,761,839,2233.758073814,2165.176452537,-78
carcassonne-boltzmann25-vs-boltzmann65-1000its,767,845,2190.785458294,2090.135509978,-78
carcassonne-ucttuned275-vs-ucttuned50-1000its,772,850,2166.819415876,2118.030909607,-78
carcassonne-uct280-vs-uct230-1000its,774,852,2226.36088297,2164.46707962,-78
carcassonne-ucttuned180-vs-ucttuned485-1000its,774,852,2273.519911964,2227.543468649,-78
carcassonne-boltzmann340-vs-boltzmann415-1000its,775,853,2177.450099074,2152.61718644,-78
carcassonne-boltzmann465-vs-boltzmann360-1000its,775,853,2276.026050677,2237.384397236,-78
carcassonne-ucttuned130-vs-ucttuned200-1000its,779,857,2192.416784786,2167.230760298,-78
carcassonne-boltzmann190-vs-boltzmann245-1000its,780,858,2187.273770246,2140.455751497,-78
carcassonne-ucttuned400-vs-ucttuned410-1000its,780,858,2202.919817555,2155.872709927,-78
carcassonne-boltzmann465-vs-boltzmann105-1000its,782,860,2178.378579818,2180.379058235,-78
carcassonne-boltzmann330-vs-boltzmann90-1000its,783,861,2200.73592569,2119.580781663,-78
carcassonne-ucttuned120-vs-ucttuned445-1000its,785,863,2209.218638103,2161.2787801,-78
carcassonne-ucttuned280-vs-ucttuned170-1000its,786,864,2208.437274739,2155.990825738,-78
carcassonne-boltzmann450-vs-boltzmann45-1000its,787,865,2192.630366743,2141.003583667,-78
carcassonne-uct140-vs-uct245-1000its,787,865,2206.262212249,2150.261353064,-78
carcassonne-uct100-vs-uct465-1000its,791,869,2243.380958362,2162.915175461,-78
carcassonne-ucttuned185-vs-ucttuned35-1000its,792,870,2224.73956076,2180.299624255,-78
carcassonne-ucttuned90-vs-ucttuned145-1000its,793,871,2173.293879596,2098.229650069,-78
carcassonne-ucttuned290-vs-ucttuned225-1000its,800,878,2298.150746279,2231.816318885,-78
carcassonne-boltzmann205-vs-boltzmann250-1000its,801,879,2186.450704412,2177.894410014,-78
carcassonne-uct250-vs-uct240-1000its,801,879,2242.14555797,2216.005842288,-78
carcassonne-uct335-vs-uct280-1000its,801,879,2172.139114073,2141.851201324,-78
carcassonne-uct240-vs-uct70-1000its,803,881,2233.585086549,2176.755975703,-78
carcassonne-uct485-vs-uct85-1000its,803,881,2258.28267854,2282.262315322,-78
carcassonne-boltzmann255-vs-boltzmann5-1000its,804,882,2240.034832448,2183.226355777,-78
carcassonne-uct400-vs-uct75-1000its,804,882,2201.959895345,2195.930430263,-78
carcassonne-ucttuned90-vs-ucttuned455-1000its,805,883,2181.509231524,2098.36456868,-78
carcassonne-uct435-vs-uct195-1000its,810,888,2128.341145685,2075.492286602,-78
carcassonne-uct235-vs-uct390-1000its,815,893,2247.174918749,2171.105560825,-78
carcassonne-boltzmann305-vs-boltzmann235-1000its,816,894,2212.03596253,2192.676313734,-78
carcassonne-ucttuned95-vs-ucttuned490-1000its,816,894,2261.114086866,2188.301026974,-78
carcassonne-uct325-vs-uct15-1000its,823,901,2186.520619159,2151.174337371,-78
carcassonne-ucttuned295-vs-ucttuned15-1000its,823,901,2166.902362768,2135.947032082,-78
carcassonne-boltzmann205-vs-boltzmann10-1000its,825,903,2192.180124538,2180.737739522,-78
carcassonne-uct210-vs-uct140-1000its,825,903,2124.567960377,2150.182400714,-78
carcassonne-uct490-vs-uct140-1000its,831,909,2234.51793335,2139.102819542,-78
carcassonne-uct145-vs-uct185-1000its,833,911,2185.138559877,2138.999761065,-78
carcassonne-uct85-vs-uct75-1000its,836,914,2159.675580239,2181.0158121,-78
carcassonne-uct395-vs-uct425-1000its,842,920,2121.307172822,2109.764081516,-78
carcassonne-uct85-vs-uct180-1000its,843,921,2269.736352925,2222.645952103,-78
carcassonne-boltzmann475-vs-boltzmann480-1000its,846,924,2255.702191169,2166.54618506,-78
carcassonne-uct140-vs-uct110-1000its,862,940,2170.394940572,2141.822438461,-78
carcassonne-ucttuned425-vs-ucttuned5-1000its,883,961,2201.87796122,2115.569344654,-78
carcassonne-uct425-vs-uct105-1000its,690,767,2297.002931165,2251.673948786,-77
carcassonne-ucttuned405-vs-ucttuned105-1000its,692,769,2201.703101375,2159.646471992,-77
carcassonne-boltzmann120-vs-boltzmann130-1000its,695,772,2174.914418876,2113.676118458,-77
carcassonne-uct160-vs-uct10-1000its,695,772,2224.422473877,2217.159973164,-77
carcassonne-boltzmann310-vs-boltzmann475-1000its,701,778,2200.568002585,2151.369352081,-77
carcassonne-uct85-vs-uct395-1000its,707,784,2183.766299234,2109.508109379,-77
carcassonne-boltzmann40-vs-boltzmann305-1000its,708,785,2166.111825746,2069.67633596,-77
carcassonne-boltzmann215-vs-boltzmann160-1000its,709,786,2263.550919093,2211.268723693,-77
carcassonne-boltzmann465-vs-boltzmann70-1000its,713,790,2190.92230075,2146.538917521,-77
carcassonne-boltzmann370-vs-boltzmann330-1000its,715,792,2217.690309622,2162.708852486,-77
carcassonne-ucttuned185-vs-ucttuned420-1000its,717,794,2216.942163177,2136.234144175,-77
carcassonne-boltzmann225-vs-boltzmann240-1000its,721,798,2178.685298089,2129.830517978,-77
carcassonne-boltzmann65-vs-boltzmann210-1000its,731,808,2159.964402552,2139.15066776,-77
carcassonne-uct105-vs-uct320-1000its,731,808,2251.059180402,2182.531602436,-77
carcassonne-boltzmann160-vs-boltzmann105-1000its,734,811,2166.566988502,2172.463195384,-77
carcassonne-uct495-vs-uct350-1000its,734,811,2204.972117057,2123.965339934,-77
carcassonne-ucttuned360-vs-ucttuned235-1000its,735,812,2153.200731374,2108.827530133,-77
carcassonne-ucttuned175-vs-ucttuned90-1000its,736,813,2151.942561974,2113.526696282,-77
carcassonne-boltzmann140-vs-boltzmann90-1000its,737,814,2188.289191775,2178.862926712,-77
carcassonne-ucttuned330-vs-ucttuned50-1000its,737,814,2264.532583173,2178.924977077,-77
carcassonne-ucttuned375-vs-ucttuned245-1000its,738,815,2165.142665331,2141.060838509,-77
carcassonne-uct45-vs-uct310-1000its,740,817,2288.38964639,2212.16415814,-77
carcassonne-boltzmann370-vs-boltzmann160-1000its,741,818,2119.611316863,2137.39784432,-77
carcassonne-boltzmann375-vs-boltzmann135-1000its,741,818,2186.391062102,2117.079165316,-77
carcassonne-uct295-vs-uct150-1000its,741,818,2232.620537285,2161.870192584,-77
carcassonne-boltzmann295-vs-boltzmann250-1000its,743,820,2203.681197561,2140.315376746,-77
carcassonne-boltzmann110-vs-boltzmann115-1000its,745,822,2185.401108035,2127.409088885,-77
carcassonne-ucttuned180-vs-ucttuned395-1000its,749,826,2230.497849717,2165.787130828,-77
carcassonne-boltzmann250-vs-boltzmann265-1000its,750,827,2230.878389858,2198.19236967,-77
carcassonne-boltzmann145-vs-boltzmann380-1000its,755,832,2164.5188849,2145.565966979,-77
carcassonne-boltzmann350-vs-boltzmann40-1000its,755,832,2275.322879263,2224.320803367,-77
carcassonne-ucttuned110-vs-ucttuned435-1000its,755,832,2139.411004725,2098.702756156,-77
carcassonne-boltzmann480-vs-boltzmann175-1000its,757,834,2110.576806654,2112.068801091,-77
carcassonne-boltzmann390-vs-boltzmann135-1000its,758,835,2177.750960937,2171.99156767,-77
carcassonne-ucttuned220-vs-ucttuned480-1000its,758,835,2110.225636239,2100.645194772,-77
carcassonne-boltzmann135-vs-boltzmann70-1000its,759,836,2210.909354266,2206.740741608,-77
carcassonne-uct105-vs-uct390-1000its,760,837,2211.101894912,2211.706238591,-77
carcassonne-uct385-vs-uct440-1000its,760,837,2148.591125529,2118.719192142,-77
carcassonne-uct420-vs-uct315-1000its,760,837,2200.29868292,2185.771856541,-77
carcassonne-boltzmann400-vs-boltzmann15-1000its,762,839,2161.981010346,2117.854211192,-77
carcassonne-boltzmann120-vs-boltzmann405-1000its,764,841,2235.982080677,2207.973617353,-77
carcassonne-boltzmann370-vs-boltzmann220-1000its,764,841,2172.39942735,2185.586332275,-77
carcassonne-boltzmann275-vs-boltzmann135-1000its,767,844,2171.677442113,2132.801447631,-77
carcassonne-boltzmann280-vs-boltzmann115-1000its,767,844,2286.421938157,2247.47832394,-77
carcassonne-ucttuned490-vs-ucttuned140-1000its,768,845,2197.604826639,2125.524142425,-77
carcassonne-boltzmann115-vs-boltzmann80-1000its,770,847,2177.36211181,2061.654450821,-77
carcassonne-uct190-vs-uct130-1000its,770,847,2182.189441993,2148.236874415,-77
carcassonne-uct115-vs-uct185-1000its,771,848,2199.78389188,2171.627770869,-77
carcassonne-ucttuned135-vs-ucttuned15-1000its,771,848,2238.91048014,2224.387449159,-77
carcassonne-boltzmann410-vs-boltzmann195-1000its,772,849,2246.394901049,2149.296326933,-77
carcassonne-boltzmann240-vs-boltzmann305-1000its,774,851,2173.247693454,2147.659693295,-77
carcassonne-ucttuned145-vs-ucttuned25-1000its,774,851,2222.456991521,2231.073778209,-77
carcassonne-ucttuned125-vs-ucttuned310-1000its,775,852,2203.281999105,2174.236845728,-77
carcassonne-uct340-vs-uct260-1000its,778,855,2166.250627012,2084.566806884,-77
carcassonne-ucttuned135-vs-ucttuned280-1000its,780,857,2211.690508744,2163.037497794,-77
carcassonne-boltzmann305-vs-boltzmann120-1000its,781,858,2200.261004827,2150.375203964,-77
carcassonne-uct395-vs-uct185-1000its,781,858,2204.339180983,2175.042699415,-77
carcassonne-ucttuned190-vs-ucttuned10-1000its,781,858,2166.687100994,2171.248043189,-77
carcassonne-ucttuned80-vs-ucttuned70-1000its,781,858,2245.757788774,2200.875243673,-77
carcassonne-boltzmann295-vs-boltzmann140-1000its,782,859,2186.463768696,2120.338119027,-77
carcassonne-boltzmann195-vs-boltzmann15-1000its,784,861,2262.112770923,2187.268952383,-77
carcassonne-boltzmann220-vs-boltzmann365-1000its,784,861,2148.258249662,2090.980960883,-77
carcassonne-uct440-vs-uct490-1000its,784,861,2162.831939498,2137.713707547,-77
carcassonne-ucttuned300-vs-ucttuned485-1000its,784,861,2290.028275853,2200.168523583,-77
carcassonne-uct250-vs-uct30-1000its,785,862,2196.414168154,2112.883197454,-77
carcassonne-boltzmann255-vs-boltzmann75-1000its,786,863,2225.538489903,2154.095731378,-77
carcassonne-ucttuned420-vs-ucttuned410-1000its,786,863,2219.352137061,2211.644114674,-77
carcassonne-uct130-vs-uct390-1000its,787,864,2201.320365941,2147.363222642,-77
carcassonne-boltzmann180-vs-boltzmann240-1000its,788,865,2191.881344302,2155.411006514,-77
carcassonne-boltzmann100-vs-boltzmann140-1000its,791,868,2184.811714125,2079.692927165,-77
carcassonne-boltzmann490-vs-boltzmann390-1000its,791,868,2243.290602999,2207.073625071,-77
carcassonne-uct130-vs-uct135-1000its,793,870,2105.154565881,2088.832342887,-77
carcassonne-ucttuned495-vs-ucttuned40-1000its,797,874,2230.973232923,2254.201107305,-77
carcassonne-uct420-vs-uct135-1000its,798,875,2170.95861753,2149.600638527,-77
carcassonne-uct220-vs-uct355-1000its,799,876,2266.40278715,2190.144670344,-77
carcassonne-ucttuned5-vs-ucttuned175-1000its,802,879,2199.51702655,2224.941131533,-77
carcassonne-boltzmann335-vs-boltzmann455-1000its,803,880,2255.124225542,2167.195378426,-77
carcassonne-boltzmann480-vs-boltzmann485-1000its,803,880,2227.402739181,2209.61385077,-77
carcassonne-ucttuned165-vs-ucttuned300-1000its,811,888,2176.694696001,2132.810269584,-77
carcassonne-ucttuned105-vs-ucttuned5-1000its,815,892,2220.295570425,2187.701048966,-77
carcassonne-boltzmann360-vs-boltzmann80-1000its,818,895,2161.647962535,2096.965225503,-77
carcassonne-ucttuned325-vs-ucttuned20-1000its,821,898,2238.096344045,2196.813410248,-77
carcassonne-boltzmann230-vs-boltzmann310-1000its,826,903,2191.151854547,2176.905048643,-77
carcassonne-uct350-vs-uct305-1000its,827,904,2154.393602128,2107.621286855,-77
carcassonne-ucttuned125-vs-ucttuned375-1000its,832,909,2245.886288305,2182.667869867,-77
carcassonne-ucttuned240-vs-ucttuned30-1000its,842,919,2216.724915765,2203.080116984,-77
carcassonne-ucttuned320-vs-ucttuned25-1000its,843,920,2184.910183264,2138.526611726,-77
carcassonne-ucttuned25-vs-ucttuned40-1000its,875,952,2134.593984211,2086.607095774,-77
carcassonne-ucttuned350-vs-ucttuned405-1000its,585,661,1773.38892536,1707.283847668,-76
carcassonne-uct230-vs-uct260-1000its,639,715,1758.242247034,1718.199917752,-76
carcassonne-boltzmann400-vs-boltzmann215-1000its,680,756,2204.456183537,2138.400033164,-76
carcassonne-uct330-vs-uct390-1000its,684,760,2241.083892695,2199.035364484,-76
carcassonne-uct15-vs-uct25-1000its,699,775,2254.054275524,2189.018736343,-76
carcassonne-boltzmann295-vs-boltzmann5-1000its,710,786,2221.227788999,2162.907249809,-76
carcassonne-ucttuned485-vs-ucttuned30-1000its,710,786,2169.601805457,2142.008290673,-76
carcassonne-ucttuned445-vs-ucttuned210-1000its,712,788,2137.134086742,2108.504886901,-76
carcassonne-uct75-vs-uct280-1000its,713,789,2226.243015872,2195.81118318,-76
carcassonne-boltzmann285-vs-boltzmann10-1000its,716,792,2240.521315272,2201.643796644,-76
carcassonne-boltzmann305-vs-boltzmann340-1000its,716,792,2274.923262886,2213.484022502,-76
carcassonne-boltzmann455-vs-boltzmann125-1000its,717,793,2159.757598548,2116.377162806,-76
carcassonne-uct330-vs-uct355-1000its,719,795,2175.309682862,2142.056254604,-76
carcassonne-ucttuned480-vs-ucttuned130-1000its,721,797,2171.509240885,2148.587293938,-76
carcassonne-boltzmann10-vs-boltzmann285-1000its,723,799,2157.1664829,2131.537697737,-76
carcassonne-boltzmann265-vs-boltzmann110-1000its,723,799,2191.005806452,2139.66147203,-76
carcassonne-uct215-vs-uct175-1000its,726,802,2206.196392759,2173.357000495,-76
carcassonne-ucttuned390-vs-ucttuned95-1000its,726,802,2196.102953683,2140.336337388,-76
carcassonne-ucttuned435-vs-ucttuned240-1000its,727,803,2260.780989179,2228.867106559,-76
carcassonne-boltzmann390-vs-boltzmann465-1000its,728,804,2202.552236393,2166.207441862,-76
carcassonne-ucttuned340-vs-ucttuned105-1000its,728,804,2166.957471205,2130.103725975,-76
carcassonne-boltzmann265-vs-boltzmann70-1000its,733,809,2289.422408415,2231.253342876,-76
carcassonne-boltzmann45-vs-boltzmann170-1000its,739,815,2204.949551054,2168.850402119,-76
carcassonne-boltzmann250-vs-boltzmann375-1000its,741,817,2188.239025028,2143.701489138,-76
carcassonne-uct185-vs-uct420-1000its,744,820,2212.204096905,2145.1494084,-76
carcassonne-boltzmann455-vs-boltzmann370-1000its,745,821,2164.81206067,2161.717441011,-76
carcassonne-uct160-vs-uct170-1000its,747,823,2217.200370649,2157.950728046,-76
carcassonne-uct200-vs-uct335-1000its,748,824,2149.574832473,2186.17731473,-76
carcassonne-ucttuned445-vs-ucttuned20-1000its,748,824,2158.754005138,2157.784901256,-76
carcassonne-boltzmann260-vs-boltzmann100-1000its,749,825,2177.503300387,2152.225963848,-76
carcassonne-boltzmann470-vs-boltzmann205-1000its,749,825,2152.302915269,2072.442746621,-76
carcassonne-uct170-vs-uct260-1000its,750,826,2256.737070052,2241.367901978,-76
carcassonne-uct365-vs-uct175-1000its,753,829,2260.434345541,2151.346148271,-76
carcassonne-uct375-vs-uct105-1000its,756,832,2191.585508062,2167.716415587,-76
carcassonne-uct120-vs-uct445-1000its,757,833,2177.753257156,2184.4182997,-76
carcassonne-uct370-vs-uct495-1000its,757,833,2184.739955565,2118.331504405,-76
carcassonne-ucttuned115-vs-ucttuned465-1000its,757,833,2203.548778144,2154.843989866,-76
carcassonne-boltzmann35-vs-boltzmann415-1000its,758,834,2246.824980516,2208.416146275,-76
carcassonne-ucttuned185-vs-ucttuned295-1000its,758,834,2180.680395428,2169.012720141,-76
carcassonne-ucttuned320-vs-ucttuned95-1000its,758,834,2214.802622829,2158.533629754,-76
carcassonne-ucttuned310-vs-ucttuned285-1000its,759,835,2207.853008707,2213.859243773,-76
carcassonne-boltzmann460-vs-boltzmann40-1000its,762,838,2162.375312919,2184.677115978,-76
carcassonne-ucttuned405-vs-ucttuned345-1000its,762,838,2244.00191684,2214.502026589,-76
carcassonne-ucttuned115-vs-ucttuned195-1000its,763,839,2108.081561468,2098.771860722,-76
carcassonne-boltzmann65-vs-boltzmann145-1000its,768,844,2169.238846315,2110.08238827,-76
carcassonne-uct360-vs-uct115-1000its,769,845,2177.945567983,2123.98085239,-76
carcassonne-uct455-vs-uct330-1000its,769,845,2272.951127468,2214.5456425,-76
carcassonne-boltzmann315-vs-boltzmann165-1000its,770,846,2237.978741894,2195.15698206,-76
carcassonne-uct260-vs-uct455-1000its,776,852,2307.601305277,2201.889386321,-76
carcassonne-boltzmann475-vs-boltzmann300-1000its,780,856,2121.919662562,2054.433911737,-76
carcassonne-ucttuned225-vs-ucttuned415-1000its,780,856,2223.111956672,2171.048637425,-76
carcassonne-ucttuned300-vs-ucttuned135-1000its,780,856,2145.146106864,2073.57839989,-76
carcassonne-uct120-vs-uct285-1000its,781,857,2161.676188427,2119.390435096,-76
carcassonne-boltzmann210-vs-boltzmann10-1000its,782,858,2157.749716854,2108.78727195,-76
carcassonne-boltzmann235-vs-boltzmann480-1000its,782,858,2154.985174814,2156.758826773,-76
carcassonne-ucttuned215-vs-ucttuned355-1000its,783,859,2173.687209295,2143.295228923,-76
carcassonne-ucttuned350-vs-ucttuned235-1000its,783,859,2163.243931759,2149.12455723,-76
carcassonne-boltzmann80-vs-boltzmann295-1000its,784,860,2281.070350773,2240.558418706,-76
carcassonne-uct490-vs-uct305-1000its,785,861,2205.288997708,2167.55275635,-76
carcassonne-boltzmann485-vs-boltzmann40-1000its,787,863,2236.449129734,2158.04755117,-76
carcassonne-boltzmann70-vs-boltzmann370-1000its,787,863,2190.430500874,2150.594132565,-76
carcassonne-uct130-vs-uct125-1000its,787,863,2175.50845157,2185.578053952,-76
carcassonne-boltzmann335-vs-boltzmann170-1000its,789,865,2199.396886335,2121.337133592,-76
carcassonne-ucttuned130-vs-ucttuned155-1000its,789,865,2207.566997815,2140.513456592,-76
carcassonne-boltzmann60-vs-boltzmann130-1000its,790,866,2281.4420593,2228.167841177,-76
carcassonne-ucttuned350-vs-ucttuned280-1000its,790,866,2204.743483945,2176.959004025,-76
carcassonne-ucttuned70-vs-ucttuned310-1000its,792,868,2128.561670039,2097.311220266,-76
carcassonne-uct445-vs-uct70-1000its,793,869,2236.842733878,2206.902640317,-76
carcassonne-boltzmann25-vs-boltzmann450-1000its,795,871,2180.432216173,2122.852528456,-76
carcassonne-uct195-vs-uct45-1000its,796,872,2298.215855083,2215.222681695,-76
carcassonne-ucttuned255-vs-ucttuned410-1000its,797,873,2256.019542526,2174.531352475,-76
carcassonne-boltzmann130-vs-boltzmann470-1000its,803,879,2180.920042346,2172.662035439,-76
carcassonne-boltzmann480-vs-boltzmann115-1000its,803,879,2210.900084191,2177.880159527,-76
carcassonne-ucttuned225-vs-ucttuned15-1000its,804,880,2177.062463379,2136.337179279,-76
carcassonne-ucttuned250-vs-ucttuned10-1000its,804,880,2298.599902853,2276.465341817,-76
carcassonne-uct285-vs-uct105-1000its,805,881,2187.05963898,2090.490192096,-76
carcassonne-ucttuned320-vs-ucttuned40-1000its,806,882,2226.284023531,2168.581806583,-76
carcassonne-uct245-vs-uct415-1000its,811,887,2240.561312696,2179.323881787,-76
carcassonne-uct335-vs-uct425-1000its,813,889,2161.457628969,2117.358019499,-76
carcassonne-uct375-vs-uct215-1000its,813,889,2154.328002569,2079.277854558,-76
carcassonne-ucttuned315-vs-ucttuned35-1000its,813,889,2153.583730984,2125.025872026,-76
carcassonne-boltzmann335-vs-boltzmann5-1000its,814,890,2119.616606694,2134.31856892,-76
carcassonne-ucttuned160-vs-ucttuned15-1000its,816,892,2119.200097961,2102.61193245,-76
carcassonne-uct375-vs-uct295-1000its,818,894,2177.776670987,2137.354408423,-76
carcassonne-uct275-vs-uct90-1000its,819,895,2291.072500523,2239.960178963,-76
carcassonne-uct350-vs-uct100-1000its,823,899,2144.705102656,2084.135200433,-76
carcassonne-ucttuned80-vs-ucttuned20-1000its,823,899,2229.562029616,2106.702257361,-76
carcassonne-uct305-vs-uct460-1000its,824,900,2144.504032988,2136.578168673,-76
carcassonne-uct55-vs-uct315-1000its,824,900,2181.923556621,2133.412057514,-76
carcassonne-ucttuned490-vs-ucttuned175-1000its,832,908,2165.456448143,2105.799715055,-76
carcassonne-ucttuned365-vs-ucttuned240-1000its,833,909,2216.797299847,2190.47177773,-76
carcassonne-boltzmann435-vs-boltzmann410-1000its,834,910,2214.953855382,2094.315990394,-76
carcassonne-ucttuned330-vs-ucttuned95-1000its,838,914,2213.989086612,2190.735119006,-76
carcassonne-ucttuned75-vs-ucttuned10-1000its,842,918,2145.984293129,2113.337156348,-76
carcassonne-ucttuned305-vs-ucttuned35-1000its,848,924,2157.148174245,2116.322748317,-76
carcassonne-ucttuned340-vs-ucttuned390-1000its,856,932,2205.668254032,2145.227173049,-76
carcassonne-boltzmann365-vs-boltzmann470-1000its,696,771,2182.841892463,2110.020115317,-75
carcassonne-ucttuned180-vs-ucttuned85-1000its,696,771,2149.979240336,2157.486865701,-75
carcassonne-ucttuned125-vs-ucttuned355-1000its,700,775,2238.60965297,2175.58675052,-75
carcassonne-uct210-vs-uct480-1000its,701,776,2284.152656375,2201.669582432,-75
carcassonne-ucttuned175-vs-ucttuned30-1000its,717,792,2191.059674493,2188.153066918,-75
carcassonne-boltzmann210-vs-boltzmann420-1000its,720,795,2281.671947445,2241.939971229,-75
carcassonne-boltzmann470-vs-boltzmann240-1000its,724,799,2121.928198658,2132.104644473,-75
carcassonne-uct210-vs-uct340-1000its,726,801,2162.987647154,2099.791463868,-75
carcassonne-ucttuned150-vs-ucttuned165-1000its,726,801,2259.809770634,2220.305780556,-75
carcassonne-uct335-vs-uct120-1000its,733,808,2109.82772003,2101.940853224,-75
carcassonne-boltzmann265-vs-boltzmann445-1000its,736,811,2189.27917528,2149.156665466,-75
carcassonne-boltzmann215-vs-boltzmann165-1000its,737,812,2178.534333962,2139.092748151,-75
carcassonne-ucttuned400-vs-ucttuned375-1000its,739,814,2179.949706045,2150.227756157,-75
carcassonne-ucttuned30-vs-ucttuned230-1000its,740,815,2248.135456659,2195.542366804,-75
carcassonne-boltzmann345-vs-boltzmann490-1000its,745,820,2168.282520512,2144.308765469,-75
carcassonne-boltzmann485-vs-boltzmann440-1000its,745,820,2174.619657783,2164.655840344,-75
carcassonne-boltzmann5-vs-boltzmann260-1000its,746,821,2172.143596244,2145.875708942,-75
carcassonne-ucttuned195-vs-ucttuned30-1000its,746,821,2296.608846222,2267.893826857,-75
carcassonne-boltzmann275-vs-boltzmann280-1000its,747,822,2188.459180955,2150.478544436,-75
carcassonne-boltzmann480-vs-boltzmann55-1000its,749,824,2249.786115539,2168.282022625,-75
carcassonne-uct440-vs-uct455-1000its,749,824,2240.189550489,2194.817144941,-75
carcassonne-boltzmann415-vs-boltzmann375-1000its,750,825,2173.739026844,2218.721119774,-75
carcassonne-uct440-vs-uct200-1000its,750,825,2184.688394545,2077.05848012,-75
carcassonne-uct80-vs-uct400-1000its,750,825,2170.335137116,2137.786920204,-75
carcassonne-boltzmann320-vs-boltzmann485-1000its,752,827,2128.464122312,2086.618784364,-75
carcassonne-boltzmann250-vs-boltzmann355-1000its,753,828,2203.97186009,2134.512428096,-75
carcassonne-uct10-vs-uct265-1000its,753,828,2251.089828231,2160.923726275,-75
carcassonne-ucttuned190-vs-ucttuned235-1000its,753,828,2218.940194139,2121.76771127,-75
carcassonne-ucttuned490-vs-ucttuned120-1000its,753,828,2299.227991548,2258.506593535,-75
carcassonne-uct195-vs-uct70-1000its,754,829,2147.218729246,2104.623996282,-75
carcassonne-uct210-vs-uct55-1000its,755,830,2256.754444425,2182.686214631,-75
carcassonne-uct260-vs-uct290-1000its,755,830,2201.835528146,2143.917185785,-75
carcassonne-boltzmann340-vs-boltzmann90-1000its,756,831,2227.523188023,2188.957720621,-75
carcassonne-uct120-vs-uct50-1000its,757,832,2171.855650623,2126.136029347,-75
carcassonne-boltzmann20-vs-boltzmann175-1000its,758,833,2238.759398675,2169.43354199,-75
carcassonne-boltzmann415-vs-boltzmann485-1000its,758,833,2198.040955339,2155.432625235,-75
carcassonne-ucttuned245-vs-ucttuned105-1000its,758,833,2200.125442945,2127.719856242,-75
carcassonne-ucttuned380-vs-ucttuned400-1000its,758,833,2236.896218916,2209.534965366,-75
carcassonne-boltzmann165-vs-boltzmann190-1000its,760,835,2202.812163575,2171.020822826,-75
carcassonne-boltzmann155-vs-boltzmann10-1000its,762,837,2173.724729741,2146.452963832,-75
carcassonne-ucttuned455-vs-ucttuned10-1000its,762,837,2191.494291481,2136.119719369,-75
carcassonne-boltzmann445-vs-boltzmann60-1000its,764,839,2204.775361198,2124.456148866,-75
carcassonne-ucttuned475-vs-ucttuned345-1000its,765,840,2154.83688114,2117.54593703,-75
carcassonne-ucttuned185-vs-ucttuned350-1000its,770,845,2230.667963951,2164.441929752,-75
carcassonne-uct330-vs-uct130-1000its,773,848,2234.78549978,2215.296105358,-75
carcassonne-ucttuned400-vs-ucttuned385-1000its,773,848,2217.766951193,2171.369911741,-75
carcassonne-uct370-vs-uct435-1000its,775,850,2180.142810083,2163.681983597,-75
carcassonne-ucttuned65-vs-ucttuned110-1000its,776,851,2246.827553828,2198.209751088,-75
carcassonne-uct155-vs-uct435-1000its,777,852,2158.404753004,2102.676602162,-75
carcassonne-boltzmann150-vs-boltzmann420-1000its,778,853,2176.392299512,2139.968306743,-75
carcassonne-boltzmann225-vs-boltzmann350-1000its,778,853,2224.637435533,2182.861644173,-75
carcassonne-boltzmann455-vs-boltzmann175-1000its,779,854,2259.327997255,2238.324987513,-75
carcassonne-uct385-vs-uct210-1000its,780,855,2167.044663603,2136.505306628,-75
carcassonne-uct60-vs-uct10-1000its,781,856,2213.307423011,2182.441778075,-75
carcassonne-uct365-vs-uct290-1000its,782,857,2197.932595735,2135.227358453,-75
carcassonne-uct155-vs-uct125-1000its,785,860,2163.958135212,2142.493712722,-75
carcassonne-boltzmann320-vs-boltzmann385-1000its,786,861,2193.867452965,2158.313215976,-75
carcassonne-uct120-vs-uct250-1000its,786,861,2246.437679399,2172.800936652,-75
carcassonne-boltzmann200-vs-boltzmann395-1000its,789,864,2247.652046956,2212.92107721,-75
carcassonne-uct320-vs-uct90-1000its,789,864,2242.657484843,2217.824881565,-75
carcassonne-boltzmann375-vs-boltzmann10-1000its,790,865,2140.995229823,2111.333159803,-75
carcassonne-uct425-vs-uct240-1000its,790,865,2185.407295319,2134.020289592,-75
carcassonne-ucttuned320-vs-ucttuned435-1000its,790,865,2242.024934535,2177.116554582,-75
carcassonne-boltzmann300-vs-boltzmann50-1000its,792,867,2242.06895252,2210.294713253,-75
carcassonne-boltzmann55-vs-boltzmann5-1000its,792,867,2127.218042104,2123.645251482,-75
carcassonne-ucttuned155-vs-ucttuned275-1000its,792,867,2318.924036134,2265.489773826,-75
carcassonne-uct105-vs-uct445-1000its,794,869,2167.554067966,2176.886780503,-75
carcassonne-uct30-vs-uct125-1000its,802,877,2193.328958189,2107.449722564,-75
carcassonne-ucttuned295-vs-ucttuned10-1000its,802,877,2230.8533312,2195.803088802,-75
carcassonne-ucttuned320-vs-ucttuned370-1000its,804,879,2152.894560568,2105.475970209,-75
carcassonne-boltzmann255-vs-boltzmann170-1000its,806,881,2209.551388675,2148.118208782,-75
carcassonne-boltzmann195-vs-boltzmann435-1000its,808,883,2149.075079347,2177.502507212,-75
carcassonne-ucttuned470-vs-ucttuned485-1000its,810,885,2349.237376131,2275.932090588,-75
carcassonne-uct390-vs-uct370-1000its,812,887,2157.25297708,2044.092992722,-75
carcassonne-ucttuned405-vs-ucttuned70-1000its,812,887,2204.644626019,2151.770744603,-75
carcassonne-uct390-vs-uct445-1000its,813,888,2229.788985327,2216.009278269,-75
carcassonne-uct395-vs-uct125-1000its,816,891,2197.247738888,2170.844870992,-75
carcassonne-ucttuned445-vs-ucttuned485-1000its,820,895,2168.007275551,2123.288922306,-75
carcassonne-ucttuned70-vs-ucttuned45-1000its,822,897,2181.976385548,2153.571575393,-75
carcassonne-ucttuned355-vs-ucttuned380-1000its,866,941,2178.398706993,2160.766113218,-75
carcassonne-uct125-vs-uct100-1000its,689,763,2245.110597697,2220.0118878,-74
carcassonne-uct125-vs-uct225-1000its,690,764,2257.097088905,2183.903624435,-74
carcassonne-boltzmann415-vs-boltzmann85-1000its,705,779,2220.90266034,2166.282373135,-74
carcassonne-boltzmann170-vs-boltzmann480-1000its,708,782,2229.635136265,2167.742645518,-74
carcassonne-ucttuned235-vs-ucttuned70-1000its,725,799,2195.954100465,2204.461913456,-74
carcassonne-uct190-vs-uct275-1000its,726,800,2361.182970291,2294.614759186,-74
carcassonne-boltzmann485-vs-boltzmann455-1000its,727,801,2240.802679795,2195.862422584,-74
carcassonne-uct190-vs-uct155-1000its,727,801,2156.062341026,2115.59484664,-74
carcassonne-uct20-vs-uct230-1000its,729,803,2120.908576442,2099.357843369,-74
carcassonne-boltzmann240-vs-boltzmann285-1000its,730,804,2216.4090188,2202.429553972,-74
carcassonne-boltzmann330-vs-boltzmann335-1000its,732,806,2142.687201773,2076.378149728,-74
carcassonne-uct45-vs-uct200-1000its,732,806,2192.40677116,2163.343620305,-74
carcassonne-boltzmann105-vs-boltzmann275-1000its,734,808,2228.489632693,2175.332489127,-74
carcassonne-boltzmann420-vs-boltzmann260-1000its,734,808,2103.936908207,2142.393345325,-74
carcassonne-ucttuned20-vs-ucttuned280-1000its,734,808,2174.068975308,2124.961250687,-74
carcassonne-boltzmann465-vs-boltzmann25-1000its,736,810,2152.352076397,2153.122135901,-74
carcassonne-boltzmann335-vs-boltzmann200-1000its,738,812,2200.452896307,2191.827703449,-74
carcassonne-uct455-vs-uct140-1000its,738,812,2194.683503942,2143.24938196,-74
carcassonne-ucttuned430-vs-ucttuned455-1000its,738,812,2144.981701979,2142.49784967,-74
carcassonne-ucttuned480-vs-ucttuned150-1000its,740,814,2210.880339234,2149.177453343,-74
carcassonne-boltzmann425-vs-boltzmann110-1000its,742,816,2183.518931912,2123.660237848,-74
carcassonne-boltzmann125-vs-boltzmann445-1000its,743,817,2214.546263859,2148.984335343,-74
carcassonne-boltzmann215-vs-boltzmann50-1000its,743,817,2227.564165459,2201.949719657,-74
carcassonne-ucttuned460-vs-ucttuned175-1000its,743,817,2223.172272008,2186.724508756,-74
carcassonne-uct280-vs-uct200-1000its,746,820,2176.14879615,2135.024950437,-74
carcassonne-ucttuned320-vs-ucttuned330-1000its,747,821,2185.333745273,2131.62849325,-74
carcassonne-ucttuned295-vs-ucttuned375-1000its,749,823,2209.052177208,2179.816476153,-74
carcassonne-boltzmann475-vs-boltzmann185-1000its,750,824,2145.115923117,2116.340110977,-74
carcassonne-uct105-vs-uct310-1000its,752,826,2150.882664304,2126.61698566,-74
carcassonne-uct340-vs-uct320-1000its,752,826,2235.728638798,2199.54013046,-74
carcassonne-ucttuned420-vs-ucttuned315-1000its,752,826,2167.565709132,2115.207505448,-74
carcassonne-ucttuned15-vs-ucttuned155-1000its,757,831,2224.733443258,2168.320839055,-74
carcassonne-boltzmann130-vs-boltzmann50-1000its,758,832,2244.38201759,2155.898640555,-74
carcassonne-uct495-vs-uct15-1000its,760,834,2171.717908643,2078.587750381,-74
carcassonne-ucttuned480-vs-ucttuned440-1000its,761,835,2259.219836186,2171.3697985,-74
carcassonne-uct300-vs-uct40-1000its,763,837,2213.759192657,2167.462652104,-74
carcassonne-ucttuned55-vs-ucttuned305-1000its,764,838,2173.083729414,2150.91699664,-74
carcassonne-boltzmann165-vs-boltzmann140-1000its,766,840,2192.60806003,2112.324552187,-74
carcassonne-boltzmann290-vs-boltzmann255-1000its,767,841,2248.373428059,2166.337628796,-74
carcassonne-ucttuned170-vs-ucttuned365-1000its,768,842,2217.878400204,2203.554741695,-74
carcassonne-ucttuned420-vs-ucttuned395-1000its,768,842,2209.851311629,2184.93634647,-74
carcassonne-uct325-vs-uct210-1000its,770,844,2170.361455162,2124.854095848,-74
carcassonne-uct170-vs-uct190-1000its,774,848,2123.038737386,2068.394354423,-74
carcassonne-uct265-vs-uct330-1000its,775,849,2196.27744072,2123.853443217,-74
carcassonne-uct435-vs-uct335-1000its,778,852,2118.530200884,2059.882018498,-74
carcassonne-boltzmann430-vs-boltzmann405-1000its,779,853,2176.816820147,2140.396865821,-74
carcassonne-ucttuned300-vs-ucttuned395-1000its,779,853,2244.941045558,2239.870419349,-74
carcassonne-uct305-vs-uct160-1000its,780,854,2289.606990483,2282.048582957,-74
carcassonne-uct415-vs-uct455-1000its,781,855,2186.364665342,2123.901722537,-74
carcassonne-uct285-vs-uct65-1000its,782,856,2167.486437913,2146.013028398,-74
carcassonne-boltzmann325-vs-boltzmann35-1000its,784,858,2250.698779121,2152.233789661,-74
carcassonne-uct95-vs-uct230-1000its,784,858,2213.82411694,2191.746797367,-74
carcassonne-uct235-vs-uct140-1000its,785,859,2155.248570184,2125.989534186,-74
carcassonne-uct15-vs-uct115-1000its,786,860,2164.82689598,2088.653498883,-74
carcassonne-uct70-vs-uct440-1000its,786,860,2140.697353775,2110.422973635,-74
carcassonne-uct485-vs-uct205-1000its,787,861,2222.950926337,2175.739813308,-74
carcassonne-uct215-vs-uct230-1000its,790,864,2163.54773081,2131.71993754,-74
carcassonne-ucttuned390-vs-ucttuned245-1000its,792,866,2125.150901854,2125.817824924,-74
carcassonne-boltzmann415-vs-boltzmann310-1000its,793,867,2206.428282048,2152.32984015,-74
carcassonne-ucttuned385-vs-ucttuned130-1000its,794,868,2223.54944578,2183.229827793,-74
carcassonne-boltzmann30-vs-boltzmann185-1000its,797,871,2201.577194396,2160.573286837,-74
carcassonne-ucttuned130-vs-ucttuned100-1000its,799,873,2196.034027852,2162.083597788,-74
carcassonne-ucttuned350-vs-ucttuned5-1000its,805,879,2143.361478524,2161.343498843,-74
carcassonne-uct310-vs-uct405-1000its,809,883,2153.498124001,2116.823776218,-74
carcassonne-uct410-vs-uct480-1000its,810,884,2223.520336164,2214.58359675,-74
carcassonne-ucttuned55-vs-ucttuned490-1000its,810,884,2170.768930924,2120.875627724,-74
carcassonne-boltzmann10-vs-boltzmann180-1000its,816,890,2146.936566028,2099.255616956,-74
carcassonne-ucttuned340-vs-ucttuned90-1000its,819,893,2295.457784012,2194.520831997,-74
carcassonne-ucttuned430-vs-ucttuned330-1000its,819,893,2153.615193324,2124.351134376,-74
carcassonne-uct465-vs-uct230-1000its,820,894,2190.085252646,2165.189823004,-74
carcassonne-ucttuned240-vs-ucttuned135-1000its,840,914,2189.642793179,2178.216195852,-74
carcassonne-boltzmann170-vs-boltzmann385-1000its,842,916,2263.410579394,2207.095476717,-74
carcassonne-boltzmann460-vs-boltzmann385-1000its,674,747,2202.814947264,2139.117349868,-73
carcassonne-uct195-vs-uct485-1000its,694,767,2218.052994258,2161.493592006,-73
carcassonne-boltzmann285-vs-boltzmann460-1000its,697,770,2245.818751288,2193.879703229,-73
carcassonne-boltzmann80-vs-boltzmann315-1000its,699,772,2167.537286007,2142.968063986,-73
carcassonne-boltzmann60-vs-boltzmann165-1000its,702,775,2200.738309504,2188.609609537,-73
carcassonne-uct235-vs-uct65-1000its,706,779,2183.086127669,2191.352770144,-73
carcassonne-uct360-vs-uct155-1000its,710,783,2253.747842817,2191.984014395,-73
carcassonne-uct80-vs-uct370-1000its,714,787,2186.463521274,2209.705737126,-73
carcassonne-boltzmann170-vs-boltzmann195-1000its,716,789,2232.491652624,2184.449093228,-73
carcassonne-boltzmann250-vs-boltzmann440-1000its,717,790,2110.008538771,2088.672996841,-73
carcassonne-ucttuned85-vs-ucttuned450-1000its,717,790,2135.269422442,2114.028620417,-73
carcassonne-boltzmann325-vs-boltzmann30-1000its,722,795,2167.444729689,2165.471118241,-73
carcassonne-boltzmann490-vs-boltzmann350-1000its,723,796,2261.025133636,2196.754623758,-73
carcassonne-boltzmann75-vs-boltzmann130-1000its,723,796,2178.222570406,2138.84509321,-73
carcassonne-boltzmann450-vs-boltzmann490-1000its,724,797,2199.8631118,2170.299513865,-73
carcassonne-uct30-vs-uct260-1000its,724,797,2205.734749278,2148.356274242,-73
carcassonne-uct435-vs-uct240-1000its,725,798,2187.799733759,2154.57252298,-73
carcassonne-boltzmann205-vs-boltzmann70-1000its,726,799,2217.009576602,2190.576079755,-73
carcassonne-uct270-vs-uct145-1000its,726,799,2228.561678647,2216.244543872,-73
carcassonne-ucttuned140-vs-ucttuned315-1000its,726,799,2192.456609195,2183.624538457,-73
carcassonne-ucttuned405-vs-ucttuned120-1000its,726,799,2244.296750208,2155.859513547,-73
carcassonne-boltzmann165-vs-boltzmann185-1000its,728,801,2219.728849607,2147.56011251,-73
carcassonne-boltzmann485-vs-boltzmann465-1000its,728,801,2141.827376932,2099.912079947,-73
carcassonne-boltzmann105-vs-boltzmann380-1000its,729,802,2202.416895245,2165.197760073,-73
carcassonne-boltzmann265-vs-boltzmann455-1000its,731,804,2157.047796029,2128.614279304,-73
carcassonne-boltzmann95-vs-boltzmann175-1000its,732,805,2287.821844333,2161.933196057,-73
carcassonne-ucttuned325-vs-ucttuned495-1000its,732,805,2315.212234914,2252.872501992,-73
carcassonne-ucttuned145-vs-ucttuned420-1000its,733,806,2154.985736465,2151.827256723,-73
carcassonne-uct485-vs-uct455-1000its,736,809,2203.352562805,2153.892133858,-73
carcassonne-ucttuned150-vs-ucttuned460-1000its,736,809,2208.332288494,2124.280845054,-73
carcassonne-uct205-vs-uct170-1000its,737,810,2250.437430083,2211.782398265,-73
carcassonne-boltzmann465-vs-boltzmann320-1000its,739,812,2171.340801168,2153.787758092,-73
carcassonne-ucttuned295-vs-ucttuned70-1000its,739,812,2122.092143394,2105.332285111,-73
carcassonne-boltzmann495-vs-boltzmann415-1000its,742,815,2246.562838097,2230.841541711,-73
carcassonne-uct250-vs-uct225-1000its,744,817,2221.352432193,2182.696578968,-73
carcassonne-boltzmann290-vs-boltzmann200-1000its,745,818,2165.757983097,2127.352803141,-73
carcassonne-uct60-vs-uct115-1000its,745,818,2208.261378762,2138.918613978,-73
carcassonne-ucttuned50-vs-ucttuned480-1000its,745,818,2180.564845545,2161.196155309,-73
carcassonne-boltzmann235-vs-boltzmann65-1000its,749,822,2230.528997043,2176.863728469,-73
carcassonne-boltzmann225-vs-boltzmann10-1000its,750,823,2179.929598269,2136.418503404,-73
carcassonne-ucttuned370-vs-ucttuned400-1000its,750,823,2185.215504271,2148.170724615,-73
carcassonne-ucttuned185-vs-ucttuned360-1000its,751,824,2153.466172026,2109.449527655,-73
carcassonne-ucttuned435-vs-ucttuned205-1000its,751,824,2190.04711208,2081.596654216,-73
carcassonne-boltzmann450-vs-boltzmann20-1000its,757,830,2192.936116283,2149.425218843,-73
carcassonne-uct320-vs-uct495-1000its,757,830,2196.835779358,2152.84912443,-73
carcassonne-ucttuned260-vs-ucttuned150-1000its,757,830,2172.102704135,2134.129830714,-73
carcassonne-ucttuned390-vs-ucttuned425-1000its,757,830,2266.107155807,2219.149283526,-73
carcassonne-uct480-vs-uct65-1000its,758,831,2235.632673556,2184.510687777,-73
carcassonne-uct40-vs-uct460-1000its,759,832,2196.273412762,2137.070112509,-73
carcassonne-uct415-vs-uct385-1000its,759,832,2181.628629165,2166.126661363,-73
carcassonne-ucttuned415-vs-ucttuned100-1000its,759,832,2173.166011318,2149.677552155,-73
carcassonne-boltzmann105-vs-boltzmann420-1000its,760,833,2156.3180945,2104.140176809,-73
carcassonne-uct15-vs-uct100-1000its,760,833,2182.579192965,2150.334662867,-73
carcassonne-boltzmann385-vs-boltzmann490-1000its,761,834,2122.746603421,2096.660818199,-73
carcassonne-uct25-vs-uct115-1000its,762,835,2169.559746671,2125.014781615,-73
carcassonne-boltzmann370-vs-boltzmann405-1000its,765,838,2273.721807469,2219.577908983,-73
carcassonne-uct90-vs-uct370-1000its,767,840,2173.02823026,2149.229897812,-73
carcassonne-ucttuned130-vs-ucttuned220-1000its,767,840,2176.7038914,2119.921904019,-73
carcassonne-uct270-vs-uct155-1000its,771,844,2255.923592715,2250.523467354,-73
carcassonne-ucttuned140-vs-ucttuned265-1000its,771,844,2214.203573232,2183.514744264,-73
carcassonne-boltzmann115-vs-boltzmann270-1000its,772,845,2209.550913934,2161.049176935,-73
carcassonne-uct150-vs-uct155-1000its,774,847,2085.362268427,2075.811092893,-73
carcassonne-uct160-vs-uct80-1000its,776,849,2218.431888881,2198.589793295,-73
carcassonne-uct30-vs-uct315-1000its,777,850,2190.921160708,2124.816350822,-73
carcassonne-uct490-vs-uct470-1000its,777,850,2257.660843883,2185.391647391,-73
carcassonne-boltzmann185-vs-boltzmann355-1000its,778,851,2158.592615101,2123.090313007,-73
carcassonne-boltzmann135-vs-boltzmann405-1000its,781,854,2223.741646265,2168.639467537,-73
carcassonne-uct145-vs-uct50-1000its,781,854,2159.579830071,2107.246970253,-73
carcassonne-ucttuned190-vs-ucttuned325-1000its,782,855,2216.666713415,2155.90929021,-73
carcassonne-boltzmann95-vs-boltzmann85-1000its,784,857,2183.337339839,2168.775782673,-73
carcassonne-uct425-vs-uct255-1000its,784,857,2209.663554019,2170.535985024,-73
carcassonne-uct75-vs-uct180-1000its,784,857,2179.484156502,2153.265424705,-73
carcassonne-uct260-vs-uct310-1000its,786,859,2176.606154342,2120.740842391,-73
carcassonne-ucttuned415-vs-ucttuned295-1000its,786,859,2138.352687035,2143.986518027,-73
carcassonne-ucttuned420-vs-ucttuned240-1000its,786,859,2195.312022065,2181.40919032,-73
carcassonne-uct310-vs-uct280-1000its,790,863,2141.590934751,2112.926655913,-73
carcassonne-boltzmann375-vs-boltzmann235-1000its,791,864,2114.609168896,2086.695206916,-73
carcassonne-ucttuned305-vs-ucttuned100-1000its,791,864,2203.887726947,2137.701582409,-73
carcassonne-uct15-vs-uct445-1000its,792,865,2258.489901532,2221.319362915,-73
carcassonne-uct45-vs-uct315-1000its,793,866,2259.13024339,2219.918806505,-73
carcassonne-ucttuned325-vs-ucttuned40-1000its,800,873,2237.868288839,2172.833875263,-73
carcassonne-boltzmann65-vs-boltzmann290-1000its,802,875,2261.395424748,2194.012731383,-73
carcassonne-ucttuned30-vs-ucttuned415-1000its,802,875,2161.324603118,2159.492397825,-73
carcassonne-boltzmann285-vs-boltzmann125-1000its,803,876,2136.967347754,2118.700300099,-73
carcassonne-uct385-vs-uct430-1000its,803,876,2349.332771561,2289.512267073,-73
carcassonne-ucttuned345-vs-ucttuned470-1000its,805,878,2206.48626487,2164.719794515,-73
carcassonne-boltzmann255-vs-boltzmann260-1000its,806,879,2214.996196742,2161.683101272,-73
carcassonne-uct375-vs-uct435-1000its,806,879,2198.653083829,2146.959557406,-73
carcassonne-ucttuned85-vs-ucttuned400-1000its,807,880,2208.196299903,2143.132117059,-73
carcassonne-boltzmann110-vs-boltzmann5-1000its,809,882,2162.114056678,2133.927770156,-73
carcassonne-uct115-vs-uct300-1000its,810,883,2159.817714151,2097.405368208,-73
carcassonne-ucttuned150-vs-ucttuned60-1000its,814,887,2210.171791503,2167.826078315,-73
carcassonne-ucttuned225-vs-ucttuned5-1000its,814,887,2242.264169722,2192.158248639,-73
carcassonne-uct40-vs-uct5-1000its,820,893,2239.572213314,2255.756436745,-73
carcassonne-ucttuned105-vs-ucttuned10-1000its,820,893,2207.828635768,2171.022405707,-73
carcassonne-ucttuned65-vs-ucttuned350-1000its,820,893,2216.33527734,2160.063985295,-73
carcassonne-ucttuned380-vs-ucttuned140-1000its,826,899,2170.688952123,2164.421322239,-73
carcassonne-boltzmann375-vs-boltzmann420-1000its,829,902,2210.799002894,2197.507009992,-73
carcassonne-uct95-vs-uct140-1000its,831,904,2204.964883495,2146.674753305,-73
carcassonne-boltzmann50-vs-boltzmann110-1000its,834,907,2190.045711057,2163.875772814,-73
carcassonne-boltzmann220-vs-boltzmann130-1000its,843,916,2248.02852575,2199.014716862,-73
carcassonne-ucttuned175-vs-ucttuned80-1000its,843,916,2120.171036689,2088.166757978,-73
carcassonne-ucttuned485-vs-ucttuned160-1000its,848,921,2212.636024038,2145.6448727,-73
carcassonne-uct85-vs-uct15-1000its,611,683,1830.243600345,1822.264566457,-72
carcassonne-boltzmann115-vs-boltzmann395-1000its,678,750,2204.931811227,2133.706439226,-72
carcassonne-boltzmann80-vs-boltzmann55-1000its,679,751,2214.868570335,2195.124315996,-72
carcassonne-boltzmann5-vs-boltzmann265-1000its,682,754,2208.262674374,2136.065206438,-72
carcassonne-boltzmann370-vs-boltzmann55-1000its,698,770,2214.008019262,2173.235675033,-72
carcassonne-boltzmann80-vs-boltzmann290-1000its,708,780,2229.183006475,2198.6110852,-72
carcassonne-ucttuned195-vs-ucttuned120-1000its,714,786,2180.859448111,2146.47289133,-72
carcassonne-ucttuned475-vs-ucttuned155-1000its,714,786,2216.829859005,2166.743295198,-72
carcassonne-boltzmann190-vs-boltzmann300-1000its,729,801,2257.023584275,2211.390102058,-72
carcassonne-boltzmann395-vs-boltzmann480-1000its,732,804,2197.300930376,2126.051504164,-72
carcassonne-boltzmann250-vs-boltzmann70-1000its,735,807,2138.462880784,2136.017972373,-72
carcassonne-boltzmann285-vs-boltzmann400-1000its,736,808,2212.24314025,2180.750424786,-72
carcassonne-boltzmann245-vs-boltzmann425-1000its,738,810,2172.196045702,2118.8212435,-72
carcassonne-ucttuned185-vs-ucttuned405-1000its,738,810,2218.655437306,2162.893688658,-72
carcassonne-boltzmann335-vs-boltzmann145-1000its,739,811,2180.397227546,2065.15212813,-72
carcassonne-uct375-vs-uct325-1000its,743,815,2210.253676555,2178.894572343,-72
carcassonne-boltzmann110-vs-boltzmann275-1000its,744,816,2192.121341903,2156.601852438,-72
carcassonne-ucttuned330-vs-ucttuned395-1000its,744,816,2240.954539224,2184.544464765,-72
carcassonne-uct125-vs-uct80-1000its,745,817,2230.189495216,2154.491092965,-72
carcassonne-ucttuned320-vs-ucttuned115-1000its,745,817,2164.195136648,2125.090130195,-72
carcassonne-boltzmann250-vs-boltzmann340-1000its,750,822,2211.458183083,2126.033829392,-72
carcassonne-boltzmann495-vs-boltzmann115-1000its,750,822,2212.790109346,2169.222291793,-72
carcassonne-boltzmann450-vs-boltzmann430-1000its,751,823,2158.887722422,2129.706167887,-72
carcassonne-ucttuned100-vs-ucttuned95-1000its,751,823,2156.218207628,2126.575898584,-72
carcassonne-uct440-vs-uct370-1000its,752,824,2130.19769801,2085.311487883,-72
carcassonne-uct75-vs-uct350-1000its,753,825,2198.434926698,2131.01928651,-72
carcassonne-uct245-vs-uct445-1000its,754,826,2238.148458763,2198.096269437,-72
carcassonne-uct205-vs-uct385-1000its,755,827,2188.92575175,2156.866052877,-72
carcassonne-uct290-vs-uct145-1000its,759,831,2267.112140023,2263.656654445,-72
carcassonne-uct275-vs-uct220-1000its,760,832,2186.739344407,2157.812566218,-72
carcassonne-uct380-vs-uct70-1000its,760,832,2260.548680191,2202.978579881,-72
carcassonne-ucttuned80-vs-ucttuned360-1000its,760,832,2285.797878578,2218.1717422,-72
carcassonne-uct210-vs-uct405-1000its,761,833,2214.134645513,2161.892934915,-72
carcassonne-uct435-vs-uct80-1000its,761,833,2173.16798858,2110.589699049,-72
carcassonne-ucttuned375-vs-ucttuned110-1000its,761,833,2226.222683729,2148.663516562,-72
carcassonne-ucttuned435-vs-ucttuned275-1000its,761,833,2214.10295031,2205.985096428,-72
carcassonne-uct245-vs-uct75-1000its,764,836,2159.082174076,2131.036033756,-72
carcassonne-uct475-vs-uct15-1000its,764,836,2254.03493283,2243.098407456,-72
carcassonne-uct250-vs-uct230-1000its,766,838,2220.154831917,2192.830889119,-72
carcassonne-ucttuned145-vs-ucttuned120-1000its,767,839,2274.187415509,2228.331513679,-72
carcassonne-boltzmann310-vs-boltzmann315-1000its,768,840,2131.495805893,2127.777149937,-72
carcassonne-uct380-vs-uct415-1000its,768,840,2151.840981674,2123.850125289,-72
carcassonne-boltzmann255-vs-boltzmann385-1000its,771,843,2169.244240438,2153.613237324,-72
carcassonne-boltzmann325-vs-boltzmann280-1000its,772,844,2253.607279026,2187.26864785,-72
carcassonne-boltzmann450-vs-boltzmann10-1000its,780,852,2221.013868195,2186.279255147,-72
carcassonne-uct165-vs-uct470-1000its,785,857,2200.26509571,2138.988563065,-72
carcassonne-uct150-vs-uct260-1000its,786,858,2175.173193918,2131.225200015,-72
carcassonne-boltzmann70-vs-boltzmann30-1000its,787,859,2215.394603358,2174.169558302,-72
carcassonne-boltzmann355-vs-boltzmann135-1000its,788,860,2216.092932152,2153.018098895,-72
carcassonne-uct330-vs-uct430-1000its,790,862,2215.350719266,2177.66984404,-72
carcassonne-uct245-vs-uct425-1000its,796,868,2205.790842454,2189.814475875,-72
carcassonne-ucttuned355-vs-ucttuned120-1000its,796,868,2250.035598191,2146.512412774,-72
carcassonne-uct50-vs-uct430-1000its,797,869,2126.896119429,2136.388885538,-72
carcassonne-ucttuned170-vs-ucttuned370-1000its,797,869,2157.730027629,2125.567081246,-72
carcassonne-boltzmann470-vs-boltzmann270-1000its,799,871,2152.890810476,2124.266177163,-72
carcassonne-ucttuned460-vs-ucttuned155-1000its,799,871,2278.341675034,2232.859191904,-72
carcassonne-uct355-vs-uct135-1000its,800,872,2242.411270253,2242.686547136,-72
carcassonne-ucttuned180-vs-ucttuned115-1000its,801,873,2154.476080605,2124.131698436,-72
carcassonne-ucttuned435-vs-ucttuned10-1000its,801,873,2191.852606633,2134.690736684,-72
carcassonne-ucttuned445-vs-ucttuned130-1000its,802,874,2192.068050894,2152.42142461,-72
carcassonne-boltzmann100-vs-boltzmann270-1000its,803,875,2179.158643027,2162.084446314,-72
carcassonne-uct325-vs-uct60-1000its,806,878,2309.633595569,2277.541686126,-72
carcassonne-ucttuned180-vs-ucttuned165-1000its,807,879,2179.421257487,2089.974827063,-72
carcassonne-boltzmann105-vs-boltzmann335-1000its,808,880,2202.270121035,2146.904444325,-72
carcassonne-ucttuned130-vs-ucttuned395-1000its,811,883,2199.216136085,2089.52898798,-72
carcassonne-ucttuned105-vs-ucttuned485-1000its,812,884,2211.294667867,2123.981936314,-72
carcassonne-ucttuned155-vs-ucttuned360-1000its,812,884,2234.886024241,2169.030696909,-72
carcassonne-boltzmann375-vs-boltzmann125-1000its,817,889,2156.23433317,2126.171245569,-72
carcassonne-ucttuned155-vs-ucttuned390-1000its,817,889,2226.680260203,2194.74890706,-72
carcassonne-uct450-vs-uct155-1000its,819,891,2249.804749405,2199.01553599,-72
carcassonne-boltzmann405-vs-boltzmann190-1000its,820,892,2140.610594701,2082.297047964,-72
carcassonne-uct335-vs-uct10-1000its,823,895,2133.348198856,2123.482959827,-72
carcassonne-uct120-vs-uct390-1000its,826,898,2253.365297899,2211.351311542,-72
carcassonne-uct485-vs-uct335-1000its,830,902,2215.915496363,2194.233076703,-72
carcassonne-boltzmann480-vs-boltzmann430-1000its,831,903,2218.397959556,2159.501913477,-72
carcassonne-uct400-vs-uct35-1000its,841,913,2314.203497694,2205.780922684,-72
carcassonne-uct75-vs-uct15-1000its,846,918,2157.014047385,2157.962275196,-72
carcassonne-ucttuned80-vs-ucttuned330-1000its,864,936,2176.323260626,2152.383475312,-72
carcassonne-boltzmann360-vs-boltzmann370-1000its,683,754,2234.548067651,2167.574876204,-71
carcassonne-uct465-vs-uct440-1000its,698,769,2266.570890344,2196.967315407,-71
carcassonne-boltzmann160-vs-boltzmann445-1000its,702,773,2200.734069574,2160.58496737,-71
carcassonne-ucttuned165-vs-ucttuned210-1000its,709,780,2183.149515968,2113.397845724,-71
carcassonne-uct480-vs-uct350-1000its,714,785,2304.878733842,2205.396876503,-71
carcassonne-ucttuned135-vs-ucttuned335-1000its,716,787,2213.182311081,2158.147638872,-71
carcassonne-boltzmann365-vs-boltzmann50-1000its,721,792,2184.770471166,2110.252104327,-71
carcassonne-boltzmann265-vs-boltzmann330-1000its,727,798,2196.320278752,2127.807302416,-71
carcassonne-uct150-vs-uct415-1000its,729,800,2261.313197599,2252.809822788,-71
carcassonne-uct355-vs-uct480-1000its,730,801,2281.223101816,2184.518186931,-71
carcassonne-ucttuned295-vs-ucttuned175-1000its,731,802,2269.656227651,2234.892869628,-71
carcassonne-boltzmann495-vs-boltzmann240-1000its,732,803,2179.674058559,2139.494256621,-71
carcassonne-boltzmann165-vs-boltzmann270-1000its,734,805,2214.220287276,2194.536021809,-71
carcassonne-boltzmann215-vs-boltzmann115-1000its,734,805,2155.905615949,2086.678155732,-71
carcassonne-uct355-vs-uct180-1000its,736,807,2165.633642148,2145.942537784,-71
carcassonne-boltzmann450-vs-boltzmann225-1000its,737,808,2179.174973193,2125.120227387,-71
carcassonne-uct35-vs-uct180-1000its,739,810,2187.783337467,2112.971812128,-71
carcassonne-uct180-vs-uct20-1000its,740,811,2225.814649188,2182.005928765,-71
carcassonne-boltzmann65-vs-boltzmann270-1000its,743,814,2202.026216779,2185.997360513,-71
carcassonne-ucttuned345-vs-ucttuned125-1000its,743,814,2247.499988464,2261.614280099,-71
carcassonne-boltzmann315-vs-boltzmann440-1000its,744,815,2201.929536126,2173.227365076,-71
carcassonne-ucttuned440-vs-ucttuned155-1000its,744,815,2228.622491831,2191.172112213,-71
carcassonne-boltzmann195-vs-boltzmann405-1000its,745,816,2142.079906824,2132.561495329,-71
carcassonne-ucttuned285-vs-ucttuned350-1000its,745,816,2215.217932432,2202.105376714,-71
carcassonne-boltzmann160-vs-boltzmann265-1000its,748,819,2232.704170126,2229.524828394,-71
carcassonne-uct35-vs-uct240-1000its,749,820,2225.672838657,2136.216144745,-71
carcassonne-uct340-vs-uct445-1000its,750,821,2240.066857461,2206.082820957,-71
carcassonne-uct260-vs-uct85-1000its,753,824,2146.711855046,2137.306856261,-71
carcassonne-ucttuned235-vs-ucttuned295-1000its,755,826,2232.515481063,2199.669366895,-71
carcassonne-ucttuned255-vs-ucttuned30-1000its,755,826,2167.209421574,2143.087347289,-71
carcassonne-boltzmann160-vs-boltzmann410-1000its,756,827,2275.464904378,2208.652802266,-71
carcassonne-ucttuned220-vs-ucttuned305-1000its,756,827,2222.860066734,2195.676070769,-71
carcassonne-ucttuned30-vs-ucttuned315-1000its,757,828,2221.436765412,2134.458436095,-71
carcassonne-boltzmann300-vs-boltzmann75-1000its,759,830,2250.271850932,2219.212506638,-71
carcassonne-boltzmann50-vs-boltzmann65-1000its,759,830,2164.098712264,2144.822979171,-71
carcassonne-boltzmann135-vs-boltzmann370-1000its,760,831,2204.486187906,2143.577402286,-71
carcassonne-ucttuned320-vs-ucttuned195-1000its,761,832,2221.913008189,2166.525933198,-71
carcassonne-ucttuned330-vs-ucttuned375-1000its,761,832,2174.739528355,2104.701219174,-71
carcassonne-boltzmann85-vs-boltzmann110-1000its,763,834,2202.286938015,2124.0102599,-71
carcassonne-boltzmann285-vs-boltzmann200-1000its,764,835,2329.337090114,2217.716335018,-71
carcassonne-ucttuned330-vs-ucttuned160-1000its,769,840,2168.854069615,2148.156594363,-71
carcassonne-boltzmann420-vs-boltzmann270-1000its,771,842,2230.859395192,2206.950216134,-71
carcassonne-boltzmann45-vs-boltzmann95-1000its,771,842,2254.798854013,2222.170348673,-71
carcassonne-uct200-vs-uct95-1000its,771,842,2166.834251111,2145.881510189,-71
carcassonne-boltzmann10-vs-boltzmann30-1000its,774,845,2216.64467256,2124.882709233,-71
carcassonne-ucttuned300-vs-ucttuned175-1000its,774,845,2237.228011235,2213.549114882,-71
carcassonne-boltzmann400-vs-boltzmann250-1000its,776,847,2191.742905351,2098.90343478,-71
carcassonne-boltzmann385-vs-boltzmann455-1000its,777,848,2184.227004634,2131.959995807,-71
carcassonne-boltzmann80-vs-boltzmann255-1000its,777,848,2213.403621847,2124.85895854,-71
carcassonne-uct365-vs-uct50-1000its,777,848,2184.063865483,2174.087294742,-71
carcassonne-ucttuned415-vs-ucttuned445-1000its,777,848,2183.763865221,2133.082173546,-71
carcassonne-boltzmann270-vs-boltzmann295-1000its,780,851,2131.917071836,2109.583975476,-71
carcassonne-ucttuned230-vs-ucttuned290-1000its,780,851,2203.39096237,2159.121164701,-71
carcassonne-ucttuned310-vs-ucttuned440-1000its,780,851,2206.94417427,2158.06811526,-71
carcassonne-ucttuned470-vs-ucttuned360-1000its,781,852,2110.338310264,2057.940331342,-71
carcassonne-boltzmann435-vs-boltzmann265-1000its,782,853,2213.047025123,2123.865532118,-71
carcassonne-boltzmann455-vs-boltzmann440-1000its,784,855,2175.90443935,2170.474000329,-71
carcassonne-ucttuned285-vs-ucttuned145-1000its,784,855,2244.323217379,2224.584702379,-71
carcassonne-ucttuned20-vs-ucttuned360-1000its,789,860,2183.287510053,2170.716972039,-71
carcassonne-ucttuned200-vs-ucttuned305-1000its,790,861,2188.50525354,2158.877215392,-71
carcassonne-ucttuned130-vs-ucttuned65-1000its,798,869,2195.819938029,2133.005518065,-71
carcassonne-ucttuned105-vs-ucttuned170-1000its,799,870,2265.448136876,2203.712712924,-71
carcassonne-ucttuned370-vs-ucttuned210-1000its,799,870,2127.758403211,2078.611879967,-71
carcassonne-ucttuned490-vs-ucttuned85-1000its,799,870,2186.902881792,2145.466800711,-71
carcassonne-boltzmann415-vs-boltzmann305-1000its,800,871,2131.708041289,2094.38192446,-71
carcassonne-boltzmann495-vs-boltzmann145-1000its,800,871,2194.223972544,2176.448423134,-71
carcassonne-ucttuned265-vs-ucttuned75-1000its,801,872,2200.407206284,2166.38034847,-71
carcassonne-ucttuned80-vs-ucttuned5-1000its,801,872,2285.973893402,2238.071464451,-71
carcassonne-boltzmann10-vs-boltzmann345-1000its,802,873,2183.310415426,2104.122718675,-71
carcassonne-uct490-vs-uct210-1000its,806,877,2181.20024078,2156.8473628,-71
carcassonne-boltzmann170-vs-boltzmann150-1000its,808,879,2240.507878391,2185.737067796,-71
carcassonne-boltzmann155-vs-boltzmann195-1000its,811,882,2227.651948427,2213.47871536,-71
carcassonne-boltzmann260-vs-boltzmann180-1000its,816,887,2207.28610684,2179.900812401,-71
carcassonne-uct165-vs-uct215-1000its,820,891,2247.567785958,2204.6068675,-71
carcassonne-boltzmann470-vs-boltzmann310-1000its,821,892,2177.183077496,2181.034951959,-71
carcassonne-ucttuned35-vs-ucttuned190-1000its,823,894,2235.192055309,2170.901558936,-71
carcassonne-ucttuned160-vs-ucttuned100-1000its,825,896,2204.607042113,2152.578943885,-71
carcassonne-ucttuned60-vs-ucttuned30-1000its,830,901,2220.135316982,2163.604431859,-71
carcassonne-ucttuned470-vs-ucttuned65-1000its,833,904,2160.165109021,2128.793969309,-71
carcassonne-uct400-vs-uct115-1000its,834,905,2125.230638204,2087.137732531,-71
carcassonne-ucttuned75-vs-ucttuned25-1000its,834,905,2155.845913705,2128.640381409,-71
carcassonne-ucttuned470-vs-ucttuned490-1000its,836,907,2176.184918577,2160.438707785,-71
carcassonne-uct425-vs-uct270-1000its,844,915,2185.797999286,2145.360716693,-71
carcassonne-boltzmann405-vs-boltzmann145-1000its,851,922,2138.703169872,2080.471526189,-71
carcassonne-boltzmann180-vs-boltzmann155-1000its,854,925,2177.033570383,2125.716619128,-71
carcassonne-uct115-vs-uct320-1000its,854,925,2212.728745594,2158.630636746,-71
carcassonne-ucttuned50-vs-ucttuned90-1000its,693,763,2218.155556849,2166.930176308,-70
carcassonne-uct365-vs-uct435-1000its,694,764,2225.673489717,2193.66281219,-70
carcassonne-boltzmann80-vs-boltzmann350-1000its,697,767,2238.060179826,2166.420389813,-70
carcassonne-boltzmann165-vs-boltzmann210-1000its,699,769,2241.650013971,2171.897005614,-70
carcassonne-uct315-vs-uct35-1000its,705,775,2140.594406356,2083.218997879,-70
carcassonne-boltzmann280-vs-boltzmann140-1000its,706,776,2184.412974363,2146.31794273,-70
carcassonne-boltzmann225-vs-boltzmann220-1000its,721,791,2139.309887918,2082.47789142,-70
carcassonne-uct350-vs-uct250-1000its,722,792,2286.10600401,2225.333443862,-70
carcassonne-boltzmann375-vs-boltzmann210-1000its,725,795,2205.789558483,2144.617449582,-70
carcassonne-uct385-vs-uct260-1000its,725,795,2073.430177584,2060.021995904,-70
carcassonne-boltzmann80-vs-boltzmann120-1000its,726,796,2184.726098659,2176.054448118,-70
carcassonne-ucttuned425-vs-ucttuned305-1000its,729,799,2268.583967312,2185.579248384,-70
carcassonne-ucttuned420-vs-ucttuned330-1000its,731,801,2142.658963818,2097.964654822,-70
carcassonne-uct350-vs-uct325-1000its,732,802,2136.296298769,2115.909995371,-70
carcassonne-boltzmann200-vs-boltzmann215-1000its,735,805,2244.420385053,2237.047502452,-70
carcassonne-boltzmann300-vs-boltzmann45-1000its,738,808,2247.771920627,2172.09862677,-70
carcassonne-ucttuned480-vs-ucttuned285-1000its,738,808,2196.337943226,2133.470221959,-70
carcassonne-uct30-vs-uct265-1000its,739,809,2157.31892505,2113.244953422,-70
carcassonne-uct170-vs-uct305-1000its,748,818,2182.303540556,2101.707739646,-70
carcassonne-boltzmann475-vs-boltzmann170-1000its,749,819,2260.387502519,2230.942797761,-70
carcassonne-uct235-vs-uct165-1000its,749,819,2159.090030354,2144.504385689,-70
carcassonne-uct475-vs-uct340-1000its,749,819,2154.920788991,2129.264122893,-70
carcassonne-boltzmann415-vs-boltzmann25-1000its,750,820,2192.836928822,2172.720754508,-70
carcassonne-boltzmann470-vs-boltzmann360-1000its,750,820,2200.83637317,2124.094806138,-70
carcassonne-ucttuned270-vs-ucttuned380-1000its,751,821,2134.153300264,2092.58511262,-70
carcassonne-uct310-vs-uct210-1000its,752,822,2150.1511046,2112.450887127,-70
carcassonne-ucttuned200-vs-ucttuned295-1000its,756,826,2207.716193015,2142.27532226,-70
carcassonne-ucttuned85-vs-ucttuned245-1000its,756,826,2236.854759232,2171.552782618,-70
carcassonne-boltzmann25-vs-boltzmann145-1000its,757,827,2188.525697074,2135.594019897,-70
carcassonne-boltzmann175-vs-boltzmann10-1000its,758,828,2182.399944132,2174.232062945,-70
carcassonne-uct420-vs-uct175-1000its,760,830,2179.184435691,2171.574733624,-70
carcassonne-uct465-vs-uct45-1000its,760,830,2204.208083322,2186.80999421,-70
carcassonne-ucttuned190-vs-ucttuned70-1000its,760,830,2186.709422665,2178.438147436,-70
carcassonne-boltzmann300-vs-boltzmann350-1000its,762,832,2176.218858251,2128.323169905,-70
carcassonne-boltzmann40-vs-boltzmann230-1000its,764,834,2222.944745062,2167.746421162,-70
carcassonne-boltzmann90-vs-boltzmann385-1000its,765,835,2223.502008248,2193.924322464,-70
carcassonne-boltzmann390-vs-boltzmann415-1000its,766,836,2166.761728611,2091.882450472,-70
carcassonne-boltzmann265-vs-boltzmann25-1000its,767,837,2137.120357043,2106.204614826,-70
carcassonne-boltzmann240-vs-boltzmann310-1000its,768,838,2231.325234325,2211.535973047,-70
carcassonne-boltzmann310-vs-boltzmann290-1000its,768,838,2259.283464868,2205.291971074,-70
carcassonne-uct460-vs-uct165-1000its,768,838,2200.986330931,2196.051848945,-70
carcassonne-ucttuned435-vs-ucttuned65-1000its,768,838,2151.021881877,2116.557604694,-70
carcassonne-ucttuned30-vs-ucttuned65-1000its,769,839,2216.918530832,2222.261830716,-70
carcassonne-ucttuned445-vs-ucttuned380-1000its,769,839,2187.425159929,2102.577512729,-70
carcassonne-uct365-vs-uct35-1000its,772,842,2202.559146076,2167.89460927,-70
carcassonne-ucttuned175-vs-ucttuned255-1000its,773,843,2200.740168516,2158.400432186,-70
carcassonne-uct360-vs-uct200-1000its,776,846,2230.970241358,2227.643179142,-70
carcassonne-ucttuned410-vs-ucttuned225-1000its,777,847,2193.9383189,2189.152700716,-70
carcassonne-boltzmann345-vs-boltzmann265-1000its,778,848,2266.875129354,2236.117867704,-70
carcassonne-boltzmann375-vs-boltzmann105-1000its,779,849,2171.270405197,2164.466252364,-70
carcassonne-uct110-vs-uct240-1000its,779,849,2257.666211667,2195.932553265,-70
carcassonne-uct460-vs-uct195-1000its,779,849,2191.056243995,2163.199648243,-70
carcassonne-ucttuned415-vs-ucttuned90-1000its,779,849,2140.589554036,2085.19787209,-70
carcassonne-boltzmann160-vs-boltzmann180-1000its,780,850,2231.329528979,2183.186927508,-70
carcassonne-uct330-vs-uct360-1000its,780,850,2192.100113091,2148.45340559,-70
carcassonne-uct255-vs-uct100-1000its,782,852,2266.7214236,2210.344810909,-70
carcassonne-uct410-vs-uct40-1000its,782,852,2183.657624809,2101.255550132,-70
carcassonne-ucttuned150-vs-ucttuned95-1000its,782,852,2243.671874341,2184.421743581,-70
carcassonne-ucttuned355-vs-ucttuned135-1000its,782,852,2227.794829022,2172.132491859,-70
carcassonne-ucttuned70-vs-ucttuned145-1000its,784,854,2261.159155721,2222.307908149,-70
carcassonne-ucttuned280-vs-ucttuned205-1000its,786,856,2257.65653842,2230.765766293,-70
carcassonne-uct25-vs-uct245-1000its,787,857,2195.660246033,2143.836604383,-70
carcassonne-uct380-vs-uct340-1000its,787,857,2189.36889877,2117.827155386,-70
carcassonne-ucttuned145-vs-ucttuned205-1000its,788,858,2186.119450528,2174.168899014,-70
carcassonne-ucttuned115-vs-ucttuned40-1000its,789,859,2132.692749646,2099.81307149,-70
carcassonne-uct320-vs-uct100-1000its,791,861,2137.566024276,2110.496797386,-70
carcassonne-uct430-vs-uct410-1000its,795,865,2188.009467322,2116.328454949,-70
carcassonne-uct390-vs-uct340-1000its,797,867,2214.120462224,2118.992304179,-70
carcassonne-boltzmann350-vs-boltzmann435-1000its,799,869,2183.373554135,2149.02015509,-70
carcassonne-ucttuned440-vs-ucttuned425-1000its,800,870,2221.905632747,2193.632542151,-70
carcassonne-uct255-vs-uct230-1000its,805,875,2218.327197444,2177.647898882,-70
carcassonne-ucttuned330-vs-ucttuned230-1000its,806,876,2157.259460024,2113.657255817,-70
carcassonne-ucttuned120-vs-ucttuned330-1000its,807,877,2157.652893206,2125.917965658,-70
carcassonne-ucttuned480-vs-ucttuned380-1000its,807,877,2234.36748136,2214.094717223,-70
carcassonne-boltzmann20-vs-boltzmann345-1000its,808,878,2176.183760946,2148.092232898,-70
carcassonne-boltzmann305-vs-boltzmann410-1000its,809,879,2198.091332703,2146.596331369,-70
carcassonne-boltzmann400-vs-boltzmann95-1000its,812,882,2164.489531045,2090.599262332,-70
carcassonne-uct240-vs-uct435-1000its,813,883,2123.285920618,2106.922476083,-70
carcassonne-uct335-vs-uct450-1000its,813,883,2170.442763489,2090.662245736,-70
carcassonne-uct435-vs-uct300-1000its,813,883,2239.434110834,2198.352736545,-70
carcassonne-ucttuned300-vs-ucttuned420-1000its,813,883,2202.263611699,2172.882782886,-70
carcassonne-uct165-vs-uct20-1000its,815,885,2145.081121549,2077.866222845,-70
carcassonne-ucttuned190-vs-ucttuned460-1000its,815,885,2207.879897045,2195.876846993,-70
carcassonne-boltzmann105-vs-boltzmann315-1000its,817,887,2178.560782805,2133.760814562,-70
carcassonne-boltzmann75-vs-boltzmann5-1000its,823,893,2147.631731675,2144.359919632,-70
carcassonne-ucttuned315-vs-ucttuned120-1000its,823,893,2231.34672296,2195.51660084,-70
carcassonne-ucttuned215-vs-ucttuned10-1000its,825,895,2128.423553772,2082.226087487,-70
carcassonne-boltzmann65-vs-boltzmann185-1000its,827,897,2186.00109257,2151.883655195,-70
carcassonne-ucttuned270-vs-ucttuned50-1000its,829,899,2206.36805947,2148.160314667,-70
carcassonne-uct95-vs-uct15-1000its,832,902,2206.971592332,2139.51864252,-70
carcassonne-ucttuned355-vs-ucttuned35-1000its,832,902,2236.097678855,2217.661128242,-70
carcassonne-ucttuned410-vs-ucttuned240-1000its,834,904,2236.694071804,2178.512166029,-70
carcassonne-uct450-vs-uct410-1000its,836,906,2193.408856924,2136.577308126,-70
carcassonne-ucttuned350-vs-ucttuned30-1000its,839,909,2297.217669573,2242.410357611,-70
carcassonne-uct470-vs-uct320-1000its,842,912,2235.66972534,2220.541485499,-70
carcassonne-uct280-vs-uct450-1000its,846,916,2149.908816003,2124.585640577,-70
carcassonne-boltzmann340-vs-boltzmann245-1000its,848,918,2203.492995185,2122.108875157,-70
carcassonne-boltzmann65-vs-boltzmann265-1000its,850,920,2232.503027416,2177.605781698,-70
carcassonne-ucttuned80-vs-ucttuned450-1000its,853,923,2182.921653461,2138.231794929,-70
carcassonne-uct255-vs-uct145-1000its,858,928,2214.451768225,2194.104802409,-70
carcassonne-ucttuned10-vs-ucttuned200-1000its,683,752,2145.060214553,2137.067167417,-69
carcassonne-boltzmann430-vs-boltzmann210-1000its,694,763,2274.980645626,2169.282383689,-69
carcassonne-ucttuned105-vs-ucttuned430-1000its,694,763,2252.203876441,2174.506329157,-69
carcassonne-boltzmann460-vs-boltzmann100-1000its,703,772,2255.632585479,2176.43170494,-69
carcassonne-ucttuned80-vs-ucttuned375-1000its,707,776,2116.149181468,2085.218420118,-69
carcassonne-uct170-vs-uct200-1000its,716,785,2330.575402086,2295.131288092,-69
carcassonne-uct80-vs-uct485-1000its,720,789,2209.961224159,2177.018215718,-69
carcassonne-ucttuned425-vs-ucttuned160-1000its,720,789,2228.374652137,2111.449523475,-69
carcassonne-boltzmann210-vs-boltzmann325-1000its,724,793,2262.00957639,2158.232684609,-69
carcassonne-uct415-vs-uct200-1000its,729,798,2230.472901134,2207.881203097,-69
carcassonne-ucttuned215-vs-ucttuned270-1000its,731,800,2193.042019232,2189.617474277,-69
carcassonne-ucttuned360-vs-ucttuned400-1000its,731,800,2199.601010533,2153.686698521,-69
carcassonne-boltzmann205-vs-boltzmann470-1000its,732,801,2185.675368583,2136.413701353,-69
carcassonne-boltzmann205-vs-boltzmann445-1000its,734,803,2197.036453252,2150.781282364,-69
carcassonne-ucttuned115-vs-ucttuned330-1000its,736,805,2121.736383639,2117.065342983,-69
carcassonne-ucttuned350-vs-ucttuned485-1000its,739,808,2191.124304711,2166.746263515,-69
carcassonne-ucttuned440-vs-ucttuned275-1000its,741,810,2196.712718591,2164.055581406,-69
carcassonne-boltzmann475-vs-boltzmann460-1000its,742,811,2153.376078493,2095.123155548,-69
carcassonne-boltzmann345-vs-boltzmann355-1000its,743,812,2144.885135239,2162.586985956,-69
carcassonne-boltzmann355-vs-boltzmann125-1000its,743,812,2197.35514068,2173.721403528,-69
carcassonne-ucttuned410-vs-ucttuned100-1000its,744,813,2145.464903554,2129.770213662,-69
carcassonne-uct485-vs-uct30-1000its,745,814,2137.54789444,2067.952397414,-69
carcassonne-boltzmann410-vs-boltzmann370-1000its,746,815,2166.79582563,2137.175384366,-69
carcassonne-boltzmann215-vs-boltzmann110-1000its,747,816,2244.394488305,2210.928407391,-69
carcassonne-ucttuned250-vs-ucttuned225-1000its,748,817,2225.671209757,2184.7382249,-69
carcassonne-ucttuned490-vs-ucttuned475-1000its,748,817,2113.201720482,2085.699621536,-69
carcassonne-uct430-vs-uct90-1000its,751,820,2202.381815477,2187.40394924,-69
carcassonne-uct450-vs-uct80-1000its,751,820,2123.901154935,2083.156698844,-69
carcassonne-ucttuned280-vs-ucttuned415-1000its,752,821,2192.78336918,2192.015990734,-69
carcassonne-boltzmann115-vs-boltzmann180-1000its,753,822,2259.242857833,2246.761519571,-69
carcassonne-uct265-vs-uct30-1000its,753,822,2148.94586642,2112.476783438,-69
carcassonne-uct420-vs-uct480-1000its,753,822,2167.082661671,2154.283639655,-69
carcassonne-boltzmann110-vs-boltzmann450-1000its,754,823,2238.491250889,2222.412317606,-69
carcassonne-uct45-vs-uct495-1000its,754,823,2154.41508076,2153.224264518,-69
carcassonne-boltzmann385-vs-boltzmann430-1000its,755,824,2250.020761071,2190.164961162,-69
carcassonne-boltzmann465-vs-boltzmann300-1000its,756,825,2241.557604226,2124.260504319,-69
carcassonne-boltzmann465-vs-boltzmann490-1000its,757,826,2218.635993647,2181.067429498,-69
carcassonne-ucttuned450-vs-ucttuned260-1000its,760,829,2245.971596368,2241.476251681,-69
carcassonne-ucttuned10-vs-ucttuned225-1000its,762,831,2237.335752139,2219.065111873,-69
carcassonne-ucttuned250-vs-ucttuned345-1000its,762,831,2198.535063998,2151.198428509,-69
carcassonne-ucttuned420-vs-ucttuned300-1000its,762,831,2156.954500703,2123.538286601,-69
carcassonne-uct100-vs-uct340-1000its,763,832,2240.929747855,2186.158623503,-69
carcassonne-boltzmann445-vs-boltzmann240-1000its,767,836,2164.262784397,2102.227314193,-69
carcassonne-ucttuned450-vs-ucttuned290-1000its,767,836,2136.931617355,2114.082471209,-69
carcassonne-ucttuned155-vs-ucttuned120-1000its,768,837,2176.305328834,2109.476045495,-69
carcassonne-boltzmann410-vs-boltzmann95-1000its,773,842,2219.03132502,2149.434181724,-69
carcassonne-ucttuned220-vs-ucttuned240-1000its,775,844,2206.109669877,2172.771728443,-69
carcassonne-uct275-vs-uct70-1000its,776,845,2120.297092135,2105.217828076,-69
carcassonne-ucttuned25-vs-ucttuned480-1000its,776,845,2261.179682317,2240.861667176,-69
carcassonne-uct435-vs-uct405-1000its,778,847,2182.545886141,2160.939465444,-69
carcassonne-uct480-vs-uct105-1000its,779,848,2207.647482045,2185.619727583,-69
carcassonne-uct45-vs-uct25-1000its,780,849,2198.424081294,2183.470394167,-69
carcassonne-ucttuned190-vs-ucttuned220-1000its,782,851,2207.34331192,2173.130327299,-69
carcassonne-ucttuned245-vs-ucttuned255-1000its,783,852,2167.831233507,2164.18046235,-69
carcassonne-boltzmann230-vs-boltzmann375-1000its,784,853,2152.640123086,2112.006751549,-69
carcassonne-uct460-vs-uct340-1000its,785,854,2218.521623695,2164.481286945,-69
carcassonne-uct20-vs-uct55-1000its,786,855,2199.383770631,2145.120747057,-69
carcassonne-uct155-vs-uct270-1000its,788,857,2209.666680528,2145.630946997,-69
carcassonne-uct215-vs-uct165-1000its,789,858,2200.181994023,2134.7246133,-69
carcassonne-uct95-vs-uct260-1000its,789,858,2167.420862685,2132.54937909,-69
carcassonne-boltzmann320-vs-boltzmann340-1000its,791,860,2207.945744508,2167.177017308,-69
carcassonne-ucttuned225-vs-ucttuned90-1000its,793,862,2226.328472938,2172.349210953,-69
carcassonne-boltzmann255-vs-boltzmann320-1000its,794,863,2320.282729817,2232.201752087,-69
carcassonne-boltzmann70-vs-boltzmann410-1000its,794,863,2252.081562828,2241.700269847,-69
carcassonne-uct245-vs-uct275-1000its,794,863,2243.564202746,2210.197197573,-69
carcassonne-ucttuned490-vs-ucttuned400-1000its,794,863,2149.426780323,2085.361301392,-69
carcassonne-uct65-vs-uct455-1000its,795,864,2177.582299172,2143.843615792,-69
carcassonne-uct90-vs-uct335-1000its,797,866,2198.72464005,2162.92528179,-69
carcassonne-uct380-vs-uct120-1000its,799,868,2202.550279598,2119.360632596,-69
carcassonne-boltzmann160-vs-boltzmann250-1000its,800,869,2228.096317607,2207.175264708,-69
carcassonne-boltzmann370-vs-boltzmann5-1000its,804,873,2244.701914424,2184.739845702,-69
carcassonne-boltzmann295-vs-boltzmann475-1000its,813,882,2246.654139661,2179.476787366,-69
carcassonne-uct65-vs-uct400-1000its,813,882,2128.627685314,2125.026683169,-69
carcassonne-boltzmann85-vs-boltzmann365-1000its,814,883,2214.083798906,2140.710270249,-69
carcassonne-ucttuned355-vs-ucttuned240-1000its,815,884,2153.674863072,2156.031528099,-69
carcassonne-boltzmann195-vs-boltzmann385-1000its,818,887,2336.429006712,2273.592150494,-69
carcassonne-uct490-vs-uct25-1000its,819,888,2213.364663592,2152.136786818,-69
carcassonne-ucttuned250-vs-ucttuned110-1000its,827,896,2161.432676257,2113.819773462,-69
carcassonne-uct200-vs-uct235-1000its,829,898,2185.503543306,2116.511543426,-69
carcassonne-uct460-vs-uct255-1000its,831,900,2179.291647366,2197.313797413,-69
carcassonne-uct380-vs-uct125-1000its,841,910,2185.611934912,2103.800980752,-69
carcassonne-ucttuned150-vs-ucttuned195-1000its,841,910,2174.735392648,2129.319001154,-69
carcassonne-ucttuned15-vs-ucttuned195-1000its,888,957,2140.277163334,2113.193740845,-69
carcassonne-uct280-vs-uct400-1000its,692,760,2163.545606889,2136.843510286,-68
carcassonne-boltzmann455-vs-boltzmann230-1000its,713,781,2193.101166925,2150.690447303,-68
carcassonne-boltzmann315-vs-boltzmann295-1000its,714,782,2193.621925982,2173.510176268,-68
carcassonne-boltzmann160-vs-boltzmann485-1000its,715,783,2174.338827526,2116.345243543,-68
carcassonne-boltzmann315-vs-boltzmann280-1000its,721,789,2177.78538524,2156.68151701,-68
carcassonne-uct315-vs-uct475-1000its,723,791,2198.197171652,2147.261080205,-68
carcassonne-boltzmann385-vs-boltzmann165-1000its,731,799,2199.060105792,2153.691653397,-68
carcassonne-ucttuned470-vs-ucttuned130-1000its,733,801,2194.17791453,2110.961411128,-68
carcassonne-boltzmann450-vs-boltzmann335-1000its,735,803,2196.80080495,2171.41693272,-68
carcassonne-ucttuned300-vs-ucttuned155-1000its,735,803,2213.982758689,2175.656982923,-68
carcassonne-boltzmann255-vs-boltzmann120-1000its,736,804,2197.367871827,2159.594809302,-68
carcassonne-ucttuned330-vs-ucttuned355-1000its,736,804,2313.462053062,2224.562341333,-68
carcassonne-boltzmann340-vs-boltzmann490-1000its,740,808,2221.922833404,2183.706509915,-68
carcassonne-boltzmann265-vs-boltzmann95-1000its,741,809,2169.205465744,2127.13373817,-68
carcassonne-boltzmann375-vs-boltzmann335-1000its,741,809,2165.228917833,2109.242458397,-68
carcassonne-boltzmann490-vs-boltzmann355-1000its,742,810,2180.766848142,2121.437537956,-68
carcassonne-uct365-vs-uct140-1000its,743,811,2163.694062674,2111.635364238,-68
carcassonne-boltzmann380-vs-boltzmann5-1000its,746,814,2147.888656776,2114.846184758,-68
carcassonne-boltzmann295-vs-boltzmann335-1000its,747,815,2228.610492936,2154.586275405,-68
carcassonne-boltzmann35-vs-boltzmann160-1000its,747,815,2261.841774688,2210.447702058,-68
carcassonne-uct335-vs-uct330-1000its,747,815,2141.859168532,2109.729122965,-68
carcassonne-uct60-vs-uct65-1000its,747,815,2137.735554084,2077.007307574,-68
carcassonne-ucttuned325-vs-ucttuned115-1000its,747,815,2162.461175391,2140.287042005,-68
carcassonne-boltzmann100-vs-boltzmann40-1000its,748,816,2179.025717993,2099.296273325,-68
carcassonne-ucttuned130-vs-ucttuned245-1000its,748,816,2241.534242138,2206.872844027,-68
carcassonne-ucttuned145-vs-ucttuned305-1000its,748,816,2171.868089864,2171.970255499,-68
carcassonne-ucttuned230-vs-ucttuned80-1000its,749,817,2224.838960453,2216.15769638,-68
carcassonne-boltzmann145-vs-boltzmann200-1000its,753,821,2203.238704389,2132.209779731,-68
carcassonne-boltzmann65-vs-boltzmann95-1000its,753,821,2138.938321645,2119.609475454,-68
carcassonne-uct475-vs-uct255-1000its,754,822,2198.921607867,2126.561313135,-68
carcassonne-uct195-vs-uct40-1000its,755,823,2210.759446059,2186.898888594,-68
carcassonne-uct410-vs-uct265-1000its,755,823,2197.334631838,2122.777670022,-68
carcassonne-boltzmann255-vs-boltzmann455-1000its,756,824,2156.74874065,2109.433646954,-68
carcassonne-uct150-vs-uct395-1000its,756,824,2118.614266417,2139.490571258,-68
carcassonne-boltzmann315-vs-boltzmann375-1000its,757,825,2273.830715004,2229.083452717,-68
carcassonne-uct115-vs-uct140-1000its,758,826,2169.509662257,2152.878741689,-68
carcassonne-uct430-vs-uct385-1000its,758,826,2223.312473467,2183.675219886,-68
carcassonne-ucttuned50-vs-ucttuned155-1000its,759,827,2160.867030288,2128.847692597,-68
carcassonne-ucttuned305-vs-ucttuned220-1000its,763,831,2238.48638035,2171.864732513,-68
carcassonne-uct280-vs-uct40-1000its,764,832,2125.194812729,2106.215069951,-68
carcassonne-boltzmann215-vs-boltzmann305-1000its,765,833,2255.259768797,2207.968166885,-68
carcassonne-ucttuned295-vs-ucttuned125-1000its,765,833,2258.264774619,2195.507125826,-68
carcassonne-uct240-vs-uct210-1000its,766,834,2200.161482717,2160.88014619,-68
carcassonne-uct245-vs-uct485-1000its,766,834,2252.681638429,2226.743792922,-68
carcassonne-ucttuned40-vs-ucttuned135-1000its,766,834,2209.528720318,2164.041683504,-68
carcassonne-ucttuned165-vs-ucttuned180-1000its,768,836,2198.177889645,2138.03687503,-68
carcassonne-ucttuned465-vs-ucttuned445-1000its,768,836,2130.110278928,2111.042290296,-68
carcassonne-uct85-vs-uct190-1000its,770,838,2140.490678217,2082.386173885,-68
carcassonne-ucttuned380-vs-ucttuned290-1000its,773,841,2248.203783599,2235.354712765,-68
carcassonne-uct210-vs-uct110-1000its,774,842,2266.920597594,2224.113666543,-68
carcassonne-uct365-vs-uct90-1000its,775,843,2257.956197704,2235.461410803,-68
carcassonne-uct70-vs-uct285-1000its,778,846,2185.381080266,2164.288969209,-68
carcassonne-uct90-vs-uct325-1000its,779,847,2135.724097009,2077.137558371,-68
carcassonne-boltzmann465-vs-boltzmann15-1000its,780,848,2161.872849283,2124.89219594,-68
carcassonne-ucttuned160-vs-ucttuned165-1000its,780,848,2211.686009145,2193.023054407,-68
carcassonne-boltzmann140-vs-boltzmann420-1000its,781,849,2305.224695027,2253.774383576,-68
carcassonne-boltzmann290-vs-boltzmann310-1000its,781,849,2203.446634447,2158.501341635,-68
carcassonne-boltzmann330-vs-boltzmann435-1000its,781,849,2196.662884942,2143.771279517,-68
carcassonne-ucttuned485-vs-ucttuned430-1000its,782,850,2143.116439612,2119.184690656,-68
carcassonne-boltzmann410-vs-boltzmann350-1000its,783,851,2095.168546713,2066.128926453,-68
carcassonne-boltzmann55-vs-boltzmann400-1000its,783,851,2145.864651489,2117.534266738,-68
carcassonne-boltzmann485-vs-boltzmann5-1000its,784,852,2213.088948097,2109.134010258,-68
carcassonne-boltzmann5-vs-boltzmann395-1000its,784,852,2301.036746564,2235.900661,-68
carcassonne-uct195-vs-uct445-1000its,784,852,2187.971322086,2128.500043098,-68
carcassonne-uct200-vs-uct5-1000its,784,852,2176.99449632,2143.171859237,-68
carcassonne-boltzmann450-vs-boltzmann280-1000its,785,853,2203.387961768,2152.814045967,-68
carcassonne-boltzmann185-vs-boltzmann35-1000its,786,854,2191.451356001,2164.345795991,-68
carcassonne-ucttuned420-vs-ucttuned440-1000its,786,854,2221.255504765,2180.703220559,-68
carcassonne-ucttuned495-vs-ucttuned140-1000its,788,856,2241.215494141,2221.040372943,-68
carcassonne-uct115-vs-uct255-1000its,789,857,2201.290081417,2139.504505135,-68
carcassonne-ucttuned135-vs-ucttuned100-1000its,791,859,2157.234360359,2105.775602579,-68
carcassonne-ucttuned225-vs-ucttuned40-1000its,792,860,2134.57142064,2133.151111838,-68
carcassonne-uct120-vs-uct45-1000its,793,861,2232.16580995,2168.262556007,-68
carcassonne-uct400-vs-uct140-1000its,794,862,2198.36602875,2149.962156256,-68
carcassonne-ucttuned150-vs-ucttuned65-1000its,794,862,2167.52642977,2124.14672778,-68
carcassonne-ucttuned325-vs-ucttuned165-1000its,794,862,2197.573870197,2150.648750745,-68
carcassonne-ucttuned160-vs-ucttuned70-1000its,795,863,2231.172002595,2188.607841065,-68
carcassonne-ucttuned420-vs-ucttuned260-1000its,796,864,2156.6965982,2152.16985218,-68
carcassonne-ucttuned125-vs-ucttuned40-1000its,798,866,2245.847596617,2187.322111657,-68
carcassonne-uct385-vs-uct405-1000its,800,868,2233.967938884,2185.943798857,-68
carcassonne-uct455-vs-uct5-1000its,800,868,2188.288122892,2164.262274648,-68
carcassonne-boltzmann315-vs-boltzmann410-1000its,801,869,2082.432729437,2079.831441863,-68
carcassonne-uct300-vs-uct25-1000its,801,869,2215.373213055,2141.862754204,-68
carcassonne-ucttuned290-vs-ucttuned370-1000its,804,872,2182.995635498,2134.872276387,-68
carcassonne-ucttuned435-vs-ucttuned355-1000its,805,873,2214.214486005,2128.695850861,-68
carcassonne-boltzmann190-vs-boltzmann5-1000its,806,874,2264.048762801,2218.5300039,-68
carcassonne-uct45-vs-uct290-1000its,806,874,2181.449067739,2167.227474332,-68
carcassonne-uct350-vs-uct35-1000its,807,875,2199.301497768,2181.109936456,-68
carcassonne-ucttuned230-vs-ucttuned45-1000its,809,877,2171.330820638,2108.374156291,-68
carcassonne-uct365-vs-uct260-1000its,811,879,2176.83574055,2145.932342626,-68
carcassonne-uct220-vs-uct475-1000its,812,880,2154.285545455,2104.569355485,-68
carcassonne-uct255-vs-uct495-1000its,816,884,2181.526994246,2158.080221674,-68
carcassonne-boltzmann160-vs-boltzmann245-1000its,820,888,2178.731332521,2162.879078984,-68
carcassonne-ucttuned325-vs-ucttuned5-1000its,828,896,2183.912147942,2180.076739382,-68
carcassonne-ucttuned395-vs-ucttuned285-1000its,828,896,2192.943075568,2148.820419614,-68
carcassonne-ucttuned490-vs-ucttuned195-1000its,833,901,2189.303547555,2136.586545014,-68
carcassonne-ucttuned160-vs-ucttuned270-1000its,834,902,2195.336793381,2188.504965521,-68
carcassonne-ucttuned215-vs-ucttuned385-1000its,838,906,2154.656584878,2122.461485326,-68
carcassonne-ucttuned140-vs-ucttuned370-1000its,843,911,2203.636764473,2164.674387684,-68
carcassonne-ucttuned20-vs-ucttuned50-1000its,844,912,2275.771315619,2288.134454732,-68
carcassonne-ucttuned395-vs-ucttuned35-1000its,845,913,2166.574544069,2141.215316052,-68
carcassonne-uct210-vs-uct320-1000its,850,918,2188.145309592,2160.999614499,-68
carcassonne-boltzmann175-vs-boltzmann220-1000its,706,773,2202.821051048,2118.97566964,-67
carcassonne-boltzmann395-vs-boltzmann420-1000its,710,777,2227.732756376,2219.101111843,-67
carcassonne-boltzmann245-vs-boltzmann355-1000its,719,786,2276.789400263,2236.561785249,-67
carcassonne-ucttuned205-vs-ucttuned135-1000its,720,787,2251.5563292,2180.120318749,-67
carcassonne-ucttuned230-vs-ucttuned340-1000its,722,789,2152.792558734,2090.298360781,-67
carcassonne-boltzmann135-vs-boltzmann330-1000its,725,792,2231.655932435,2168.205589096,-67
carcassonne-boltzmann120-vs-boltzmann345-1000its,730,797,2194.705174703,2165.313104173,-67
carcassonne-boltzmann285-vs-boltzmann385-1000its,732,799,2251.492158994,2203.706817596,-67
carcassonne-ucttuned315-vs-ucttuned80-1000its,733,800,2150.88036858,2119.412225896,-67
carcassonne-boltzmann140-vs-boltzmann145-1000its,735,802,2231.890427868,2155.325217796,-67
carcassonne-boltzmann180-vs-boltzmann75-1000its,735,802,2238.972343014,2192.044871113,-67
carcassonne-uct130-vs-uct235-1000its,735,802,2210.083959435,2139.178427269,-67
carcassonne-boltzmann125-vs-boltzmann170-1000its,740,807,2290.264139583,2248.704614134,-67
carcassonne-ucttuned115-vs-ucttuned55-1000its,741,808,2194.288945618,2185.270183136,-67
carcassonne-uct140-vs-uct395-1000its,746,813,2194.38794757,2142.460451617,-67
carcassonne-boltzmann140-vs-boltzmann465-1000its,750,817,2151.079144834,2094.019352448,-67
carcassonne-uct490-vs-uct215-1000its,750,817,2145.337320371,2099.411394592,-67
carcassonne-ucttuned80-vs-ucttuned320-1000its,752,819,2245.772317024,2237.849899959,-67
carcassonne-boltzmann290-vs-boltzmann5-1000its,753,820,2173.090626612,2120.926008345,-67
carcassonne-boltzmann470-vs-boltzmann25-1000its,753,820,2201.275058772,2181.066228856,-67
carcassonne-ucttuned330-vs-ucttuned40-1000its,753,820,2225.584997456,2195.955184599,-67
carcassonne-boltzmann160-vs-boltzmann455-1000its,756,823,2167.217113213,2098.109353177,-67
carcassonne-ucttuned185-vs-ucttuned55-1000its,756,823,2208.189819744,2175.119083998,-67
carcassonne-ucttuned235-vs-ucttuned245-1000its,757,824,2177.822213228,2141.24237343,-67
carcassonne-boltzmann35-vs-boltzmann360-1000its,759,826,2206.51156959,2133.865825416,-67
carcassonne-uct195-vs-uct15-1000its,759,826,2124.575050547,2081.942886244,-67
carcassonne-boltzmann350-vs-boltzmann85-1000its,761,828,2188.802241805,2200.116231632,-67
carcassonne-boltzmann475-vs-boltzmann195-1000its,761,828,2158.47770929,2096.812184601,-67
carcassonne-uct390-vs-uct290-1000its,762,829,2235.812034988,2158.107126615,-67
carcassonne-ucttuned470-vs-ucttuned330-1000its,766,833,2204.15236812,2161.711572472,-67
carcassonne-boltzmann105-vs-boltzmann385-1000its,767,834,2169.706295865,2179.995189978,-67
carcassonne-boltzmann290-vs-boltzmann300-1000its,767,834,2203.300751202,2199.314759199,-67
carcassonne-uct485-vs-uct100-1000its,768,835,2234.685698294,2214.391907191,-67
carcassonne-boltzmann140-vs-boltzmann75-1000its,771,838,2183.993045355,2125.31738571,-67
carcassonne-uct215-vs-uct110-1000its,772,839,2257.615422284,2236.951244237,-67
carcassonne-boltzmann120-vs-boltzmann135-1000its,775,842,2192.846853165,2147.484082935,-67
carcassonne-ucttuned45-vs-ucttuned380-1000its,776,843,2180.483576102,2142.710677339,-67
carcassonne-boltzmann255-vs-boltzmann425-1000its,777,844,2233.285465145,2163.643888558,-67
carcassonne-ucttuned410-vs-ucttuned275-1000its,778,845,2210.801538338,2154.657787011,-67
carcassonne-ucttuned210-vs-ucttuned185-1000its,780,847,2153.497844635,2124.841849502,-67
carcassonne-ucttuned330-vs-ucttuned145-1000its,780,847,2209.800739484,2149.065382771,-67
carcassonne-uct290-vs-uct350-1000its,784,851,2141.284203469,2119.261979765,-67
carcassonne-ucttuned275-vs-ucttuned25-1000its,784,851,2146.948254773,2126.118471623,-67
carcassonne-boltzmann460-vs-boltzmann20-1000its,789,856,2247.390138504,2206.43997486,-67
carcassonne-ucttuned175-vs-ucttuned20-1000its,789,856,2277.570647375,2223.667227354,-67
carcassonne-ucttuned465-vs-ucttuned55-1000its,789,856,2187.738257379,2136.964191227,-67
carcassonne-uct315-vs-uct455-1000its,791,858,2168.107398465,2119.036725299,-67
carcassonne-uct395-vs-uct380-1000its,792,859,2160.516436357,2163.848643497,-67
carcassonne-uct20-vs-uct40-1000its,794,861,2135.247826655,2104.886840036,-67
carcassonne-boltzmann210-vs-boltzmann455-1000its,796,863,2183.786064751,2095.946235431,-67
carcassonne-uct100-vs-uct75-1000its,796,863,2194.72162423,2150.724420104,-67
carcassonne-ucttuned55-vs-ucttuned70-1000its,797,864,2180.712185547,2074.814586439,-67
carcassonne-uct185-vs-uct250-1000its,799,866,2234.880417558,2202.213189854,-67
carcassonne-uct425-vs-uct85-1000its,802,869,2200.622954233,2185.903234038,-67
carcassonne-boltzmann185-vs-boltzmann15-1000its,803,870,2117.451331588,2068.002695289,-67
carcassonne-boltzmann225-vs-boltzmann15-1000its,805,872,2177.234149538,2110.690697584,-67
carcassonne-ucttuned385-vs-ucttuned165-1000its,811,878,2174.959278393,2172.983534935,-67
carcassonne-uct295-vs-uct270-1000its,813,880,2276.62951284,2195.974388205,-67
carcassonne-uct195-vs-uct360-1000its,818,885,2185.357383502,2120.710651295,-67
carcassonne-uct25-vs-uct340-1000its,827,894,2188.759658863,2159.734992056,-67
carcassonne-ucttuned370-vs-ucttuned195-1000its,830,897,2171.64120138,2118.941975281,-67
carcassonne-uct445-vs-uct245-1000its,845,912,2223.82630324,2175.422823413,-67
carcassonne-boltzmann150-vs-boltzmann25-1000its,863,930,2235.985932856,2195.14773512,-67
carcassonne-ucttuned400-vs-ucttuned5-1000its,864,931,2197.373447688,2194.264434843,-67
carcassonne-ucttuned125-vs-ucttuned425-1000its,882,949,2214.787053038,2167.702623819,-67
carcassonne-boltzmann130-vs-boltzmann340-1000its,670,736,2196.021269792,2137.548065557,-66
carcassonne-boltzmann85-vs-boltzmann295-1000its,679,745,2177.064304666,2158.76759084,-66
carcassonne-boltzmann280-vs-boltzmann75-1000its,703,769,2168.582751718,2124.344541493,-66
carcassonne-boltzmann420-vs-boltzmann65-1000its,705,771,2222.098241411,2191.937195077,-66
carcassonne-uct360-vs-uct290-1000its,705,771,2166.736566086,2120.871306654,-66
carcassonne-uct375-vs-uct160-1000its,713,779,2301.726049963,2175.885005644,-66
carcassonne-uct90-vs-uct25-1000its,716,782,2183.537105438,2131.916427767,-66
carcassonne-boltzmann60-vs-boltzmann80-1000its,720,786,2298.904235415,2251.867186468,-66
carcassonne-boltzmann210-vs-boltzmann140-1000its,723,789,2202.20267823,2112.895996512,-66
carcassonne-boltzmann410-vs-boltzmann275-1000its,723,789,2201.90911033,2154.596593913,-66
carcassonne-boltzmann430-vs-boltzmann30-1000its,724,790,2257.444179244,2214.05569986,-66
carcassonne-uct30-vs-uct195-1000its,724,790,2223.16446147,2170.968067022,-66
carcassonne-ucttuned210-vs-ucttuned90-1000its,726,792,2231.668993742,2204.874132522,-66
carcassonne-ucttuned485-vs-ucttuned100-1000its,731,797,2202.000799566,2172.69466871,-66
carcassonne-uct385-vs-uct85-1000its,732,798,2186.617039042,2155.219379049,-66
carcassonne-ucttuned380-vs-ucttuned175-1000its,736,802,2175.59015404,2139.561425434,-66
carcassonne-boltzmann470-vs-boltzmann235-1000its,741,807,2239.97587007,2177.841163981,-66
carcassonne-ucttuned445-vs-ucttuned320-1000its,742,808,2145.450639809,2154.702918857,-66
carcassonne-boltzmann410-vs-boltzmann30-1000its,743,809,2223.025116532,2202.866245601,-66
carcassonne-uct215-vs-uct375-1000its,743,809,2169.247130439,2121.149081418,-66
carcassonne-ucttuned395-vs-ucttuned320-1000its,744,810,2240.985352801,2155.007717054,-66
carcassonne-boltzmann320-vs-boltzmann495-1000its,747,813,2154.785608184,2141.995465122,-66
carcassonne-ucttuned325-vs-ucttuned285-1000its,747,813,2117.735465626,2072.419333837,-66
carcassonne-boltzmann125-vs-boltzmann25-1000its,750,816,2266.364426213,2275.749086745,-66
carcassonne-uct20-vs-uct435-1000its,752,818,2197.357264968,2161.524520168,-66
carcassonne-boltzmann400-vs-boltzmann350-1000its,754,820,2214.000622647,2120.560732635,-66
carcassonne-boltzmann160-vs-boltzmann155-1000its,755,821,2202.59920782,2135.519657021,-66
carcassonne-boltzmann50-vs-boltzmann380-1000its,755,821,2176.972101121,2109.002630878,-66
carcassonne-ucttuned25-vs-ucttuned360-1000its,755,821,2193.546921766,2122.313827449,-66
carcassonne-ucttuned440-vs-ucttuned10-1000its,755,821,2191.694858316,2140.181071518,-66
carcassonne-boltzmann290-vs-boltzmann435-1000its,756,822,2257.636094717,2224.586914624,-66
carcassonne-uct145-vs-uct475-1000its,757,823,2230.216768123,2177.84639472,-66
carcassonne-uct250-vs-uct455-1000its,757,823,2120.202137619,2039.013317463,-66
carcassonne-uct340-vs-uct390-1000its,757,823,2156.761809874,2124.664874309,-66
carcassonne-boltzmann480-vs-boltzmann330-1000its,761,827,2156.610910883,2110.129053027,-66
carcassonne-uct315-vs-uct50-1000its,762,828,2203.490390163,2138.564314725,-66
carcassonne-ucttuned120-vs-ucttuned320-1000its,762,828,2170.048389017,2146.609773926,-66
carcassonne-uct305-vs-uct355-1000its,764,830,2173.907015419,2133.946837495,-66
carcassonne-ucttuned130-vs-ucttuned25-1000its,764,830,2172.299239821,2131.995012619,-66
carcassonne-ucttuned335-vs-ucttuned270-1000its,764,830,2224.330075528,2159.593134046,-66
carcassonne-boltzmann280-vs-boltzmann65-1000its,765,831,2216.773602702,2193.187915317,-66
carcassonne-uct210-vs-uct470-1000its,767,833,2259.442262577,2215.778620347,-66
carcassonne-uct410-vs-uct470-1000its,770,836,2238.857312213,2225.391576159,-66
carcassonne-ucttuned275-vs-ucttuned295-1000its,774,840,2236.470335635,2200.356743595,-66
carcassonne-uct250-vs-uct390-1000its,775,841,2128.668539375,2068.512267278,-66
carcassonne-boltzmann215-vs-boltzmann225-1000its,777,843,2163.07099055,2144.901285408,-66
carcassonne-uct235-vs-uct220-1000its,777,843,2161.009153421,2087.748460654,-66
carcassonne-ucttuned130-vs-ucttuned190-1000its,777,843,2185.907969101,2126.287462295,-66
carcassonne-ucttuned230-vs-ucttuned335-1000its,779,845,2219.504900063,2143.409203063,-66
carcassonne-boltzmann125-vs-boltzmann135-1000its,780,846,2258.811249751,2196.052785764,-66
carcassonne-uct90-vs-uct40-1000its,781,847,2169.046099633,2141.223274937,-66
carcassonne-boltzmann120-vs-boltzmann330-1000its,782,848,2225.860941184,2197.556343884,-66
carcassonne-boltzmann425-vs-boltzmann440-1000its,782,848,2172.726193596,2097.632998941,-66
carcassonne-uct115-vs-uct165-1000its,782,848,2176.154813853,2150.14335403,-66
carcassonne-boltzmann260-vs-boltzmann175-1000its,783,849,2202.566781387,2161.300748693,-66
carcassonne-ucttuned115-vs-ucttuned180-1000its,783,849,2138.953375444,2114.240065268,-66
carcassonne-boltzmann240-vs-boltzmann5-1000its,784,850,2130.737251106,2074.301730486,-66
carcassonne-uct180-vs-uct385-1000its,784,850,2253.593692767,2179.848207853,-66
carcassonne-uct390-vs-uct485-1000its,784,850,2142.818741101,2124.562555939,-66
carcassonne-uct370-vs-uct355-1000its,785,851,2171.579983703,2158.843049523,-66
carcassonne-boltzmann320-vs-boltzmann315-1000its,787,853,2220.38989819,2210.885046909,-66
carcassonne-boltzmann325-vs-boltzmann350-1000its,788,854,2214.393817438,2200.688813831,-66
carcassonne-uct205-vs-uct440-1000its,788,854,2193.117872856,2138.653665354,-66
carcassonne-uct90-vs-uct75-1000its,789,855,2201.631110796,2158.647493438,-66
carcassonne-uct395-vs-uct145-1000its,790,856,2235.913818013,2197.455182804,-66
carcassonne-ucttuned495-vs-ucttuned10-1000its,790,856,2191.084147014,2200.767203282,-66
carcassonne-ucttuned50-vs-ucttuned290-1000its,790,856,2187.167315382,2138.207975484,-66
carcassonne-uct425-vs-uct290-1000its,791,857,2243.288821812,2135.166285801,-66
carcassonne-uct5-vs-uct400-1000its,791,857,2188.181379307,2132.880606203,-66
carcassonne-boltzmann450-vs-boltzmann440-1000its,792,858,2120.504160586,2109.456811336,-66
carcassonne-uct320-vs-uct20-1000its,792,858,2184.99016141,2149.939431875,-66
carcassonne-ucttuned335-vs-ucttuned485-1000its,795,861,2239.903076761,2149.746645298,-66
carcassonne-uct140-vs-uct465-1000its,796,862,2205.708159608,2169.653451167,-66
carcassonne-ucttuned375-vs-ucttuned95-1000its,797,863,2194.684375984,2130.563547499,-66
carcassonne-ucttuned175-vs-ucttuned5-1000its,802,868,2173.337174422,2109.249306446,-66
carcassonne-uct345-vs-uct370-1000its,804,870,2246.069845884,2186.52749943,-66
carcassonne-ucttuned220-vs-ucttuned65-1000its,804,870,2217.696882669,2185.261752706,-66
carcassonne-boltzmann60-vs-boltzmann360-1000its,806,872,2210.417725328,2135.842413772,-66
carcassonne-ucttuned405-vs-ucttuned190-1000its,811,877,2255.626699715,2224.449442349,-66
carcassonne-boltzmann190-vs-boltzmann465-1000its,812,878,2262.380559475,2188.169482709,-66
carcassonne-uct265-vs-uct470-1000its,819,885,2177.47938938,2122.234475273,-66
carcassonne-ucttuned445-vs-ucttuned95-1000its,822,888,2167.672598257,2065.47921885,-66
carcassonne-boltzmann180-vs-boltzmann150-1000its,825,891,2224.77239793,2167.921602029,-66
carcassonne-uct230-vs-uct385-1000its,830,896,2181.720153124,2149.76585579,-66
carcassonne-uct490-vs-uct185-1000its,831,897,2152.449840709,2124.770606536,-66
carcassonne-ucttuned295-vs-ucttuned50-1000its,831,897,2140.326392811,2107.444678973,-66
carcassonne-uct440-vs-uct155-1000its,832,898,2214.638824476,2167.172475598,-66
carcassonne-ucttuned440-vs-ucttuned115-1000its,836,902,2117.954628247,2076.284579018,-66
carcassonne-uct435-vs-uct35-1000its,845,911,2114.799252737,2100.529520219,-66
carcassonne-ucttuned65-vs-ucttuned410-1000its,856,922,2182.748949435,2146.438809719,-66
carcassonne-ucttuned135-vs-ucttuned125-1000its,858,924,2200.983173967,2149.140133481,-66
carcassonne-boltzmann375-vs-boltzmann150-1000its,675,740,2231.561488106,2138.368129146,-65
carcassonne-boltzmann385-vs-boltzmann180-1000its,684,749,2178.765237702,2191.102576533,-65
carcassonne-ucttuned435-vs-ucttuned160-1000its,688,753,2214.073662365,2178.727509252,-65
carcassonne-boltzmann80-vs-boltzmann430-1000its,695,760,2203.331193299,2130.833825873,-65
carcassonne-boltzmann115-vs-boltzmann415-1000its,701,766,2172.831837975,2182.818290469,-65
carcassonne-boltzmann405-vs-boltzmann450-1000its,705,770,2182.300796375,2102.675448251,-65
carcassonne-uct145-vs-uct255-1000its,709,774,2131.530449522,2110.033294984,-65
carcassonne-uct245-vs-uct285-1000its,709,774,2204.40456382,2159.071683567,-65
carcassonne-boltzmann260-vs-boltzmann490-1000its,713,778,2120.599743224,2118.46518765,-65
carcassonne-ucttuned85-vs-ucttuned360-1000its,715,780,2221.759726282,2149.571023424,-65
carcassonne-uct30-vs-uct270-1000its,717,782,2185.863235517,2170.304122679,-65
carcassonne-boltzmann480-vs-boltzmann445-1000its,718,783,2218.538063432,2208.147948735,-65
carcassonne-ucttuned420-vs-ucttuned140-1000its,722,787,2248.594065038,2206.592590132,-65
carcassonne-boltzmann235-vs-boltzmann460-1000its,724,789,2174.649275519,2124.294989697,-65
carcassonne-uct45-vs-uct405-1000its,724,789,2172.959388476,2128.792397006,-65
carcassonne-ucttuned225-vs-ucttuned360-1000its,724,789,2176.499937867,2114.48721694,-65
carcassonne-boltzmann485-vs-boltzmann175-1000its,725,790,2157.219505728,2121.57599829,-65
carcassonne-uct45-vs-uct345-1000its,726,791,2180.487254383,2127.077311367,-65
carcassonne-uct260-vs-uct200-1000its,727,792,2136.302455005,2108.854329053,-65
carcassonne-ucttuned465-vs-ucttuned450-1000its,728,793,2175.757403441,2139.039066208,-65
carcassonne-uct440-vs-uct475-1000its,731,796,2221.252395125,2202.726034499,-65
carcassonne-uct480-vs-uct225-1000its,732,797,2205.215933999,2196.650698572,-65
carcassonne-boltzmann330-vs-boltzmann160-1000its,733,798,2220.894025767,2215.774577383,-65
carcassonne-uct370-vs-uct190-1000its,733,798,2187.981703687,2117.718984283,-65
carcassonne-boltzmann495-vs-boltzmann15-1000its,735,800,2147.707485939,2107.821610532,-65
carcassonne-ucttuned370-vs-ucttuned130-1000its,737,802,2188.463589718,2128.323701486,-65
carcassonne-boltzmann265-vs-boltzmann415-1000its,740,805,2268.211670337,2207.786908273,-65
carcassonne-uct240-vs-uct295-1000its,742,807,2219.372242307,2181.255126146,-65
carcassonne-ucttuned455-vs-ucttuned285-1000its,743,808,2208.770718472,2134.165586737,-65
carcassonne-boltzmann485-vs-boltzmann140-1000its,744,809,2150.322963232,2098.243015047,-65
carcassonne-uct130-vs-uct345-1000its,745,810,2245.229680806,2200.56665423,-65
carcassonne-boltzmann250-vs-boltzmann335-1000its,746,811,2220.068616246,2212.683793774,-65
carcassonne-uct170-vs-uct90-1000its,747,812,2225.76630411,2181.949554204,-65
carcassonne-uct365-vs-uct440-1000its,751,816,2198.163393376,2145.105298867,-65
carcassonne-boltzmann65-vs-boltzmann285-1000its,752,817,2177.604090778,2129.006262699,-65
carcassonne-uct405-vs-uct230-1000its,756,821,2303.082945262,2214.15002769,-65
carcassonne-boltzmann145-vs-boltzmann120-1000its,757,822,2179.960872985,2142.941718002,-65
carcassonne-boltzmann140-vs-boltzmann115-1000its,759,824,2179.976136365,2113.161020957,-65
carcassonne-uct295-vs-uct495-1000its,761,826,2201.184641425,2147.042467217,-65
carcassonne-uct475-vs-uct495-1000its,764,829,2217.206861193,2168.690552565,-65
carcassonne-ucttuned235-vs-ucttuned275-1000its,764,829,2207.863496082,2146.65648595,-65
carcassonne-ucttuned460-vs-ucttuned205-1000its,764,829,2179.717131267,2115.364703376,-65
carcassonne-uct455-vs-uct295-1000its,765,830,2170.168029487,2119.945744755,-65
carcassonne-boltzmann410-vs-boltzmann325-1000its,768,833,2166.293011547,2131.428582597,-65
carcassonne-ucttuned400-vs-ucttuned370-1000its,770,835,2218.403798322,2217.761912173,-65
carcassonne-uct425-vs-uct195-1000its,771,836,2148.635715168,2164.661043056,-65
carcassonne-boltzmann115-vs-boltzmann155-1000its,772,837,2180.096566939,2115.127897894,-65
carcassonne-boltzmann70-vs-boltzmann90-1000its,772,837,2240.16782119,2218.937012944,-65
carcassonne-ucttuned295-vs-ucttuned120-1000its,774,839,2175.606226297,2172.535257285,-65
carcassonne-boltzmann325-vs-boltzmann300-1000its,778,843,2266.088263868,2226.069039322,-65
carcassonne-uct310-vs-uct480-1000its,778,843,2186.433920848,2166.079639161,-65
carcassonne-uct325-vs-uct5-1000its,778,843,2206.065612107,2192.620094787,-65
carcassonne-ucttuned150-vs-ucttuned490-1000its,778,843,2212.691520224,2153.241437311,-65
carcassonne-ucttuned170-vs-ucttuned265-1000its,778,843,2188.448521741,2128.330932861,-65
carcassonne-ucttuned425-vs-ucttuned255-1000its,783,848,2236.661006947,2206.191378652,-65
carcassonne-ucttuned90-vs-ucttuned475-1000its,783,848,2140.659919269,2108.880713315,-65
carcassonne-boltzmann380-vs-boltzmann35-1000its,784,849,2236.320172864,2193.263391038,-65
carcassonne-boltzmann265-vs-boltzmann45-1000its,785,850,2193.617006567,2180.642453535,-65
carcassonne-boltzmann355-vs-boltzmann175-1000its,787,852,2158.625352496,2104.534699842,-65
carcassonne-ucttuned115-vs-ucttuned400-1000its,787,852,2264.956419321,2216.109282905,-65
carcassonne-ucttuned295-vs-ucttuned285-1000its,787,852,2183.094189554,2151.616025255,-65
carcassonne-boltzmann310-vs-boltzmann370-1000its,788,853,2183.507472209,2126.367758658,-65
carcassonne-uct490-vs-uct130-1000its,788,853,2144.681234088,2166.633132784,-65
carcassonne-ucttuned240-vs-ucttuned345-1000its,788,853,2280.792385652,2208.640293718,-65
carcassonne-uct230-vs-uct75-1000its,789,854,2192.45331112,2186.816711641,-65
carcassonne-uct235-vs-uct240-1000its,789,854,2188.826351659,2166.52371585,-65
carcassonne-boltzmann355-vs-boltzmann365-1000its,790,855,2215.925173546,2168.375500594,-65
carcassonne-uct240-vs-uct485-1000its,790,855,2179.84559866,2103.858503837,-65
carcassonne-uct385-vs-uct285-1000its,790,855,2127.04249189,2110.067577139,-65
carcassonne-ucttuned265-vs-ucttuned125-1000its,790,855,2200.95668758,2180.166124965,-65
carcassonne-uct435-vs-uct420-1000its,794,859,2235.815914732,2205.870101923,-65
carcassonne-boltzmann335-vs-boltzmann10-1000its,795,860,2246.906394189,2191.220297328,-65
carcassonne-uct375-vs-uct5-1000its,795,860,2175.603332542,2169.400897941,-65
carcassonne-ucttuned185-vs-ucttuned70-1000its,795,860,2186.972977916,2154.961925117,-65
carcassonne-ucttuned15-vs-ucttuned215-1000its,797,862,2185.997994371,2161.055260868,-65
carcassonne-ucttuned375-vs-ucttuned5-1000its,797,862,2145.529767291,2097.586314854,-65
carcassonne-boltzmann470-vs-boltzmann70-1000its,798,863,2207.524987571,2171.155055521,-65
carcassonne-boltzmann475-vs-boltzmann290-1000its,798,863,2169.946013271,2083.848445614,-65
carcassonne-uct200-vs-uct490-1000its,798,863,2179.386019192,2152.552852736,-65
carcassonne-boltzmann210-vs-boltzmann485-1000its,799,864,2184.422385282,2140.678464818,-65
carcassonne-ucttuned390-vs-ucttuned220-1000its,800,865,2122.292282043,2111.285809964,-65
carcassonne-uct100-vs-uct135-1000its,802,867,2201.355408469,2154.996096561,-65
carcassonne-ucttuned70-vs-ucttuned390-1000its,804,869,2162.921846375,2123.297525451,-65
carcassonne-uct220-vs-uct70-1000its,805,870,2211.372956967,2222.859802339,-65
carcassonne-uct295-vs-uct370-1000its,806,871,2193.014611097,2162.135839508,-65
carcassonne-uct375-vs-uct285-1000its,806,871,2151.136910935,2123.072361105,-65
carcassonne-ucttuned110-vs-ucttuned320-1000its,809,874,2174.483319781,2130.977860451,-65
carcassonne-ucttuned95-vs-ucttuned485-1000its,809,874,2197.618649433,2141.386547582,-65
carcassonne-ucttuned110-vs-ucttuned85-1000its,810,875,2268.4650645,2214.828620849,-65
carcassonne-uct195-vs-uct410-1000its,811,876,2205.412922107,2185.4998371,-65
carcassonne-uct440-vs-uct460-1000its,812,877,2229.784212632,2198.426847758,-65
carcassonne-uct340-vs-uct55-1000its,814,879,2235.625589823,2155.23765866,-65
carcassonne-uct135-vs-uct380-1000its,815,880,2170.264749319,2118.883309038,-65
carcassonne-uct20-vs-uct30-1000its,815,880,2182.879645567,2116.297866962,-65
carcassonne-ucttuned20-vs-ucttuned375-1000its,815,880,2176.787618994,2142.60907004,-65
carcassonne-boltzmann440-vs-boltzmann110-1000its,816,881,2203.573692693,2146.268745061,-65
carcassonne-ucttuned15-vs-ucttuned60-1000its,816,881,2193.738620287,2175.229181098,-65
carcassonne-ucttuned360-vs-ucttuned95-1000its,817,882,2195.270350281,2129.938516834,-65
carcassonne-boltzmann340-vs-boltzmann335-1000its,819,884,2261.581431995,2219.420587009,-65
carcassonne-uct125-vs-uct75-1000its,822,887,2222.082819331,2190.243682913,-65
carcassonne-ucttuned380-vs-ucttuned395-1000its,823,888,2236.480866684,2185.886807505,-65
carcassonne-boltzmann125-vs-boltzmann480-1000its,826,891,2251.178710071,2206.500577805,-65
carcassonne-boltzmann135-vs-boltzmann290-1000its,836,901,2206.064236812,2144.615126839,-65
carcassonne-uct475-vs-uct245-1000its,836,901,2189.918235767,2162.30124857,-65
carcassonne-uct365-vs-uct265-1000its,837,902,2190.310787969,2118.862564279,-65
carcassonne-boltzmann220-vs-boltzmann475-1000its,843,908,2155.747870732,2125.292037909,-65
carcassonne-boltzmann260-vs-boltzmann85-1000its,843,908,2268.138866557,2218.716040195,-65
carcassonne-ucttuned420-vs-ucttuned145-1000its,845,910,2185.88417609,2125.828370507,-65
carcassonne-uct130-vs-uct360-1000its,856,921,2135.722135747,2164.539085151,-65
carcassonne-uct270-vs-uct180-1000its,863,928,2245.030013046,2198.379947411,-65
carcassonne-ucttuned375-vs-ucttuned160-1000its,890,955,2195.851856278,2146.24147848,-65
carcassonne-ucttuned195-vs-ucttuned425-1000its,895,960,2267.284951983,2229.95461016,-65
carcassonne-ucttuned305-vs-ucttuned180-1000its,649,713,1715.848930984,1694.143748887,-64
carcassonne-boltzmann360-vs-boltzmann315-1000its,673,737,2174.267889771,2112.746616,-64
carcassonne-boltzmann445-vs-boltzmann320-1000its,685,749,2140.072239241,2131.249994678,-64
carcassonne-boltzmann295-vs-boltzmann75-1000its,692,756,2185.172267877,2131.835105983,-64
carcassonne-uct490-vs-uct240-1000its,702,766,2267.898571522,2220.429178118,-64
carcassonne-ucttuned270-vs-ucttuned150-1000its,702,766,2178.448554723,2148.504445618,-64
carcassonne-boltzmann200-vs-boltzmann245-1000its,704,768,2204.189574778,2119.47794785,-64
carcassonne-uct300-vs-uct420-1000its,707,771,2266.752614261,2224.739569086,-64
carcassonne-ucttuned250-vs-ucttuned460-1000its,712,776,2194.94020008,2133.786685433,-64
carcassonne-boltzmann470-vs-boltzmann275-1000its,715,779,2173.711344585,2131.116613579,-64
carcassonne-ucttuned350-vs-ucttuned120-1000its,718,782,2223.205855178,2176.835272909,-64
carcassonne-ucttuned480-vs-ucttuned310-1000its,725,789,2178.174505786,2108.569606517,-64
carcassonne-ucttuned205-vs-ucttuned245-1000its,726,790,2182.110853419,2114.256566335,-64
carcassonne-uct80-vs-uct60-1000its,730,794,2194.058245115,2136.883306953,-64
carcassonne-uct70-vs-uct450-1000its,731,795,2238.246424091,2184.168954901,-64
carcassonne-ucttuned145-vs-ucttuned160-1000its,737,801,2283.088226418,2183.943694921,-64
carcassonne-uct370-vs-uct35-1000its,739,803,2189.473284614,2164.591948147,-64
carcassonne-boltzmann90-vs-boltzmann420-1000its,740,804,2152.440648371,2114.55033922,-64
carcassonne-uct200-vs-uct345-1000its,740,804,2276.280477794,2239.326407755,-64
carcassonne-uct355-vs-uct220-1000its,740,804,2253.522090371,2184.036063474,-64
carcassonne-uct50-vs-uct485-1000its,743,807,2163.509519557,2058.556639681,-64
carcassonne-boltzmann420-vs-boltzmann465-1000its,744,808,2189.961281235,2157.97343026,-64
carcassonne-boltzmann305-vs-boltzmann470-1000its,745,809,2191.714417964,2151.522574659,-64
carcassonne-boltzmann475-vs-boltzmann225-1000its,745,809,2192.679443756,2156.701513819,-64
carcassonne-uct195-vs-uct415-1000its,748,812,2200.626410836,2134.481579636,-64
carcassonne-uct415-vs-uct465-1000its,749,813,2170.825932341,2083.819840141,-64
carcassonne-ucttuned260-vs-ucttuned100-1000its,749,813,2173.189552826,2161.763588006,-64
carcassonne-boltzmann35-vs-boltzmann110-1000its,750,814,2146.709973338,2116.957961862,-64
carcassonne-ucttuned275-vs-ucttuned200-1000its,751,815,2236.34743695,2150.804925956,-64
carcassonne-boltzmann405-vs-boltzmann160-1000its,752,816,2165.613062258,2125.884893978,-64
carcassonne-uct75-vs-uct275-1000its,753,817,2158.17565536,2101.781437705,-64
carcassonne-ucttuned485-vs-ucttuned245-1000its,753,817,2194.118219269,2171.978565232,-64
carcassonne-uct460-vs-uct360-1000its,754,818,2182.976256542,2143.467380372,-64
carcassonne-boltzmann235-vs-boltzmann385-1000its,758,822,2173.096594526,2112.689308016,-64
carcassonne-uct390-vs-uct210-1000its,759,823,2129.416554917,2094.790560984,-64
carcassonne-ucttuned255-vs-ucttuned40-1000its,760,824,2195.219746838,2129.381580621,-64
carcassonne-boltzmann295-vs-boltzmann145-1000its,761,825,2259.108600126,2198.886045111,-64
carcassonne-boltzmann230-vs-boltzmann65-1000its,762,826,2239.756445216,2220.143292646,-64
carcassonne-uct460-vs-uct250-1000its,762,826,2204.257622023,2160.799264613,-64
carcassonne-boltzmann465-vs-boltzmann180-1000its,764,828,2241.356103566,2178.103413284,-64
carcassonne-uct115-vs-uct200-1000its,765,829,2268.437688546,2233.211349314,-64
carcassonne-uct190-vs-uct160-1000its,766,830,2178.547197518,2117.903955647,-64
carcassonne-boltzmann380-vs-boltzmann210-1000its,767,831,2201.428451079,2155.695184266,-64
carcassonne-uct415-vs-uct445-1000its,767,831,2232.736994351,2188.71459284,-64
carcassonne-ucttuned475-vs-ucttuned195-1000its,767,831,2179.056137945,2144.404246298,-64
carcassonne-ucttuned290-vs-ucttuned85-1000its,768,832,2273.569845593,2212.011131243,-64
carcassonne-uct110-vs-uct90-1000its,769,833,2131.534383829,2065.932411676,-64
carcassonne-ucttuned365-vs-ucttuned410-1000its,769,833,2210.071843399,2155.203324412,-64
carcassonne-boltzmann245-vs-boltzmann475-1000its,771,835,2152.136144862,2147.244690567,-64
carcassonne-boltzmann435-vs-boltzmann210-1000its,771,835,2184.238638591,2153.778490879,-64
carcassonne-boltzmann445-vs-boltzmann395-1000its,772,836,2227.541981426,2150.92323919,-64
carcassonne-uct95-vs-uct400-1000its,773,837,2205.619038902,2158.255209519,-64
carcassonne-ucttuned60-vs-ucttuned385-1000its,773,837,2144.909186423,2120.700828563,-64
carcassonne-ucttuned370-vs-ucttuned455-1000its,774,838,2146.432261985,2082.27154506,-64
carcassonne-ucttuned10-vs-ucttuned475-1000its,775,839,2266.218608999,2200.091405855,-64
carcassonne-ucttuned325-vs-ucttuned105-1000its,775,839,2205.604536477,2167.32856471,-64
carcassonne-uct320-vs-uct330-1000its,777,841,2152.613678109,2167.904266759,-64
carcassonne-uct445-vs-uct450-1000its,779,843,2192.19454304,2181.284569834,-64
carcassonne-ucttuned40-vs-ucttuned75-1000its,779,843,2252.224219998,2180.744074015,-64
carcassonne-uct290-vs-uct490-1000its,780,844,2154.595904621,2093.031096547,-64
carcassonne-ucttuned405-vs-ucttuned460-1000its,780,844,2179.849411292,2169.548355203,-64
carcassonne-boltzmann210-vs-boltzmann55-1000its,782,846,2227.706464248,2197.495671196,-64
carcassonne-ucttuned95-vs-ucttuned265-1000its,782,846,2158.520383575,2121.068682579,-64
carcassonne-uct445-vs-uct225-1000its,789,853,2171.884668852,2169.815577162,-64
carcassonne-ucttuned280-vs-ucttuned220-1000its,790,854,2161.915174213,2066.313110143,-64
carcassonne-boltzmann350-vs-boltzmann495-1000its,792,856,2143.10582113,2107.903011916,-64
carcassonne-uct70-vs-uct65-1000its,793,857,2132.786111521,2097.927751939,-64
carcassonne-ucttuned270-vs-ucttuned215-1000its,793,857,2161.653451086,2122.92318955,-64
carcassonne-ucttuned495-vs-ucttuned60-1000its,794,858,2166.585842927,2156.279577799,-64
carcassonne-uct150-vs-uct65-1000its,795,859,2243.008497955,2210.226553843,-64
carcassonne-ucttuned285-vs-ucttuned15-1000its,796,860,2184.824311668,2146.00986169,-64
carcassonne-ucttuned105-vs-ucttuned415-1000its,798,862,2299.758847807,2226.128415491,-64
carcassonne-boltzmann35-vs-boltzmann340-1000its,800,864,2116.744042693,2121.671693862,-64
carcassonne-boltzmann45-vs-boltzmann330-1000its,800,864,2274.173431153,2263.28720348,-64
carcassonne-boltzmann15-vs-boltzmann120-1000its,802,866,2261.664267561,2181.649919216,-64
carcassonne-boltzmann195-vs-boltzmann345-1000its,802,866,2281.017296615,2233.157040643,-64
carcassonne-uct170-vs-uct490-1000its,802,866,2142.828848659,2102.048585013,-64
carcassonne-ucttuned220-vs-ucttuned155-1000its,802,866,2260.576048834,2234.483209416,-64
carcassonne-ucttuned485-vs-ucttuned435-1000its,802,866,2272.191492145,2226.666761496,-64
carcassonne-ucttuned455-vs-ucttuned125-1000its,803,867,2137.910304526,2070.015544139,-64
carcassonne-ucttuned225-vs-ucttuned125-1000its,808,872,2190.007946173,2118.906801094,-64
carcassonne-boltzmann275-vs-boltzmann315-1000its,810,874,2175.118115543,2134.703087874,-64
carcassonne-ucttuned45-vs-ucttuned35-1000its,810,874,2158.609195165,2116.860691436,-64
carcassonne-ucttuned225-vs-ucttuned75-1000its,814,878,2156.181870023,2170.254781971,-64
carcassonne-uct365-vs-uct335-1000its,819,883,2227.864365095,2179.630121626,-64
carcassonne-ucttuned125-vs-ucttuned5-1000its,820,884,2212.981374176,2125.839802916,-64
carcassonne-boltzmann210-vs-boltzmann75-1000its,821,885,2236.364561513,2178.634848066,-64
carcassonne-ucttuned80-vs-ucttuned310-1000its,823,887,2171.527843287,2096.930363604,-64
carcassonne-uct160-vs-uct45-1000its,824,888,2252.855866224,2253.530512057,-64
carcassonne-uct370-vs-uct350-1000its,824,888,2198.914469669,2174.06590109,-64
carcassonne-boltzmann155-vs-boltzmann425-1000its,825,889,2161.178007788,2164.148552119,-64
carcassonne-uct200-vs-uct210-1000its,826,890,2206.485441629,2206.895944849,-64
carcassonne-boltzmann430-vs-boltzmann450-1000its,836,900,2161.817293694,2146.010052263,-64
carcassonne-ucttuned305-vs-ucttuned350-1000its,844,908,2272.161527298,2162.579716701,-64
carcassonne-boltzmann115-vs-boltzmann170-1000its,850,914,2184.670928734,2148.010976842,-64
carcassonne-uct325-vs-uct250-1000its,859,923,2184.210578418,2119.391750336,-64
carcassonne-ucttuned490-vs-ucttuned5-1000its,877,941,2189.23441664,2124.537080108,-64
carcassonne-uct440-vs-uct130-1000its,662,725,2185.983815081,2128.967954233,-63
carcassonne-uct360-vs-uct225-1000its,681,744,2198.854234819,2165.703131753,-63
carcassonne-uct275-vs-uct180-1000its,691,754,2177.571730679,2129.715113047,-63
carcassonne-uct55-vs-uct195-1000its,699,762,2246.963178724,2187.089008807,-63
carcassonne-boltzmann275-vs-boltzmann165-1000its,700,763,2221.340397751,2204.529831368,-63
carcassonne-ucttuned340-vs-ucttuned360-1000its,703,766,2189.06085672,2154.553375912,-63
carcassonne-uct345-vs-uct290-1000its,705,768,2151.908319514,2131.277743799,-63
carcassonne-uct180-vs-uct205-1000its,706,769,2195.504747932,2144.831693185,-63
carcassonne-uct445-vs-uct215-1000its,708,771,2165.009103063,2090.18186856,-63
carcassonne-uct15-vs-uct205-1000its,713,776,2210.777954174,2170.441315859,-63
carcassonne-uct65-vs-uct295-1000its,713,776,2170.776447047,2135.732857165,-63
carcassonne-ucttuned165-vs-ucttuned265-1000its,716,779,2208.083170057,2130.820748373,-63
carcassonne-boltzmann280-vs-boltzmann230-1000its,720,783,2152.134086234,2130.32550331,-63
carcassonne-boltzmann485-vs-boltzmann280-1000its,721,784,2185.568796098,2138.891245571,-63
carcassonne-boltzmann385-vs-boltzmann215-1000its,726,789,2154.542457831,2137.555297581,-63
carcassonne-uct475-vs-uct280-1000its,728,791,2223.397976833,2145.87461203,-63
carcassonne-uct235-vs-uct295-1000its,735,798,2182.641687941,2126.568001037,-63
carcassonne-uct445-vs-uct465-1000its,736,799,2133.470502846,2123.874345833,-63
carcassonne-boltzmann450-vs-boltzmann305-1000its,737,800,2194.23445128,2140.140571954,-63
carcassonne-boltzmann195-vs-boltzmann175-1000its,738,801,2213.157366345,2214.566350078,-63
carcassonne-boltzmann30-vs-boltzmann20-1000its,738,801,2183.935956093,2111.684150858,-63
carcassonne-ucttuned80-vs-ucttuned205-1000its,738,801,2202.983495458,2168.592073458,-63
carcassonne-boltzmann445-vs-boltzmann325-1000its,739,802,2154.019960828,2110.503176436,-63
carcassonne-uct30-vs-uct385-1000its,739,802,2213.449108939,2174.12222524,-63
carcassonne-boltzmann310-vs-boltzmann25-1000its,744,807,2170.437078202,2157.107143879,-63
carcassonne-boltzmann55-vs-boltzmann20-1000its,744,807,2197.518840131,2152.843869262,-63
carcassonne-uct110-vs-uct395-1000its,745,808,2207.496045127,2174.934347425,-63
carcassonne-ucttuned145-vs-ucttuned35-1000its,746,809,2167.312294961,2149.088074848,-63
carcassonne-uct335-vs-uct220-1000its,748,811,2177.427811578,2164.776699068,-63
carcassonne-boltzmann145-vs-boltzmann230-1000its,750,813,2172.171114531,2132.627100754,-63
carcassonne-uct220-vs-uct250-1000its,753,816,2236.503212094,2184.733317525,-63
carcassonne-boltzmann200-vs-boltzmann70-1000its,754,817,2157.943169698,2144.045814319,-63
carcassonne-ucttuned330-vs-ucttuned240-1000its,754,817,2266.909236809,2233.132094629,-63
carcassonne-boltzmann340-vs-boltzmann295-1000its,758,821,2198.923083095,2168.804572189,-63
carcassonne-uct295-vs-uct300-1000its,759,822,2157.289571696,2110.017033263,-63
carcassonne-boltzmann195-vs-boltzmann445-1000its,762,825,2220.821622127,2207.920758641,-63
carcassonne-boltzmann395-vs-boltzmann75-1000its,764,827,2151.184165179,2103.527937731,-63
carcassonne-boltzmann125-vs-boltzmann360-1000its,765,828,2192.508673922,2133.929256655,-63
carcassonne-boltzmann360-vs-boltzmann165-1000its,765,828,2240.909018593,2240.814166566,-63
carcassonne-boltzmann45-vs-boltzmann465-1000its,765,828,2120.79623956,2077.900314986,-63
carcassonne-ucttuned315-vs-ucttuned75-1000its,765,828,2192.437603821,2130.171420507,-63
carcassonne-ucttuned200-vs-ucttuned245-1000its,767,830,2193.968979066,2173.619770872,-63
carcassonne-boltzmann345-vs-boltzmann105-1000its,768,831,2215.922048205,2125.962279593,-63
carcassonne-ucttuned490-vs-ucttuned50-1000its,768,831,2300.458839469,2203.477498259,-63
carcassonne-ucttuned335-vs-ucttuned225-1000its,771,834,2182.956204564,2156.327851493,-63
carcassonne-uct230-vs-uct295-1000its,772,835,2219.16290498,2142.122218421,-63
carcassonne-uct255-vs-uct40-1000its,772,835,2249.13048693,2212.242241254,-63
carcassonne-ucttuned55-vs-ucttuned280-1000its,776,839,2238.187437597,2170.122688586,-63
carcassonne-uct270-vs-uct415-1000its,777,840,2191.381139887,2135.970578677,-63
carcassonne-ucttuned235-vs-ucttuned490-1000its,777,840,2214.568746564,2175.756401328,-63
carcassonne-uct85-vs-uct315-1000its,778,841,2209.948131693,2150.55749788,-63
carcassonne-uct115-vs-uct340-1000its,779,842,2223.773356177,2201.153917378,-63
carcassonne-uct495-vs-uct115-1000its,779,842,2261.611417126,2218.045324259,-63
carcassonne-uct80-vs-uct185-1000its,779,842,2139.957005808,2119.117717476,-63
carcassonne-uct400-vs-uct160-1000its,780,843,2162.54462155,2089.397702022,-63
carcassonne-ucttuned380-vs-ucttuned30-1000its,781,844,2140.801730121,2121.15283143,-63
carcassonne-boltzmann385-vs-boltzmann10-1000its,783,846,2215.350782768,2189.065616344,-63
carcassonne-ucttuned195-vs-ucttuned205-1000its,783,846,2189.486718726,2077.200428732,-63
carcassonne-boltzmann300-vs-boltzmann60-1000its,784,847,2181.470612509,2152.250854261,-63
carcassonne-uct270-vs-uct255-1000its,784,847,2255.76479693,2214.458030711,-63
carcassonne-uct355-vs-uct280-1000its,784,847,2241.611420668,2204.014828431,-63
carcassonne-ucttuned415-vs-ucttuned490-1000its,785,848,2155.151506504,2088.284303293,-63
carcassonne-boltzmann385-vs-boltzmann80-1000its,786,849,2241.745960271,2187.231560029,-63
carcassonne-boltzmann165-vs-boltzmann355-1000its,788,851,2183.818026812,2152.673519623,-63
carcassonne-uct135-vs-uct125-1000its,790,853,2164.488125522,2135.503143033,-63
carcassonne-ucttuned350-vs-ucttuned365-1000its,795,858,2254.005344689,2222.666359964,-63
carcassonne-boltzmann375-vs-boltzmann30-1000its,796,859,2212.689722239,2148.052683935,-63
carcassonne-uct190-vs-uct365-1000its,803,866,2160.085796692,2141.51241193,-63
carcassonne-ucttuned205-vs-ucttuned400-1000its,805,868,2169.349689107,2109.696637009,-63
carcassonne-ucttuned185-vs-ucttuned25-1000its,806,869,2288.400748808,2223.626161875,-63
carcassonne-ucttuned275-vs-ucttuned300-1000its,807,870,2182.871777774,2167.772336549,-63
carcassonne-uct45-vs-uct435-1000its,808,871,2199.127054149,2152.188684362,-63
carcassonne-ucttuned270-vs-ucttuned370-1000its,808,871,2176.799773023,2148.555424306,-63
carcassonne-ucttuned65-vs-ucttuned385-1000its,808,871,2192.384851686,2122.461715328,-63
carcassonne-ucttuned200-vs-ucttuned10-1000its,811,874,2206.054705163,2127.423551451,-63
carcassonne-boltzmann10-vs-boltzmann450-1000its,817,880,2233.864382891,2193.135782948,-63
carcassonne-uct270-vs-uct495-1000its,817,880,2162.399735662,2156.849805249,-63
carcassonne-uct460-vs-uct35-1000its,824,887,2205.822606578,2149.545929242,-63
carcassonne-boltzmann20-vs-boltzmann235-1000its,832,895,2126.605322624,2085.272131164,-63
carcassonne-uct260-vs-uct350-1000its,837,900,2186.206817411,2136.13337889,-63
carcassonne-uct325-vs-uct445-1000its,839,902,2196.780298017,2155.103719213,-63
carcassonne-ucttuned80-vs-ucttuned395-1000its,839,902,2236.007986273,2170.065059038,-63
carcassonne-boltzmann390-vs-boltzmann185-1000its,842,905,2147.699058758,2158.228832271,-63
carcassonne-boltzmann75-vs-boltzmann235-1000its,847,910,2201.68239788,2165.205498242,-63
carcassonne-ucttuned390-vs-ucttuned5-1000its,857,920,2194.679656533,2124.16801356,-63
carcassonne-ucttuned295-vs-ucttuned390-1000its,893,956,2320.109481895,2252.436169372,-63
carcassonne-ucttuned165-vs-ucttuned10-1000its,905,968,2239.79058036,2182.639933384,-63
carcassonne-boltzmann65-vs-boltzmann490-1000its,697,759,2125.347201451,2140.382921472,-62
carcassonne-uct100-vs-uct30-1000its,705,767,2120.857312932,2098.92963652,-62
carcassonne-boltzmann35-vs-boltzmann130-1000its,707,769,2225.67775593,2174.005046173,-62
carcassonne-ucttuned215-vs-ucttuned485-1000its,709,771,2188.27683657,2145.175485096,-62
carcassonne-uct420-vs-uct355-1000its,717,779,2170.674530114,2126.097088007,-62
carcassonne-boltzmann205-vs-boltzmann370-1000its,719,781,2166.024147307,2153.469693585,-62
carcassonne-uct140-vs-uct360-1000its,725,787,2232.169762985,2193.810096813,-62
carcassonne-ucttuned460-vs-ucttuned240-1000its,726,788,2236.025354741,2169.549948346,-62
carcassonne-ucttuned310-vs-ucttuned65-1000its,729,791,2173.724658458,2140.951996996,-62
carcassonne-boltzmann485-vs-boltzmann415-1000its,733,795,2151.470467149,2114.855153518,-62
carcassonne-uct110-vs-uct375-1000its,738,800,2225.761195651,2177.256891555,-62
carcassonne-uct85-vs-uct145-1000its,740,802,2218.777226023,2179.753743866,-62
carcassonne-ucttuned225-vs-ucttuned180-1000its,742,804,2094.726864807,2037.01185229,-62
carcassonne-uct120-vs-uct145-1000its,744,806,2196.607106085,2199.48028488,-62
carcassonne-uct65-vs-uct355-1000its,744,806,2223.604821782,2149.417126471,-62
carcassonne-boltzmann135-vs-boltzmann105-1000its,745,807,2216.502148826,2179.636946644,-62
carcassonne-ucttuned360-vs-ucttuned255-1000its,745,807,2234.065611278,2215.467072454,-62
carcassonne-uct345-vs-uct180-1000its,755,817,2242.597844108,2210.393302713,-62
carcassonne-uct55-vs-uct400-1000its,757,819,2177.260597524,2109.285078081,-62
carcassonne-ucttuned475-vs-ucttuned370-1000its,757,819,2169.257462366,2155.156551318,-62
carcassonne-uct135-vs-uct230-1000its,758,820,2288.586433619,2229.612076075,-62
carcassonne-uct20-vs-uct310-1000its,758,820,2184.066572131,2136.96223665,-62
carcassonne-ucttuned305-vs-ucttuned125-1000its,759,821,2210.747206673,2178.871942762,-62
carcassonne-ucttuned135-vs-ucttuned25-1000its,762,824,2277.830616373,2230.215696641,-62
carcassonne-boltzmann320-vs-boltzmann465-1000its,763,825,2255.606861539,2182.899461309,-62
carcassonne-boltzmann90-vs-boltzmann105-1000its,767,829,2220.6329964,2179.494644265,-62
carcassonne-ucttuned30-vs-ucttuned210-1000its,767,829,2151.628524518,2118.088015793,-62
carcassonne-boltzmann45-vs-boltzmann420-1000its,769,831,2197.485260127,2106.628087101,-62
carcassonne-uct170-vs-uct120-1000its,769,831,2239.270965148,2221.269509169,-62
carcassonne-ucttuned420-vs-ucttuned220-1000its,770,832,2224.648688329,2174.919698279,-62
carcassonne-uct455-vs-uct130-1000its,772,834,2246.884693545,2198.863237619,-62
carcassonne-uct195-vs-uct85-1000its,775,837,2212.653474421,2178.851376447,-62
carcassonne-boltzmann140-vs-boltzmann225-1000its,778,840,2180.910275937,2150.271829171,-62
carcassonne-boltzmann460-vs-boltzmann185-1000its,779,841,2206.896983053,2135.203756955,-62
carcassonne-ucttuned335-vs-ucttuned5-1000its,779,841,2202.07302319,2157.468752078,-62
carcassonne-boltzmann350-vs-boltzmann220-1000its,780,842,2173.102780045,2107.786970431,-62
carcassonne-ucttuned125-vs-ucttuned260-1000its,781,843,2191.184864094,2124.665668481,-62
carcassonne-ucttuned335-vs-ucttuned390-1000its,781,843,2280.590359608,2243.004088492,-62
carcassonne-ucttuned355-vs-ucttuned255-1000its,781,843,2190.181524713,2118.610963733,-62
carcassonne-boltzmann375-vs-boltzmann75-1000its,782,844,2172.063207817,2159.113212305,-62
carcassonne-boltzmann410-vs-boltzmann235-1000its,783,845,2301.296656533,2217.490648396,-62
carcassonne-uct90-vs-uct310-1000its,784,846,2225.509306352,2209.907096872,-62
carcassonne-ucttuned345-vs-ucttuned65-1000its,784,846,2154.169499484,2093.659877654,-62
carcassonne-boltzmann480-vs-boltzmann300-1000its,785,847,2147.485600115,2090.977684285,-62
carcassonne-uct360-vs-uct415-1000its,785,847,2206.175191915,2153.775869481,-62
carcassonne-uct265-vs-uct320-1000its,787,849,2194.80880035,2146.646756429,-62
carcassonne-uct235-vs-uct465-1000its,788,850,2248.895530803,2213.027207597,-62
carcassonne-ucttuned55-vs-ucttuned5-1000its,788,850,2210.773973632,2133.503791316,-62
carcassonne-boltzmann145-vs-boltzmann415-1000its,790,852,2171.778112435,2132.673031595,-62
carcassonne-uct135-vs-uct305-1000its,791,853,2191.46849865,2166.616600899,-62
carcassonne-uct265-vs-uct430-1000its,792,854,2221.911428807,2206.426164992,-62
carcassonne-uct80-vs-uct155-1000its,792,854,2226.717282793,2195.265855947,-62
carcassonne-uct280-vs-uct410-1000its,793,855,2174.151235123,2159.125649172,-62
carcassonne-boltzmann120-vs-boltzmann315-1000its,798,860,2177.263811457,2136.592613963,-62
carcassonne-uct315-vs-uct450-1000its,798,860,2176.848355824,2163.02818199,-62
carcassonne-boltzmann15-vs-boltzmann375-1000its,799,861,2207.937509602,2163.829490695,-62
carcassonne-boltzmann155-vs-boltzmann390-1000its,799,861,2294.05634488,2234.931827359,-62
carcassonne-boltzmann490-vs-boltzmann415-1000its,799,861,2247.102549469,2183.423908008,-62
carcassonne-uct145-vs-uct400-1000its,799,861,2227.594206603,2146.274112972,-62
carcassonne-boltzmann270-vs-boltzmann145-1000its,800,862,2221.857930448,2127.552566761,-62
carcassonne-uct475-vs-uct95-1000its,800,862,2270.29414164,2176.207454448,-62
carcassonne-boltzmann255-vs-boltzmann25-1000its,801,863,2352.347950248,2332.197599599,-62
carcassonne-uct490-vs-uct85-1000its,801,863,2265.345868192,2170.91897615,-62
carcassonne-ucttuned180-vs-ucttuned125-1000its,801,863,2181.119705174,2155.756748706,-62
carcassonne-uct230-vs-uct270-1000its,802,864,2139.948897082,2119.067881573,-62
carcassonne-boltzmann50-vs-boltzmann150-1000its,807,869,2211.378476706,2214.020699341,-62
carcassonne-uct90-vs-uct415-1000its,809,871,2181.721616348,2134.177800135,-62
carcassonne-boltzmann35-vs-boltzmann475-1000its,810,872,2111.838767152,2075.976758065,-62
carcassonne-uct440-vs-uct315-1000its,810,872,2199.871381881,2124.884303528,-62
carcassonne-ucttuned340-vs-ucttuned270-1000its,814,876,2213.965377123,2209.62347697,-62
carcassonne-ucttuned370-vs-ucttuned380-1000its,816,878,2187.292932237,2131.422180941,-62
carcassonne-ucttuned305-vs-ucttuned390-1000its,819,881,2172.482306306,2104.499518849,-62
carcassonne-boltzmann485-vs-boltzmann200-1000its,821,883,2151.420189459,2103.746492833,-62
carcassonne-boltzmann130-vs-boltzmann495-1000its,823,885,2186.981894051,2133.640817657,-62
carcassonne-uct135-vs-uct260-1000its,835,897,2192.096850003,2135.193593066,-62
carcassonne-ucttuned230-vs-ucttuned15-1000its,838,900,2137.24163607,2091.82049721,-62
carcassonne-boltzmann180-vs-boltzmann230-1000its,841,903,2199.537218673,2165.483941861,-62
carcassonne-ucttuned15-vs-ucttuned415-1000its,841,903,2219.364106659,2132.676432568,-62
carcassonne-boltzmann425-vs-boltzmann150-1000its,843,905,2209.981106124,2163.366572268,-62
carcassonne-ucttuned175-vs-ucttuned485-1000its,846,908,2285.0915526,2227.177669736,-62
carcassonne-uct195-vs-uct35-1000its,849,911,2158.715057468,2131.137022691,-62
carcassonne-uct285-vs-uct165-1000its,851,913,2200.265362405,2183.46168226,-62
carcassonne-ucttuned260-vs-ucttuned455-1000its,855,917,2252.102603607,2216.100345294,-62
carcassonne-uct225-vs-uct275-1000its,863,925,2246.830761858,2194.107584951,-62
carcassonne-ucttuned170-vs-ucttuned15-1000its,865,927,2152.673552197,2097.568282231,-62
carcassonne-boltzmann20-vs-boltzmann5-1000its,867,929,2248.504787454,2223.970344813,-62
carcassonne-boltzmann265-vs-boltzmann10-1000its,686,747,2202.882904494,2147.582143574,-61
carcassonne-ucttuned190-vs-ucttuned210-1000its,693,754,2166.012887818,2137.628928254,-61
carcassonne-boltzmann50-vs-boltzmann445-1000its,707,768,2148.047301957,2096.304964224,-61
carcassonne-uct220-vs-uct140-1000its,708,769,2185.899926366,2180.809559806,-61
carcassonne-boltzmann295-vs-boltzmann260-1000its,709,770,2200.051299742,2166.378217454,-61
carcassonne-ucttuned125-vs-ucttuned235-1000its,713,774,2181.688236989,2186.507865094,-61
carcassonne-ucttuned405-vs-ucttuned175-1000its,715,776,2137.605951494,2121.837882113,-61
carcassonne-uct95-vs-uct340-1000its,716,777,2168.074051641,2111.181858726,-61
carcassonne-boltzmann485-vs-boltzmann405-1000its,717,778,2255.897562254,2236.73457211,-61
carcassonne-uct185-vs-uct50-1000its,717,778,2172.819257074,2137.469298796,-61
carcassonne-ucttuned330-vs-ucttuned180-1000its,717,778,2233.299966332,2177.946586583,-61
carcassonne-uct90-vs-uct260-1000its,721,782,2177.742430522,2127.334679469,-61
carcassonne-boltzmann345-vs-boltzmann130-1000its,722,783,2171.224772986,2136.393807215,-61
carcassonne-boltzmann405-vs-boltzmann305-1000its,725,786,2165.229139414,2112.894684434,-61
carcassonne-ucttuned120-vs-ucttuned395-1000its,726,787,2203.845923481,2160.367198325,-61
carcassonne-uct440-vs-uct95-1000its,727,788,2170.349182674,2120.475466584,-61
carcassonne-boltzmann365-vs-boltzmann205-1000its,729,790,2172.412840386,2128.82668576,-61
carcassonne-boltzmann250-vs-boltzmann55-1000its,730,791,2157.681011886,2119.556924375,-61
carcassonne-boltzmann420-vs-boltzmann70-1000its,732,793,2210.938667482,2151.393087629,-61
carcassonne-uct415-vs-uct315-1000its,736,797,2158.956852765,2131.821198293,-61
carcassonne-ucttuned305-vs-ucttuned140-1000its,739,800,2215.9887108,2162.592973474,-61
carcassonne-boltzmann40-vs-boltzmann140-1000its,741,802,2305.246174752,2232.886906607,-61
carcassonne-boltzmann35-vs-boltzmann470-1000its,742,803,2191.220886736,2166.003039548,-61
carcassonne-boltzmann50-vs-boltzmann160-1000its,742,803,2274.63636749,2240.618593946,-61
carcassonne-ucttuned250-vs-ucttuned430-1000its,742,803,2181.972668572,2148.355359729,-61
carcassonne-boltzmann325-vs-boltzmann170-1000its,745,806,2198.729049782,2115.345085114,-61
carcassonne-boltzmann355-vs-boltzmann375-1000its,746,807,2209.886046814,2177.11339924,-61
carcassonne-boltzmann85-vs-boltzmann10-1000its,746,807,2215.000689184,2229.797311169,-61
carcassonne-uct170-vs-uct430-1000its,748,809,2184.660781828,2092.450720915,-61
carcassonne-ucttuned185-vs-ucttuned60-1000its,750,811,2187.506983279,2154.338762353,-61
carcassonne-boltzmann245-vs-boltzmann260-1000its,751,812,2131.784321136,2107.915018065,-61
carcassonne-boltzmann465-vs-boltzmann290-1000its,751,812,2200.583145561,2213.93213853,-61
carcassonne-uct405-vs-uct150-1000its,751,812,2201.768354778,2159.578119714,-61
carcassonne-boltzmann165-vs-boltzmann30-1000its,752,813,2196.026433372,2152.138124001,-61
carcassonne-uct310-vs-uct65-1000its,753,814,2183.491361057,2154.59363299,-61
carcassonne-boltzmann160-vs-boltzmann65-1000its,754,815,2190.084612047,2179.852074853,-61
carcassonne-boltzmann235-vs-boltzmann490-1000its,755,816,2197.349432393,2206.290999224,-61
carcassonne-ucttuned485-vs-ucttuned65-1000its,755,816,2193.43378051,2096.910719308,-61
carcassonne-boltzmann30-vs-boltzmann400-1000its,756,817,2165.60936526,2146.287145988,-61
carcassonne-boltzmann405-vs-boltzmann360-1000its,756,817,2152.55625116,2144.167366455,-61
carcassonne-uct170-vs-uct355-1000its,757,818,2206.118245929,2142.121676266,-61
carcassonne-uct490-vs-uct280-1000its,757,818,2136.630027497,2100.617192655,-61
carcassonne-boltzmann65-vs-boltzmann150-1000its,758,819,2130.083063151,2140.82691001,-61
carcassonne-uct425-vs-uct490-1000its,758,819,2197.832256099,2161.437640805,-61
carcassonne-uct245-vs-uct405-1000its,759,820,2175.661113156,2124.379760758,-61
carcassonne-uct65-vs-uct165-1000its,761,822,2193.333301481,2133.922053823,-61
carcassonne-uct330-vs-uct460-1000its,762,823,2294.023995943,2208.207527026,-61
carcassonne-boltzmann380-vs-boltzmann195-1000its,763,824,2224.171051858,2172.638242043,-61
carcassonne-uct165-vs-uct85-1000its,763,824,2164.086502121,2141.871946857,-61
carcassonne-uct105-vs-uct325-1000its,764,825,2149.864429999,2107.094176931,-61
carcassonne-boltzmann105-vs-boltzmann480-1000its,765,826,2083.642537197,2086.407896221,-61
carcassonne-boltzmann385-vs-boltzmann195-1000its,765,826,2148.246051189,2141.813296176,-61
carcassonne-ucttuned495-vs-ucttuned380-1000its,765,826,2165.829927696,2118.857606753,-61
carcassonne-uct170-vs-uct160-1000its,766,827,2285.374044481,2281.120364655,-61
carcassonne-boltzmann330-vs-boltzmann290-1000its,768,829,2126.075984801,2075.025997103,-61
carcassonne-boltzmann380-vs-boltzmann90-1000its,768,829,2179.995755341,2143.634136518,-61
carcassonne-uct455-vs-uct240-1000its,768,829,2208.855394104,2194.302254307,-61
carcassonne-ucttuned470-vs-ucttuned465-1000its,768,829,2163.808607168,2090.741132562,-61
carcassonne-ucttuned310-vs-ucttuned190-1000its,769,830,2157.327581667,2127.865430644,-61
carcassonne-ucttuned60-vs-ucttuned315-1000its,771,832,2237.43900253,2209.733115671,-61
carcassonne-ucttuned360-vs-ucttuned465-1000its,773,834,2214.668504002,2203.00966279,-61
carcassonne-uct410-vs-uct195-1000its,776,837,2155.295699406,2148.719146478,-61
carcassonne-uct340-vs-uct200-1000its,777,838,2153.922149084,2110.61910769,-61
carcassonne-boltzmann405-vs-boltzmann120-1000its,779,840,2196.419549679,2177.239449847,-61
carcassonne-uct305-vs-uct230-1000its,779,840,2163.497000913,2088.409629994,-61
carcassonne-ucttuned325-vs-ucttuned340-1000its,780,841,2161.168923443,2157.150308836,-61
carcassonne-boltzmann180-vs-boltzmann425-1000its,781,842,2222.725576004,2176.784700176,-61
carcassonne-ucttuned465-vs-ucttuned20-1000its,781,842,2229.957562333,2201.053225741,-61
carcassonne-ucttuned30-vs-ucttuned185-1000its,782,843,2219.449377433,2192.932963049,-61
carcassonne-boltzmann125-vs-boltzmann325-1000its,787,848,2167.842697344,2100.136969053,-61
carcassonne-ucttuned395-vs-ucttuned65-1000its,787,848,2252.62733344,2175.697461663,-61
carcassonne-boltzmann400-vs-boltzmann280-1000its,788,849,2204.454935874,2084.142763351,-61
carcassonne-boltzmann225-vs-boltzmann285-1000its,791,852,2236.376523779,2185.251325313,-61
carcassonne-uct230-vs-uct215-1000its,791,852,2193.176243933,2118.3934659,-61
carcassonne-uct275-vs-uct435-1000its,791,852,2139.703586833,2101.537892944,-61
carcassonne-boltzmann440-vs-boltzmann225-1000its,793,854,2189.880761817,2162.97317315,-61
carcassonne-uct420-vs-uct55-1000its,793,854,2195.286667539,2146.828129118,-61
carcassonne-ucttuned5-vs-ucttuned195-1000its,796,857,2181.499248662,2173.695657633,-61
carcassonne-ucttuned335-vs-ucttuned205-1000its,797,858,2244.770762228,2182.54417696,-61
carcassonne-ucttuned340-vs-ucttuned335-1000its,797,858,2172.537362253,2140.923057591,-61
carcassonne-uct285-vs-uct15-1000its,798,859,2239.077849394,2187.182235955,-61
carcassonne-ucttuned385-vs-ucttuned295-1000its,799,860,2125.831046618,2080.592391798,-61
carcassonne-ucttuned385-vs-ucttuned335-1000its,799,860,2135.953413323,2099.322686688,-61
carcassonne-ucttuned340-vs-ucttuned320-1000its,800,861,2229.380050054,2180.845413908,-61
carcassonne-uct155-vs-uct135-1000its,801,862,2150.054353918,2108.824391873,-61
carcassonne-uct375-vs-uct455-1000its,801,862,2196.495985423,2136.809332072,-61
carcassonne-ucttuned495-vs-ucttuned390-1000its,801,862,2143.913317901,2096.834271666,-61
carcassonne-ucttuned155-vs-ucttuned305-1000its,803,864,2163.303478194,2163.903735582,-61
carcassonne-ucttuned385-vs-ucttuned30-1000its,805,866,2180.29772895,2129.499771013,-61
carcassonne-ucttuned425-vs-ucttuned150-1000its,805,866,2221.210119364,2184.319048568,-61
carcassonne-ucttuned315-vs-ucttuned450-1000its,806,867,2229.892811517,2177.682358967,-61
carcassonne-ucttuned330-vs-ucttuned5-1000its,807,868,2163.674867952,2125.355253141,-61
carcassonne-uct190-vs-uct35-1000its,810,871,2218.180123716,2141.130284533,-61
carcassonne-ucttuned285-vs-ucttuned275-1000its,811,872,2182.957822809,2141.552051183,-61
carcassonne-boltzmann270-vs-boltzmann35-1000its,812,873,2218.229760092,2214.579981707,-61
carcassonne-ucttuned115-vs-ucttuned80-1000its,812,873,2155.470354305,2081.494492438,-61
carcassonne-uct255-vs-uct45-1000its,816,877,2275.101299572,2244.551934435,-61
carcassonne-uct30-vs-uct190-1000its,817,878,2265.739429012,2167.612236223,-61
carcassonne-ucttuned300-vs-ucttuned45-1000its,817,878,2137.468326045,2099.559071057,-61
carcassonne-ucttuned50-vs-ucttuned415-1000its,818,879,2212.413755629,2142.822098762,-61
carcassonne-ucttuned80-vs-ucttuned455-1000its,818,879,2222.054271258,2172.064934852,-61
carcassonne-ucttuned175-vs-ucttuned10-1000its,821,882,2188.950300794,2188.642630468,-61
carcassonne-ucttuned235-vs-ucttuned20-1000its,821,882,2184.096043729,2161.4063447,-61
carcassonne-ucttuned205-vs-ucttuned100-1000its,824,885,2159.635321358,2094.612981049,-61
carcassonne-uct165-vs-uct465-1000its,827,888,2182.422294116,2124.407500651,-61
carcassonne-uct425-vs-uct250-1000its,827,888,2189.456315906,2147.524016317,-61
carcassonne-uct275-vs-uct470-1000its,828,889,2201.625334819,2126.334206267,-61
carcassonne-ucttuned335-vs-ucttuned400-1000its,832,893,2245.86711169,2200.950835092,-61
carcassonne-ucttuned100-vs-ucttuned340-1000its,833,894,2156.800212416,2101.552977727,-61
carcassonne-boltzmann250-vs-boltzmann485-1000its,835,896,2170.910563629,2157.646887761,-61
carcassonne-uct250-vs-uct495-1000its,838,899,2187.377447758,2156.433573528,-61
carcassonne-ucttuned260-vs-ucttuned330-1000its,838,899,2233.592153816,2187.317113424,-61
carcassonne-ucttuned440-vs-ucttuned390-1000its,841,902,2240.334875999,2210.557238144,-61
carcassonne-uct125-vs-uct95-1000its,857,918,2155.552346829,2081.939149844,-61
carcassonne-ucttuned310-vs-ucttuned415-1000its,876,937,2190.166421774,2105.10662644,-61
carcassonne-ucttuned420-vs-ucttuned70-1000its,905,966,2129.999501792,2102.347485278,-61
carcassonne-boltzmann285-vs-boltzmann195-1000its,675,735,2225.702404497,2167.874753557,-60
carcassonne-ucttuned140-vs-ucttuned405-1000its,701,761,2266.465919742,2197.601944338,-60
carcassonne-boltzmann85-vs-boltzmann270-1000its,705,765,2226.037130366,2175.755307411,-60
carcassonne-uct340-vs-uct135-1000its,718,778,2162.837872331,2140.900718694,-60
carcassonne-boltzmann100-vs-boltzmann490-1000its,719,779,2194.094685152,2114.245330523,-60
carcassonne-boltzmann220-vs-boltzmann275-1000its,719,779,2177.401015202,2157.452810564,-60
carcassonne-ucttuned245-vs-ucttuned490-1000its,723,783,2208.923760946,2178.457004017,-60
carcassonne-boltzmann390-vs-boltzmann395-1000its,728,788,2275.247317293,2249.423958097,-60
carcassonne-boltzmann155-vs-boltzmann70-1000its,730,790,2194.277031164,2134.936288405,-60
carcassonne-uct270-vs-uct70-1000its,731,791,2157.687055891,2110.223887161,-60
carcassonne-ucttuned325-vs-ucttuned485-1000its,732,792,2107.082039569,2065.194254122,-60
carcassonne-boltzmann280-vs-boltzmann485-1000its,733,793,2175.611570455,2137.700216263,-60
carcassonne-boltzmann340-vs-boltzmann250-1000its,734,794,2196.30957103,2158.336097683,-60
carcassonne-boltzmann420-vs-boltzmann305-1000its,735,795,2210.727224274,2150.764444867,-60
carcassonne-uct160-vs-uct250-1000its,737,797,2168.219261468,2115.805266551,-60
carcassonne-boltzmann250-vs-boltzmann225-1000its,738,798,2196.302203769,2141.278960221,-60
carcassonne-uct440-vs-uct335-1000its,741,801,2137.510777422,2161.906536576,-60
carcassonne-boltzmann10-vs-boltzmann465-1000its,742,802,2195.850056102,2138.967465878,-60
carcassonne-boltzmann295-vs-boltzmann470-1000its,744,804,2208.080487898,2152.289262638,-60
carcassonne-uct400-vs-uct470-1000its,745,805,2133.217064574,2152.540586061,-60
carcassonne-ucttuned210-vs-ucttuned355-1000its,745,805,2219.064063946,2184.896376757,-60
carcassonne-boltzmann410-vs-boltzmann60-1000its,746,806,2202.75299226,2172.934448094,-60
carcassonne-boltzmann495-vs-boltzmann175-1000its,748,808,2165.076221406,2087.722014718,-60
carcassonne-boltzmann460-vs-boltzmann325-1000its,749,809,2186.096681969,2089.696652852,-60
carcassonne-ucttuned110-vs-ucttuned365-1000its,756,816,2086.471903449,2078.074812956,-60
carcassonne-ucttuned255-vs-ucttuned335-1000its,756,816,2121.435173364,2092.233141968,-60
carcassonne-uct345-vs-uct470-1000its,757,817,2148.036281182,2145.311609886,-60
carcassonne-uct260-vs-uct130-1000its,758,818,2138.411238946,2133.9855427,-60
carcassonne-boltzmann430-vs-boltzmann95-1000its,759,819,2186.534744815,2166.180869518,-60
carcassonne-ucttuned290-vs-ucttuned435-1000its,759,819,2150.268276427,2083.294708904,-60
carcassonne-boltzmann400-vs-boltzmann170-1000its,761,821,2238.50605216,2213.143348424,-60
carcassonne-boltzmann395-vs-boltzmann85-1000its,762,822,2295.556256293,2263.922321647,-60
carcassonne-uct300-vs-uct315-1000its,762,822,2200.980187487,2117.39613211,-60
carcassonne-ucttuned230-vs-ucttuned25-1000its,762,822,2168.085174213,2114.392745129,-60
carcassonne-uct90-vs-uct240-1000its,763,823,2186.825287978,2165.409815203,-60
carcassonne-ucttuned370-vs-ucttuned230-1000its,763,823,2235.525724919,2213.898103825,-60
carcassonne-uct400-vs-uct85-1000its,767,827,2153.055142116,2174.780424271,-60
carcassonne-uct470-vs-uct95-1000its,768,828,2151.992186744,2178.780083018,-60
carcassonne-ucttuned90-vs-ucttuned185-1000its,768,828,2233.272632124,2150.400399059,-60
carcassonne-uct295-vs-uct75-1000its,769,829,2208.97321126,2177.422944815,-60
carcassonne-ucttuned400-vs-ucttuned230-1000its,772,832,2169.042851972,2124.070533279,-60
carcassonne-boltzmann165-vs-boltzmann35-1000its,773,833,2108.455691606,2081.839927205,-60
carcassonne-uct280-vs-uct330-1000its,773,833,2222.591083176,2167.408763839,-60
carcassonne-boltzmann485-vs-boltzmann95-1000its,774,834,2212.609142801,2164.335185393,-60
carcassonne-boltzmann70-vs-boltzmann275-1000its,775,835,2218.27118252,2165.424790762,-60
carcassonne-uct250-vs-uct315-1000its,775,835,2192.613293837,2177.644429301,-60
carcassonne-uct90-vs-uct100-1000its,775,835,2154.092284975,2103.837798693,-60
carcassonne-ucttuned390-vs-ucttuned105-1000its,775,835,2221.801649255,2172.177612451,-60
carcassonne-boltzmann140-vs-boltzmann220-1000its,776,836,2147.721751889,2074.602299435,-60
carcassonne-uct465-vs-uct20-1000its,778,838,2203.776523773,2159.701053179,-60
carcassonne-ucttuned385-vs-ucttuned80-1000its,778,838,2233.300245512,2212.899174734,-60
carcassonne-uct5-vs-uct475-1000its,779,839,2252.01386985,2180.82228052,-60
carcassonne-ucttuned265-vs-ucttuned445-1000its,779,839,2233.697629595,2160.973849301,-60
carcassonne-ucttuned450-vs-ucttuned195-1000its,779,839,2267.273918267,2198.493185459,-60
carcassonne-ucttuned320-vs-ucttuned325-1000its,783,843,2227.220027411,2188.681465977,-60
carcassonne-uct65-vs-uct195-1000its,784,844,2256.791735212,2203.782031962,-60
carcassonne-boltzmann280-vs-boltzmann325-1000its,785,845,2221.37041829,2197.2390266,-60
carcassonne-boltzmann430-vs-boltzmann320-1000its,785,845,2223.356399874,2164.288468988,-60
carcassonne-uct140-vs-uct60-1000its,785,845,2187.334213306,2149.121791518,-60
carcassonne-ucttuned240-vs-ucttuned60-1000its,786,846,2173.94849417,2136.241725801,-60
carcassonne-ucttuned370-vs-ucttuned270-1000its,786,846,2178.956020319,2178.086440278,-60
carcassonne-ucttuned400-vs-ucttuned325-1000its,786,846,2259.433209443,2187.637487564,-60
carcassonne-ucttuned435-vs-ucttuned485-1000its,786,846,2222.17027328,2169.617570889,-60
carcassonne-boltzmann40-vs-boltzmann250-1000its,788,848,2274.354144799,2229.825435901,-60
carcassonne-boltzmann130-vs-boltzmann90-1000its,789,849,2269.69397848,2187.569371337,-60
carcassonne-boltzmann215-vs-boltzmann380-1000its,789,849,2142.590985947,2098.917894511,-60
carcassonne-ucttuned210-vs-ucttuned30-1000its,789,849,2201.509757136,2144.593445294,-60
carcassonne-uct460-vs-uct130-1000its,790,850,2190.999982864,2157.134891059,-60
carcassonne-boltzmann20-vs-boltzmann370-1000its,791,851,2187.394190218,2130.75924314,-60
carcassonne-boltzmann145-vs-boltzmann275-1000its,792,852,2155.093422275,2128.5141801,-60
carcassonne-boltzmann140-vs-boltzmann450-1000its,793,853,2258.666843507,2222.54808225,-60
carcassonne-uct240-vs-uct360-1000its,793,853,2159.579270779,2127.036007795,-60
carcassonne-uct325-vs-uct390-1000its,793,853,2268.877798136,2191.849425477,-60
carcassonne-boltzmann215-vs-boltzmann30-1000its,794,854,2145.041876228,2111.712502012,-60
carcassonne-uct465-vs-uct215-1000its,795,855,2252.630846428,2183.586677004,-60
carcassonne-ucttuned30-vs-ucttuned55-1000its,795,855,2218.071276875,2185.097353352,-60
carcassonne-boltzmann190-vs-boltzmann85-1000its,797,857,2272.020829508,2230.530010501,-60
carcassonne-uct385-vs-uct155-1000its,798,858,2234.220550041,2216.882258274,-60
carcassonne-boltzmann250-vs-boltzmann350-1000its,800,860,2246.308896497,2263.436212435,-60
carcassonne-ucttuned360-vs-ucttuned320-1000its,800,860,2154.315664631,2109.822427981,-60
carcassonne-uct140-vs-uct10-1000its,802,862,2230.342606439,2215.384531552,-60
carcassonne-boltzmann110-vs-boltzmann405-1000its,804,864,2213.989312581,2166.142820719,-60
carcassonne-uct175-vs-uct245-1000its,804,864,2170.017349039,2150.610368653,-60
carcassonne-boltzmann355-vs-boltzmann30-1000its,806,866,2190.323301019,2101.441802275,-60
carcassonne-ucttuned85-vs-ucttuned205-1000its,806,866,2188.469940537,2174.135863642,-60
carcassonne-boltzmann60-vs-boltzmann260-1000its,811,871,2206.211935857,2209.995177862,-60
carcassonne-ucttuned90-vs-ucttuned215-1000its,811,871,2220.964652076,2180.875874874,-60
carcassonne-uct420-vs-uct95-1000its,812,872,2207.273841156,2160.727217664,-60
carcassonne-boltzmann375-vs-boltzmann145-1000its,813,873,2156.570781553,2139.89010619,-60
carcassonne-boltzmann30-vs-boltzmann80-1000its,816,876,2217.421140856,2145.235770862,-60
carcassonne-ucttuned135-vs-ucttuned310-1000its,816,876,2188.54060197,2186.130731671,-60
carcassonne-ucttuned70-vs-ucttuned495-1000its,816,876,2244.73249469,2212.952399794,-60
carcassonne-boltzmann455-vs-boltzmann100-1000its,823,883,2143.531639916,2117.465278219,-60
carcassonne-uct215-vs-uct405-1000its,823,883,2225.896581174,2179.265617351,-60
carcassonne-ucttuned465-vs-ucttuned470-1000its,824,884,2214.422695954,2147.260615958,-60
carcassonne-ucttuned485-vs-ucttuned50-1000its,824,884,2204.991256826,2134.212875416,-60
carcassonne-uct380-vs-uct130-1000its,825,885,2181.06729184,2099.304829609,-60
carcassonne-ucttuned160-vs-ucttuned205-1000its,825,885,2130.277546399,2092.877928183,-60
carcassonne-ucttuned300-vs-ucttuned180-1000its,826,886,2190.136220549,2137.485692201,-60
carcassonne-boltzmann225-vs-boltzmann275-1000its,827,887,2236.954457627,2175.917075408,-60
carcassonne-uct45-vs-uct35-1000its,828,888,2191.448775499,2148.477721041,-60
carcassonne-ucttuned465-vs-ucttuned100-1000its,829,889,2168.555101216,2116.254109021,-60
carcassonne-boltzmann95-vs-boltzmann30-1000its,835,895,2134.679801771,2128.477235937,-60
carcassonne-ucttuned120-vs-ucttuned380-1000its,842,902,2134.454272716,2149.263182881,-60
carcassonne-uct215-vs-uct225-1000its,844,904,2174.235526969,2095.800727674,-60
carcassonne-uct340-vs-uct60-1000its,846,906,2217.243897156,2185.589154867,-60
carcassonne-uct415-vs-uct45-1000its,849,909,2198.269168077,2155.762349285,-60
carcassonne-boltzmann260-vs-boltzmann130-1000its,863,923,2191.834535187,2149.986530715,-60
carcassonne-uct350-vs-uct105-1000its,871,931,2271.8125641,2227.918941608,-60
carcassonne-ucttuned330-vs-ucttuned25-1000its,894,954,2247.573278078,2201.647845768,-60
carcassonne-boltzmann275-vs-boltzmann150-1000its,654,713,2130.34122486,2113.976192193,-59
carcassonne-boltzmann470-vs-boltzmann380-1000its,675,734,2237.253420991,2178.138978989,-59
carcassonne-uct295-vs-uct170-1000its,704,763,2183.52579525,2163.221361914,-59
carcassonne-ucttuned225-vs-ucttuned480-1000its,709,768,2203.441455819,2133.624029242,-59
carcassonne-ucttuned270-vs-ucttuned400-1000its,714,773,2167.11223531,2121.916774301,-59
carcassonne-uct70-vs-uct320-1000its,715,774,2219.145688838,2161.754848132,-59
carcassonne-boltzmann335-vs-boltzmann165-1000its,722,781,2249.369540063,2211.309601038,-59
carcassonne-uct415-vs-uct130-1000its,726,785,2131.908285816,2081.012634917,-59
carcassonne-boltzmann445-vs-boltzmann95-1000its,727,786,2233.52035488,2195.989717239,-59
carcassonne-uct410-vs-uct460-1000its,728,787,2202.00938693,2155.895719958,-59
carcassonne-uct95-vs-uct115-1000its,728,787,2195.387309739,2155.383765213,-59
carcassonne-uct290-vs-uct80-1000its,733,792,2162.440259706,2146.001616723,-59
carcassonne-boltzmann295-vs-boltzmann80-1000its,735,794,2203.213473559,2174.080864691,-59
carcassonne-boltzmann50-vs-boltzmann495-1000its,735,794,2165.358143188,2131.56743375,-59
carcassonne-uct55-vs-uct495-1000its,735,794,2230.829860908,2199.625087945,-59
carcassonne-uct70-vs-uct60-1000its,738,797,2136.131355826,2098.11549467,-59
carcassonne-boltzmann55-vs-boltzmann290-1000its,739,798,2269.547842887,2182.169974925,-59
carcassonne-boltzmann155-vs-boltzmann250-1000its,741,800,2174.463237665,2145.564812417,-59
carcassonne-boltzmann255-vs-boltzmann240-1000its,741,800,2166.18757987,2131.053315061,-59
carcassonne-ucttuned460-vs-ucttuned415-1000its,743,802,2168.685586342,2146.6400567,-59
carcassonne-uct480-vs-uct15-1000its,744,803,2138.070758579,2152.339975828,-59
carcassonne-boltzmann460-vs-boltzmann105-1000its,745,804,2149.592363052,2089.220387003,-59
carcassonne-boltzmann90-vs-boltzmann380-1000its,745,804,2125.013067096,2078.294832639,-59
carcassonne-boltzmann200-vs-boltzmann170-1000its,746,805,2259.944626679,2195.362969065,-59
carcassonne-boltzmann335-vs-boltzmann150-1000its,748,807,2112.251585057,2058.437986422,-59
carcassonne-ucttuned380-vs-ucttuned225-1000its,750,809,2223.033378132,2231.342835097,-59
carcassonne-ucttuned455-vs-ucttuned195-1000its,752,811,2174.58109736,2104.695654629,-59
carcassonne-uct170-vs-uct250-1000its,753,812,2162.189581501,2172.044934947,-59
carcassonne-ucttuned370-vs-ucttuned320-1000its,753,812,2152.672673006,2095.338980398,-59
carcassonne-ucttuned370-vs-ucttuned445-1000its,754,813,2175.859304237,2167.171649219,-59
carcassonne-ucttuned280-vs-ucttuned115-1000its,755,814,2122.073345645,2176.096608849,-59
carcassonne-uct440-vs-uct215-1000its,756,815,2207.415937326,2145.120333872,-59
carcassonne-boltzmann170-vs-boltzmann25-1000its,757,816,2230.172642354,2167.114825801,-59
carcassonne-ucttuned185-vs-ucttuned175-1000its,757,816,2199.614947251,2164.14804046,-59
carcassonne-uct205-vs-uct100-1000its,758,817,2222.722706016,2142.864466325,-59
carcassonne-boltzmann130-vs-boltzmann255-1000its,759,818,2272.895888081,2269.730144858,-59
carcassonne-uct80-vs-uct180-1000its,759,818,2180.989739628,2144.796210577,-59
carcassonne-uct305-vs-uct465-1000its,760,819,2226.748600382,2153.592500371,-59
carcassonne-ucttuned160-vs-ucttuned485-1000its,762,821,2213.682423309,2138.744597655,-59
carcassonne-ucttuned250-vs-ucttuned395-1000its,762,821,2146.422131214,2051.20406358,-59
carcassonne-boltzmann230-vs-boltzmann200-1000its,763,822,2145.054334086,2097.108709725,-59
carcassonne-boltzmann400-vs-boltzmann45-1000its,763,822,2156.016405087,2124.789965668,-59
carcassonne-ucttuned260-vs-ucttuned195-1000its,765,824,2156.660853997,2083.092390988,-59
carcassonne-boltzmann135-vs-boltzmann485-1000its,766,825,2208.330029912,2125.394408321,-59
carcassonne-boltzmann305-vs-boltzmann215-1000its,766,825,2276.648934799,2231.125929052,-59
carcassonne-ucttuned480-vs-ucttuned100-1000its,767,826,2202.785901423,2194.468664739,-59
carcassonne-boltzmann330-vs-boltzmann300-1000its,768,827,2228.808895016,2120.360264479,-59
carcassonne-boltzmann370-vs-boltzmann80-1000its,768,827,2177.809738356,2140.243725249,-59
carcassonne-boltzmann145-vs-boltzmann20-1000its,769,828,2169.521081862,2140.506142848,-59
carcassonne-boltzmann340-vs-boltzmann385-1000its,769,828,2252.654908453,2212.849975349,-59
carcassonne-ucttuned310-vs-ucttuned85-1000its,769,828,2158.784074331,2108.982926784,-59
carcassonne-boltzmann220-vs-boltzmann205-1000its,770,829,2249.696781544,2183.223101273,-59
carcassonne-uct10-vs-uct320-1000its,770,829,2161.057247509,2086.581003831,-59
carcassonne-uct245-vs-uct20-1000its,770,829,2175.230545487,2125.944435789,-59
carcassonne-boltzmann485-vs-boltzmann375-1000its,771,830,2143.798721633,2146.957213268,-59
carcassonne-ucttuned370-vs-ucttuned275-1000its,771,830,2178.82951317,2105.4847461,-59
carcassonne-uct210-vs-uct420-1000its,772,831,2158.09226305,2102.303629588,-59
carcassonne-uct350-vs-uct135-1000its,777,836,2175.08483218,2104.726836935,-59
carcassonne-ucttuned495-vs-ucttuned335-1000its,779,838,2169.056522841,2064.333407997,-59
carcassonne-uct400-vs-uct380-1000its,780,839,2195.448205793,2157.61674269,-59
carcassonne-ucttuned305-vs-ucttuned20-1000its,781,840,2157.790847521,2121.562935939,-59
carcassonne-ucttuned390-vs-ucttuned250-1000its,781,840,2141.99497224,2112.620858261,-59
carcassonne-boltzmann105-vs-boltzmann165-1000its,782,841,2139.794420821,2110.828629387,-59
carcassonne-uct150-vs-uct245-1000its,782,841,2236.390600833,2227.210134623,-59
carcassonne-ucttuned360-vs-ucttuned90-1000its,783,842,2148.979366217,2159.175691758,-59
carcassonne-ucttuned255-vs-ucttuned470-1000its,784,843,2225.122026652,2151.867646044,-59
carcassonne-boltzmann75-vs-boltzmann400-1000its,785,844,2182.264541126,2163.080846572,-59
carcassonne-ucttuned185-vs-ucttuned75-1000its,785,844,2166.849546852,2137.075965789,-59
carcassonne-uct195-vs-uct370-1000its,786,845,2236.960485819,2133.162070512,-59
carcassonne-uct390-vs-uct310-1000its,786,845,2179.015387361,2165.711858562,-59
carcassonne-ucttuned230-vs-ucttuned440-1000its,787,846,2246.804323676,2159.525992375,-59
carcassonne-uct85-vs-uct355-1000its,788,847,2206.913755353,2192.609387602,-59
carcassonne-boltzmann215-vs-boltzmann435-1000its,789,848,2269.012521174,2207.970161328,-59
carcassonne-uct350-vs-uct390-1000its,789,848,2151.070445064,2142.954431488,-59
carcassonne-uct405-vs-uct425-1000its,789,848,2248.611703033,2184.455325906,-59
carcassonne-boltzmann475-vs-boltzmann260-1000its,790,849,2208.002881422,2180.232704914,-59
carcassonne-boltzmann480-vs-boltzmann315-1000its,791,850,2204.58941577,2174.043592507,-59
carcassonne-uct355-vs-uct30-1000its,791,850,2236.510434337,2190.117879899,-59
carcassonne-uct390-vs-uct270-1000its,793,852,2158.958325138,2149.200409394,-59
carcassonne-ucttuned320-vs-ucttuned390-1000its,793,852,2166.159825919,2094.294947077,-59
carcassonne-uct295-vs-uct15-1000its,794,853,2178.066432858,2121.877906051,-59
carcassonne-boltzmann365-vs-boltzmann260-1000its,796,855,2196.189980595,2170.382145979,-59
carcassonne-uct245-vs-uct155-1000its,798,857,2220.906732616,2197.152692707,-59
carcassonne-ucttuned480-vs-ucttuned215-1000its,798,857,2168.746721222,2129.950989725,-59
carcassonne-ucttuned180-vs-ucttuned110-1000its,799,858,2148.250876976,2111.916008912,-59
carcassonne-uct130-vs-uct200-1000its,800,859,2183.109570445,2137.508544243,-59
carcassonne-uct145-vs-uct100-1000its,802,861,2204.34383213,2176.902104192,-59
carcassonne-ucttuned250-vs-ucttuned310-1000its,802,861,2229.246689229,2201.072052799,-59
carcassonne-ucttuned455-vs-ucttuned245-1000its,803,862,2231.163393782,2139.263349595,-59
carcassonne-boltzmann400-vs-boltzmann360-1000its,805,864,2216.69325371,2165.994635439,-59
carcassonne-uct60-vs-uct280-1000its,806,865,2204.130767921,2150.177898016,-59
carcassonne-ucttuned240-vs-ucttuned325-1000its,806,865,2175.892747575,2119.078415963,-59
carcassonne-uct460-vs-uct235-1000its,807,866,2269.775489198,2243.184118451,-59
carcassonne-boltzmann305-vs-boltzmann490-1000its,808,867,2246.656656561,2215.863115517,-59
carcassonne-uct420-vs-uct165-1000its,810,869,2224.050700053,2149.272805468,-59
carcassonne-uct205-vs-uct195-1000its,813,872,2275.949336827,2241.572009941,-59
carcassonne-boltzmann355-vs-boltzmann155-1000its,815,874,2272.525621892,2187.034392801,-59
carcassonne-ucttuned395-vs-ucttuned440-1000its,815,874,2289.19791318,2245.26491147,-59
carcassonne-boltzmann250-vs-boltzmann445-1000its,818,877,2227.769780941,2179.997012643,-59
carcassonne-uct315-vs-uct325-1000its,821,880,2187.123345092,2146.691107014,-59
carcassonne-ucttuned155-vs-ucttuned380-1000its,821,880,2223.427702184,2158.284954307,-59
carcassonne-uct355-vs-uct170-1000its,822,881,2158.154824989,2130.32278229,-59
carcassonne-ucttuned110-vs-ucttuned35-1000its,826,885,2219.743590053,2205.736831828,-59
carcassonne-ucttuned360-vs-ucttuned30-1000its,826,885,2098.182877834,2071.955670989,-59
carcassonne-boltzmann395-vs-boltzmann170-1000its,827,886,2237.021564589,2172.322078195,-59
carcassonne-ucttuned75-vs-ucttuned65-1000its,829,888,2231.548828558,2185.531376365,-59
carcassonne-ucttuned115-vs-ucttuned415-1000its,833,892,2164.5364628,2138.534152001,-59
carcassonne-ucttuned360-vs-ucttuned40-1000its,836,895,2143.150139735,2125.913728557,-59
carcassonne-ucttuned60-vs-ucttuned25-1000its,836,895,2222.15852073,2183.175273622,-59
carcassonne-uct330-vs-uct375-1000its,850,909,2192.780194106,2151.687731951,-59
carcassonne-ucttuned365-vs-ucttuned400-1000its,851,910,2243.709940516,2227.11534719,-59
carcassonne-uct340-vs-uct15-1000its,858,917,2288.061861216,2259.04022818,-59
carcassonne-uct405-vs-uct50-1000its,617,675,1708.002311282,1691.440852419,-58
carcassonne-boltzmann370-vs-boltzmann390-1000its,696,754,2237.184265072,2206.831481608,-58
carcassonne-boltzmann30-vs-boltzmann60-1000its,697,755,2316.054203385,2291.838280437,-58
carcassonne-ucttuned130-vs-ucttuned145-1000its,700,758,2212.087033701,2136.768090561,-58
carcassonne-uct345-vs-uct445-1000its,707,765,2198.674807993,2145.724420912,-58
carcassonne-uct130-vs-uct430-1000its,711,769,2189.293090509,2114.650057025,-58
carcassonne-boltzmann110-vs-boltzmann295-1000its,712,770,2199.812887927,2108.224669825,-58
carcassonne-boltzmann35-vs-boltzmann150-1000its,712,770,2251.396641404,2197.457106824,-58
carcassonne-boltzmann495-vs-boltzmann330-1000its,715,773,2175.628323974,2140.507905762,-58
carcassonne-boltzmann385-vs-boltzmann480-1000its,718,776,2292.745573592,2259.764952645,-58
carcassonne-uct145-vs-uct70-1000its,726,784,2266.472901684,2203.271677022,-58
carcassonne-boltzmann280-vs-boltzmann120-1000its,727,785,2209.588045844,2186.285594636,-58
carcassonne-ucttuned465-vs-ucttuned315-1000its,729,787,2258.909743978,2219.886149676,-58
carcassonne-boltzmann300-vs-boltzmann15-1000its,731,789,2150.113822028,2155.246729239,-58
carcassonne-boltzmann40-vs-boltzmann430-1000its,731,789,2233.357990402,2190.659823772,-58
carcassonne-uct30-vs-uct280-1000its,731,789,2152.905861546,2129.476160034,-58
carcassonne-boltzmann350-vs-boltzmann215-1000its,733,791,2184.013429675,2179.498988384,-58
carcassonne-ucttuned250-vs-ucttuned220-1000its,733,791,2178.735026173,2152.899116613,-58
carcassonne-boltzmann140-vs-boltzmann480-1000its,736,794,2200.98275791,2110.714239265,-58
carcassonne-boltzmann150-vs-boltzmann385-1000its,737,795,2189.176428945,2151.713736853,-58
carcassonne-uct480-vs-uct60-1000its,737,795,2123.056900853,2068.946580051,-58
carcassonne-ucttuned475-vs-ucttuned145-1000its,738,796,2166.762678328,2158.052999461,-58
carcassonne-ucttuned235-vs-ucttuned370-1000its,741,799,2188.149255114,2160.646488718,-58
carcassonne-uct155-vs-uct265-1000its,742,800,2120.445610657,2123.228106223,-58
carcassonne-boltzmann400-vs-boltzmann275-1000its,745,803,2247.663916839,2213.816330881,-58
carcassonne-boltzmann485-vs-boltzmann370-1000its,746,804,2233.17046336,2193.131590168,-58
carcassonne-boltzmann415-vs-boltzmann240-1000its,749,807,2225.479048518,2185.652448864,-58
carcassonne-uct465-vs-uct100-1000its,749,807,2199.622336267,2130.888691763,-58
carcassonne-ucttuned240-vs-ucttuned155-1000its,749,807,2191.498782527,2163.352054806,-58
carcassonne-uct410-vs-uct20-1000its,751,809,2151.378680525,2089.34543721,-58
carcassonne-ucttuned205-vs-ucttuned485-1000its,751,809,2236.896799059,2169.277864854,-58
carcassonne-boltzmann480-vs-boltzmann30-1000its,752,810,2192.268005348,2159.147946646,-58
carcassonne-boltzmann130-vs-boltzmann285-1000its,753,811,2206.706247943,2155.738980556,-58
carcassonne-ucttuned370-vs-ucttuned220-1000its,754,812,2201.344614511,2133.333276288,-58
carcassonne-ucttuned30-vs-ucttuned290-1000its,758,816,2273.047930638,2187.517312525,-58
carcassonne-boltzmann100-vs-boltzmann75-1000its,759,817,2267.825083881,2193.993212228,-58
carcassonne-boltzmann95-vs-boltzmann55-1000its,760,818,2155.439756451,2131.797044153,-58
carcassonne-uct445-vs-uct85-1000its,760,818,2155.110222639,2118.948319535,-58
carcassonne-boltzmann185-vs-boltzmann290-1000its,761,819,2227.027232976,2179.432572043,-58
carcassonne-uct75-vs-uct35-1000its,761,819,2263.161132594,2244.428915971,-58
carcassonne-ucttuned240-vs-ucttuned175-1000its,766,824,2224.35559802,2137.328426267,-58
carcassonne-uct450-vs-uct400-1000its,767,825,2245.980828804,2185.024440071,-58
carcassonne-ucttuned295-vs-ucttuned290-1000its,767,825,2212.243372263,2156.34881667,-58
carcassonne-ucttuned120-vs-ucttuned90-1000its,768,826,2202.77963176,2167.741317599,-58
carcassonne-boltzmann90-vs-boltzmann35-1000its,770,828,2129.250175232,2079.359718423,-58
carcassonne-uct305-vs-uct380-1000its,770,828,2250.979504602,2172.968797964,-58
carcassonne-uct185-vs-uct345-1000its,771,829,2121.893765596,2054.728257124,-58
carcassonne-boltzmann315-vs-boltzmann65-1000its,775,833,2144.37617501,2083.153435644,-58
carcassonne-boltzmann160-vs-boltzmann475-1000its,776,834,2151.558015756,2099.379848983,-58
carcassonne-boltzmann460-vs-boltzmann45-1000its,776,834,2140.017442191,2093.729737549,-58
carcassonne-boltzmann290-vs-boltzmann350-1000its,778,836,2222.867929965,2214.813555895,-58
carcassonne-boltzmann355-vs-boltzmann350-1000its,779,837,2191.926159607,2130.766009246,-58
carcassonne-boltzmann200-vs-boltzmann225-1000its,780,838,2226.070663722,2148.831102738,-58
carcassonne-boltzmann475-vs-boltzmann350-1000its,780,838,2165.039912676,2143.104627825,-58
carcassonne-ucttuned355-vs-ucttuned5-1000its,780,838,2191.313455023,2124.344471007,-58
carcassonne-ucttuned395-vs-ucttuned225-1000its,780,838,2192.647176351,2105.189538292,-58
carcassonne-boltzmann225-vs-boltzmann450-1000its,782,840,2178.360080816,2181.307878466,-58
carcassonne-uct475-vs-uct430-1000its,782,840,2197.742981504,2175.982533305,-58
carcassonne-ucttuned45-vs-ucttuned400-1000its,784,842,2228.891310872,2169.538166368,-58
carcassonne-uct300-vs-uct490-1000its,786,844,2207.47191632,2169.244730204,-58
carcassonne-ucttuned455-vs-ucttuned170-1000its,786,844,2226.591612282,2123.090234115,-58
carcassonne-ucttuned95-vs-ucttuned330-1000its,786,844,2169.584611277,2116.908226944,-58
carcassonne-boltzmann275-vs-boltzmann345-1000its,788,846,2200.854771647,2128.547184485,-58
carcassonne-boltzmann380-vs-boltzmann20-1000its,788,846,2209.906435601,2140.75252605,-58
carcassonne-uct50-vs-uct155-1000its,788,846,2202.417746381,2119.681571464,-58
carcassonne-uct180-vs-uct280-1000its,790,848,2149.256862922,2111.854598194,-58
carcassonne-uct210-vs-uct395-1000its,791,849,2213.06158801,2179.491828035,-58
carcassonne-ucttuned410-vs-ucttuned325-1000its,791,849,2222.028501945,2196.15963097,-58
carcassonne-uct175-vs-uct430-1000its,793,851,2221.637025567,2169.412139679,-58
carcassonne-uct295-vs-uct155-1000its,796,854,2161.563427291,2134.59706533,-58
carcassonne-ucttuned290-vs-ucttuned130-1000its,797,855,2201.99424006,2170.333636229,-58
carcassonne-boltzmann255-vs-boltzmann365-1000its,799,857,2318.07064506,2267.264641896,-58
carcassonne-uct380-vs-uct5-1000its,799,857,2192.51305898,2129.679946362,-58
carcassonne-ucttuned160-vs-ucttuned225-1000its,799,857,2208.144489494,2157.609138758,-58
carcassonne-ucttuned235-vs-ucttuned440-1000its,799,857,2137.353677026,2141.121584037,-58
carcassonne-ucttuned285-vs-ucttuned375-1000its,799,857,2183.428996202,2182.773681761,-58
carcassonne-ucttuned160-vs-ucttuned120-1000its,806,864,2167.623454537,2110.999394811,-58
carcassonne-uct240-vs-uct130-1000its,807,865,2234.438761859,2168.384036762,-58
carcassonne-uct440-vs-uct320-1000its,811,869,2143.360525972,2118.091278458,-58
carcassonne-uct175-vs-uct140-1000its,812,870,2174.218517356,2121.434307151,-58
carcassonne-ucttuned315-vs-ucttuned200-1000its,814,872,2266.754471034,2181.353529991,-58
carcassonne-boltzmann175-vs-boltzmann420-1000its,815,873,2226.127993269,2220.270001542,-58
carcassonne-uct145-vs-uct55-1000its,815,873,2177.064165445,2138.101450889,-58
carcassonne-ucttuned460-vs-ucttuned495-1000its,815,873,2108.735786778,2068.007800862,-58
carcassonne-boltzmann20-vs-boltzmann395-1000its,816,874,2230.423633396,2196.353647289,-58
carcassonne-uct200-vs-uct475-1000its,818,876,2238.969865935,2199.51348173,-58
carcassonne-ucttuned65-vs-ucttuned25-1000its,819,877,2170.836365461,2116.890388097,-58
carcassonne-uct440-vs-uct60-1000its,820,878,2198.159869862,2192.570827781,-58
carcassonne-ucttuned245-vs-ucttuned265-1000its,821,879,2242.850230903,2208.154746811,-58
carcassonne-boltzmann45-vs-boltzmann65-1000its,823,881,2130.873940223,2088.376568281,-58
carcassonne-ucttuned440-vs-ucttuned260-1000its,824,882,2257.321253521,2200.207144224,-58
carcassonne-ucttuned160-vs-ucttuned335-1000its,827,885,2330.816996014,2304.120569196,-58
carcassonne-uct430-vs-uct325-1000its,832,890,2268.946103049,2236.919799155,-58
carcassonne-ucttuned325-vs-ucttuned395-1000its,833,891,2219.438180115,2186.563772092,-58
carcassonne-uct295-vs-uct10-1000its,835,893,2247.581308849,2220.663245426,-58
carcassonne-uct45-vs-uct130-1000its,835,893,2245.653857262,2196.898194854,-58
carcassonne-uct230-vs-uct35-1000its,836,894,2207.302337275,2147.250638426,-58
carcassonne-ucttuned120-vs-ucttuned30-1000its,840,898,2192.090318896,2195.916619885,-58
carcassonne-boltzmann90-vs-boltzmann445-1000its,842,900,2157.222327988,2115.08873199,-58
carcassonne-uct235-vs-uct30-1000its,844,902,2128.83097281,2112.057010022,-58
carcassonne-uct440-vs-uct10-1000its,848,906,2169.404102524,2103.771282941,-58
carcassonne-ucttuned480-vs-ucttuned475-1000its,857,915,2191.518854083,2182.004095644,-58
carcassonne-boltzmann400-vs-boltzmann60-1000its,858,916,2273.886798616,2225.651696417,-58
carcassonne-ucttuned110-vs-ucttuned45-1000its,860,918,2126.140964686,2073.313420835,-58
carcassonne-boltzmann165-vs-boltzmann40-1000its,667,724,2201.574909361,2134.073927854,-57
carcassonne-boltzmann120-vs-boltzmann10-1000its,699,756,2211.487643252,2178.378756512,-57
carcassonne-ucttuned230-vs-ucttuned420-1000its,706,763,2203.509944801,2148.984469337,-57
carcassonne-uct90-vs-uct430-1000its,709,766,2236.113622752,2190.907173735,-57
carcassonne-boltzmann85-vs-boltzmann145-1000its,715,772,2204.786835102,2177.252862623,-57
carcassonne-boltzmann210-vs-boltzmann375-1000its,720,777,2183.060390236,2129.88389338,-57
carcassonne-uct480-vs-uct490-1000its,721,778,2182.92181359,2141.811120525,-57
carcassonne-boltzmann290-vs-boltzmann40-1000its,722,779,2166.255717214,2121.485348548,-57
carcassonne-uct370-vs-uct125-1000its,723,780,2192.089654882,2166.340475046,-57
carcassonne-boltzmann295-vs-boltzmann95-1000its,727,784,2217.710956648,2169.091754898,-57
carcassonne-boltzmann310-vs-boltzmann330-1000its,729,786,2280.085640238,2247.057516874,-57
carcassonne-boltzmann455-vs-boltzmann30-1000its,731,788,2195.716508083,2121.738920672,-57
carcassonne-uct320-vs-uct355-1000its,731,788,2172.451024388,2147.629733067,-57
carcassonne-boltzmann450-vs-boltzmann95-1000its,732,789,2212.689292908,2185.54614313,-57
carcassonne-uct155-vs-uct200-1000its,732,789,2195.849648739,2186.127759767,-57
carcassonne-boltzmann295-vs-boltzmann455-1000its,736,793,2230.813088004,2174.916746714,-57
carcassonne-boltzmann445-vs-boltzmann105-1000its,736,793,2260.329365255,2208.284245537,-57
carcassonne-boltzmann280-vs-boltzmann195-1000its,737,794,2202.649766017,2126.603819968,-57
carcassonne-boltzmann25-vs-boltzmann455-1000its,738,795,2174.472413745,2076.042738142,-57
carcassonne-boltzmann200-vs-boltzmann335-1000its,739,796,2200.1388788,2120.104056488,-57
carcassonne-uct210-vs-uct40-1000its,739,796,2180.801076641,2133.878078073,-57
carcassonne-ucttuned450-vs-ucttuned270-1000its,739,796,2178.741033521,2155.386118981,-57
carcassonne-uct270-vs-uct135-1000its,740,797,2239.208635854,2167.176526648,-57
carcassonne-uct25-vs-uct75-1000its,743,800,2216.636031071,2192.941959999,-57
carcassonne-boltzmann300-vs-boltzmann355-1000its,746,803,2221.304882195,2180.034668255,-57
carcassonne-boltzmann165-vs-boltzmann460-1000its,748,805,2205.594158193,2197.240690874,-57
carcassonne-boltzmann245-vs-boltzmann160-1000its,748,805,2251.190994618,2185.473764095,-57
carcassonne-ucttuned280-vs-ucttuned40-1000its,749,806,2249.818159748,2184.544936434,-57
carcassonne-ucttuned85-vs-ucttuned65-1000its,750,807,2246.090154927,2192.571706044,-57
carcassonne-uct175-vs-uct330-1000its,751,808,2224.195460229,2192.718899641,-57
carcassonne-ucttuned115-vs-ucttuned450-1000its,751,808,2210.773500882,2126.13097985,-57
carcassonne-uct225-vs-uct290-1000its,753,810,2126.324843465,2109.771315997,-57
carcassonne-uct290-vs-uct140-1000its,755,812,2211.655408735,2171.459511198,-57
carcassonne-uct460-vs-uct230-1000its,755,812,2215.985536649,2123.581437577,-57
carcassonne-boltzmann145-vs-boltzmann345-1000its,758,815,2286.056946328,2267.029936244,-57
carcassonne-ucttuned235-vs-ucttuned290-1000its,759,816,2218.92457782,2218.70476907,-57
carcassonne-uct140-vs-uct350-1000its,761,818,2214.277749508,2198.364507422,-57
carcassonne-uct335-vs-uct415-1000its,761,818,2143.620978693,2137.575967043,-57
carcassonne-uct150-vs-uct170-1000its,763,820,2141.20497525,2107.982321252,-57
carcassonne-boltzmann395-vs-boltzmann400-1000its,765,822,2181.008085989,2171.280171876,-57
carcassonne-ucttuned370-vs-ucttuned315-1000its,766,823,2242.223914893,2202.438078544,-57
carcassonne-ucttuned405-vs-ucttuned430-1000its,768,825,2169.063474861,2089.542382538,-57
carcassonne-boltzmann25-vs-boltzmann335-1000its,770,827,2175.336766982,2111.523785958,-57
carcassonne-boltzmann410-vs-boltzmann200-1000its,772,829,2293.009361273,2271.111683821,-57
carcassonne-boltzmann140-vs-boltzmann490-1000its,775,832,2217.850976359,2168.377792701,-57
carcassonne-boltzmann320-vs-boltzmann490-1000its,777,834,2205.34833756,2181.298404184,-57
carcassonne-boltzmann270-vs-boltzmann325-1000its,778,835,2147.176733336,2128.118355715,-57
carcassonne-boltzmann275-vs-boltzmann155-1000its,778,835,2205.583878016,2170.079671209,-57
carcassonne-uct75-vs-uct240-1000its,779,836,2192.243384644,2128.804429541,-57
carcassonne-boltzmann430-vs-boltzmann420-1000its,781,838,2144.049161442,2141.283261299,-57
carcassonne-uct245-vs-uct140-1000its,783,840,2128.877377813,2126.054174069,-57
carcassonne-uct445-vs-uct5-1000its,783,840,2204.454553197,2167.448675081,-57
carcassonne-uct60-vs-uct100-1000its,785,842,2199.923099331,2152.252417663,-57
carcassonne-uct480-vs-uct20-1000its,789,846,2131.719404827,2091.424172811,-57
carcassonne-ucttuned240-vs-ucttuned290-1000its,792,849,2200.403138631,2216.633268971,-57
carcassonne-boltzmann210-vs-boltzmann400-1000its,793,850,2154.246612322,2091.012219627,-57
carcassonne-boltzmann75-vs-boltzmann100-1000its,793,850,2194.49806414,2170.708381511,-57
carcassonne-uct45-vs-uct475-1000its,794,851,2179.918623453,2143.861341589,-57
carcassonne-ucttuned320-vs-ucttuned140-1000its,794,851,2205.82988863,2191.131804195,-57
carcassonne-uct415-vs-uct340-1000its,795,852,2225.572236566,2164.363670125,-57
carcassonne-ucttuned275-vs-ucttuned345-1000its,795,852,2258.506255343,2232.768588851,-57
carcassonne-uct290-vs-uct230-1000its,796,853,2182.037272075,2134.167048786,-57
carcassonne-uct40-vs-uct95-1000its,796,853,2197.15165899,2135.250871747,-57
carcassonne-uct170-vs-uct280-1000its,798,855,2237.017071649,2134.797866038,-57
carcassonne-uct400-vs-uct270-1000its,799,856,2208.944134896,2196.295420249,-57
carcassonne-ucttuned45-vs-ucttuned370-1000its,799,856,2199.20321782,2155.656867348,-57
carcassonne-ucttuned440-vs-ucttuned220-1000its,800,857,2210.099875712,2161.004719019,-57
carcassonne-boltzmann405-vs-boltzmann350-1000its,801,858,2233.731004218,2130.264817488,-57
carcassonne-ucttuned180-vs-ucttuned40-1000its,801,858,2314.839347611,2283.991065026,-57
carcassonne-boltzmann280-vs-boltzmann10-1000its,802,859,2253.561787613,2214.490054413,-57
carcassonne-ucttuned300-vs-ucttuned255-1000its,802,859,2181.022785146,2083.904439438,-57
carcassonne-boltzmann195-vs-boltzmann200-1000its,810,867,2158.228426047,2085.433843096,-57
carcassonne-boltzmann50-vs-boltzmann420-1000its,814,871,2259.796515744,2226.779972765,-57
carcassonne-uct430-vs-uct300-1000its,815,872,2166.289908833,2116.913511439,-57
carcassonne-ucttuned140-vs-ucttuned260-1000its,815,872,2235.996826435,2206.801042158,-57
carcassonne-ucttuned360-vs-ucttuned310-1000its,817,874,2155.010242029,2091.2935345,-57
carcassonne-uct140-vs-uct240-1000its,818,875,2165.294412123,2170.364877021,-57
carcassonne-boltzmann470-vs-boltzmann455-1000its,819,876,2182.398129442,2132.956392718,-57
carcassonne-boltzmann370-vs-boltzmann30-1000its,820,877,2231.373809665,2183.853497615,-57
carcassonne-boltzmann470-vs-boltzmann10-1000its,820,877,2241.818034414,2198.80789026,-57
carcassonne-uct235-vs-uct25-1000its,822,879,2106.488909831,2075.967078471,-57
carcassonne-uct5-vs-uct160-1000its,822,879,2203.534887212,2164.697868051,-57
carcassonne-ucttuned295-vs-ucttuned470-1000its,823,880,2213.037104142,2165.729292628,-57
carcassonne-uct115-vs-uct15-1000its,826,883,2143.043099735,2111.273902885,-57
carcassonne-uct215-vs-uct100-1000its,827,884,2173.465819132,2102.787897704,-57
carcassonne-ucttuned110-vs-ucttuned150-1000its,831,888,2152.325224429,2135.813066859,-57
carcassonne-boltzmann470-vs-boltzmann375-1000its,833,890,2165.572208196,2154.915400741,-57
carcassonne-boltzmann230-vs-boltzmann5-1000its,835,892,2188.910695801,2160.988119142,-57
carcassonne-boltzmann80-vs-boltzmann305-1000its,835,892,2151.848281877,2117.313985581,-57
carcassonne-boltzmann280-vs-boltzmann15-1000its,838,895,2156.570142681,2155.893961522,-57
carcassonne-uct210-vs-uct230-1000its,841,898,2195.808579224,2142.270804548,-57
carcassonne-uct365-vs-uct280-1000its,843,900,2275.867914638,2209.324223937,-57
carcassonne-ucttuned195-vs-ucttuned45-1000its,849,906,2175.401746825,2170.853677369,-57
carcassonne-uct350-vs-uct445-1000its,850,907,2165.069652598,2143.095881533,-57
carcassonne-uct185-vs-uct425-1000its,852,909,2312.715696971,2276.911580389,-57
carcassonne-ucttuned380-vs-ucttuned445-1000its,856,913,2193.480314429,2135.810691009,-57
carcassonne-ucttuned325-vs-ucttuned225-1000its,865,922,2173.761332956,2093.772568687,-57
carcassonne-ucttuned480-vs-ucttuned195-1000its,878,935,2219.930411584,2192.315485002,-57
carcassonne-ucttuned390-vs-ucttuned170-1000its,625,681,1762.944475821,1765.162303052,-56
carcassonne-ucttuned150-vs-ucttuned180-1000its,700,756,2199.088852734,2124.118508156,-56
carcassonne-ucttuned290-vs-ucttuned145-1000its,712,768,2256.783157908,2238.871593185,-56
carcassonne-ucttuned50-vs-ucttuned355-1000its,715,771,2216.104869411,2206.58586149,-56
carcassonne-ucttuned105-vs-ucttuned70-1000its,717,773,2178.809768257,2157.362884007,-56
carcassonne-uct420-vs-uct20-1000its,720,776,2267.875132797,2223.206218014,-56
carcassonne-ucttuned300-vs-ucttuned225-1000its,725,781,2204.53739883,2116.164839532,-56
carcassonne-uct375-vs-uct55-1000its,726,782,2183.633341135,2150.478287693,-56
carcassonne-boltzmann220-vs-boltzmann145-1000its,729,785,2210.929344296,2164.154456523,-56
carcassonne-uct235-vs-uct275-1000its,735,791,2242.518610612,2152.945064153,-56
carcassonne-uct355-vs-uct350-1000its,736,792,2268.055858262,2217.33816766,-56
carcassonne-boltzmann150-vs-boltzmann50-1000its,737,793,2170.153947749,2155.192723897,-56
carcassonne-ucttuned385-vs-ucttuned120-1000its,737,793,2178.976573666,2126.649353702,-56
carcassonne-boltzmann160-vs-boltzmann205-1000its,742,798,2187.000425444,2135.928602788,-56
carcassonne-boltzmann195-vs-boltzmann240-1000its,742,798,2209.476894478,2120.477880913,-56
carcassonne-uct230-vs-uct85-1000its,743,799,2086.345158362,2097.593122714,-56
carcassonne-uct460-vs-uct310-1000its,745,801,2188.237853675,2154.333117394,-56
carcassonne-ucttuned235-vs-ucttuned180-1000its,745,801,2232.949964834,2189.644351387,-56
carcassonne-boltzmann155-vs-boltzmann240-1000its,748,804,2185.285457637,2062.352267265,-56
carcassonne-boltzmann50-vs-boltzmann185-1000its,748,804,2339.457488386,2270.221570024,-56
carcassonne-ucttuned120-vs-ucttuned50-1000its,749,805,2195.796117277,2168.733385653,-56
carcassonne-boltzmann370-vs-boltzmann265-1000its,750,806,2136.419378078,2100.745774379,-56
carcassonne-uct380-vs-uct210-1000its,750,806,2172.786791613,2154.098180757,-56
carcassonne-ucttuned105-vs-ucttuned315-1000its,750,806,2223.345324586,2127.057937219,-56
carcassonne-uct480-vs-uct315-1000its,751,807,2209.978061489,2183.968534571,-56
carcassonne-ucttuned195-vs-ucttuned15-1000its,751,807,2181.623712612,2158.979584739,-56
carcassonne-ucttuned400-vs-ucttuned395-1000its,753,809,2145.660587082,2113.265185282,-56
carcassonne-ucttuned85-vs-ucttuned15-1000its,753,809,2259.51204145,2258.775540589,-56
carcassonne-boltzmann115-vs-boltzmann90-1000its,755,811,2195.786675225,2145.65938193,-56
carcassonne-boltzmann275-vs-boltzmann15-1000its,756,812,2184.144905039,2208.280517175,-56
carcassonne-uct455-vs-uct360-1000its,756,812,2144.226125011,2130.218484962,-56
carcassonne-boltzmann295-vs-boltzmann15-1000its,757,813,2187.269440594,2100.340186181,-56
carcassonne-ucttuned95-vs-ucttuned245-1000its,757,813,2214.54512356,2156.315816263,-56
carcassonne-boltzmann140-vs-boltzmann45-1000its,758,814,2219.310586356,2171.69252451,-56
carcassonne-ucttuned235-vs-ucttuned475-1000its,758,814,2254.965969583,2180.05986317,-56
carcassonne-uct285-vs-uct405-1000its,761,817,2226.947896696,2171.79795275,-56
carcassonne-ucttuned380-vs-ucttuned150-1000its,761,817,2202.890237545,2190.475077965,-56
carcassonne-boltzmann400-vs-boltzmann185-1000its,762,818,2191.468309694,2110.959757924,-56
carcassonne-ucttuned90-vs-ucttuned410-1000its,764,820,2154.293270381,2142.711504896,-56
carcassonne-boltzmann55-vs-boltzmann180-1000its,765,821,2156.957307952,2139.409542515,-56
carcassonne-uct110-vs-uct95-1000its,765,821,2197.713441503,2180.562260134,-56
carcassonne-ucttuned475-vs-ucttuned50-1000its,765,821,2188.660722621,2134.033397033,-56
carcassonne-boltzmann395-vs-boltzmann415-1000its,767,823,2224.592094913,2183.691863658,-56
carcassonne-boltzmann40-vs-boltzmann5-1000its,767,823,2149.133448697,2179.023609398,-56
carcassonne-uct105-vs-uct255-1000its,768,824,2186.687780112,2128.195389985,-56
carcassonne-ucttuned360-vs-ucttuned55-1000its,768,824,2220.108317666,2178.538087966,-56
carcassonne-boltzmann315-vs-boltzmann455-1000its,770,826,2131.963776771,2122.516670534,-56
carcassonne-boltzmann330-vs-boltzmann230-1000its,770,826,2144.118056739,2134.520832275,-56
carcassonne-ucttuned5-vs-ucttuned370-1000its,771,827,2191.501423258,2129.333404105,-56
carcassonne-uct150-vs-uct255-1000its,772,828,2219.951388553,2211.460065571,-56
carcassonne-ucttuned285-vs-ucttuned210-1000its,772,828,2160.693894343,2104.425325264,-56
carcassonne-ucttuned330-vs-ucttuned220-1000its,772,828,2197.791005881,2138.336470592,-56
carcassonne-uct440-vs-uct210-1000its,774,830,2257.345111861,2226.573340794,-56
carcassonne-uct445-vs-uct20-1000its,775,831,2214.946825427,2137.573137598,-56
carcassonne-boltzmann345-vs-boltzmann335-1000its,777,833,2223.333650915,2173.50894203,-56
carcassonne-ucttuned370-vs-ucttuned365-1000its,777,833,2166.017437876,2091.588831578,-56
carcassonne-boltzmann150-vs-boltzmann15-1000its,778,834,2241.609793297,2198.17384019,-56
carcassonne-boltzmann10-vs-boltzmann25-1000its,779,835,2185.541662006,2082.387784758,-56
carcassonne-boltzmann450-vs-boltzmann115-1000its,779,835,2260.122123454,2145.548172038,-56
carcassonne-boltzmann485-vs-boltzmann190-1000its,779,835,2130.601898864,2095.860597845,-56
carcassonne-uct370-vs-uct315-1000its,780,836,2190.391514112,2139.752873307,-56
carcassonne-boltzmann390-vs-boltzmann165-1000its,782,838,2288.151073321,2247.370179583,-56
carcassonne-boltzmann105-vs-boltzmann285-1000its,783,839,2192.458738923,2136.136940711,-56
carcassonne-boltzmann390-vs-boltzmann140-1000its,783,839,2162.734969325,2152.277643287,-56
carcassonne-boltzmann370-vs-boltzmann225-1000its,784,840,2165.683565561,2136.647500366,-56
carcassonne-uct75-vs-uct175-1000its,784,840,2204.824664282,2140.579203757,-56
carcassonne-ucttuned410-vs-ucttuned245-1000its,785,841,2185.165308847,2135.695810427,-56
carcassonne-boltzmann45-vs-boltzmann180-1000its,787,843,2201.403925587,2211.028479984,-56
carcassonne-boltzmann380-vs-boltzmann125-1000its,788,844,2204.520839766,2148.605079765,-56
carcassonne-ucttuned260-vs-ucttuned45-1000its,788,844,2206.748386603,2185.123486861,-56
carcassonne-ucttuned175-vs-ucttuned155-1000its,789,845,2162.844165065,2151.866475023,-56
carcassonne-ucttuned485-vs-ucttuned5-1000its,789,845,2182.475101315,2135.73575124,-56
carcassonne-boltzmann115-vs-boltzmann145-1000its,790,846,2199.145199662,2113.922690809,-56
carcassonne-boltzmann240-vs-boltzmann230-1000its,791,847,2181.862422849,2159.519526556,-56
carcassonne-boltzmann295-vs-boltzmann40-1000its,792,848,2169.266863303,2117.056420684,-56
carcassonne-boltzmann335-vs-boltzmann315-1000its,792,848,2281.333886235,2218.546097562,-56
carcassonne-uct220-vs-uct55-1000its,795,851,2100.395068865,2088.658283673,-56
carcassonne-ucttuned85-vs-ucttuned145-1000its,795,851,2258.437958633,2225.553456964,-56
carcassonne-ucttuned30-vs-ucttuned435-1000its,796,852,2185.50830068,2118.311999118,-56
carcassonne-boltzmann25-vs-boltzmann10-1000its,799,855,2201.268012104,2177.210733463,-56
carcassonne-boltzmann295-vs-boltzmann330-1000its,799,855,2183.467234347,2175.356497778,-56
carcassonne-ucttuned455-vs-ucttuned495-1000its,799,855,2258.720053447,2193.468283042,-56
carcassonne-boltzmann405-vs-boltzmann220-1000its,800,856,2203.027081658,2103.523203777,-56
carcassonne-ucttuned230-vs-ucttuned60-1000its,801,857,2172.410686601,2155.613106418,-56
carcassonne-ucttuned350-vs-ucttuned345-1000its,803,859,2247.564307058,2212.211284242,-56
carcassonne-ucttuned275-vs-ucttuned420-1000its,804,860,2124.458634933,2096.953005482,-56
carcassonne-ucttuned60-vs-ucttuned130-1000its,807,863,2121.950443119,2110.5114935,-56
carcassonne-uct130-vs-uct60-1000its,808,864,2141.097893384,2141.614843139,-56
carcassonne-uct435-vs-uct440-1000its,808,864,2259.101479501,2198.347079503,-56
carcassonne-uct415-vs-uct75-1000its,809,865,2169.44431991,2157.604962581,-56
carcassonne-boltzmann165-vs-boltzmann230-1000its,810,866,2254.849655965,2216.159835173,-56
carcassonne-uct260-vs-uct55-1000its,812,868,2287.394799333,2201.95411381,-56
carcassonne-uct300-vs-uct115-1000its,813,869,2187.458782451,2172.938136405,-56
carcassonne-uct400-vs-uct250-1000its,813,869,2225.9342416,2243.68321815,-56
carcassonne-ucttuned345-vs-ucttuned435-1000its,821,877,2279.805771084,2243.630733934,-56
carcassonne-ucttuned70-vs-ucttuned60-1000its,821,877,2146.543733544,2143.890451976,-56
carcassonne-boltzmann35-vs-boltzmann180-1000its,825,881,2247.674122501,2182.162561886,-56
carcassonne-ucttuned140-vs-ucttuned10-1000its,825,881,2221.116994849,2228.24878899,-56
carcassonne-ucttuned220-vs-ucttuned30-1000its,825,881,2220.837301191,2149.600600829,-56
carcassonne-boltzmann190-vs-boltzmann370-1000its,827,883,2160.742869123,2118.513475629,-56
carcassonne-boltzmann195-vs-boltzmann360-1000its,828,884,2235.987788076,2156.33963927,-56
carcassonne-uct205-vs-uct280-1000its,834,890,2168.188315604,2125.873269983,-56
carcassonne-boltzmann190-vs-boltzmann410-1000its,853,909,2277.40313342,2214.63853442,-56
carcassonne-boltzmann110-vs-boltzmann145-1000its,856,912,2148.706453063,2131.011157573,-56
carcassonne-uct310-vs-uct245-1000its,856,912,2133.084123527,2087.964195536,-56
carcassonne-uct305-vs-uct360-1000its,860,916,2229.861271941,2168.511382961,-56
carcassonne-boltzmann110-vs-boltzmann35-1000its,889,945,2184.655248663,2153.621607429,-56
carcassonne-boltzmann275-vs-boltzmann170-1000its,893,949,2202.506948202,2184.631027654,-56
carcassonne-boltzmann280-vs-boltzmann445-1000its,896,952,2262.080451258,2221.447041988,-56
carcassonne-boltzmann320-vs-boltzmann420-1000its,637,692,1711.147003457,1666.742676019,-55
carcassonne-ucttuned420-vs-ucttuned385-1000its,707,762,2206.38767606,2150.931632655,-55
carcassonne-ucttuned80-vs-ucttuned140-1000its,714,769,2224.387272764,2167.637462064,-55
carcassonne-uct235-vs-uct460-1000its,717,772,2140.834027834,2123.006727864,-55
carcassonne-uct225-vs-uct205-1000its,722,777,2203.495278532,2142.762603621,-55
carcassonne-uct95-vs-uct435-1000its,725,780,2187.663905196,2121.521012785,-55
carcassonne-ucttuned175-vs-ucttuned330-1000its,725,780,2220.069767525,2149.786069328,-55
carcassonne-uct225-vs-uct335-1000its,726,781,2247.401320689,2176.168762223,-55
carcassonne-boltzmann35-vs-boltzmann235-1000its,729,784,2225.625712238,2105.914903085,-55
carcassonne-uct425-vs-uct260-1000its,729,784,2190.672908871,2189.408140291,-55
carcassonne-uct105-vs-uct455-1000its,730,785,2210.180130412,2195.364634287,-55
carcassonne-uct205-vs-uct485-1000its,732,787,2229.345697212,2130.818069573,-55
carcassonne-boltzmann305-vs-boltzmann85-1000its,733,788,2184.845166523,2175.086177345,-55
carcassonne-uct365-vs-uct370-1000its,734,789,2199.421501772,2186.27734261,-55
carcassonne-boltzmann200-vs-boltzmann465-1000its,736,791,2127.827236712,2064.91691641,-55
carcassonne-boltzmann260-vs-boltzmann425-1000its,736,791,2143.30770396,2051.390601812,-55
carcassonne-boltzmann320-vs-boltzmann355-1000its,741,796,2205.628492028,2165.829156802,-55
carcassonne-ucttuned45-vs-ucttuned465-1000its,744,799,2223.173458299,2125.270415488,-55
carcassonne-boltzmann100-vs-boltzmann420-1000its,745,800,2189.751758859,2137.731035288,-55
carcassonne-uct330-vs-uct240-1000its,745,800,2189.721408003,2131.759587542,-55
carcassonne-boltzmann135-vs-boltzmann335-1000its,748,803,2187.321537937,2173.825502337,-55
carcassonne-boltzmann320-vs-boltzmann180-1000its,749,804,2194.120216141,2149.034853444,-55
carcassonne-boltzmann180-vs-boltzmann25-1000its,750,805,2210.436653508,2160.734005552,-55
carcassonne-ucttuned485-vs-ucttuned465-1000its,750,805,2175.674001419,2144.851242139,-55
carcassonne-boltzmann465-vs-boltzmann10-1000its,752,807,2197.075296065,2171.182175603,-55
carcassonne-boltzmann75-vs-boltzmann380-1000its,752,807,2134.488231005,2126.989372477,-55
carcassonne-ucttuned250-vs-ucttuned305-1000its,752,807,2211.920027294,2150.342087237,-55
carcassonne-uct360-vs-uct165-1000its,755,810,2237.21103792,2162.411892055,-55
carcassonne-boltzmann250-vs-boltzmann120-1000its,756,811,2238.109471754,2173.845852954,-55
carcassonne-boltzmann220-vs-boltzmann290-1000its,757,812,2170.27003522,2167.735353232,-55
carcassonne-boltzmann35-vs-boltzmann75-1000its,757,812,2240.247579748,2168.197524709,-55
carcassonne-uct275-vs-uct420-1000its,757,812,2205.259854959,2167.189742141,-55
carcassonne-uct125-vs-uct275-1000its,763,818,2277.698005075,2286.473585491,-55
carcassonne-uct175-vs-uct315-1000its,764,819,2218.59479899,2154.673437373,-55
carcassonne-uct90-vs-uct355-1000its,764,819,2228.020825783,2170.194303979,-55
carcassonne-ucttuned385-vs-ucttuned40-1000its,765,820,2165.291300925,2174.88735485,-55
carcassonne-uct330-vs-uct490-1000its,766,821,2086.806331664,2104.270187925,-55
carcassonne-ucttuned445-vs-ucttuned230-1000its,766,821,2226.793459465,2203.927854694,-55
carcassonne-ucttuned375-vs-ucttuned345-1000its,767,822,2210.800899513,2171.006483674,-55
carcassonne-uct410-vs-uct330-1000its,768,823,2221.040442133,2179.090515528,-55
carcassonne-ucttuned475-vs-ucttuned180-1000its,768,823,2258.494018113,2225.070778318,-55
carcassonne-ucttuned390-vs-ucttuned50-1000its,771,826,2252.151469583,2200.550343189,-55
carcassonne-ucttuned430-vs-ucttuned350-1000its,771,826,2211.051062606,2211.644104682,-55
carcassonne-uct475-vs-uct85-1000its,774,829,2193.78748161,2145.802846306,-55
carcassonne-uct60-vs-uct385-1000its,775,830,2300.541655376,2265.317432612,-55
carcassonne-ucttuned355-vs-ucttuned295-1000its,777,832,2138.613552618,2128.168592557,-55
carcassonne-uct435-vs-uct455-1000its,778,833,2174.954653216,2132.006261504,-55
carcassonne-ucttuned370-vs-ucttuned345-1000its,778,833,2172.671820038,2121.894848378,-55
carcassonne-ucttuned40-vs-ucttuned365-1000its,778,833,2146.6628067,2103.607491522,-55
carcassonne-boltzmann440-vs-boltzmann70-1000its,779,834,2189.680386713,2139.002849897,-55
carcassonne-boltzmann10-vs-boltzmann220-1000its,780,835,2274.86004706,2230.374198514,-55
carcassonne-boltzmann110-vs-boltzmann325-1000its,780,835,2273.854208049,2178.174425692,-55
carcassonne-boltzmann415-vs-boltzmann130-1000its,780,835,2140.507936783,2073.617992165,-55
carcassonne-boltzmann240-vs-boltzmann55-1000its,781,836,2177.051121221,2122.022152236,-55
carcassonne-uct125-vs-uct385-1000its,781,836,2252.49679083,2218.869178141,-55
carcassonne-ucttuned25-vs-ucttuned395-1000its,781,836,2222.382570946,2177.646712845,-55
carcassonne-uct120-vs-uct365-1000its,782,837,2311.242643294,2213.810388393,-55
carcassonne-ucttuned180-vs-ucttuned215-1000its,785,840,2161.620451691,2110.328966173,-55
carcassonne-ucttuned115-vs-ucttuned170-1000its,786,841,2265.251243509,2223.577943175,-55
carcassonne-boltzmann115-vs-boltzmann315-1000its,787,842,2189.543814828,2185.958146465,-55
carcassonne-boltzmann415-vs-boltzmann160-1000its,787,842,2202.628501473,2126.633900765,-55
carcassonne-uct200-vs-uct285-1000its,787,842,2164.90978359,2097.098823092,-55
carcassonne-boltzmann320-vs-boltzmann405-1000its,788,843,2201.242484008,2155.507836749,-55
carcassonne-boltzmann50-vs-boltzmann480-1000its,788,843,2203.32412111,2120.760284388,-55
carcassonne-uct215-vs-uct265-1000its,788,843,2127.401100607,2083.554713219,-55
carcassonne-uct105-vs-uct65-1000its,791,846,2235.662906744,2177.6413502,-55
carcassonne-ucttuned175-vs-ucttuned110-1000its,791,846,2186.060543178,2146.965858452,-55
carcassonne-uct205-vs-uct20-1000its,793,848,2267.091428651,2218.062773155,-55
carcassonne-boltzmann485-vs-boltzmann310-1000its,794,849,2206.908767435,2180.143258482,-55
carcassonne-uct470-vs-uct255-1000its,794,849,2133.742322715,2105.759081902,-55
carcassonne-ucttuned80-vs-ucttuned430-1000its,796,851,2150.725767434,2083.98264679,-55
carcassonne-uct275-vs-uct250-1000its,798,853,2209.194091643,2133.627467861,-55
carcassonne-uct120-vs-uct85-1000its,799,854,2181.27609638,2164.092368847,-55
carcassonne-ucttuned210-vs-ucttuned460-1000its,799,854,2246.922820613,2189.497289751,-55
carcassonne-boltzmann245-vs-boltzmann290-1000its,800,855,2161.09091906,2094.74889106,-55
carcassonne-boltzmann45-vs-boltzmann445-1000its,800,855,2231.310461574,2142.531688063,-55
carcassonne-boltzmann360-vs-boltzmann180-1000its,801,856,2242.677009911,2203.635775825,-55
carcassonne-uct475-vs-uct455-1000its,802,857,2238.574812263,2159.622392722,-55
carcassonne-boltzmann210-vs-boltzmann365-1000its,803,858,2287.732922274,2231.467023361,-55
carcassonne-uct405-vs-uct290-1000its,803,858,2196.520435588,2190.01097992,-55
carcassonne-boltzmann265-vs-boltzmann115-1000its,804,859,2252.039136597,2219.54463192,-55
carcassonne-boltzmann195-vs-boltzmann140-1000its,805,860,2246.076533589,2205.238709925,-55
carcassonne-boltzmann320-vs-boltzmann200-1000its,805,860,2260.877966193,2184.562985238,-55
carcassonne-boltzmann495-vs-boltzmann355-1000its,805,860,2169.607204376,2092.055843902,-55
carcassonne-uct280-vs-uct165-1000its,805,860,2234.249685652,2215.430184754,-55
carcassonne-ucttuned235-vs-ucttuned50-1000its,805,860,2218.161372293,2189.747795499,-55
carcassonne-boltzmann150-vs-boltzmann300-1000its,808,863,2178.654724563,2129.091218655,-55
carcassonne-boltzmann175-vs-boltzmann200-1000its,808,863,2213.23267851,2183.378597653,-55
carcassonne-ucttuned160-vs-ucttuned180-1000its,808,863,2155.507514231,2115.90474516,-55
carcassonne-boltzmann140-vs-boltzmann150-1000its,810,865,2250.875033112,2172.54848663,-55
carcassonne-boltzmann230-vs-boltzmann205-1000its,811,866,2122.716026724,2097.071871119,-55
carcassonne-ucttuned90-vs-ucttuned75-1000its,813,868,2175.233912814,2108.653753643,-55
carcassonne-uct65-vs-uct40-1000its,815,870,2212.69960618,2156.105544285,-55
carcassonne-ucttuned160-vs-ucttuned75-1000its,817,872,2224.582376815,2161.145149038,-55
carcassonne-uct260-vs-uct380-1000its,818,873,2114.952870064,2111.584858913,-55
carcassonne-boltzmann75-vs-boltzmann240-1000its,819,874,2254.00847045,2194.813708937,-55
carcassonne-ucttuned195-vs-ucttuned295-1000its,820,875,2158.629204869,2113.971121226,-55
carcassonne-uct345-vs-uct250-1000its,823,878,2226.990497781,2170.16653725,-55
carcassonne-uct95-vs-uct190-1000its,826,881,2202.941499192,2141.537623623,-55
carcassonne-uct230-vs-uct255-1000its,828,883,2189.426025491,2138.545159218,-55
carcassonne-ucttuned135-vs-ucttuned105-1000its,833,888,2255.604666935,2224.785016909,-55
carcassonne-uct470-vs-uct485-1000its,836,891,2168.40511278,2136.975921852,-55
carcassonne-boltzmann235-vs-boltzmann260-1000its,837,892,2198.831015283,2157.172740466,-55
carcassonne-uct105-vs-uct440-1000its,839,894,2185.617970124,2143.836104695,-55
carcassonne-boltzmann480-vs-boltzmann415-1000its,840,895,2179.035568707,2155.538142561,-55
carcassonne-ucttuned65-vs-ucttuned5-1000its,844,899,2227.597967238,2159.865896803,-55
carcassonne-uct210-vs-uct365-1000its,848,903,2207.33696706,2173.043214286,-55
carcassonne-ucttuned130-vs-ucttuned250-1000its,856,911,2193.407666833,2166.436621434,-55
carcassonne-boltzmann490-vs-boltzmann5-1000its,858,913,2126.589739187,2108.421184077,-55
carcassonne-ucttuned345-vs-ucttuned300-1000its,874,929,2199.685282465,2153.728187348,-55
carcassonne-boltzmann410-vs-boltzmann25-1000its,877,932,2189.317920397,2141.791345473,-55
carcassonne-boltzmann495-vs-boltzmann135-1000its,893,948,2227.359890942,2177.309847021,-55
carcassonne-boltzmann100-vs-boltzmann210-1000its,670,724,2118.280479886,2139.852514334,-54
carcassonne-uct100-vs-uct50-1000its,693,747,2174.189873823,2139.943810264,-54
carcassonne-ucttuned360-vs-ucttuned275-1000its,701,755,2182.49638655,2169.760953635,-54
carcassonne-boltzmann375-vs-boltzmann295-1000its,702,756,2208.554871298,2148.868902365,-54
carcassonne-boltzmann95-vs-boltzmann425-1000its,707,761,2152.693210287,2103.981592828,-54
carcassonne-boltzmann240-vs-boltzmann340-1000its,712,766,2186.071563942,2112.770120532,-54
carcassonne-ucttuned125-vs-ucttuned340-1000its,713,767,2216.391937085,2179.56145309,-54
carcassonne-boltzmann455-vs-boltzmann395-1000its,729,783,2170.335017979,2150.762431139,-54
carcassonne-uct160-vs-uct325-1000its,734,788,2232.246641878,2182.438929703,-54
carcassonne-uct180-vs-uct35-1000its,734,788,2238.031590038,2239.334638378,-54
carcassonne-ucttuned175-vs-ucttuned70-1000its,740,794,2164.745996934,2135.404856278,-54
carcassonne-boltzmann420-vs-boltzmann5-1000its,742,796,2181.170245057,2126.816855835,-54
carcassonne-boltzmann65-vs-boltzmann220-1000its,743,797,2215.689551531,2158.41760898,-54
carcassonne-uct160-vs-uct175-1000its,743,797,2170.344053654,2110.075809425,-54
carcassonne-ucttuned370-vs-ucttuned310-1000its,750,804,2266.062262906,2206.080660961,-54
carcassonne-boltzmann335-vs-boltzmann310-1000its,751,805,2174.521050707,2156.248165257,-54
carcassonne-boltzmann125-vs-boltzmann230-1000its,752,806,2186.243065073,2196.078058862,-54
carcassonne-boltzmann30-vs-boltzmann275-1000its,752,806,2165.460851039,2108.599716036,-54
carcassonne-boltzmann395-vs-boltzmann340-1000its,752,806,2188.786797835,2163.332272836,-54
carcassonne-ucttuned255-vs-ucttuned300-1000its,752,806,2262.765410201,2259.359597089,-54
carcassonne-boltzmann50-vs-boltzmann145-1000its,753,807,2224.159260659,2183.910593692,-54
carcassonne-ucttuned205-vs-ucttuned225-1000its,753,807,2129.727914345,2144.364029317,-54
carcassonne-boltzmann275-vs-boltzmann270-1000its,754,808,2250.29714077,2210.198308935,-54
carcassonne-ucttuned180-vs-ucttuned330-1000its,754,808,2202.783644907,2168.748950868,-54
carcassonne-ucttuned240-vs-ucttuned125-1000its,755,809,2214.596768538,2222.792955392,-54
carcassonne-uct310-vs-uct25-1000its,756,810,2189.962056552,2159.574885858,-54
carcassonne-ucttuned365-vs-ucttuned375-1000its,759,813,2201.844852355,2134.761139467,-54
carcassonne-boltzmann245-vs-boltzmann155-1000its,760,814,2207.459059167,2178.122851508,-54
carcassonne-ucttuned135-vs-ucttuned305-1000its,761,815,2187.679398643,2167.641662101,-54
carcassonne-uct55-vs-uct485-1000its,762,816,2196.953757303,2145.855826793,-54
carcassonne-uct90-vs-uct190-1000its,762,816,2162.784413332,2122.456865367,-54
carcassonne-boltzmann400-vs-boltzmann405-1000its,765,819,2286.298728842,2253.378221747,-54
carcassonne-ucttuned320-vs-ucttuned360-1000its,767,821,2168.242532371,2122.954674875,-54
carcassonne-ucttuned230-vs-ucttuned400-1000its,768,822,2159.244661167,2144.115014499,-54
carcassonne-uct130-vs-uct220-1000its,769,823,2169.675445187,2139.207187535,-54
carcassonne-ucttuned350-vs-ucttuned90-1000its,769,823,2142.78104622,2131.650793659,-54
carcassonne-uct420-vs-uct490-1000its,770,824,2248.541756059,2194.25581023,-54
carcassonne-boltzmann430-vs-boltzmann490-1000its,772,826,2155.382723705,2085.454739802,-54
carcassonne-boltzmann110-vs-boltzmann315-1000its,773,827,2329.623539686,2285.962235499,-54
carcassonne-boltzmann335-vs-boltzmann35-1000its,773,827,2216.688265204,2192.984978252,-54
carcassonne-uct440-vs-uct350-1000its,774,828,2179.125446458,2178.69855015,-54
carcassonne-ucttuned325-vs-ucttuned420-1000its,774,828,2252.066835041,2222.53983379,-54
carcassonne-uct65-vs-uct335-1000its,775,829,2207.634637112,2172.246749221,-54
carcassonne-uct375-vs-uct200-1000its,776,830,2197.311809054,2124.113068669,-54
carcassonne-ucttuned115-vs-ucttuned355-1000its,776,830,2215.619343349,2157.659979305,-54
carcassonne-boltzmann200-vs-boltzmann425-1000its,777,831,2233.685846863,2223.950347127,-54
carcassonne-ucttuned315-vs-ucttuned60-1000its,778,832,2154.962178521,2133.586838418,-54
carcassonne-boltzmann35-vs-boltzmann250-1000its,784,838,2210.106522648,2155.704443399,-54
carcassonne-boltzmann375-vs-boltzmann185-1000its,784,838,2149.532863187,2100.130400841,-54
carcassonne-ucttuned405-vs-ucttuned230-1000its,785,839,2125.795129755,2125.65239443,-54
carcassonne-boltzmann385-vs-boltzmann325-1000its,787,841,2177.077603472,2129.16092791,-54
carcassonne-uct425-vs-uct235-1000its,787,841,2199.084611853,2145.48570049,-54
carcassonne-ucttuned350-vs-ucttuned175-1000its,789,843,2204.151505389,2170.316731233,-54
carcassonne-ucttuned365-vs-ucttuned250-1000its,790,844,2185.893922443,2181.486506362,-54
carcassonne-ucttuned245-vs-ucttuned445-1000its,792,846,2178.40287009,2116.68716917,-54
carcassonne-ucttuned385-vs-ucttuned275-1000its,792,846,2210.390390336,2149.297371153,-54
carcassonne-boltzmann450-vs-boltzmann375-1000its,793,847,2159.925139504,2136.836790402,-54
carcassonne-boltzmann30-vs-boltzmann50-1000its,795,849,2190.103983274,2158.459846493,-54
carcassonne-boltzmann450-vs-boltzmann385-1000its,795,849,2207.012405151,2135.80304625,-54
carcassonne-ucttuned240-vs-ucttuned15-1000its,796,850,2255.198848783,2222.827394659,-54
carcassonne-ucttuned180-vs-ucttuned455-1000its,798,852,2165.650393689,2115.924933546,-54
carcassonne-uct245-vs-uct370-1000its,799,853,2215.641486923,2219.7442592,-54
carcassonne-ucttuned145-vs-ucttuned80-1000its,799,853,2194.245475071,2128.55304898,-54
carcassonne-boltzmann50-vs-boltzmann90-1000its,800,854,2171.611400485,2126.539527326,-54
carcassonne-boltzmann210-vs-boltzmann120-1000its,804,858,2158.462135001,2135.073267564,-54
carcassonne-uct220-vs-uct190-1000its,806,860,2160.03797651,2100.316673722,-54
carcassonne-uct25-vs-uct255-1000its,806,860,2234.477826052,2210.155658788,-54
carcassonne-ucttuned355-vs-ucttuned70-1000its,808,862,2195.331328735,2157.501208817,-54
carcassonne-uct130-vs-uct40-1000its,810,864,2124.70928697,2089.148412413,-54
carcassonne-boltzmann235-vs-boltzmann15-1000its,811,865,2162.962353206,2156.645884964,-54
carcassonne-uct175-vs-uct390-1000its,812,866,2244.364124442,2174.010395647,-54
carcassonne-ucttuned190-vs-ucttuned155-1000its,812,866,2140.641046505,2080.626891166,-54
carcassonne-uct300-vs-uct245-1000its,814,868,2253.663299814,2214.203861965,-54
carcassonne-uct405-vs-uct320-1000its,816,870,2190.813188416,2130.758862454,-54
carcassonne-uct455-vs-uct190-1000its,817,871,2231.768529093,2181.431679394,-54
carcassonne-uct325-vs-uct490-1000its,818,872,2187.341868158,2100.192382195,-54
carcassonne-boltzmann170-vs-boltzmann110-1000its,819,873,2160.258484869,2120.462412713,-54
carcassonne-ucttuned45-vs-ucttuned80-1000its,819,873,2229.055435034,2152.46328152,-54
carcassonne-uct245-vs-uct300-1000its,820,874,2247.921345342,2244.009617425,-54
carcassonne-uct425-vs-uct5-1000its,820,874,2194.031400977,2197.58233703,-54
carcassonne-boltzmann370-vs-boltzmann10-1000its,828,882,2204.142566385,2120.634384389,-54
carcassonne-uct480-vs-uct440-1000its,828,882,2179.143372369,2202.919164557,-54
carcassonne-uct145-vs-uct435-1000its,829,883,2257.11497665,2211.835900978,-54
carcassonne-ucttuned160-vs-ucttuned195-1000its,830,884,2154.152572035,2151.985388412,-54
carcassonne-boltzmann255-vs-boltzmann115-1000its,831,885,2228.630135244,2177.33183669,-54
carcassonne-ucttuned70-vs-ucttuned25-1000its,831,885,2224.814341402,2197.407185049,-54
carcassonne-uct120-vs-uct80-1000its,833,887,2197.926095834,2195.954980886,-54
carcassonne-boltzmann475-vs-boltzmann295-1000its,834,888,2269.168109514,2192.55107898,-54
carcassonne-uct345-vs-uct310-1000its,836,890,2157.201595309,2116.491505392,-54
carcassonne-ucttuned470-vs-ucttuned160-1000its,836,890,2150.619995534,2080.497702798,-54
carcassonne-uct390-vs-uct10-1000its,841,895,2189.648855965,2175.384141569,-54
carcassonne-ucttuned365-vs-ucttuned45-1000its,842,896,2161.145477452,2085.890138069,-54
carcassonne-boltzmann320-vs-boltzmann360-1000its,844,898,2190.393703515,2150.245696452,-54
carcassonne-uct200-vs-uct125-1000its,844,898,2220.150564516,2175.755008135,-54
carcassonne-uct25-vs-uct430-1000its,847,901,2206.616626608,2171.054295403,-54
carcassonne-uct125-vs-uct445-1000its,849,903,2111.799083924,2110.892608038,-54
carcassonne-boltzmann280-vs-boltzmann110-1000its,851,905,2267.28126789,2185.646252149,-54
carcassonne-ucttuned25-vs-ucttuned70-1000its,852,906,2219.202140344,2143.941032199,-54
carcassonne-uct75-vs-uct50-1000its,853,907,2136.818554316,2114.7030076,-54
carcassonne-uct315-vs-uct15-1000its,858,912,2102.973905674,2070.795134379,-54
carcassonne-ucttuned395-vs-ucttuned50-1000its,862,916,2251.803269498,2212.74642372,-54
carcassonne-ucttuned20-vs-ucttuned35-1000its,867,921,2185.060980995,2140.415225553,-54
carcassonne-boltzmann250-vs-boltzmann95-1000its,876,930,2113.859714736,2127.58775817,-54
carcassonne-ucttuned65-vs-ucttuned115-1000its,878,932,2183.677894911,2129.884495503,-54
carcassonne-ucttuned15-vs-ucttuned220-1000its,885,939,2264.099016844,2239.153158071,-54
carcassonne-ucttuned65-vs-ucttuned405-1000its,893,947,2139.630876378,2142.589096721,-54
carcassonne-uct115-vs-uct475-1000its,901,955,2187.904347667,2167.370370685,-54
carcassonne-boltzmann355-vs-boltzmann455-1000its,682,735,2146.562670582,2147.427891392,-53
carcassonne-ucttuned120-vs-ucttuned375-1000its,686,739,2207.607456933,2141.794826661,-53
carcassonne-boltzmann395-vs-boltzmann70-1000its,689,742,2214.680775269,2147.928425404,-53
carcassonne-boltzmann385-vs-boltzmann35-1000its,701,754,2152.547452257,2081.425402356,-53
carcassonne-boltzmann220-vs-boltzmann390-1000its,705,758,2223.107698025,2178.752574118,-53
carcassonne-ucttuned175-vs-ucttuned375-1000its,707,760,2217.627308226,2198.046448202,-53
carcassonne-boltzmann260-vs-boltzmann495-1000its,719,772,2213.903214684,2185.945167213,-53
carcassonne-boltzmann135-vs-boltzmann360-1000its,720,773,2161.979143439,2132.109385851,-53
carcassonne-boltzmann200-vs-boltzmann325-1000its,720,773,2216.6637839,2188.517624717,-53
carcassonne-uct405-vs-uct225-1000its,720,773,2204.355503606,2135.61547263,-53
carcassonne-ucttuned455-vs-ucttuned370-1000its,721,774,2151.207869354,2143.301847364,-53
carcassonne-ucttuned290-vs-ucttuned120-1000its,726,779,2155.443119618,2128.575849427,-53
carcassonne-ucttuned125-vs-ucttuned200-1000its,728,781,2250.730319086,2213.678106378,-53
carcassonne-boltzmann225-vs-boltzmann170-1000its,729,782,2237.03708752,2194.413745033,-53
carcassonne-uct420-vs-uct440-1000its,733,786,2200.125764696,2122.231354839,-53
carcassonne-uct80-vs-uct10-1000its,734,787,2168.828373373,2118.547789016,-53
carcassonne-ucttuned195-vs-ucttuned335-1000its,734,787,2164.10406394,2103.505563138,-53
carcassonne-boltzmann250-vs-boltzmann35-1000its,735,788,2140.596162246,2108.092079358,-53
carcassonne-ucttuned65-vs-ucttuned310-1000its,735,788,2189.87227342,2106.881121963,-53
carcassonne-boltzmann370-vs-boltzmann375-1000its,739,792,2176.555672796,2139.285130201,-53
carcassonne-uct235-vs-uct225-1000its,740,793,2179.264699227,2110.293099081,-53
carcassonne-boltzmann250-vs-boltzmann150-1000its,741,794,2238.754035566,2155.299731814,-53
carcassonne-boltzmann385-vs-boltzmann100-1000its,742,795,2214.566781295,2180.126181883,-53
carcassonne-boltzmann20-vs-boltzmann300-1000its,744,797,2164.509535866,2189.794094901,-53
carcassonne-boltzmann370-vs-boltzmann435-1000its,744,797,2164.240941216,2088.922051673,-53
carcassonne-boltzmann260-vs-boltzmann300-1000its,745,798,2172.901699325,2124.668685326,-53
carcassonne-ucttuned145-vs-ucttuned210-1000its,745,798,2139.133621687,2135.69834925,-53
carcassonne-boltzmann140-vs-boltzmann5-1000its,748,801,2187.173955025,2077.37938843,-53
carcassonne-boltzmann70-vs-boltzmann55-1000its,749,802,2221.908037524,2204.545352407,-53
carcassonne-uct110-vs-uct80-1000its,749,802,2166.823018178,2172.195353455,-53
carcassonne-boltzmann55-vs-boltzmann230-1000its,750,803,2144.384656128,2136.33465579,-53
carcassonne-boltzmann80-vs-boltzmann165-1000its,750,803,2219.638533733,2104.817583414,-53
carcassonne-ucttuned240-vs-ucttuned95-1000its,750,803,2151.918737977,2124.366220159,-53
carcassonne-uct135-vs-uct355-1000its,751,804,2168.966741456,2116.202565547,-53
carcassonne-boltzmann325-vs-boltzmann145-1000its,752,805,2191.125455232,2114.887191979,-53
carcassonne-boltzmann375-vs-boltzmann5-1000its,752,805,2150.301111305,2114.989531368,-53
carcassonne-uct465-vs-uct360-1000its,753,806,2240.001386893,2172.690723382,-53
carcassonne-ucttuned405-vs-ucttuned470-1000its,753,806,2205.580995011,2122.571400206,-53
carcassonne-ucttuned310-vs-ucttuned80-1000its,754,807,2228.601937938,2204.796345346,-53
carcassonne-boltzmann195-vs-boltzmann305-1000its,755,808,2108.304861199,2090.378663238,-53
carcassonne-uct5-vs-uct440-1000its,755,808,2198.938947281,2143.492524974,-53
carcassonne-ucttuned325-vs-ucttuned275-1000its,755,808,2151.988307064,2151.020840714,-53
carcassonne-ucttuned60-vs-ucttuned245-1000its,755,808,2189.893022647,2131.429066027,-53
carcassonne-boltzmann80-vs-boltzmann375-1000its,756,809,2163.113247199,2151.110454929,-53
carcassonne-ucttuned245-vs-ucttuned120-1000its,756,809,2147.520393143,2141.686349484,-53
carcassonne-ucttuned165-vs-ucttuned280-1000its,758,811,2263.293636333,2170.268906351,-53
carcassonne-ucttuned370-vs-ucttuned405-1000its,758,811,2271.328160405,2219.083891049,-53
carcassonne-boltzmann180-vs-boltzmann55-1000its,759,812,2152.226937613,2142.704955207,-53
carcassonne-uct470-vs-uct340-1000its,759,812,2135.990824733,2130.081744931,-53
carcassonne-ucttuned335-vs-ucttuned45-1000its,759,812,2124.749921552,2073.191582438,-53
carcassonne-boltzmann380-vs-boltzmann200-1000its,760,813,2214.643279229,2159.287101139,-53
carcassonne-uct450-vs-uct415-1000its,761,814,2206.825857409,2137.38523099,-53
carcassonne-boltzmann270-vs-boltzmann100-1000its,765,818,2195.77349542,2163.904602795,-53
carcassonne-uct290-vs-uct60-1000its,766,819,2221.920462274,2199.596141787,-53
carcassonne-ucttuned210-vs-ucttuned440-1000its,766,819,2189.026794907,2176.848237125,-53
carcassonne-ucttuned310-vs-ucttuned60-1000its,766,819,2251.090727106,2233.463614742,-53
carcassonne-ucttuned450-vs-ucttuned215-1000its,766,819,2206.006454554,2169.30728857,-53
carcassonne-ucttuned190-vs-ucttuned380-1000its,767,820,2279.473604934,2192.420849191,-53
carcassonne-boltzmann25-vs-boltzmann350-1000its,768,821,2163.238202041,2103.048813807,-53
carcassonne-uct5-vs-uct190-1000its,769,822,2189.316518995,2141.471870451,-53
carcassonne-boltzmann40-vs-boltzmann390-1000its,770,823,2219.067369659,2153.221632491,-53
carcassonne-ucttuned210-vs-ucttuned315-1000its,771,824,2314.675030544,2223.392982781,-53
carcassonne-ucttuned485-vs-ucttuned290-1000its,771,824,2196.385844308,2156.122375115,-53
carcassonne-boltzmann125-vs-boltzmann450-1000its,773,826,2223.389545697,2190.773706512,-53
carcassonne-boltzmann60-vs-boltzmann55-1000its,773,826,2167.699751904,2167.031297009,-53
carcassonne-uct270-vs-uct385-1000its,773,826,2144.307524624,2184.233611043,-53
carcassonne-boltzmann165-vs-boltzmann425-1000its,774,827,2195.715390812,2161.153604168,-53
carcassonne-uct120-vs-uct30-1000its,775,828,2133.582854765,2075.363693682,-53
carcassonne-ucttuned85-vs-ucttuned350-1000its,776,829,2242.984304915,2139.260225819,-53
carcassonne-boltzmann115-vs-boltzmann255-1000its,777,830,2131.033209598,2120.549618586,-53
carcassonne-uct420-vs-uct295-1000its,777,830,2166.553420531,2109.587425958,-53
carcassonne-ucttuned260-vs-ucttuned115-1000its,778,831,2138.865812886,2101.823937728,-53
carcassonne-ucttuned310-vs-ucttuned495-1000its,778,831,2223.932633894,2194.859110528,-53
carcassonne-boltzmann410-vs-boltzmann255-1000its,781,834,2177.416166135,2135.021020633,-53
carcassonne-boltzmann395-vs-boltzmann315-1000its,783,836,2226.321788668,2206.374397818,-53
carcassonne-boltzmann50-vs-boltzmann210-1000its,784,837,2177.99782614,2153.237349685,-53
carcassonne-ucttuned105-vs-ucttuned155-1000its,784,837,2171.846408792,2132.122845471,-53
carcassonne-uct340-vs-uct295-1000its,785,838,2246.786134334,2221.629016071,-53
carcassonne-ucttuned460-vs-ucttuned355-1000its,787,840,2118.660798211,2149.673745958,-53
carcassonne-boltzmann40-vs-boltzmann15-1000its,788,841,2142.528292666,2134.249779625,-53
carcassonne-ucttuned265-vs-ucttuned70-1000its,788,841,2182.317323777,2129.348641923,-53
carcassonne-ucttuned345-vs-ucttuned490-1000its,788,841,2192.90213603,2163.183193554,-53
carcassonne-ucttuned15-vs-ucttuned450-1000its,789,842,2197.555657715,2158.815301165,-53
carcassonne-ucttuned465-vs-ucttuned165-1000its,791,844,2176.531666639,2118.763498858,-53
carcassonne-ucttuned80-vs-ucttuned345-1000its,793,846,2169.63353661,2169.136595817,-53
carcassonne-boltzmann480-vs-boltzmann280-1000its,794,847,2183.369294403,2112.741843441,-53
carcassonne-uct460-vs-uct5-1000its,794,847,2172.596365912,2120.40990152,-53
carcassonne-boltzmann80-vs-boltzmann435-1000its,795,848,2192.982900524,2176.621441001,-53
carcassonne-uct340-vs-uct405-1000its,795,848,2222.402117134,2151.271006253,-53
carcassonne-ucttuned205-vs-ucttuned310-1000its,795,848,2188.828878108,2155.434065394,-53
carcassonne-uct320-vs-uct370-1000its,796,849,2284.280033892,2231.231423751,-53
carcassonne-uct30-vs-uct205-1000its,800,853,2175.253009804,2158.026165705,-53
carcassonne-uct45-vs-uct270-1000its,800,853,2198.129578224,2176.078376967,-53
carcassonne-uct455-vs-uct145-1000its,800,853,2196.609360906,2176.624628305,-53
carcassonne-ucttuned65-vs-ucttuned140-1000its,801,854,2266.170378009,2271.785944517,-53
carcassonne-boltzmann5-vs-boltzmann330-1000its,805,858,2198.009345932,2165.347172394,-53
carcassonne-boltzmann180-vs-boltzmann370-1000its,807,860,2228.588923866,2218.160409765,-53
carcassonne-uct40-vs-uct10-1000its,810,863,2203.684179479,2180.103046958,-53
carcassonne-boltzmann390-vs-boltzmann15-1000its,812,865,2216.166192496,2139.117165631,-53
carcassonne-ucttuned295-vs-ucttuned140-1000its,813,866,2207.665985357,2188.510878516,-53
carcassonne-ucttuned350-vs-ucttuned265-1000its,813,866,2172.969577405,2137.103100649,-53
carcassonne-uct190-vs-uct205-1000its,814,867,2196.815072499,2137.309329643,-53
carcassonne-uct35-vs-uct230-1000its,818,871,2260.516509797,2155.890665587,-53
carcassonne-ucttuned375-vs-ucttuned460-1000its,819,872,2224.702738059,2206.01807655,-53
carcassonne-boltzmann170-vs-boltzmann305-1000its,822,875,2241.229919001,2178.514827308,-53
carcassonne-uct230-vs-uct15-1000its,829,882,2126.394093364,2111.733544309,-53
carcassonne-uct270-vs-uct190-1000its,830,883,2193.657864065,2146.208878642,-53
carcassonne-uct390-vs-uct5-1000its,834,887,2263.098646094,2208.067996388,-53
carcassonne-ucttuned370-vs-ucttuned80-1000its,840,893,2249.295316369,2170.797763359,-53
carcassonne-ucttuned15-vs-ucttuned120-1000its,858,911,2203.373195249,2117.080132163,-53
carcassonne-ucttuned225-vs-ucttuned45-1000its,887,940,2158.300814692,2117.191207184,-53
carcassonne-ucttuned165-vs-ucttuned150-1000its,690,742,2201.198251338,2143.012657979,-52
carcassonne-ucttuned250-vs-ucttuned160-1000its,697,749,2173.9575629,2149.437594044,-52
carcassonne-uct360-vs-uct75-1000its,700,752,2149.971501096,2079.129236219,-52
carcassonne-ucttuned345-vs-ucttuned255-1000its,700,752,2191.239363925,2126.519167855,-52
carcassonne-boltzmann255-vs-boltzmann390-1000its,706,758,2142.192229291,2110.170942892,-52
carcassonne-ucttuned215-vs-ucttuned205-1000its,706,758,2273.850173294,2245.965801827,-52
carcassonne-uct355-vs-uct380-1000its,715,767,2222.117768917,2195.4283817,-52
carcassonne-uct410-vs-uct105-1000its,718,770,2194.546363006,2153.29909787,-52
carcassonne-ucttuned35-vs-ucttuned300-1000its,720,772,2237.059779558,2138.205123314,-52
carcassonne-boltzmann160-vs-boltzmann15-1000its,723,775,2155.145394528,2131.994366197,-52
carcassonne-ucttuned365-vs-ucttuned285-1000its,725,777,2203.36248559,2160.549952955,-52
carcassonne-ucttuned65-vs-ucttuned260-1000its,727,779,2233.084339572,2146.624021487,-52
carcassonne-boltzmann365-vs-boltzmann450-1000its,728,780,2196.168837665,2150.578657416,-52
carcassonne-boltzmann300-vs-boltzmann370-1000its,730,782,2262.191909637,2208.472622675,-52
carcassonne-boltzmann490-vs-boltzmann80-1000its,731,783,2224.813202382,2147.824585339,-52
carcassonne-boltzmann350-vs-boltzmann365-1000its,733,785,2285.049310004,2256.521052546,-52
carcassonne-uct165-vs-uct105-1000its,735,787,2204.445086365,2160.720545732,-52
carcassonne-ucttuned430-vs-ucttuned395-1000its,736,788,2182.333865997,2119.378725959,-52
carcassonne-uct460-vs-uct135-1000its,737,789,2149.885462409,2121.405754869,-52
carcassonne-uct265-vs-uct270-1000its,740,792,2257.654428677,2195.586263236,-52
carcassonne-boltzmann405-vs-boltzmann315-1000its,743,795,2106.072317387,2110.868283411,-52
carcassonne-uct295-vs-uct320-1000its,745,797,2294.162298705,2257.751879248,-52
carcassonne-boltzmann210-vs-boltzmann70-1000its,746,798,2264.685940717,2220.347474733,-52
carcassonne-boltzmann55-vs-boltzmann455-1000its,746,798,2203.040675041,2133.076090107,-52
carcassonne-boltzmann420-vs-boltzmann10-1000its,747,799,2200.224311849,2170.502137981,-52
carcassonne-uct315-vs-uct295-1000its,747,799,2198.214200357,2159.980327478,-52
carcassonne-ucttuned225-vs-ucttuned340-1000its,747,799,2195.906069021,2150.630906376,-52
carcassonne-boltzmann130-vs-boltzmann330-1000its,749,801,2173.161296075,2150.273704411,-52
carcassonne-uct200-vs-uct465-1000its,751,803,2159.781126063,2171.474390817,-52
carcassonne-boltzmann100-vs-boltzmann365-1000its,752,804,2198.896776541,2110.62333447,-52
carcassonne-boltzmann335-vs-boltzmann250-1000its,752,804,2223.641321294,2214.154816521,-52
carcassonne-uct460-vs-uct280-1000its,752,804,2208.369403719,2203.92665996,-52
carcassonne-uct185-vs-uct235-1000its,753,805,2185.831354564,2169.751958522,-52
carcassonne-boltzmann140-vs-boltzmann290-1000its,755,807,2317.206493797,2273.260366839,-52
carcassonne-boltzmann445-vs-boltzmann315-1000its,758,810,2150.003303635,2091.078321036,-52
carcassonne-boltzmann195-vs-boltzmann90-1000its,760,812,2201.205172351,2159.737630973,-52
carcassonne-boltzmann115-vs-boltzmann55-1000its,761,813,2254.403463909,2196.507337661,-52
carcassonne-uct165-vs-uct380-1000its,762,814,2162.521047281,2094.32302001,-52
carcassonne-uct260-vs-uct145-1000its,763,815,2159.686468245,2097.066801153,-52
carcassonne-ucttuned425-vs-ucttuned445-1000its,765,817,2192.450004135,2143.812783646,-52
carcassonne-ucttuned220-vs-ucttuned150-1000its,770,822,2190.27279112,2143.319121931,-52
carcassonne-ucttuned220-vs-ucttuned170-1000its,770,822,2241.607624161,2158.869627663,-52
carcassonne-ucttuned470-vs-ucttuned220-1000its,770,822,2123.933031287,2095.125172761,-52
carcassonne-uct475-vs-uct130-1000its,771,823,2154.995329401,2103.55172945,-52
carcassonne-boltzmann20-vs-boltzmann255-1000its,773,825,2163.598303682,2141.187036425,-52
carcassonne-boltzmann325-vs-boltzmann470-1000its,774,826,2178.132570346,2111.836523908,-52
carcassonne-uct400-vs-uct45-1000its,775,827,2139.8123886,2053.309699571,-52
carcassonne-uct45-vs-uct115-1000its,776,828,2216.148520489,2178.046520375,-52
carcassonne-ucttuned345-vs-ucttuned265-1000its,776,828,2267.691953404,2224.679167264,-52
carcassonne-boltzmann295-vs-boltzmann480-1000its,779,831,2246.666014391,2139.730176028,-52
carcassonne-ucttuned70-vs-ucttuned340-1000its,780,832,2195.12044095,2157.737611579,-52
carcassonne-uct360-vs-uct450-1000its,781,833,2271.406190715,2187.652620505,-52
carcassonne-uct375-vs-uct170-1000its,781,833,2185.382141335,2126.470559187,-52
carcassonne-uct445-vs-uct145-1000its,782,834,2176.518567484,2168.346177157,-52
carcassonne-uct5-vs-uct470-1000its,782,834,2270.665039498,2143.598613273,-52
carcassonne-ucttuned445-vs-ucttuned10-1000its,782,834,2212.03504059,2173.825721716,-52
carcassonne-uct80-vs-uct35-1000its,783,835,2225.161830039,2144.378955639,-52
carcassonne-uct90-vs-uct50-1000its,784,836,2229.688386574,2219.56535755,-52
carcassonne-ucttuned325-vs-ucttuned290-1000its,784,836,2190.577032235,2148.123688208,-52
carcassonne-uct200-vs-uct300-1000its,786,838,2255.479381592,2185.61836697,-52
carcassonne-ucttuned105-vs-ucttuned180-1000its,786,838,2218.805139628,2160.156190256,-52
carcassonne-ucttuned465-vs-ucttuned355-1000its,786,838,2216.09553121,2158.006443302,-52
carcassonne-ucttuned60-vs-ucttuned225-1000its,786,838,2208.154329045,2191.982040056,-52
carcassonne-uct210-vs-uct15-1000its,792,844,2196.370068121,2172.68049714,-52
carcassonne-uct45-vs-uct10-1000its,792,844,2159.10854734,2116.287166261,-52
carcassonne-boltzmann190-vs-boltzmann55-1000its,793,845,2170.537622366,2152.279580737,-52
carcassonne-boltzmann425-vs-boltzmann470-1000its,793,845,2217.867616952,2142.132457729,-52
carcassonne-uct165-vs-uct145-1000its,793,845,2267.281600159,2211.051499569,-52
carcassonne-boltzmann75-vs-boltzmann45-1000its,797,849,2200.70611668,2170.246363033,-52
carcassonne-boltzmann80-vs-boltzmann410-1000its,798,850,2151.966117999,2077.315641382,-52
carcassonne-ucttuned315-vs-ucttuned400-1000its,798,850,2171.862443495,2141.995033573,-52
carcassonne-ucttuned440-vs-ucttuned445-1000its,799,851,2252.537834556,2174.36168091,-52
carcassonne-boltzmann345-vs-boltzmann280-1000its,800,852,2336.735485588,2250.985732034,-52
carcassonne-uct155-vs-uct325-1000its,800,852,2185.142169046,2173.225153838,-52
carcassonne-boltzmann440-vs-boltzmann25-1000its,801,853,2182.096949215,2127.077149629,-52
carcassonne-boltzmann360-vs-boltzmann100-1000its,806,858,2208.248224009,2175.084834397,-52
carcassonne-uct175-vs-uct290-1000its,807,859,2218.985726835,2158.480138522,-52
carcassonne-ucttuned235-vs-ucttuned455-1000its,808,860,2240.210847504,2190.900578999,-52
carcassonne-uct85-vs-uct90-1000its,809,861,2189.728522743,2117.346846358,-52
carcassonne-ucttuned85-vs-ucttuned405-1000its,809,861,2141.787685721,2094.458220956,-52
carcassonne-boltzmann410-vs-boltzmann55-1000its,810,862,2222.816757939,2160.393529945,-52
carcassonne-boltzmann300-vs-boltzmann175-1000its,811,863,2170.575380112,2098.681552513,-52
carcassonne-ucttuned280-vs-ucttuned265-1000its,812,864,2135.644100303,2107.989054992,-52
carcassonne-boltzmann380-vs-boltzmann420-1000its,813,865,2244.247796078,2180.682630361,-52
carcassonne-ucttuned305-vs-ucttuned475-1000its,814,866,2177.874245019,2116.612736079,-52
carcassonne-boltzmann240-vs-boltzmann495-1000its,815,867,2262.665744264,2219.438535695,-52
carcassonne-ucttuned490-vs-ucttuned185-1000its,817,869,2173.272820513,2154.884374602,-52
carcassonne-ucttuned470-vs-ucttuned80-1000its,818,870,2184.219482554,2180.121193207,-52
carcassonne-ucttuned390-vs-ucttuned90-1000its,819,871,2169.968260054,2149.56665979,-52
carcassonne-ucttuned325-vs-ucttuned155-1000its,820,872,2158.847125701,2152.042813216,-52
carcassonne-boltzmann125-vs-boltzmann60-1000its,823,875,2215.961849317,2168.927088545,-52
carcassonne-boltzmann445-vs-boltzmann420-1000its,823,875,2212.941346374,2197.527823154,-52
carcassonne-uct135-vs-uct475-1000its,825,877,2244.033559697,2203.165513907,-52
carcassonne-ucttuned100-vs-ucttuned395-1000its,825,877,2280.815737113,2229.978879508,-52
carcassonne-boltzmann290-vs-boltzmann115-1000its,829,881,2172.437406614,2132.711434324,-52
carcassonne-uct340-vs-uct385-1000its,833,885,2145.140516075,2101.240546539,-52
carcassonne-ucttuned35-vs-ucttuned15-1000its,836,888,2130.398762983,2125.90957584,-52
carcassonne-uct270-vs-uct335-1000its,837,889,2123.270986038,2125.547826907,-52
carcassonne-boltzmann270-vs-boltzmann370-1000its,841,893,2188.43731353,2138.303593838,-52
carcassonne-ucttuned305-vs-ucttuned120-1000its,854,906,2267.542098386,2238.50577805,-52
carcassonne-ucttuned240-vs-ucttuned340-1000its,861,913,2174.084393213,2084.07876039,-52
carcassonne-ucttuned10-vs-ucttuned35-1000its,862,914,2251.822620699,2215.55189668,-52
carcassonne-ucttuned150-vs-ucttuned445-1000its,869,921,2184.66083289,2117.931700406,-52
carcassonne-ucttuned375-vs-ucttuned60-1000its,925,977,2135.512482397,2107.420614673,-52
carcassonne-boltzmann90-vs-boltzmann270-1000its,676,727,2202.169594256,2160.933320188,-51
carcassonne-uct370-vs-uct20-1000its,696,747,2240.12704391,2190.33458007,-51
carcassonne-uct335-vs-uct170-1000its,716,767,2262.200112308,2235.017640801,-51
carcassonne-ucttuned50-vs-ucttuned260-1000its,716,767,2230.183314222,2155.718461153,-51
carcassonne-boltzmann325-vs-boltzmann440-1000its,718,769,2208.260444215,2158.263484772,-51
carcassonne-uct150-vs-uct205-1000its,720,771,2221.040161257,2191.604355251,-51
carcassonne-boltzmann170-vs-boltzmann355-1000its,725,776,2295.066617917,2238.873898395,-51
carcassonne-uct130-vs-uct75-1000its,727,778,2156.515903476,2112.373626333,-51
carcassonne-ucttuned215-vs-ucttuned125-1000its,733,784,2237.451672365,2168.792441298,-51
carcassonne-boltzmann435-vs-boltzmann255-1000its,734,785,2246.028424684,2218.149543035,-51
carcassonne-boltzmann475-vs-boltzmann420-1000its,735,786,2248.805317833,2163.817515587,-51
carcassonne-boltzmann70-vs-boltzmann10-1000its,735,786,2198.985956274,2142.279491198,-51
carcassonne-uct70-vs-uct185-1000its,736,787,2136.384563065,2109.829179556,-51
carcassonne-boltzmann455-vs-boltzmann450-1000its,739,790,2168.68404369,2125.479544423,-51
carcassonne-uct230-vs-uct30-1000its,740,791,2151.865561316,2102.597617331,-51
carcassonne-boltzmann120-vs-boltzmann60-1000its,741,792,2221.375546795,2172.916172763,-51
carcassonne-ucttuned395-vs-ucttuned85-1000its,741,792,2235.292554624,2208.633999353,-51
carcassonne-uct225-vs-uct430-1000its,744,795,2175.442210367,2127.474290875,-51
carcassonne-uct235-vs-uct130-1000its,744,795,2213.487757568,2187.282635824,-51
carcassonne-boltzmann270-vs-boltzmann465-1000its,747,798,2199.135992179,2173.205443502,-51
carcassonne-boltzmann35-vs-boltzmann345-1000its,748,799,2237.572248177,2182.286696872,-51
carcassonne-boltzmann80-vs-boltzmann300-1000its,748,799,2194.746194003,2146.097232086,-51
carcassonne-uct85-vs-uct405-1000its,748,799,2149.858950651,2118.572518398,-51
carcassonne-ucttuned175-vs-ucttuned190-1000its,748,799,2172.660535107,2162.677774459,-51
carcassonne-uct160-vs-uct365-1000its,749,800,2202.198071823,2153.709111197,-51
carcassonne-uct335-vs-uct125-1000its,750,801,2244.052934483,2184.301325846,-51
carcassonne-boltzmann25-vs-boltzmann495-1000its,753,804,2266.466989241,2218.022102862,-51
carcassonne-ucttuned350-vs-ucttuned85-1000its,755,806,2261.017396989,2194.587719054,-51
carcassonne-ucttuned100-vs-ucttuned410-1000its,756,807,2183.565435284,2122.819427767,-51
carcassonne-boltzmann350-vs-boltzmann305-1000its,758,809,2200.675429765,2152.290351613,-51
carcassonne-uct365-vs-uct295-1000its,758,809,2161.782851157,2115.798963527,-51
carcassonne-boltzmann35-vs-boltzmann410-1000its,759,810,2138.047872215,2093.53292626,-51
carcassonne-boltzmann335-vs-boltzmann355-1000its,760,811,2120.413831238,2117.143520038,-51
carcassonne-ucttuned395-vs-ucttuned290-1000its,760,811,2171.85205839,2137.06409368,-51
carcassonne-boltzmann250-vs-boltzmann240-1000its,761,812,2180.255086043,2170.851053873,-51
carcassonne-boltzmann215-vs-boltzmann190-1000its,762,813,2270.525246897,2227.072739283,-51
carcassonne-boltzmann315-vs-boltzmann110-1000its,762,813,2210.499752089,2161.584323214,-51
carcassonne-boltzmann365-vs-boltzmann35-1000its,764,815,2226.825685145,2189.915376587,-51
carcassonne-boltzmann185-vs-boltzmann485-1000its,765,816,2226.876757714,2185.825309719,-51
carcassonne-uct55-vs-uct155-1000its,765,816,2081.006512858,2057.608421749,-51
carcassonne-ucttuned420-vs-ucttuned195-1000its,767,818,2211.494251745,2077.363240351,-51
carcassonne-uct70-vs-uct385-1000its,769,820,2160.396172002,2094.073530295,-51
carcassonne-ucttuned360-vs-ucttuned5-1000its,769,820,2208.175995036,2188.5520017,-51
carcassonne-uct320-vs-uct135-1000its,770,821,2179.843961929,2105.909988119,-51
carcassonne-ucttuned95-vs-ucttuned355-1000its,770,821,2179.445393205,2115.164997423,-51
carcassonne-ucttuned175-vs-ucttuned95-1000its,771,822,2143.659874748,2121.454818866,-51
carcassonne-uct80-vs-uct200-1000its,772,823,2266.460921126,2212.147495422,-51
carcassonne-uct240-vs-uct325-1000its,774,825,2148.5735379,2121.228562486,-51
carcassonne-boltzmann460-vs-boltzmann250-1000its,775,826,2150.789901316,2139.32727854,-51
carcassonne-uct135-vs-uct360-1000its,775,826,2127.902676432,2091.707430977,-51
carcassonne-uct255-vs-uct205-1000its,775,826,2159.890341093,2142.955800953,-51
carcassonne-boltzmann215-vs-boltzmann140-1000its,777,828,2232.209104898,2141.010320748,-51
carcassonne-boltzmann355-vs-boltzmann225-1000its,778,829,2229.046081889,2196.703803857,-51
carcassonne-boltzmann470-vs-boltzmann445-1000its,781,832,2164.949289416,2129.371986962,-51
carcassonne-boltzmann65-vs-boltzmann375-1000its,781,832,2146.925227049,2109.53041175,-51
carcassonne-ucttuned160-vs-ucttuned175-1000its,781,832,2155.732574348,2150.858893537,-51
carcassonne-uct385-vs-uct460-1000its,782,833,2244.234646396,2188.809306816,-51
carcassonne-uct185-vs-uct95-1000its,783,834,2089.22000499,2072.292706472,-51
carcassonne-ucttuned30-vs-ucttuned445-1000its,783,834,2204.158534041,2152.818350976,-51
carcassonne-ucttuned100-vs-ucttuned190-1000its,786,837,2161.972928438,2147.829188168,-51
carcassonne-ucttuned200-vs-ucttuned495-1000its,787,838,2252.727056782,2187.209694584,-51
carcassonne-boltzmann455-vs-boltzmann140-1000its,788,839,2285.799339537,2201.726351727,-51
carcassonne-ucttuned70-vs-ucttuned95-1000its,788,839,2236.630005782,2221.581492823,-51
carcassonne-boltzmann240-vs-boltzmann385-1000its,789,840,2167.380635058,2131.528349467,-51
carcassonne-boltzmann150-vs-boltzmann465-1000its,790,841,2271.6824306,2192.394225545,-51
carcassonne-uct265-vs-uct290-1000its,790,841,2284.402434673,2269.058252765,-51
carcassonne-ucttuned395-vs-ucttuned110-1000its,790,841,2188.66942041,2151.616706087,-51
carcassonne-ucttuned310-vs-ucttuned345-1000its,791,842,2237.353248191,2181.18353033,-51
carcassonne-ucttuned250-vs-ucttuned400-1000its,792,843,2171.418086386,2098.43980826,-51
carcassonne-boltzmann325-vs-boltzmann305-1000its,793,844,2272.299185822,2166.361606557,-51
carcassonne-boltzmann90-vs-boltzmann135-1000its,793,844,2183.700291812,2146.040294688,-51
carcassonne-boltzmann20-vs-boltzmann30-1000its,794,845,2166.91118559,2111.063620314,-51
carcassonne-uct435-vs-uct260-1000its,795,846,2245.332646536,2188.439963816,-51
carcassonne-boltzmann5-vs-boltzmann105-1000its,796,847,2158.081985334,2081.978224618,-51
carcassonne-ucttuned15-vs-ucttuned180-1000its,796,847,2203.623622646,2117.600297043,-51
carcassonne-ucttuned215-vs-ucttuned220-1000its,798,849,2227.742264679,2185.420297777,-51
carcassonne-ucttuned265-vs-ucttuned230-1000its,799,850,2245.076013886,2175.718125236,-51
carcassonne-boltzmann355-vs-boltzmann460-1000its,800,851,2235.515703844,2186.794712075,-51
carcassonne-boltzmann135-vs-boltzmann260-1000its,801,852,2190.355703337,2100.18736873,-51
carcassonne-uct115-vs-uct345-1000its,801,852,2246.751697323,2183.855300047,-51
carcassonne-boltzmann355-vs-boltzmann70-1000its,802,853,2250.713877614,2233.453196255,-51
carcassonne-uct250-vs-uct150-1000its,806,857,2159.717940697,2122.098319898,-51
carcassonne-uct275-vs-uct60-1000its,806,857,2215.780935285,2229.108852276,-51
carcassonne-ucttuned135-vs-ucttuned480-1000its,806,857,2182.064980216,2112.675322662,-51
carcassonne-ucttuned380-vs-ucttuned35-1000its,806,857,2244.290470971,2179.851909623,-51
carcassonne-uct20-vs-uct15-1000its,807,858,2217.652469585,2154.699880328,-51
carcassonne-boltzmann65-vs-boltzmann385-1000its,808,859,2180.546876319,2175.221256372,-51
carcassonne-uct310-vs-uct5-1000its,808,859,2114.383865017,2108.276962221,-51
carcassonne-uct440-vs-uct290-1000its,809,860,2210.325086287,2176.980220137,-51
carcassonne-ucttuned400-vs-ucttuned185-1000its,809,860,2214.58278178,2171.792426718,-51
carcassonne-boltzmann190-vs-boltzmann175-1000its,811,862,2214.996407633,2162.501137793,-51
carcassonne-boltzmann480-vs-boltzmann385-1000its,811,862,2241.236993024,2212.096403418,-51
carcassonne-uct440-vs-uct105-1000its,811,862,2161.414593874,2153.966405356,-51
carcassonne-boltzmann305-vs-boltzmann230-1000its,812,863,2149.612153795,2130.362679419,-51
carcassonne-ucttuned140-vs-ucttuned215-1000its,812,863,2219.307405583,2184.149400515,-51
carcassonne-ucttuned475-vs-ucttuned240-1000its,813,864,2216.337233437,2180.288455806,-51
carcassonne-boltzmann125-vs-boltzmann315-1000its,816,867,2237.427458587,2157.034585135,-51
carcassonne-ucttuned410-vs-ucttuned170-1000its,816,867,2267.119165099,2209.46163955,-51
carcassonne-uct370-vs-uct55-1000its,822,873,2158.337511587,2150.58290173,-51
carcassonne-boltzmann195-vs-boltzmann450-1000its,823,874,2260.167614963,2201.333945241,-51
carcassonne-boltzmann495-vs-boltzmann455-1000its,824,875,2198.87307575,2156.57746262,-51
carcassonne-uct400-vs-uct260-1000its,825,876,2226.481932255,2190.035538079,-51
carcassonne-ucttuned75-vs-ucttuned115-1000its,826,877,2112.716008157,2045.157306293,-51
carcassonne-uct30-vs-uct480-1000its,827,878,2151.62713757,2138.19371169,-51
carcassonne-uct140-vs-uct5-1000its,830,881,2176.968057518,2102.215911138,-51
carcassonne-ucttuned260-vs-ucttuned130-1000its,833,884,2227.290767568,2244.021027247,-51
carcassonne-ucttuned290-vs-ucttuned215-1000its,833,884,2229.375393269,2167.712034534,-51
carcassonne-ucttuned100-vs-ucttuned355-1000its,834,885,2192.762528335,2164.892131486,-51
carcassonne-uct445-vs-uct310-1000its,835,886,2200.044052896,2155.257879027,-51
carcassonne-uct490-vs-uct260-1000its,838,889,2141.687261566,2103.86260694,-51
carcassonne-boltzmann225-vs-boltzmann165-1000its,847,898,2225.848936441,2187.469334139,-51
carcassonne-uct285-vs-uct400-1000its,848,899,2290.543178876,2266.05856627,-51
carcassonne-uct35-vs-uct65-1000its,850,901,2194.573795003,2182.032500256,-51
carcassonne-uct385-vs-uct100-1000its,851,902,2198.317440196,2179.347594549,-51
carcassonne-ucttuned70-vs-ucttuned100-1000its,853,904,2165.949446725,2146.458261358,-51
carcassonne-ucttuned150-vs-ucttuned10-1000its,860,911,2209.711136661,2204.46772309,-51
carcassonne-uct300-vs-uct140-1000its,928,979,2256.013299063,2229.361984211,-51
carcassonne-boltzmann245-vs-boltzmann25-1000its,693,743,2310.255920224,2273.998390532,-50
carcassonne-boltzmann360-vs-boltzmann410-1000its,704,754,2206.676865207,2196.75271748,-50
carcassonne-uct190-vs-uct30-1000its,710,760,2181.215546577,2160.379681736,-50
carcassonne-uct250-vs-uct425-1000its,710,760,2219.192673936,2142.507086255,-50
carcassonne-ucttuned380-vs-ucttuned250-1000its,716,766,2092.753283017,2105.091687735,-50
carcassonne-ucttuned480-vs-ucttuned240-1000its,717,767,2147.428920846,2148.507329099,-50
carcassonne-ucttuned75-vs-ucttuned105-1000its,717,767,2230.512289209,2185.812621242,-50
carcassonne-uct265-vs-uct240-1000its,719,769,2164.413434971,2126.364552413,-50
carcassonne-uct95-vs-uct130-1000its,729,779,2144.191062733,2106.237440319,-50
carcassonne-ucttuned315-vs-ucttuned210-1000its,729,779,2233.118317594,2182.699449174,-50
carcassonne-ucttuned440-vs-ucttuned370-1000its,729,779,2178.81944107,2142.363896122,-50
carcassonne-ucttuned455-vs-ucttuned315-1000its,730,780,2110.03567714,2117.55767384,-50
carcassonne-boltzmann70-vs-boltzmann305-1000its,732,782,2169.614951646,2101.307202302,-50
carcassonne-uct325-vs-uct270-1000its,733,783,2212.05983893,2226.111928182,-50
carcassonne-ucttuned370-vs-ucttuned435-1000its,734,784,2192.284003991,2125.182485371,-50
carcassonne-uct180-vs-uct155-1000its,735,785,2198.49399075,2158.124098099,-50
carcassonne-ucttuned470-vs-ucttuned35-1000its,735,785,2149.034152055,2067.344826588,-50
carcassonne-uct130-vs-uct480-1000its,737,787,2180.685625512,2096.945514449,-50
carcassonne-uct15-vs-uct210-1000its,742,792,2183.984385571,2125.463826279,-50
carcassonne-uct335-vs-uct165-1000its,744,794,2265.70281388,2204.916084867,-50
carcassonne-ucttuned325-vs-ucttuned345-1000its,744,794,2147.828717956,2126.052473436,-50
carcassonne-ucttuned90-vs-ucttuned180-1000its,745,795,2292.977154047,2169.262920148,-50
carcassonne-boltzmann50-vs-boltzmann205-1000its,747,797,2236.187084567,2170.418676841,-50
carcassonne-uct340-vs-uct195-1000its,748,798,2199.059133805,2164.640467385,-50
carcassonne-ucttuned280-vs-ucttuned405-1000its,748,798,2199.057246924,2148.010137652,-50
carcassonne-ucttuned455-vs-ucttuned295-1000its,749,799,2108.189162575,2109.02695506,-50
carcassonne-boltzmann155-vs-boltzmann355-1000its,751,801,2234.82055166,2160.940446959,-50
carcassonne-ucttuned410-vs-ucttuned215-1000its,752,802,2160.192531557,2154.921008724,-50
carcassonne-uct340-vs-uct270-1000its,754,804,2146.166450841,2118.787444413,-50
carcassonne-ucttuned190-vs-ucttuned125-1000its,754,804,2243.216431423,2215.999535967,-50
carcassonne-boltzmann85-vs-boltzmann165-1000its,755,805,2187.281579131,2121.298538923,-50
carcassonne-boltzmann205-vs-boltzmann110-1000its,756,806,2233.380781056,2183.921611039,-50
carcassonne-boltzmann210-vs-boltzmann215-1000its,756,806,2189.353768867,2151.944714367,-50
carcassonne-uct210-vs-uct295-1000its,756,806,2215.155074189,2139.174409193,-50
carcassonne-uct75-vs-uct65-1000its,757,807,2192.921475679,2136.097907651,-50
carcassonne-uct360-vs-uct45-1000its,758,808,2159.981015723,2132.075558094,-50
carcassonne-uct495-vs-uct330-1000its,759,809,2204.180801761,2156.159963392,-50
carcassonne-uct100-vs-uct380-1000its,761,811,2195.047442687,2112.201887009,-50
carcassonne-uct430-vs-uct85-1000its,761,811,2168.192656111,2110.710377684,-50
carcassonne-boltzmann315-vs-boltzmann15-1000its,763,813,2134.827777123,2078.568798276,-50
carcassonne-uct210-vs-uct30-1000its,765,815,2210.467321718,2187.651986975,-50
carcassonne-boltzmann225-vs-boltzmann295-1000its,766,816,2161.674482853,2128.545128671,-50
carcassonne-uct85-vs-uct400-1000its,766,816,2251.77045163,2215.89244932,-50
carcassonne-ucttuned220-vs-ucttuned245-1000its,766,816,2145.33611628,2095.236932986,-50
carcassonne-uct370-vs-uct480-1000its,767,817,2153.517676601,2126.162871231,-50
carcassonne-uct400-vs-uct410-1000its,767,817,2277.727203461,2268.379416419,-50
carcassonne-boltzmann150-vs-boltzmann185-1000its,768,818,2190.433928643,2153.278197145,-50
carcassonne-uct185-vs-uct390-1000its,768,818,2168.872959123,2159.647471694,-50
carcassonne-ucttuned100-vs-ucttuned380-1000its,771,821,2157.182393409,2144.574676646,-50
carcassonne-boltzmann420-vs-boltzmann120-1000its,772,822,2207.787798003,2200.489001023,-50
carcassonne-boltzmann90-vs-boltzmann30-1000its,773,823,2218.043238296,2171.216530387,-50
carcassonne-uct405-vs-uct145-1000its,773,823,2142.273809265,2172.913619574,-50
carcassonne-uct80-vs-uct110-1000its,773,823,2240.773285634,2211.75684247,-50
carcassonne-boltzmann150-vs-boltzmann260-1000its,775,825,2170.272203396,2121.223198491,-50
carcassonne-uct80-vs-uct230-1000its,775,825,2187.695907962,2196.357983847,-50
carcassonne-ucttuned445-vs-ucttuned15-1000its,775,825,2184.454972399,2108.233739675,-50
carcassonne-ucttuned495-vs-ucttuned480-1000its,775,825,2186.229834709,2144.930428423,-50
carcassonne-boltzmann15-vs-boltzmann415-1000its,776,826,2253.783784072,2210.933243225,-50
carcassonne-uct290-vs-uct190-1000its,776,826,2170.166481357,2135.857141194,-50
carcassonne-ucttuned460-vs-ucttuned220-1000its,776,826,2221.990809608,2168.888939159,-50
carcassonne-uct195-vs-uct295-1000its,777,827,2242.836204038,2183.103943734,-50
carcassonne-uct350-vs-uct285-1000its,778,828,2270.525102469,2250.98757131,-50
carcassonne-ucttuned370-vs-ucttuned300-1000its,781,831,2275.996235277,2181.869199961,-50
carcassonne-uct85-vs-uct255-1000its,784,834,2180.129921552,2122.815614858,-50
carcassonne-ucttuned195-vs-ucttuned255-1000its,784,834,2201.3458067,2170.365305081,-50
carcassonne-boltzmann85-vs-boltzmann130-1000its,785,835,2156.791735184,2101.398152977,-50
carcassonne-uct250-vs-uct335-1000its,785,835,2178.999838249,2129.01368933,-50
carcassonne-ucttuned280-vs-ucttuned125-1000its,785,835,2231.60984209,2131.770267408,-50
carcassonne-ucttuned180-vs-ucttuned50-1000its,786,836,2163.074422558,2130.083107926,-50
carcassonne-uct135-vs-uct435-1000its,787,837,2182.479393745,2116.318773111,-50
carcassonne-uct295-vs-uct85-1000its,787,837,2206.117624631,2145.782552016,-50
carcassonne-ucttuned120-vs-ucttuned135-1000its,787,837,2176.816899983,2103.634505293,-50
carcassonne-boltzmann270-vs-boltzmann25-1000its,788,838,2217.665768205,2139.123375316,-50
carcassonne-uct275-vs-uct405-1000its,790,840,2268.91108418,2195.992168518,-50
carcassonne-boltzmann290-vs-boltzmann400-1000its,792,842,2234.151846347,2216.272776691,-50
carcassonne-ucttuned410-vs-ucttuned265-1000its,792,842,2200.538995419,2159.692510658,-50
carcassonne-ucttuned215-vs-ucttuned115-1000its,793,843,2139.352276935,2074.446297425,-50
carcassonne-uct385-vs-uct390-1000its,794,844,2183.526409909,2164.127898523,-50
carcassonne-uct305-vs-uct375-1000its,795,845,2249.471063832,2181.997293999,-50
carcassonne-ucttuned135-vs-ucttuned410-1000its,795,845,2203.784531378,2133.082335528,-50
carcassonne-boltzmann165-vs-boltzmann205-1000its,796,846,2195.157276079,2187.050779278,-50
carcassonne-ucttuned85-vs-ucttuned120-1000its,796,846,2262.348456011,2221.291367114,-50
carcassonne-uct255-vs-uct225-1000its,797,847,2186.867647421,2104.3351379,-50
carcassonne-uct435-vs-uct490-1000its,797,847,2231.863085357,2178.265437862,-50
carcassonne-boltzmann265-vs-boltzmann260-1000its,798,848,2163.058545276,2109.901528609,-50
carcassonne-ucttuned245-vs-ucttuned300-1000its,798,848,2251.250594245,2224.284279552,-50
carcassonne-uct90-vs-uct200-1000its,799,849,2184.374039815,2143.482596089,-50
carcassonne-boltzmann335-vs-boltzmann185-1000its,800,850,2257.039190721,2209.566595317,-50
carcassonne-boltzmann470-vs-boltzmann425-1000its,801,851,2181.556848256,2117.985540141,-50
carcassonne-ucttuned10-vs-ucttuned455-1000its,802,852,2164.080643412,2110.59779492,-50
carcassonne-boltzmann245-vs-boltzmann445-1000its,806,856,2254.551900721,2229.704782182,-50
carcassonne-ucttuned350-vs-ucttuned65-1000its,808,858,2189.528376592,2124.913828432,-50
carcassonne-boltzmann380-vs-boltzmann480-1000its,809,859,2127.192371818,2053.360762002,-50
carcassonne-ucttuned195-vs-ucttuned370-1000its,809,859,2226.471736333,2150.308939097,-50
carcassonne-uct410-vs-uct415-1000its,811,861,2165.220372776,2123.231158887,-50
carcassonne-ucttuned345-vs-ucttuned220-1000its,811,861,2186.686366125,2100.770048242,-50
carcassonne-uct490-vs-uct290-1000its,813,863,2122.491087082,2073.084967126,-50
carcassonne-uct425-vs-uct160-1000its,817,867,2140.79153631,2096.233838954,-50
carcassonne-uct390-vs-uct125-1000its,819,869,2239.484617386,2216.386987227,-50
carcassonne-uct10-vs-uct40-1000its,821,871,2173.503295536,2115.933042347,-50
carcassonne-uct280-vs-uct225-1000its,821,871,2200.862402759,2142.50573883,-50
carcassonne-boltzmann400-vs-boltzmann310-1000its,822,872,2152.73225351,2148.387535298,-50
carcassonne-ucttuned455-vs-ucttuned230-1000its,823,873,2258.672989161,2218.004319477,-50
carcassonne-ucttuned425-vs-ucttuned355-1000its,824,874,2156.62012255,2128.300172358,-50
carcassonne-boltzmann390-vs-boltzmann375-1000its,825,875,2144.292564294,2134.428643461,-50
carcassonne-ucttuned70-vs-ucttuned345-1000its,826,876,2192.748948561,2163.089332515,-50
carcassonne-uct360-vs-uct300-1000its,832,882,2230.300194304,2183.446298733,-50
carcassonne-boltzmann400-vs-boltzmann90-1000its,835,885,2181.929052892,2136.665581431,-50
carcassonne-ucttuned185-vs-ucttuned455-1000its,835,885,2223.29487736,2155.09201325,-50
carcassonne-ucttuned455-vs-ucttuned345-1000its,836,886,2173.948412462,2149.644618253,-50
carcassonne-uct440-vs-uct30-1000its,837,887,2197.340970605,2144.251214435,-50
carcassonne-ucttuned450-vs-ucttuned250-1000its,839,889,2176.094926664,2149.584530942,-50
carcassonne-boltzmann455-vs-boltzmann180-1000its,846,896,2228.012253856,2151.079234206,-50
carcassonne-ucttuned15-vs-ucttuned325-1000its,850,900,2184.45519319,2148.342190919,-50
carcassonne-boltzmann25-vs-boltzmann5-1000its,855,905,2160.145633617,2148.052097643,-50
carcassonne-uct30-vs-uct25-1000its,860,910,2130.669817301,2122.156710631,-50
carcassonne-ucttuned225-vs-ucttuned55-1000its,860,910,2214.502065637,2193.550185228,-50
carcassonne-ucttuned365-vs-ucttuned450-1000its,861,911,2217.173982912,2172.22628884,-50
carcassonne-ucttuned490-vs-ucttuned15-1000its,872,922,2194.728491841,2137.457604863,-50
carcassonne-uct20-vs-uct335-1000its,877,927,2257.746062909,2227.250740768,-50
carcassonne-ucttuned335-vs-ucttuned475-1000its,883,933,2233.483195036,2189.724838387,-50
carcassonne-boltzmann100-vs-boltzmann380-1000its,691,740,2218.534250769,2146.996829633,-49
carcassonne-boltzmann75-vs-boltzmann70-1000its,696,745,2175.089241089,2138.294985743,-49
carcassonne-uct230-vs-uct80-1000its,696,745,2172.485960448,2169.660914889,-49
carcassonne-uct335-vs-uct105-1000its,727,776,2205.521498147,2189.598833396,-49
carcassonne-uct430-vs-uct285-1000its,730,779,2219.452605766,2149.456788784,-49
carcassonne-ucttuned465-vs-ucttuned135-1000its,730,779,2194.348830179,2205.789391857,-49
carcassonne-boltzmann255-vs-boltzmann40-1000its,732,781,2182.295352372,2146.756794109,-49
carcassonne-uct355-vs-uct75-1000its,733,782,2106.575942263,2089.199541567,-49
carcassonne-boltzmann140-vs-boltzmann55-1000its,736,785,2168.23441988,2096.936406311,-49
carcassonne-boltzmann180-vs-boltzmann140-1000its,737,786,2145.559684122,2150.872844729,-49
carcassonne-boltzmann260-vs-boltzmann65-1000its,739,788,2144.372294758,2110.714889667,-49
carcassonne-uct40-vs-uct15-1000its,743,792,2157.408688534,2132.874600505,-49
carcassonne-ucttuned185-vs-ucttuned480-1000its,745,794,2231.115073506,2148.98362206,-49
carcassonne-boltzmann460-vs-boltzmann15-1000its,746,795,2164.425023057,2103.269114955,-49
carcassonne-ucttuned400-vs-ucttuned290-1000its,746,795,2218.510503039,2151.496070774,-49
carcassonne-ucttuned300-vs-ucttuned60-1000its,747,796,2200.395701248,2170.594643548,-49
carcassonne-uct325-vs-uct470-1000its,748,797,2196.681177776,2128.889088782,-49
carcassonne-boltzmann60-vs-boltzmann415-1000its,749,798,2220.683969782,2217.724761324,-49
carcassonne-uct310-vs-uct120-1000its,752,801,2152.553116828,2119.30875775,-49
carcassonne-ucttuned100-vs-ucttuned175-1000its,753,802,2229.680721146,2115.508103265,-49
carcassonne-boltzmann330-vs-boltzmann365-1000its,754,803,2259.513617765,2171.100302284,-49
carcassonne-boltzmann365-vs-boltzmann225-1000its,760,809,2244.933704966,2171.47374869,-49
carcassonne-ucttuned65-vs-ucttuned365-1000its,760,809,2189.557144765,2141.354016107,-49
carcassonne-boltzmann120-vs-boltzmann300-1000its,761,810,2276.551949583,2241.549995003,-49
carcassonne-uct375-vs-uct135-1000its,762,811,2244.294389787,2171.543371885,-49
carcassonne-boltzmann110-vs-boltzmann270-1000its,768,817,2261.960973543,2162.488787117,-49
carcassonne-boltzmann205-vs-boltzmann345-1000its,768,817,2197.388001341,2145.657702525,-49
carcassonne-boltzmann370-vs-boltzmann215-1000its,769,818,2219.95057766,2189.348824866,-49
carcassonne-uct425-vs-uct360-1000its,770,819,2194.34855405,2150.944681896,-49
carcassonne-uct450-vs-uct165-1000its,770,819,2223.843570922,2196.879630273,-49
carcassonne-ucttuned55-vs-ucttuned430-1000its,771,820,2268.733628942,2187.406317919,-49
carcassonne-uct235-vs-uct180-1000its,772,821,2221.418203719,2172.427749545,-49
carcassonne-uct230-vs-uct490-1000its,773,822,2225.279745349,2204.714364976,-49
carcassonne-ucttuned495-vs-ucttuned135-1000its,773,822,2194.05765118,2151.390527216,-49
carcassonne-boltzmann50-vs-boltzmann490-1000its,774,823,2229.335276123,2181.585047418,-49
carcassonne-boltzmann405-vs-boltzmann70-1000its,775,824,2208.250939375,2161.314121775,-49
carcassonne-boltzmann470-vs-boltzmann105-1000its,775,824,2235.589237868,2213.840699623,-49
carcassonne-uct350-vs-uct65-1000its,775,824,2268.10266934,2189.419928817,-49
carcassonne-boltzmann125-vs-boltzmann75-1000its,777,826,2190.834487019,2142.230649809,-49
carcassonne-boltzmann395-vs-boltzmann220-1000its,778,827,2298.94984718,2252.094268515,-49
carcassonne-boltzmann405-vs-boltzmann470-1000its,778,827,2178.325884698,2128.068750143,-49
carcassonne-ucttuned360-vs-ucttuned200-1000its,781,830,2206.296830868,2172.185645108,-49
carcassonne-uct450-vs-uct35-1000its,782,831,2207.311170016,2170.28417242,-49
carcassonne-boltzmann190-vs-boltzmann390-1000its,784,833,2163.302573518,2098.758289937,-49
carcassonne-uct265-vs-uct325-1000its,788,837,2201.377463379,2148.163517201,-49
carcassonne-uct310-vs-uct420-1000its,788,837,2204.757579815,2166.807186427,-49
carcassonne-uct325-vs-uct310-1000its,789,838,2193.081821451,2115.420135896,-49
carcassonne-boltzmann340-vs-boltzmann375-1000its,791,840,2296.698667981,2251.497194992,-49
carcassonne-boltzmann120-vs-boltzmann250-1000its,792,841,2175.923415104,2139.968593076,-49
carcassonne-uct450-vs-uct320-1000its,792,841,2137.86695042,2140.417597247,-49
carcassonne-boltzmann145-vs-boltzmann155-1000its,793,842,2180.22435904,2129.540530595,-49
carcassonne-ucttuned265-vs-ucttuned415-1000its,793,842,2189.78947236,2116.885470412,-49
carcassonne-boltzmann95-vs-boltzmann340-1000its,795,844,2136.468054216,2098.771691144,-49
carcassonne-boltzmann85-vs-boltzmann95-1000its,796,845,2229.15058037,2198.21120457,-49
carcassonne-boltzmann245-vs-boltzmann120-1000its,797,846,2198.870649559,2155.023151811,-49
carcassonne-ucttuned205-vs-ucttuned170-1000its,798,847,2174.436672274,2148.409587046,-49
carcassonne-boltzmann455-vs-boltzmann315-1000its,801,850,2249.776718244,2202.439284902,-49
carcassonne-uct390-vs-uct460-1000its,801,850,2217.049581556,2136.54029578,-49
carcassonne-ucttuned365-vs-ucttuned180-1000its,801,850,2203.251534695,2151.016267311,-49
carcassonne-boltzmann400-vs-boltzmann20-1000its,803,852,2173.426072601,2167.353014999,-49
carcassonne-uct30-vs-uct80-1000its,803,852,2204.800242319,2143.704014471,-49
carcassonne-uct75-vs-uct445-1000its,806,855,2185.900139962,2132.439254194,-49
carcassonne-uct120-vs-uct40-1000its,807,856,2228.844503356,2177.517034941,-49
carcassonne-boltzmann365-vs-boltzmann75-1000its,809,858,2206.138386993,2144.765823686,-49
carcassonne-uct465-vs-uct135-1000its,809,858,2136.755676932,2131.699938044,-49
carcassonne-uct200-vs-uct440-1000its,810,859,2265.537519819,2227.734233513,-49
carcassonne-boltzmann420-vs-boltzmann385-1000its,813,862,2200.867110231,2173.140133073,-49
carcassonne-uct435-vs-uct180-1000its,813,862,2226.484788236,2209.793663057,-49
carcassonne-boltzmann75-vs-boltzmann290-1000its,814,863,2207.129229329,2152.97634428,-49
carcassonne-ucttuned340-vs-ucttuned370-1000its,817,866,2187.696899081,2146.209749221,-49
carcassonne-ucttuned270-vs-ucttuned340-1000its,818,867,2138.937266567,2124.0765035,-49
carcassonne-ucttuned125-vs-ucttuned475-1000its,819,868,2174.429374591,2125.228839385,-49
carcassonne-boltzmann265-vs-boltzmann295-1000its,821,870,2231.177172875,2185.606108784,-49
carcassonne-uct485-vs-uct70-1000its,821,870,2239.603302693,2231.900886305,-49
carcassonne-boltzmann355-vs-boltzmann475-1000its,825,874,2170.29046663,2113.02499876,-49
carcassonne-ucttuned215-vs-ucttuned160-1000its,830,879,2177.209480093,2137.467754415,-49
carcassonne-ucttuned100-vs-ucttuned15-1000its,838,887,2207.546957921,2161.1892659,-49
carcassonne-ucttuned110-vs-ucttuned235-1000its,839,888,2195.002355367,2156.012273566,-49
carcassonne-ucttuned475-vs-ucttuned330-1000its,839,888,2208.439584533,2180.372952473,-49
carcassonne-uct340-vs-uct350-1000its,840,889,2099.138226157,2073.176997119,-49
carcassonne-ucttuned130-vs-ucttuned450-1000its,841,890,2180.692165604,2125.039906435,-49
carcassonne-ucttuned10-vs-ucttuned330-1000its,845,894,2194.612126566,2148.373266015,-49
carcassonne-boltzmann195-vs-boltzmann60-1000its,856,905,2218.148997826,2191.095637203,-49
carcassonne-ucttuned450-vs-ucttuned10-1000its,857,906,2198.041760771,2152.993339341,-49
carcassonne-ucttuned210-vs-ucttuned325-1000its,860,909,2196.543689334,2156.610214394,-49
carcassonne-boltzmann70-vs-boltzmann130-1000its,862,911,2197.01306776,2109.384706516,-49
carcassonne-uct90-vs-uct305-1000its,865,914,2167.431006054,2132.261550125,-49
carcassonne-boltzmann10-vs-boltzmann255-1000its,869,918,2212.940875454,2169.96087222,-49
carcassonne-uct135-vs-uct490-1000its,872,921,2169.973215868,2136.290070287,-49
carcassonne-ucttuned105-vs-ucttuned95-1000its,908,957,2120.858469601,2103.457428257,-49
carcassonne-ucttuned265-vs-ucttuned245-1000its,675,723,2248.119514067,2181.168263906,-48
carcassonne-uct370-vs-uct180-1000its,689,737,2264.576947466,2190.452488526,-48
carcassonne-boltzmann265-vs-boltzmann490-1000its,706,754,2212.060733296,2161.564396768,-48
carcassonne-uct95-vs-uct225-1000its,710,758,2167.815769804,2142.021384141,-48
carcassonne-uct185-vs-uct335-1000its,712,760,2188.204859912,2198.181555415,-48
carcassonne-ucttuned315-vs-ucttuned125-1000its,715,763,2204.193704721,2164.951907958,-48
carcassonne-ucttuned375-vs-ucttuned55-1000its,715,763,2164.506557987,2128.241558143,-48
carcassonne-uct50-vs-uct95-1000its,717,765,2185.129932642,2117.918814924,-48
carcassonne-ucttuned310-vs-ucttuned125-1000its,718,766,2177.592224699,2135.909082644,-48
carcassonne-ucttuned460-vs-ucttuned490-1000its,718,766,2151.549566919,2105.2731111,-48
carcassonne-uct85-vs-uct260-1000its,721,769,2132.616890005,2086.560836865,-48
carcassonne-uct240-vs-uct80-1000its,723,771,2244.497155621,2158.512356874,-48
carcassonne-uct335-vs-uct205-1000its,725,773,2207.807463386,2181.804350461,-48
carcassonne-ucttuned440-vs-ucttuned100-1000its,725,773,2283.856227875,2177.597641068,-48
carcassonne-uct460-vs-uct265-1000its,728,776,2158.874122179,2154.612695524,-48
carcassonne-ucttuned255-vs-ucttuned375-1000its,734,782,2116.70771132,2100.955684774,-48
carcassonne-ucttuned445-vs-ucttuned90-1000its,734,782,2214.144500224,2150.949515791,-48
carcassonne-ucttuned180-vs-ucttuned200-1000its,737,785,2201.967200945,2156.707165082,-48
carcassonne-boltzmann285-vs-boltzmann455-1000its,738,786,2179.92273637,2157.624630128,-48
carcassonne-boltzmann310-vs-boltzmann295-1000its,739,787,2142.546497146,2098.260556898,-48
carcassonne-boltzmann110-vs-boltzmann425-1000its,741,789,2164.541695563,2098.959102983,-48
carcassonne-boltzmann365-vs-boltzmann170-1000its,742,790,2306.990630764,2246.364633448,-48
carcassonne-uct300-vs-uct335-1000its,744,792,2261.732709699,2250.63383285,-48
carcassonne-boltzmann40-vs-boltzmann405-1000its,745,793,2161.480991977,2139.183588708,-48
carcassonne-uct160-vs-uct255-1000its,746,794,2230.890310653,2155.406825314,-48
carcassonne-boltzmann240-vs-boltzmann170-1000its,750,798,2159.744240064,2171.77214998,-48
carcassonne-uct275-vs-uct290-1000its,750,798,2232.94979244,2159.459090804,-48
carcassonne-ucttuned255-vs-ucttuned75-1000its,750,798,2160.848488931,2161.674268377,-48
carcassonne-ucttuned175-vs-ucttuned75-1000its,753,801,2224.213812922,2171.251897469,-48
carcassonne-boltzmann125-vs-boltzmann220-1000its,754,802,2207.615300466,2185.602394244,-48
carcassonne-boltzmann175-vs-boltzmann305-1000its,756,804,2250.199172553,2205.063733382,-48
carcassonne-boltzmann345-vs-boltzmann165-1000its,759,807,2221.340169227,2149.980967556,-48
carcassonne-boltzmann225-vs-boltzmann180-1000its,760,808,2302.579629859,2258.248781287,-48
carcassonne-uct45-vs-uct165-1000its,761,809,2151.086819056,2108.816136415,-48
carcassonne-boltzmann430-vs-boltzmann70-1000its,762,810,2271.841867213,2173.969002401,-48
carcassonne-boltzmann440-vs-boltzmann170-1000its,763,811,2252.149065983,2205.655495861,-48
carcassonne-uct390-vs-uct475-1000its,763,811,2245.402590906,2174.94813798,-48
carcassonne-uct260-vs-uct195-1000its,764,812,2208.773789875,2143.43334691,-48
carcassonne-ucttuned175-vs-ucttuned345-1000its,764,812,2209.987894883,2143.469907011,-48
carcassonne-boltzmann495-vs-boltzmann430-1000its,766,814,2182.441884839,2138.74741618,-48
carcassonne-boltzmann255-vs-boltzmann295-1000its,768,816,2177.693866957,2123.822158488,-48
carcassonne-boltzmann285-vs-boltzmann35-1000its,768,816,2190.306397689,2157.478734636,-48
carcassonne-uct260-vs-uct440-1000its,770,818,2141.568372864,2114.770606004,-48
carcassonne-uct80-vs-uct25-1000its,770,818,2156.549307822,2136.680365465,-48
carcassonne-uct385-vs-uct470-1000its,772,820,2205.270703161,2188.236602585,-48
carcassonne-ucttuned295-vs-ucttuned320-1000its,774,822,2213.142444976,2119.244572226,-48
carcassonne-ucttuned75-vs-ucttuned190-1000its,775,823,2160.62561766,2135.934961641,-48
carcassonne-boltzmann295-vs-boltzmann300-1000its,776,824,2260.722417659,2228.331422764,-48
carcassonne-uct385-vs-uct195-1000its,776,824,2175.297839275,2114.721216775,-48
carcassonne-uct470-vs-uct210-1000its,776,824,2171.763293168,2093.782579467,-48
carcassonne-boltzmann115-vs-boltzmann10-1000its,778,826,2221.830695827,2160.343558326,-48
carcassonne-boltzmann210-vs-boltzmann125-1000its,778,826,2247.415491135,2196.756448364,-48
carcassonne-boltzmann75-vs-boltzmann135-1000its,778,826,2234.688902752,2212.271402843,-48
carcassonne-uct410-vs-uct435-1000its,778,826,2226.473133083,2150.07898482,-48
carcassonne-ucttuned240-vs-ucttuned435-1000its,778,826,2195.748726147,2136.507871606,-48
carcassonne-boltzmann160-vs-boltzmann60-1000its,779,827,2215.72002626,2173.862754758,-48
carcassonne-ucttuned410-vs-ucttuned30-1000its,779,827,2164.496106843,2127.902560619,-48
carcassonne-boltzmann165-vs-boltzmann90-1000its,780,828,2251.169432625,2221.865006002,-48
carcassonne-uct140-vs-uct310-1000its,781,829,2188.79826028,2167.438597324,-48
carcassonne-uct300-vs-uct340-1000its,781,829,2148.899549283,2092.049061042,-48
carcassonne-uct110-vs-uct25-1000its,783,831,2217.220208461,2225.379557857,-48
carcassonne-boltzmann240-vs-boltzmann365-1000its,785,833,2233.775710302,2215.300511602,-48
carcassonne-uct145-vs-uct355-1000its,785,833,2181.891284486,2121.294689114,-48
carcassonne-uct80-vs-uct290-1000its,785,833,2195.424515503,2163.969153136,-48
carcassonne-ucttuned105-vs-ucttuned295-1000its,785,833,2186.601345479,2127.228316089,-48
carcassonne-ucttuned245-vs-ucttuned340-1000its,786,834,2205.015330553,2167.287754947,-48
carcassonne-uct260-vs-uct80-1000its,787,835,2155.410563801,2130.362763573,-48
carcassonne-uct380-vs-uct320-1000its,787,835,2197.400705121,2197.255731882,-48
carcassonne-ucttuned345-vs-ucttuned230-1000its,787,835,2177.479321597,2113.249851846,-48
carcassonne-ucttuned360-vs-ucttuned335-1000its,788,836,2181.067147733,2146.44505288,-48
carcassonne-boltzmann135-vs-boltzmann115-1000its,789,837,2132.05837808,2119.305329425,-48
carcassonne-boltzmann285-vs-boltzmann265-1000its,789,837,2146.981409105,2145.77938615,-48
carcassonne-boltzmann465-vs-boltzmann140-1000its,791,839,2187.545291326,2151.344136269,-48
carcassonne-uct260-vs-uct480-1000its,791,839,2163.050341982,2133.701129208,-48
carcassonne-uct470-vs-uct110-1000its,791,839,2185.890210566,2161.352952061,-48
carcassonne-uct425-vs-uct220-1000its,792,840,2163.795604359,2132.468560099,-48
carcassonne-boltzmann220-vs-boltzmann295-1000its,793,841,2254.760390432,2244.150744392,-48
carcassonne-boltzmann345-vs-boltzmann390-1000its,793,841,2210.13534477,2180.105086546,-48
carcassonne-ucttuned75-vs-ucttuned70-1000its,793,841,2162.867722493,2118.116044341,-48
carcassonne-uct110-vs-uct435-1000its,794,842,2205.398646046,2152.134788416,-48
carcassonne-uct400-vs-uct120-1000its,794,842,2207.482247597,2150.286130514,-48
carcassonne-ucttuned185-vs-ucttuned430-1000its,794,842,2161.625942582,2106.27912247,-48
carcassonne-ucttuned345-vs-ucttuned340-1000its,794,842,2142.82152631,2172.745533376,-48
carcassonne-uct125-vs-uct235-1000its,795,843,2161.16388786,2151.29083126,-48
carcassonne-uct405-vs-uct280-1000its,795,843,2147.590128822,2110.143190158,-48
carcassonne-ucttuned460-vs-ucttuned380-1000its,796,844,2164.869356893,2099.131716345,-48
carcassonne-boltzmann195-vs-boltzmann40-1000its,797,845,2283.490435194,2216.013442774,-48
carcassonne-uct485-vs-uct10-1000its,797,845,2164.658589741,2124.646318511,-48
carcassonne-ucttuned25-vs-ucttuned290-1000its,800,848,2207.528059174,2176.18044812,-48
carcassonne-ucttuned270-vs-ucttuned255-1000its,802,850,2235.917728994,2227.935701393,-48
carcassonne-uct310-vs-uct450-1000its,805,853,2171.597037463,2147.789046985,-48
carcassonne-ucttuned130-vs-ucttuned75-1000its,805,853,2163.4137797,2144.248257311,-48
carcassonne-ucttuned305-vs-ucttuned10-1000its,805,853,2104.560911725,2055.532420923,-48
carcassonne-uct100-vs-uct460-1000its,808,856,2188.70547676,2159.248577022,-48
carcassonne-ucttuned285-vs-ucttuned485-1000its,808,856,2198.635361556,2155.907832108,-48
carcassonne-boltzmann295-vs-boltzmann160-1000its,809,857,2207.659165974,2130.261362676,-48
carcassonne-uct185-vs-uct295-1000its,810,858,2133.980088478,2121.346397589,-48
carcassonne-uct10-vs-uct280-1000its,811,859,2260.983826123,2188.57001604,-48
carcassonne-uct225-vs-uct25-1000its,813,861,2225.257170174,2195.643569438,-48
carcassonne-ucttuned35-vs-ucttuned400-1000its,815,863,2279.908811286,2269.272366976,-48
carcassonne-ucttuned205-vs-ucttuned105-1000its,816,864,2211.126945451,2152.366442916,-48
carcassonne-uct160-vs-uct445-1000its,817,865,2131.905996066,2121.670162437,-48
carcassonne-uct320-vs-uct220-1000its,817,865,2126.00060927,2088.360753852,-48
carcassonne-boltzmann425-vs-boltzmann285-1000its,819,867,2240.084270951,2193.550379626,-48
carcassonne-ucttuned345-vs-ucttuned365-1000its,819,867,2174.093352947,2143.473431907,-48
carcassonne-ucttuned50-vs-ucttuned15-1000its,819,867,2182.754094528,2048.076666793,-48
carcassonne-boltzmann310-vs-boltzmann375-1000its,821,869,2222.209645843,2160.209647101,-48
carcassonne-uct240-vs-uct490-1000its,822,870,2168.285030311,2144.831112189,-48
carcassonne-uct350-vs-uct385-1000its,822,870,2242.526095268,2182.384953254,-48
carcassonne-ucttuned10-vs-ucttuned265-1000its,822,870,2236.434621004,2194.376950438,-48
carcassonne-ucttuned90-vs-ucttuned465-1000its,826,874,2183.798445991,2174.652661683,-48
carcassonne-boltzmann180-vs-boltzmann385-1000its,827,875,2178.958858406,2135.6091141,-48
carcassonne-uct170-vs-uct20-1000its,829,877,2251.822596598,2195.943058782,-48
carcassonne-uct215-vs-uct395-1000its,829,877,2195.240306113,2177.071894661,-48
carcassonne-ucttuned20-vs-ucttuned25-1000its,831,879,2191.244693792,2133.230528319,-48
carcassonne-uct430-vs-uct15-1000its,834,882,2224.938439715,2225.783975997,-48
carcassonne-ucttuned245-vs-ucttuned40-1000its,834,882,2205.566349241,2203.060837901,-48
carcassonne-uct425-vs-uct445-1000its,835,883,2188.764258296,2094.95881947,-48
carcassonne-ucttuned275-vs-ucttuned185-1000its,837,885,2213.069280944,2168.702698125,-48
carcassonne-uct290-vs-uct85-1000its,838,886,2252.028625406,2153.479290372,-48
carcassonne-ucttuned450-vs-ucttuned375-1000its,839,887,2266.705677628,2183.876239472,-48
carcassonne-uct460-vs-uct350-1000its,846,894,2226.76388461,2159.476468705,-48
carcassonne-ucttuned55-vs-ucttuned215-1000its,847,895,2231.703776928,2174.522271726,-48
carcassonne-boltzmann365-vs-boltzmann280-1000its,848,896,2212.443929451,2160.692474772,-48
carcassonne-uct95-vs-uct100-1000its,851,899,2246.043875631,2178.585531851,-48
carcassonne-ucttuned370-vs-ucttuned205-1000its,851,899,2134.449501727,2111.440513941,-48
carcassonne-ucttuned495-vs-ucttuned295-1000its,851,899,2189.615754982,2173.18145466,-48
carcassonne-ucttuned25-vs-ucttuned110-1000its,853,901,2209.642558931,2167.093401921,-48
carcassonne-ucttuned475-vs-ucttuned65-1000its,867,915,2211.527920758,2204.065949671,-48
carcassonne-ucttuned265-vs-ucttuned465-1000its,869,917,2204.304976084,2167.356336275,-48
carcassonne-ucttuned365-vs-ucttuned55-1000its,869,917,2205.849168606,2182.310549054,-48
carcassonne-uct110-vs-uct485-1000its,876,924,2247.575561524,2213.685621113,-48
carcassonne-ucttuned465-vs-ucttuned435-1000its,882,930,2192.74878884,2109.704625595,-48
carcassonne-ucttuned265-vs-ucttuned495-1000its,884,932,2228.293041656,2200.812526457,-48
carcassonne-uct400-vs-uct180-1000its,904,952,2171.227905146,2120.937017105,-48
carcassonne-uct415-vs-uct215-1000its,687,734,2171.534198781,2113.677435615,-47
carcassonne-uct385-vs-uct455-1000its,692,739,2243.966476987,2170.578668156,-47
carcassonne-boltzmann160-vs-boltzmann270-1000its,723,770,2158.014021396,2157.76262975,-47
carcassonne-ucttuned465-vs-ucttuned25-1000its,727,774,2230.321772383,2224.92404831,-47
carcassonne-boltzmann245-vs-boltzmann140-1000its,730,777,2210.981879782,2158.980050784,-47
carcassonne-ucttuned165-vs-ucttuned400-1000its,731,778,2167.20493225,2113.022035839,-47
carcassonne-boltzmann405-vs-boltzmann80-1000its,732,779,2185.307355075,2167.869761588,-47
carcassonne-boltzmann180-vs-boltzmann340-1000its,733,780,2182.560467912,2161.97480361,-47
carcassonne-boltzmann205-vs-boltzmann275-1000its,734,781,2240.728303937,2227.487201362,-47
carcassonne-boltzmann315-vs-boltzmann395-1000its,734,781,2223.103900924,2184.650197225,-47
carcassonne-ucttuned160-vs-ucttuned440-1000its,734,781,2149.291134212,2115.384473351,-47
carcassonne-boltzmann395-vs-boltzmann325-1000its,738,785,2281.970573876,2191.019272913,-47
carcassonne-uct65-vs-uct130-1000its,739,786,2223.17621802,2179.59319052,-47
carcassonne-uct35-vs-uct215-1000its,743,790,2203.395935209,2141.809168535,-47
carcassonne-uct390-vs-uct150-1000its,743,790,2192.093780782,2193.002588336,-47
carcassonne-boltzmann30-vs-boltzmann205-1000its,744,791,2133.347074675,2049.965869838,-47
carcassonne-boltzmann375-vs-boltzmann40-1000its,744,791,2262.992771418,2226.577959196,-47
carcassonne-uct260-vs-uct90-1000its,748,795,2124.916262675,2119.027211877,-47
carcassonne-uct90-vs-uct475-1000its,748,795,2171.819568255,2168.322263197,-47
carcassonne-ucttuned190-vs-ucttuned255-1000its,748,795,2234.064811739,2189.718809813,-47
carcassonne-uct80-vs-uct75-1000its,749,796,2160.308864705,2145.263707116,-47
carcassonne-ucttuned375-vs-ucttuned290-1000its,750,797,2202.407762045,2131.11234218,-47
carcassonne-boltzmann420-vs-boltzmann105-1000its,751,798,2203.028910613,2189.455975307,-47
carcassonne-ucttuned125-vs-ucttuned130-1000its,751,798,2200.846942093,2172.687234203,-47
carcassonne-boltzmann225-vs-boltzmann480-1000its,752,799,2202.665591034,2147.25958719,-47
carcassonne-ucttuned90-vs-ucttuned450-1000its,752,799,2217.888317174,2142.624221237,-47
carcassonne-ucttuned160-vs-ucttuned10-1000its,754,801,2234.522867786,2197.597849107,-47
carcassonne-boltzmann115-vs-boltzmann85-1000its,755,802,2140.265636453,2148.964236796,-47
carcassonne-ucttuned445-vs-ucttuned145-1000its,757,804,2119.883420903,2101.359332227,-47
carcassonne-uct360-vs-uct15-1000its,758,805,2223.197017706,2161.312825691,-47
carcassonne-uct125-vs-uct250-1000its,761,808,2134.320557019,2082.681252504,-47
carcassonne-ucttuned205-vs-ucttuned70-1000its,761,808,2132.886714816,2091.751723027,-47
carcassonne-ucttuned455-vs-ucttuned380-1000its,762,809,2260.968997323,2175.522908147,-47
carcassonne-uct310-vs-uct85-1000its,766,813,2169.310512744,2144.754116158,-47
carcassonne-boltzmann135-vs-boltzmann180-1000its,768,815,2209.420432211,2160.6912919,-47
carcassonne-uct40-vs-uct110-1000its,768,815,2210.520991339,2163.541775332,-47
carcassonne-uct495-vs-uct5-1000its,768,815,2238.828795011,2196.586471391,-47
carcassonne-boltzmann30-vs-boltzmann45-1000its,770,817,2181.347338371,2163.907651943,-47
carcassonne-uct295-vs-uct475-1000its,771,818,2182.06045316,2115.338144729,-47
carcassonne-uct90-vs-uct365-1000its,771,818,2189.095210901,2142.378977911,-47
carcassonne-uct485-vs-uct155-1000its,773,820,2207.704573081,2155.869388428,-47
carcassonne-ucttuned115-vs-ucttuned60-1000its,773,820,2189.971263494,2149.633075345,-47
carcassonne-uct190-vs-uct350-1000its,774,821,2227.184767066,2148.555688114,-47
carcassonne-ucttuned460-vs-ucttuned95-1000its,775,822,2154.143244714,2072.424028934,-47
carcassonne-uct280-vs-uct35-1000its,776,823,2284.804827869,2215.350033287,-47
carcassonne-uct345-vs-uct265-1000its,776,823,2136.147259038,2118.335324686,-47
carcassonne-boltzmann10-vs-boltzmann145-1000its,777,824,2170.234600436,2137.931084552,-47
carcassonne-ucttuned170-vs-ucttuned220-1000its,777,824,2164.656367228,2077.489410943,-47
carcassonne-boltzmann30-vs-boltzmann65-1000its,778,825,2107.786826691,2070.219647519,-47
carcassonne-boltzmann475-vs-boltzmann345-1000its,780,827,2126.464741756,2088.022111082,-47
carcassonne-ucttuned195-vs-ucttuned260-1000its,780,827,2257.747285459,2182.244178727,-47
carcassonne-ucttuned375-vs-ucttuned190-1000its,781,828,2190.10336516,2145.632543305,-47
carcassonne-boltzmann270-vs-boltzmann365-1000its,783,830,2232.442532827,2187.576272784,-47
carcassonne-ucttuned115-vs-ucttuned215-1000its,784,831,2163.814970166,2158.695977168,-47
carcassonne-boltzmann325-vs-boltzmann310-1000its,786,833,2186.678587559,2169.290022129,-47
carcassonne-uct120-vs-uct260-1000its,786,833,2207.922068955,2157.389188978,-47
carcassonne-boltzmann200-vs-boltzmann440-1000its,787,834,2226.502092978,2167.317374635,-47
carcassonne-uct180-vs-uct80-1000its,787,834,2229.744333934,2235.978765662,-47
carcassonne-boltzmann270-vs-boltzmann355-1000its,788,835,2116.362789536,2096.464930631,-47
carcassonne-boltzmann115-vs-boltzmann330-1000its,789,836,2229.973865514,2150.172946244,-47
carcassonne-boltzmann120-vs-boltzmann255-1000its,792,839,2234.794549258,2166.758890582,-47
carcassonne-boltzmann380-vs-boltzmann270-1000its,793,840,2207.942221617,2149.724145321,-47
carcassonne-ucttuned360-vs-ucttuned15-1000its,794,841,2184.815315711,2160.685903197,-47
carcassonne-boltzmann445-vs-boltzmann450-1000its,798,845,2258.54312764,2249.388035426,-47
carcassonne-boltzmann440-vs-boltzmann10-1000its,799,846,2182.077402816,2147.929521544,-47
carcassonne-boltzmann290-vs-boltzmann325-1000its,800,847,2154.199763765,2119.557269601,-47
carcassonne-uct495-vs-uct50-1000its,800,847,2194.91404087,2161.69319129,-47
carcassonne-uct465-vs-uct180-1000its,804,851,2161.404263052,2152.506603137,-47
carcassonne-uct50-vs-uct145-1000its,804,851,2155.963020197,2107.719746594,-47
carcassonne-uct250-vs-uct135-1000its,805,852,2175.177255608,2144.678220104,-47
carcassonne-uct60-vs-uct175-1000its,805,852,2183.214405062,2154.004279238,-47
carcassonne-ucttuned255-vs-ucttuned485-1000its,808,855,2220.121140954,2200.604550808,-47
carcassonne-ucttuned45-vs-ucttuned480-1000its,809,856,2256.498032202,2199.853716613,-47
carcassonne-ucttuned455-vs-ucttuned270-1000its,810,857,2145.622891911,2086.518572588,-47
carcassonne-ucttuned275-vs-ucttuned205-1000its,811,858,2158.772111817,2088.145546618,-47
carcassonne-boltzmann425-vs-boltzmann100-1000its,812,859,2165.613819645,2129.391472453,-47
carcassonne-ucttuned230-vs-ucttuned135-1000its,812,859,2214.936862778,2169.885375811,-47
carcassonne-ucttuned285-vs-ucttuned495-1000its,812,859,2208.020493641,2151.61072753,-47
carcassonne-uct210-vs-uct200-1000its,813,860,2275.389287761,2181.631306598,-47
carcassonne-uct320-vs-uct95-1000its,817,864,2212.670949761,2180.343027549,-47
carcassonne-uct450-vs-uct215-1000its,817,864,2213.902183074,2200.589230607,-47
carcassonne-uct200-vs-uct350-1000its,818,865,2253.785171205,2226.771172551,-47
carcassonne-ucttuned475-vs-ucttuned260-1000its,818,865,2128.928002189,2097.79317093,-47
carcassonne-ucttuned220-vs-ucttuned80-1000its,819,866,2176.270827331,2183.315820338,-47
carcassonne-ucttuned240-vs-ucttuned330-1000its,819,866,2188.64494372,2140.996102782,-47
carcassonne-uct275-vs-uct50-1000its,820,867,2240.165509701,2187.739203264,-47
carcassonne-uct75-vs-uct30-1000its,820,867,2220.330784045,2157.691284781,-47
carcassonne-ucttuned235-vs-ucttuned130-1000its,820,867,2145.990330514,2073.151957951,-47
carcassonne-ucttuned470-vs-ucttuned20-1000its,823,870,2238.468311544,2176.757874505,-47
carcassonne-ucttuned385-vs-ucttuned5-1000its,831,878,2224.718321512,2192.379414391,-47
carcassonne-boltzmann375-vs-boltzmann330-1000its,832,879,2222.708525331,2151.18244066,-47
carcassonne-ucttuned445-vs-ucttuned5-1000its,832,879,2219.635328207,2144.333769464,-47
carcassonne-ucttuned425-vs-ucttuned30-1000its,834,881,2145.604318218,2132.392925267,-47
carcassonne-uct450-vs-uct305-1000its,836,883,2191.071592455,2138.458117241,-47
carcassonne-boltzmann145-vs-boltzmann490-1000its,840,887,2139.240409944,2122.725607842,-47
carcassonne-boltzmann455-vs-boltzmann375-1000its,841,888,2208.856948927,2189.649921743,-47
carcassonne-uct105-vs-uct35-1000its,848,895,2262.30435163,2167.426484591,-47
carcassonne-boltzmann230-vs-boltzmann255-1000its,851,898,2226.634756301,2147.032779133,-47
carcassonne-boltzmann390-vs-boltzmann5-1000its,851,898,2155.295640234,2186.651929826,-47
carcassonne-ucttuned355-vs-ucttuned450-1000its,860,907,2190.912561494,2167.534619506,-47
carcassonne-ucttuned480-vs-ucttuned385-1000its,863,910,2209.276893055,2124.270355153,-47
carcassonne-ucttuned235-vs-ucttuned250-1000its,588,634,1769.185971138,1709.087410278,-46
carcassonne-ucttuned330-vs-ucttuned90-1000its,671,717,2225.403641496,2165.259482703,-46
carcassonne-uct460-vs-uct305-1000its,703,749,2157.710376181,2094.707135373,-46
carcassonne-ucttuned375-vs-ucttuned145-1000its,708,754,2220.290270857,2180.368636127,-46
carcassonne-boltzmann355-vs-boltzmann80-1000its,724,770,2292.27709213,2247.121309899,-46
carcassonne-boltzmann450-vs-boltzmann155-1000its,724,770,2217.676935665,2185.002480421,-46
carcassonne-uct140-vs-uct450-1000its,725,771,2257.429698679,2207.983141089,-46
carcassonne-ucttuned125-vs-ucttuned290-1000its,726,772,2211.159848995,2174.460591299,-46
carcassonne-boltzmann300-vs-boltzmann470-1000its,727,773,2132.006852105,2112.168655138,-46
carcassonne-ucttuned255-vs-ucttuned380-1000its,728,774,2171.301005225,2110.515321304,-46
carcassonne-boltzmann190-vs-boltzmann315-1000its,729,775,2184.636239334,2155.289590945,-46
carcassonne-boltzmann300-vs-boltzmann220-1000its,733,779,2239.187952543,2193.461238564,-46
carcassonne-ucttuned385-vs-ucttuned365-1000its,733,779,2185.268124491,2159.903563361,-46
carcassonne-uct80-vs-uct420-1000its,736,782,2135.604178091,2096.528567672,-46
carcassonne-boltzmann5-vs-boltzmann90-1000its,738,784,2196.48582059,2193.007553301,-46
carcassonne-boltzmann385-vs-boltzmann400-1000its,741,787,2173.612162426,2116.620194083,-46
carcassonne-boltzmann75-vs-boltzmann410-1000its,741,787,2251.656558258,2224.329028689,-46
carcassonne-ucttuned495-vs-ucttuned125-1000its,741,787,2203.348037352,2150.632601804,-46
carcassonne-boltzmann355-vs-boltzmann440-1000its,748,794,2152.540718843,2107.028545564,-46
carcassonne-boltzmann465-vs-boltzmann165-1000its,748,794,2207.430627581,2128.289533956,-46
carcassonne-boltzmann475-vs-boltzmann270-1000its,749,795,2130.578564724,2144.245884653,-46
carcassonne-uct50-vs-uct65-1000its,750,796,2189.254446312,2169.08050361,-46
carcassonne-uct185-vs-uct260-1000its,752,798,2207.576249059,2195.825022847,-46
carcassonne-boltzmann385-vs-boltzmann380-1000its,753,799,2204.244616913,2168.052069682,-46
carcassonne-uct60-vs-uct365-1000its,755,801,2225.603748325,2176.700058845,-46
carcassonne-uct470-vs-uct85-1000its,756,802,2232.726371513,2234.483568409,-46
carcassonne-uct185-vs-uct115-1000its,757,803,2228.231873196,2194.848776383,-46
carcassonne-ucttuned370-vs-ucttuned90-1000its,759,805,2219.568331698,2124.426622326,-46
carcassonne-ucttuned300-vs-ucttuned495-1000its,760,806,2236.494489241,2190.493395116,-46
carcassonne-uct325-vs-uct255-1000its,761,807,2202.373381775,2106.292983848,-46
carcassonne-uct365-vs-uct195-1000its,761,807,2210.796651505,2197.040841519,-46
carcassonne-uct140-vs-uct115-1000its,762,808,2182.385905334,2104.763855519,-46
carcassonne-uct480-vs-uct285-1000its,762,808,2166.368161758,2127.757174146,-46
carcassonne-uct190-vs-uct175-1000its,763,809,2214.014384378,2194.125152501,-46
carcassonne-ucttuned135-vs-ucttuned425-1000its,763,809,2232.640563389,2204.896688751,-46
carcassonne-boltzmann30-vs-boltzmann465-1000its,764,810,2276.860614781,2265.773289728,-46
carcassonne-ucttuned225-vs-ucttuned450-1000its,764,810,2257.387403969,2182.475953476,-46
carcassonne-boltzmann120-vs-boltzmann95-1000its,765,811,2165.652552357,2118.1620743,-46
carcassonne-ucttuned360-vs-ucttuned135-1000its,765,811,2167.537197262,2102.41723356,-46
carcassonne-ucttuned475-vs-ucttuned85-1000its,765,811,2219.124049703,2162.731746648,-46
carcassonne-ucttuned85-vs-ucttuned140-1000its,765,811,2258.725726978,2257.320242205,-46
carcassonne-ucttuned370-vs-ucttuned355-1000its,767,813,2191.40166009,2159.2972706,-46
carcassonne-boltzmann65-vs-boltzmann320-1000its,768,814,2176.634240668,2076.211455075,-46
carcassonne-uct10-vs-uct195-1000its,771,817,2245.03947264,2201.382540306,-46
carcassonne-uct420-vs-uct120-1000its,772,818,2213.720830714,2219.998008901,-46
carcassonne-uct425-vs-uct145-1000its,772,818,2177.873738423,2174.920435663,-46
carcassonne-boltzmann255-vs-boltzmann185-1000its,774,820,2180.704324848,2129.870192118,-46
carcassonne-boltzmann285-vs-boltzmann270-1000its,774,820,2248.813999049,2236.386345117,-46
carcassonne-boltzmann70-vs-boltzmann175-1000its,775,821,2247.772116269,2188.348731159,-46
carcassonne-uct175-vs-uct460-1000its,776,822,2259.535119977,2178.220119989,-46
carcassonne-boltzmann435-vs-boltzmann285-1000its,777,823,2185.071351554,2172.912035506,-46
carcassonne-uct380-vs-uct405-1000its,777,823,2263.913195475,2195.925817995,-46
carcassonne-ucttuned140-vs-ucttuned65-1000its,777,823,2164.169777789,2147.659147328,-46
carcassonne-boltzmann275-vs-boltzmann45-1000its,779,825,2262.857729938,2191.934447927,-46
carcassonne-boltzmann315-vs-boltzmann305-1000its,779,825,2198.823061598,2102.271666986,-46
carcassonne-uct450-vs-uct295-1000its,780,826,2167.784157961,2151.689293478,-46
carcassonne-boltzmann150-vs-boltzmann125-1000its,782,828,2252.303109947,2194.754096617,-46
carcassonne-boltzmann440-vs-boltzmann370-1000its,783,829,2240.921711011,2197.729249575,-46
carcassonne-uct220-vs-uct410-1000its,783,829,2159.77436543,2152.361517869,-46
carcassonne-uct65-vs-uct365-1000its,786,832,2222.566526853,2148.684827346,-46
carcassonne-uct235-vs-uct470-1000its,788,834,2216.579515404,2216.376943028,-46
carcassonne-ucttuned280-vs-ucttuned15-1000its,788,834,2222.297127839,2155.676457954,-46
carcassonne-ucttuned300-vs-ucttuned275-1000its,788,834,2235.209912654,2201.764030719,-46
carcassonne-boltzmann245-vs-boltzmann285-1000its,789,835,2146.068493253,2115.995813834,-46
carcassonne-boltzmann315-vs-boltzmann475-1000its,789,835,2226.956542258,2171.224771254,-46
carcassonne-uct195-vs-uct330-1000its,789,835,2193.605271463,2154.370017189,-46
carcassonne-boltzmann20-vs-boltzmann365-1000its,791,837,2208.124104424,2181.954990981,-46
carcassonne-uct355-vs-uct460-1000its,791,837,2216.709856347,2153.210061427,-46
carcassonne-boltzmann345-vs-boltzmann60-1000its,792,838,2248.614187327,2187.295085815,-46
carcassonne-ucttuned50-vs-ucttuned455-1000its,794,840,2168.724360851,2161.570796515,-46
carcassonne-boltzmann105-vs-boltzmann430-1000its,795,841,2175.265223956,2118.02215681,-46
carcassonne-ucttuned400-vs-ucttuned255-1000its,795,841,2203.454571878,2173.199829615,-46
carcassonne-boltzmann95-vs-boltzmann115-1000its,796,842,2219.012266109,2125.935848853,-46
carcassonne-ucttuned445-vs-ucttuned425-1000its,796,842,2216.839822843,2186.989874206,-46
carcassonne-boltzmann470-vs-boltzmann405-1000its,797,843,2219.875845073,2187.350161722,-46
carcassonne-ucttuned220-vs-ucttuned330-1000its,797,843,2232.748310601,2141.633657073,-46
carcassonne-uct135-vs-uct335-1000its,799,845,2166.816995902,2171.154920786,-46
carcassonne-uct365-vs-uct465-1000its,799,845,2262.250409783,2207.998032692,-46
carcassonne-ucttuned420-vs-ucttuned65-1000its,799,845,2138.378329263,2096.139821983,-46
carcassonne-ucttuned100-vs-ucttuned40-1000its,800,846,2160.839612316,2151.282173517,-46
carcassonne-ucttuned350-vs-ucttuned80-1000its,801,847,2201.112018434,2156.776912625,-46
carcassonne-uct455-vs-uct395-1000its,803,849,2249.993895856,2182.620912513,-46
carcassonne-ucttuned170-vs-ucttuned45-1000its,803,849,2161.325734124,2120.095273249,-46
carcassonne-ucttuned495-vs-ucttuned115-1000its,803,849,2185.474884743,2156.107564148,-46
carcassonne-uct330-vs-uct325-1000its,805,851,2236.596864396,2234.693846621,-46
carcassonne-ucttuned435-vs-ucttuned105-1000its,806,852,2153.075668129,2149.186447807,-46
carcassonne-uct415-vs-uct490-1000its,807,853,2194.751271781,2123.368361157,-46
carcassonne-ucttuned150-vs-ucttuned245-1000its,807,853,2150.145422964,2117.250629379,-46
carcassonne-boltzmann70-vs-boltzmann255-1000its,809,855,2224.017149494,2197.668754676,-46
carcassonne-ucttuned355-vs-ucttuned220-1000its,809,855,2239.332834389,2183.982801251,-46
carcassonne-boltzmann230-vs-boltzmann190-1000its,811,857,2176.644752901,2130.04249868,-46
carcassonne-ucttuned5-vs-ucttuned145-1000its,811,857,2222.05213916,2209.682666783,-46
carcassonne-uct260-vs-uct475-1000its,812,858,2228.754046727,2187.227753142,-46
carcassonne-ucttuned15-vs-ucttuned135-1000its,814,860,2190.792796753,2161.711349215,-46
carcassonne-boltzmann325-vs-boltzmann75-1000its,815,861,2206.284222214,2177.549434237,-46
carcassonne-boltzmann60-vs-boltzmann35-1000its,815,861,2159.730657677,2115.928215294,-46
carcassonne-ucttuned480-vs-ucttuned145-1000its,816,862,2133.241555641,2091.186190193,-46
carcassonne-uct335-vs-uct85-1000its,818,864,2219.635671589,2172.399662684,-46
carcassonne-ucttuned15-vs-ucttuned340-1000its,818,864,2228.421761432,2156.789165064,-46
carcassonne-ucttuned110-vs-ucttuned385-1000its,822,868,2200.1929863,2210.507991268,-46
carcassonne-ucttuned10-vs-ucttuned320-1000its,824,870,2208.124608407,2144.960195423,-46
carcassonne-boltzmann185-vs-boltzmann320-1000its,825,871,2186.910438594,2167.414649887,-46
carcassonne-boltzmann35-vs-boltzmann425-1000its,825,871,2162.11997708,2117.209191291,-46
carcassonne-boltzmann180-vs-boltzmann10-1000its,826,872,2238.171939151,2217.839371241,-46
carcassonne-ucttuned490-vs-ucttuned160-1000its,829,875,2181.801818179,2157.240655507,-46
carcassonne-boltzmann355-vs-boltzmann305-1000its,833,879,2141.13752865,2117.396893298,-46
carcassonne-ucttuned335-vs-ucttuned50-1000its,835,881,2211.21616801,2167.169255944,-46
carcassonne-ucttuned415-vs-ucttuned60-1000its,835,881,2122.103541048,2105.574961676,-46
carcassonne-ucttuned115-vs-ucttuned15-1000its,838,884,2179.770938339,2137.921886009,-46
carcassonne-boltzmann450-vs-boltzmann350-1000its,841,887,2169.36087957,2131.981829041,-46
carcassonne-uct5-vs-uct10-1000its,849,895,2166.150817751,2130.805333499,-46
carcassonne-boltzmann360-vs-boltzmann490-1000its,868,914,2170.313897862,2192.97816704,-46
carcassonne-boltzmann405-vs-boltzmann365-1000its,887,933,2189.42284151,2163.025488789,-46
carcassonne-boltzmann80-vs-boltzmann425-1000its,679,724,2202.178166727,2158.740326182,-45
carcassonne-boltzmann150-vs-boltzmann170-1000its,702,747,2179.939647432,2135.235241411,-45
carcassonne-boltzmann170-vs-boltzmann10-1000its,709,754,2213.778364095,2195.361728496,-45
carcassonne-boltzmann305-vs-boltzmann385-1000its,714,759,2144.289477316,2123.603447805,-45
carcassonne-boltzmann55-vs-boltzmann340-1000its,722,767,2275.754684487,2245.344775451,-45
carcassonne-ucttuned430-vs-ucttuned360-1000its,722,767,2229.00761187,2149.668741416,-45
carcassonne-boltzmann435-vs-boltzmann245-1000its,724,769,2185.146449455,2117.089930768,-45
carcassonne-uct150-vs-uct215-1000its,732,777,2215.432232784,2189.00282183,-45
carcassonne-uct60-vs-uct70-1000its,738,783,2208.480938037,2169.703952698,-45
carcassonne-boltzmann60-vs-boltzmann230-1000its,739,784,2224.059538911,2162.398159786,-45
carcassonne-uct195-vs-uct145-1000its,739,784,2222.020506484,2231.620647123,-45
carcassonne-ucttuned230-vs-ucttuned210-1000its,739,784,2167.721696385,2159.008001199,-45
carcassonne-boltzmann65-vs-boltzmann100-1000its,740,785,2193.140755803,2203.598511258,-45
carcassonne-boltzmann135-vs-boltzmann20-1000its,741,786,2248.173891767,2237.783885527,-45
carcassonne-ucttuned130-vs-ucttuned85-1000its,741,786,2225.529415448,2218.339351018,-45
carcassonne-boltzmann135-vs-boltzmann425-1000its,742,787,2199.446967994,2151.476910492,-45
carcassonne-boltzmann365-vs-boltzmann355-1000its,748,793,2213.712865426,2120.141518904,-45
carcassonne-boltzmann420-vs-boltzmann160-1000its,748,793,2186.92450493,2131.984583194,-45
carcassonne-ucttuned235-vs-ucttuned460-1000its,750,795,2182.681368176,2120.047299103,-45
carcassonne-boltzmann425-vs-boltzmann175-1000its,754,799,2144.508765246,2077.103465083,-45
carcassonne-uct345-vs-uct190-1000its,755,800,2212.931188975,2127.091545446,-45
carcassonne-uct360-vs-uct455-1000its,755,800,2229.38975467,2196.736777817,-45
carcassonne-uct385-vs-uct15-1000its,755,800,2181.849318091,2145.317225915,-45
carcassonne-uct430-vs-uct310-1000its,755,800,2146.559728869,2122.711454518,-45
carcassonne-uct65-vs-uct215-1000its,755,800,2150.39754244,2106.54562542,-45
carcassonne-boltzmann440-vs-boltzmann495-1000its,757,802,2208.863689459,2154.48365975,-45
carcassonne-uct40-vs-uct310-1000its,758,803,2201.602770843,2177.346957519,-45
carcassonne-uct200-vs-uct460-1000its,761,806,2156.22926501,2128.449751844,-45
carcassonne-boltzmann215-vs-boltzmann310-1000its,762,807,2220.554133291,2196.502987793,-45
carcassonne-ucttuned305-vs-ucttuned340-1000its,762,807,2186.397177009,2151.400277967,-45
carcassonne-boltzmann365-vs-boltzmann350-1000its,764,809,2176.848752301,2126.658675116,-45
carcassonne-ucttuned155-vs-ucttuned450-1000its,766,811,2251.930892627,2212.133673987,-45
carcassonne-ucttuned385-vs-ucttuned405-1000its,767,812,2183.231029216,2161.616039722,-45
carcassonne-uct215-vs-uct380-1000its,768,813,2294.490011981,2212.904510843,-45
carcassonne-uct335-vs-uct25-1000its,770,815,2226.686722598,2182.818405635,-45
carcassonne-ucttuned270-vs-ucttuned330-1000its,770,815,2170.568130914,2200.999747089,-45
carcassonne-uct60-vs-uct260-1000its,772,817,2178.69240882,2152.09185789,-45
carcassonne-boltzmann480-vs-boltzmann305-1000its,774,819,2173.365671902,2153.680652016,-45
carcassonne-boltzmann365-vs-boltzmann115-1000its,776,821,2257.357661963,2177.71924571,-45
carcassonne-ucttuned400-vs-ucttuned55-1000its,776,821,2175.675637835,2136.785768615,-45
carcassonne-ucttuned440-vs-ucttuned340-1000its,776,821,2186.464018059,2162.363902103,-45
carcassonne-boltzmann340-vs-boltzmann210-1000its,780,825,2268.846670318,2224.85959025,-45
carcassonne-boltzmann65-vs-boltzmann75-1000its,781,826,2152.327912283,2162.891509776,-45
carcassonne-ucttuned375-vs-ucttuned305-1000its,783,828,2179.936656641,2137.290053553,-45
carcassonne-boltzmann105-vs-boltzmann235-1000its,784,829,2292.535490089,2256.285896183,-45
carcassonne-uct25-vs-uct50-1000its,784,829,2217.308680817,2144.172498899,-45
carcassonne-uct495-vs-uct325-1000its,784,829,2197.434586527,2179.121905823,-45
carcassonne-ucttuned345-vs-ucttuned95-1000its,787,832,2150.287214151,2119.531459643,-45
carcassonne-uct150-vs-uct285-1000its,789,834,2208.407373618,2165.423380895,-45
carcassonne-uct255-vs-uct320-1000its,789,834,2140.285603954,2124.017298522,-45
carcassonne-uct470-vs-uct380-1000its,789,834,2226.464972363,2168.327932338,-45
carcassonne-boltzmann150-vs-boltzmann5-1000its,790,835,2164.324563158,2143.207918625,-45
carcassonne-boltzmann335-vs-boltzmann45-1000its,790,835,2201.21107658,2129.444079057,-45
carcassonne-boltzmann60-vs-boltzmann185-1000its,790,835,2258.914700489,2218.351680892,-45
carcassonne-boltzmann70-vs-boltzmann210-1000its,790,835,2228.825270254,2178.8389052,-45
carcassonne-ucttuned45-vs-ucttuned325-1000its,790,835,2250.42590828,2202.110849766,-45
carcassonne-boltzmann35-vs-boltzmann120-1000its,794,839,2211.556589458,2139.940124904,-45
carcassonne-boltzmann170-vs-boltzmann185-1000its,795,840,2257.868389659,2191.100490971,-45
carcassonne-boltzmann90-vs-boltzmann320-1000its,796,841,2219.181281545,2180.326103408,-45
carcassonne-ucttuned390-vs-ucttuned450-1000its,796,841,2153.58412865,2123.693726449,-45
carcassonne-uct45-vs-uct330-1000its,797,842,2258.078532612,2222.210268958,-45
carcassonne-ucttuned380-vs-ucttuned125-1000its,797,842,2217.432910762,2157.884493898,-45
carcassonne-ucttuned80-vs-ucttuned405-1000its,797,842,2166.011932333,2148.362646747,-45
carcassonne-ucttuned65-vs-ucttuned340-1000its,798,843,2226.039423397,2207.667834104,-45
carcassonne-uct140-vs-uct180-1000its,799,844,2166.291450949,2117.686604295,-45
carcassonne-boltzmann385-vs-boltzmann290-1000its,800,845,2246.947352188,2195.633528691,-45
carcassonne-boltzmann270-vs-boltzmann160-1000its,804,849,2186.626690528,2121.115635511,-45
carcassonne-boltzmann470-vs-boltzmann340-1000its,804,849,2155.961720117,2160.060568017,-45
carcassonne-ucttuned150-vs-ucttuned210-1000its,805,850,2161.396245268,2162.385045932,-45
carcassonne-uct275-vs-uct200-1000its,806,851,2156.424534251,2124.829542174,-45
carcassonne-boltzmann195-vs-boltzmann70-1000its,807,852,2196.018043799,2172.3856991,-45
carcassonne-boltzmann285-vs-boltzmann425-1000its,807,852,2196.342894274,2213.047625244,-45
carcassonne-boltzmann310-vs-boltzmann250-1000its,808,853,2201.718737941,2129.922074881,-45
carcassonne-ucttuned120-vs-ucttuned410-1000its,808,853,2238.246510788,2192.677989636,-45
carcassonne-boltzmann75-vs-boltzmann80-1000its,810,855,2232.355676979,2179.634285915,-45
carcassonne-boltzmann315-vs-boltzmann450-1000its,812,857,2251.888100802,2199.862009589,-45
carcassonne-ucttuned370-vs-ucttuned460-1000its,814,859,2169.673765105,2105.689372524,-45
carcassonne-ucttuned365-vs-ucttuned355-1000its,815,860,2107.609123292,2071.220001443,-45
carcassonne-boltzmann165-vs-boltzmann220-1000its,816,861,2206.461007563,2200.601972366,-45
carcassonne-boltzmann350-vs-boltzmann60-1000its,819,864,2161.804813257,2103.692156515,-45
carcassonne-uct495-vs-uct65-1000its,819,864,2188.245071412,2127.264954467,-45
carcassonne-ucttuned220-vs-ucttuned445-1000its,819,864,2204.289635451,2140.739830946,-45
carcassonne-ucttuned285-vs-ucttuned50-1000its,819,864,2175.346639514,2194.396609119,-45
carcassonne-ucttuned365-vs-ucttuned195-1000its,820,865,2168.321291447,2123.555646409,-45
carcassonne-uct345-vs-uct420-1000its,823,868,2190.15446567,2116.033267931,-45
carcassonne-uct480-vs-uct205-1000its,824,869,2269.24192591,2211.442917941,-45
carcassonne-ucttuned105-vs-ucttuned410-1000its,827,872,2222.003422391,2164.555382023,-45
carcassonne-boltzmann320-vs-boltzmann135-1000its,829,874,2199.358927713,2127.746536845,-45
carcassonne-uct55-vs-uct75-1000its,829,874,2174.342225279,2142.149544936,-45
carcassonne-uct365-vs-uct325-1000its,830,875,2213.544478175,2144.005652648,-45
carcassonne-boltzmann230-vs-boltzmann215-1000its,831,876,2152.890198723,2104.449932776,-45
carcassonne-ucttuned165-vs-ucttuned130-1000its,831,876,2188.88525273,2131.556659407,-45
carcassonne-boltzmann360-vs-boltzmann480-1000its,835,880,2183.794551774,2145.898657478,-45
carcassonne-ucttuned45-vs-ucttuned205-1000its,843,888,2225.617383754,2162.955775694,-45
carcassonne-uct130-vs-uct460-1000its,851,896,2208.291683001,2174.604508402,-45
carcassonne-boltzmann55-vs-boltzmann265-1000its,854,899,2237.765395494,2185.993858805,-45
carcassonne-uct430-vs-uct490-1000its,861,906,2193.837319411,2175.768265012,-45
carcassonne-ucttuned150-vs-ucttuned25-1000its,872,917,2176.937468585,2132.972542341,-45
carcassonne-uct390-vs-uct30-1000its,893,938,2161.783400458,2132.608473428,-45
carcassonne-ucttuned165-vs-ucttuned335-1000its,924,969,2180.334538579,2123.766539183,-45
carcassonne-boltzmann480-vs-boltzmann470-1000its,702,746,2113.395905671,2044.108206876,-44
carcassonne-uct200-vs-uct305-1000its,723,767,2292.111735501,2216.245841799,-44
carcassonne-uct385-vs-uct95-1000its,725,769,2142.925763368,2143.838955218,-44
carcassonne-boltzmann450-vs-boltzmann40-1000its,727,771,2211.158500612,2155.478081218,-44
carcassonne-uct495-vs-uct165-1000its,727,771,2186.624907233,2103.368805822,-44
carcassonne-boltzmann410-vs-boltzmann160-1000its,730,774,2158.702319513,2143.007742756,-44
carcassonne-uct60-vs-uct445-1000its,737,781,2181.119851291,2173.195380379,-44
carcassonne-boltzmann245-vs-boltzmann275-1000its,740,784,2187.89246001,2154.556616436,-44
carcassonne-boltzmann70-vs-boltzmann225-1000its,741,785,2216.790097149,2202.449558312,-44
carcassonne-boltzmann240-vs-boltzmann190-1000its,744,788,2217.988179347,2160.739082031,-44
carcassonne-uct250-vs-uct115-1000its,744,788,2230.149684683,2170.757886423,-44
carcassonne-boltzmann270-vs-boltzmann265-1000its,745,789,2188.808695787,2196.738306559,-44
carcassonne-ucttuned425-vs-ucttuned465-1000its,746,790,2270.122422268,2182.365973004,-44
carcassonne-ucttuned480-vs-ucttuned305-1000its,747,791,2265.896279732,2224.805718702,-44
carcassonne-boltzmann170-vs-boltzmann405-1000its,748,792,2231.710157731,2214.829923554,-44
carcassonne-uct395-vs-uct260-1000its,748,792,2218.018880379,2172.582521547,-44
carcassonne-boltzmann250-vs-boltzmann40-1000its,751,795,2152.925092446,2098.445342002,-44
carcassonne-uct240-vs-uct125-1000its,751,795,2214.775729669,2183.66472281,-44
carcassonne-ucttuned305-vs-ucttuned445-1000its,751,795,2232.727245555,2191.061118232,-44
carcassonne-ucttuned250-vs-ucttuned105-1000its,752,796,2258.13362196,2256.348321725,-44
carcassonne-ucttuned365-vs-ucttuned125-1000its,752,796,2194.943210284,2140.489546206,-44
carcassonne-boltzmann75-vs-boltzmann190-1000its,754,798,2228.289026407,2195.764315816,-44
carcassonne-boltzmann340-vs-boltzmann145-1000its,756,800,2268.661470709,2251.08299665,-44
carcassonne-boltzmann455-vs-boltzmann170-1000its,759,803,2211.874080324,2161.618972968,-44
carcassonne-uct475-vs-uct170-1000its,759,803,2181.202029264,2154.978396518,-44
carcassonne-uct420-vs-uct460-1000its,762,806,2203.316617485,2148.179334644,-44
carcassonne-uct85-vs-uct460-1000its,762,806,2132.644279567,2081.610640195,-44
carcassonne-ucttuned425-vs-ucttuned330-1000its,763,807,2163.483433455,2125.560542428,-44
carcassonne-ucttuned105-vs-ucttuned120-1000its,766,810,2319.975961546,2277.108916137,-44
carcassonne-ucttuned420-vs-ucttuned190-1000its,766,810,2198.514296801,2143.756010837,-44
carcassonne-boltzmann130-vs-boltzmann160-1000its,767,811,2198.752733429,2172.201056779,-44
carcassonne-ucttuned280-vs-ucttuned350-1000its,767,811,2211.486450758,2116.762370953,-44
carcassonne-uct180-vs-uct360-1000its,769,813,2140.260437671,2150.405056539,-44
carcassonne-uct75-vs-uct325-1000its,769,813,2176.576938956,2126.953017699,-44
carcassonne-boltzmann320-vs-boltzmann220-1000its,770,814,2190.823038694,2159.029139371,-44
carcassonne-boltzmann360-vs-boltzmann155-1000its,771,815,2166.973300629,2121.521847544,-44
carcassonne-boltzmann105-vs-boltzmann310-1000its,773,817,2183.553303836,2177.024352765,-44
carcassonne-boltzmann455-vs-boltzmann240-1000its,773,817,2231.894310585,2236.750246329,-44
carcassonne-ucttuned415-vs-ucttuned275-1000its,774,818,2223.05832446,2140.02167607,-44
carcassonne-uct325-vs-uct105-1000its,777,821,2187.04996013,2124.337668855,-44
carcassonne-ucttuned150-vs-ucttuned275-1000its,777,821,2228.903498366,2203.2783759,-44
carcassonne-ucttuned85-vs-ucttuned190-1000its,777,821,2185.483034673,2115.515666513,-44
carcassonne-uct475-vs-uct50-1000its,778,822,2238.218341089,2174.874542958,-44
carcassonne-ucttuned355-vs-ucttuned470-1000its,778,822,2196.470954668,2133.178361494,-44
carcassonne-uct490-vs-uct205-1000its,780,824,2294.675127852,2260.057085832,-44
carcassonne-boltzmann300-vs-boltzmann315-1000its,782,826,2207.975651462,2142.993461798,-44
carcassonne-boltzmann400-vs-boltzmann440-1000its,782,826,2242.59845666,2211.760008581,-44
carcassonne-boltzmann415-vs-boltzmann100-1000its,782,826,2239.265596881,2170.008905467,-44
carcassonne-boltzmann485-vs-boltzmann340-1000its,782,826,2264.563592715,2212.399004369,-44
carcassonne-ucttuned190-vs-ucttuned400-1000its,782,826,2114.476365343,2105.085625011,-44
carcassonne-boltzmann460-vs-boltzmann120-1000its,784,828,2178.274500883,2111.329519239,-44
carcassonne-ucttuned380-vs-ucttuned190-1000its,784,828,2274.372443355,2193.20504353,-44
carcassonne-boltzmann330-vs-boltzmann270-1000its,786,830,2147.001052793,2129.800914518,-44
carcassonne-ucttuned70-vs-ucttuned280-1000its,786,830,2139.109921929,2123.193197649,-44
carcassonne-uct20-vs-uct415-1000its,787,831,2164.405014475,2090.378382373,-44
carcassonne-uct255-vs-uct390-1000its,787,831,2220.887608516,2141.767661953,-44
carcassonne-uct10-vs-uct65-1000its,788,832,2205.921883918,2147.371614762,-44
carcassonne-uct300-vs-uct155-1000its,788,832,2177.330087623,2149.476716616,-44
carcassonne-uct325-vs-uct160-1000its,788,832,2157.327326278,2109.648816651,-44
carcassonne-ucttuned20-vs-ucttuned240-1000its,789,833,2188.862797779,2161.809915137,-44
carcassonne-ucttuned350-vs-ucttuned400-1000its,789,833,2319.773275623,2232.152017856,-44
carcassonne-ucttuned420-vs-ucttuned15-1000its,791,835,2177.891584018,2174.821691753,-44
carcassonne-ucttuned50-vs-ucttuned205-1000its,791,835,2125.576957908,2108.369449679,-44
carcassonne-boltzmann450-vs-boltzmann175-1000its,792,836,2181.954211444,2127.822775286,-44
carcassonne-boltzmann380-vs-boltzmann295-1000its,793,837,2171.495592944,2165.150374185,-44
carcassonne-uct35-vs-uct200-1000its,795,839,2110.634039951,2086.08587301,-44
carcassonne-ucttuned385-vs-ucttuned290-1000its,795,839,2193.145395287,2141.638409197,-44
carcassonne-uct30-vs-uct470-1000its,796,840,2210.687610387,2142.160386039,-44
carcassonne-uct140-vs-uct405-1000its,797,841,2228.133963919,2165.100818898,-44
carcassonne-ucttuned25-vs-ucttuned465-1000its,797,841,2206.171773456,2136.463245007,-44
carcassonne-ucttuned95-vs-ucttuned160-1000its,798,842,2213.03359984,2172.843263171,-44
carcassonne-uct215-vs-uct495-1000its,799,843,2267.447285564,2228.387591058,-44
carcassonne-boltzmann120-vs-boltzmann245-1000its,800,844,2186.728978632,2183.228114844,-44
carcassonne-uct405-vs-uct10-1000its,802,846,2255.630829359,2255.594799992,-44
carcassonne-ucttuned175-vs-ucttuned140-1000its,802,846,2281.369799459,2280.186630612,-44
carcassonne-ucttuned425-vs-ucttuned90-1000its,802,846,2187.022511981,2089.330511663,-44
carcassonne-ucttuned270-vs-ucttuned135-1000its,803,847,2192.782123543,2147.927641123,-44
carcassonne-uct310-vs-uct225-1000its,804,848,2220.749377547,2164.583426269,-44
carcassonne-ucttuned465-vs-ucttuned75-1000its,805,849,2239.753325931,2200.259350662,-44
carcassonne-ucttuned295-vs-ucttuned235-1000its,810,854,2184.382917659,2140.74913654,-44
carcassonne-boltzmann160-vs-boltzmann490-1000its,811,855,2161.953531169,2105.433686825,-44
carcassonne-uct180-vs-uct455-1000its,811,855,2200.348959291,2194.877260347,-44
carcassonne-boltzmann105-vs-boltzmann370-1000its,813,857,2241.084996469,2222.906087551,-44
carcassonne-boltzmann235-vs-boltzmann345-1000its,813,857,2119.328001565,2096.016274146,-44
carcassonne-uct155-vs-uct440-1000its,813,857,2173.570520227,2106.90461811,-44
carcassonne-boltzmann160-vs-boltzmann130-1000its,814,858,2193.162984726,2149.081987222,-44
carcassonne-boltzmann305-vs-boltzmann325-1000its,815,859,2176.584781786,2129.426426883,-44
carcassonne-boltzmann50-vs-boltzmann255-1000its,816,860,2229.691665388,2169.171285409,-44
carcassonne-uct410-vs-uct70-1000its,816,860,2159.982834018,2104.19526399,-44
carcassonne-uct490-vs-uct15-1000its,819,863,2132.010311096,2071.783210529,-44
carcassonne-boltzmann320-vs-boltzmann455-1000its,822,866,2187.762473155,2103.221474514,-44
carcassonne-uct495-vs-uct310-1000its,822,866,2262.087009553,2181.350123213,-44
carcassonne-ucttuned155-vs-ucttuned365-1000its,822,866,2257.244432816,2165.814030985,-44
carcassonne-uct165-vs-uct340-1000its,823,867,2207.420039834,2156.596849056,-44
carcassonne-ucttuned385-vs-ucttuned350-1000its,828,872,2241.173955421,2210.536207932,-44
carcassonne-ucttuned470-vs-ucttuned90-1000its,829,873,2166.229597079,2139.37685322,-44
carcassonne-boltzmann85-vs-boltzmann160-1000its,831,875,2209.269165344,2193.8236578,-44
carcassonne-uct105-vs-uct345-1000its,831,875,2187.217217076,2135.763462276,-44
carcassonne-uct145-vs-uct155-1000its,832,876,2191.485662272,2153.528532818,-44
carcassonne-uct355-vs-uct360-1000its,832,876,2229.886222839,2186.73478117,-44
carcassonne-uct140-vs-uct330-1000its,834,878,2162.816753995,2134.849993225,-44
carcassonne-uct85-vs-uct300-1000its,836,880,2195.228097588,2135.684272315,-44
carcassonne-ucttuned200-vs-ucttuned170-1000its,844,888,2229.304570015,2184.275327058,-44
carcassonne-uct15-vs-uct180-1000its,846,890,2215.013623513,2170.675603256,-44
carcassonne-uct215-vs-uct125-1000its,854,898,2225.397312255,2198.915687536,-44
carcassonne-uct150-vs-uct40-1000its,855,899,2345.330436323,2311.606981983,-44
carcassonne-ucttuned410-vs-ucttuned385-1000its,856,900,2254.092989558,2196.902332866,-44
carcassonne-boltzmann5-vs-boltzmann390-1000its,858,902,2176.197205008,2158.014420605,-44
carcassonne-uct270-vs-uct405-1000its,858,902,2258.341320636,2199.533631152,-44
carcassonne-uct365-vs-uct405-1000its,873,917,2163.48588671,2147.242392237,-44
carcassonne-ucttuned465-vs-ucttuned180-1000its,876,920,2138.096878328,2122.643871145,-44
carcassonne-ucttuned240-vs-ucttuned365-1000its,879,923,2237.216793232,2179.33543012,-44
carcassonne-ucttuned380-vs-ucttuned100-1000its,907,951,2186.857234483,2168.786101367,-44
carcassonne-uct440-vs-uct375-1000its,586,629,1761.957734905,1708.358905609,-43
carcassonne-boltzmann75-vs-boltzmann335-1000its,677,720,2199.542933902,2153.683955024,-43
carcassonne-uct160-vs-uct195-1000its,681,724,2172.335333298,2128.473550386,-43
carcassonne-uct390-vs-uct255-1000its,692,735,2212.264647386,2150.510869741,-43
carcassonne-ucttuned345-vs-ucttuned275-1000its,700,743,2185.215301298,2133.770164258,-43
carcassonne-boltzmann65-vs-boltzmann120-1000its,712,755,2302.518580149,2220.062200527,-43
carcassonne-uct165-vs-uct55-1000its,725,768,2182.03836743,2107.840140564,-43
carcassonne-boltzmann155-vs-boltzmann145-1000its,731,774,2234.97409478,2160.934830812,-43
carcassonne-boltzmann105-vs-boltzmann410-1000its,738,781,2192.263443132,2152.546944561,-43
carcassonne-boltzmann425-vs-boltzmann155-1000its,739,782,2210.33933315,2189.101442491,-43
carcassonne-boltzmann330-vs-boltzmann135-1000its,741,784,2161.821385584,2098.721849356,-43
carcassonne-uct485-vs-uct350-1000its,741,784,2183.694392776,2178.276900808,-43
carcassonne-ucttuned185-vs-ucttuned240-1000its,742,785,2269.678909897,2241.62937716,-43
carcassonne-ucttuned470-vs-ucttuned235-1000its,743,786,2243.553805514,2204.575957472,-43
carcassonne-boltzmann455-vs-boltzmann95-1000its,744,787,2271.619853791,2217.856409297,-43
carcassonne-ucttuned330-vs-ucttuned435-1000its,744,787,2187.87461764,2094.513766796,-43
carcassonne-ucttuned95-vs-ucttuned150-1000its,744,787,2230.814466812,2128.481302836,-43
carcassonne-uct235-vs-uct285-1000its,747,790,2212.419607351,2165.556311405,-43
carcassonne-uct345-vs-uct365-1000its,747,790,2195.337842532,2178.953590599,-43
carcassonne-ucttuned415-vs-ucttuned405-1000its,747,790,2210.061837198,2214.990906849,-43
carcassonne-boltzmann150-vs-boltzmann380-1000its,751,794,2261.373376606,2231.182118057,-43
carcassonne-uct170-vs-uct35-1000its,755,798,2191.662974701,2132.614791614,-43
carcassonne-boltzmann50-vs-boltzmann365-1000its,756,799,2210.972051732,2155.57407788,-43
carcassonne-uct440-vs-uct120-1000its,756,799,2208.856439227,2160.431240605,-43
carcassonne-uct440-vs-uct160-1000its,756,799,2246.189956221,2204.540854105,-43
carcassonne-ucttuned105-vs-ucttuned370-1000its,756,799,2256.600070852,2258.9556808,-43
carcassonne-boltzmann205-vs-boltzmann160-1000its,757,800,2151.856809125,2078.65395283,-43
carcassonne-uct335-vs-uct35-1000its,757,800,2257.144566756,2211.06820625,-43
carcassonne-boltzmann350-vs-boltzmann25-1000its,758,801,2130.006970492,2094.059351963,-43
carcassonne-ucttuned295-vs-ucttuned395-1000its,758,801,2161.021244976,2094.546489781,-43
carcassonne-boltzmann90-vs-boltzmann60-1000its,760,803,2154.761471995,2150.748144057,-43
carcassonne-uct130-vs-uct115-1000its,761,804,2206.804225674,2119.190557716,-43
carcassonne-boltzmann245-vs-boltzmann90-1000its,765,808,2194.671267712,2168.757934802,-43
carcassonne-uct240-vs-uct415-1000its,765,808,2168.568969481,2062.002271969,-43
carcassonne-boltzmann145-vs-boltzmann180-1000its,766,809,2168.836003411,2109.742116752,-43
carcassonne-boltzmann265-vs-boltzmann140-1000its,766,809,2177.334894437,2138.885626934,-43
carcassonne-boltzmann370-vs-boltzmann290-1000its,766,809,2220.965564331,2186.036388375,-43
carcassonne-boltzmann380-vs-boltzmann440-1000its,767,810,2175.851508799,2090.541927115,-43
carcassonne-uct205-vs-uct365-1000its,767,810,2271.946647176,2246.221497258,-43
carcassonne-uct215-vs-uct85-1000its,767,810,2172.475133823,2151.851130597,-43
carcassonne-boltzmann155-vs-boltzmann80-1000its,768,811,2229.089056311,2195.199185114,-43
carcassonne-uct330-vs-uct190-1000its,769,812,2170.186353515,2170.469761716,-43
carcassonne-ucttuned440-vs-ucttuned95-1000its,769,812,2204.480421127,2148.171236851,-43
carcassonne-uct370-vs-uct470-1000its,771,814,2163.067843484,2125.17215886,-43
carcassonne-boltzmann170-vs-boltzmann45-1000its,772,815,2147.047333901,2095.207006972,-43
carcassonne-uct115-vs-uct260-1000its,774,817,2262.941637307,2200.762936702,-43
carcassonne-uct215-vs-uct280-1000its,776,819,2225.502147675,2184.702497856,-43
carcassonne-boltzmann240-vs-boltzmann480-1000its,777,820,2214.888096868,2163.147169967,-43
carcassonne-boltzmann335-vs-boltzmann370-1000its,777,820,2163.789379713,2088.999152273,-43
carcassonne-boltzmann405-vs-boltzmann65-1000its,778,821,2240.337228781,2220.532393009,-43
carcassonne-boltzmann310-vs-boltzmann95-1000its,780,823,2181.052639223,2112.634691665,-43
carcassonne-boltzmann80-vs-boltzmann195-1000its,780,823,2269.965547776,2235.623127902,-43
carcassonne-uct250-vs-uct485-1000its,780,823,2203.571888526,2175.48350382,-43
carcassonne-uct260-vs-uct160-1000its,780,823,2283.263707137,2225.283133462,-43
carcassonne-boltzmann380-vs-boltzmann425-1000its,783,826,2121.971541578,2091.217692908,-43
carcassonne-uct405-vs-uct95-1000its,783,826,2209.519960622,2154.964641981,-43
carcassonne-ucttuned360-vs-ucttuned195-1000its,783,826,2176.725086618,2125.719671375,-43
carcassonne-boltzmann170-vs-boltzmann360-1000its,784,827,2138.682088137,2103.822145834,-43
carcassonne-boltzmann245-vs-boltzmann370-1000its,784,827,2229.475403767,2212.898507657,-43
carcassonne-ucttuned330-vs-ucttuned30-1000its,784,827,2106.225558117,2061.480747009,-43
carcassonne-ucttuned425-vs-ucttuned265-1000its,784,827,2246.080389121,2134.809590367,-43
carcassonne-uct180-vs-uct260-1000its,785,828,2180.76982788,2124.055471199,-43
carcassonne-ucttuned480-vs-ucttuned140-1000its,785,828,2213.294654322,2124.248638518,-43
carcassonne-uct75-vs-uct465-1000its,789,832,2192.932356714,2145.967704697,-43
carcassonne-boltzmann280-vs-boltzmann460-1000its,790,833,2189.230587016,2156.261157531,-43
carcassonne-uct320-vs-uct130-1000its,791,834,2205.198353972,2145.387328833,-43
carcassonne-ucttuned365-vs-ucttuned145-1000its,791,834,2250.676612628,2183.851317758,-43
carcassonne-uct450-vs-uct220-1000its,792,835,2264.426183313,2214.586059503,-43
carcassonne-uct450-vs-uct370-1000its,792,835,2199.786994682,2154.160641661,-43
carcassonne-ucttuned385-vs-ucttuned70-1000its,792,835,2231.29794634,2241.867440703,-43
carcassonne-boltzmann365-vs-boltzmann130-1000its,793,836,2253.31353859,2193.897874449,-43
carcassonne-ucttuned285-vs-ucttuned460-1000its,793,836,2179.494036282,2095.351399458,-43
carcassonne-ucttuned290-vs-ucttuned155-1000its,793,836,2182.034142257,2148.677561489,-43
carcassonne-uct165-vs-uct135-1000its,794,837,2189.523705063,2150.53839247,-43
carcassonne-uct305-vs-uct110-1000its,794,837,2160.057596636,2135.717621131,-43
carcassonne-ucttuned190-vs-ucttuned50-1000its,796,839,2141.530596746,2103.920072247,-43
carcassonne-ucttuned210-vs-ucttuned135-1000its,797,840,2128.631465224,2110.469209072,-43
carcassonne-boltzmann140-vs-boltzmann265-1000its,801,844,2127.078183414,2110.764077773,-43
carcassonne-uct495-vs-uct205-1000its,801,844,2267.789032923,2267.653508227,-43
carcassonne-uct460-vs-uct210-1000its,802,845,2158.059675806,2145.857040103,-43
carcassonne-uct410-vs-uct350-1000its,803,846,2159.570903994,2108.599899127,-43
carcassonne-ucttuned255-vs-ucttuned310-1000its,804,847,2276.088041756,2185.145442871,-43
carcassonne-uct40-vs-uct410-1000its,805,848,2230.276516151,2167.529223712,-43
carcassonne-boltzmann235-vs-boltzmann120-1000its,806,849,2246.770576609,2169.321360051,-43
carcassonne-uct235-vs-uct280-1000its,807,850,2181.913902957,2179.155214143,-43
carcassonne-ucttuned315-vs-ucttuned340-1000its,807,850,2180.776963566,2146.466016574,-43
carcassonne-uct430-vs-uct360-1000its,810,853,2213.391634131,2194.829704901,-43
carcassonne-uct275-vs-uct365-1000its,811,854,2195.626987673,2128.077788869,-43
carcassonne-ucttuned435-vs-ucttuned410-1000its,812,855,2232.153678094,2180.307782446,-43
carcassonne-ucttuned45-vs-ucttuned195-1000its,812,855,2175.575596338,2121.05354495,-43
carcassonne-boltzmann235-vs-boltzmann85-1000its,813,856,2204.207708979,2195.398390573,-43
carcassonne-uct140-vs-uct125-1000its,815,858,2152.580633225,2129.588951507,-43
carcassonne-boltzmann125-vs-boltzmann490-1000its,816,859,2239.100530592,2163.970191622,-43
carcassonne-ucttuned435-vs-ucttuned45-1000its,816,859,2179.955048282,2162.502693729,-43
carcassonne-boltzmann20-vs-boltzmann390-1000its,817,860,2249.024192396,2212.85094052,-43
carcassonne-boltzmann465-vs-boltzmann125-1000its,817,860,2193.145443781,2181.77221765,-43
carcassonne-ucttuned205-vs-ucttuned460-1000its,817,860,2135.084335236,2106.232300578,-43
carcassonne-uct370-vs-uct400-1000its,818,861,2234.426213304,2161.946659831,-43
carcassonne-ucttuned420-vs-ucttuned200-1000its,818,861,2214.051307562,2160.053389802,-43
carcassonne-uct460-vs-uct160-1000its,819,862,2193.676234671,2133.197663254,-43
carcassonne-uct495-vs-uct400-1000its,820,863,2264.028514476,2216.539128355,-43
carcassonne-ucttuned420-vs-ucttuned5-1000its,821,864,2165.895226112,2120.541390724,-43
carcassonne-boltzmann350-vs-boltzmann465-1000its,822,865,2200.087020873,2159.769267647,-43
carcassonne-boltzmann240-vs-boltzmann135-1000its,823,866,2193.901000707,2149.549402952,-43
carcassonne-boltzmann215-vs-boltzmann80-1000its,824,867,2200.174766121,2135.462311279,-43
carcassonne-uct345-vs-uct480-1000its,825,868,2201.370633662,2130.918387212,-43
carcassonne-ucttuned410-vs-ucttuned290-1000its,825,868,2157.920814765,2140.181471472,-43
carcassonne-ucttuned95-vs-ucttuned450-1000its,825,868,2149.308817349,2099.786011489,-43
carcassonne-boltzmann355-vs-boltzmann45-1000its,826,869,2239.197724278,2105.344854133,-43
carcassonne-ucttuned185-vs-ucttuned460-1000its,826,869,2240.141020019,2160.80537058,-43
carcassonne-boltzmann155-vs-boltzmann295-1000its,829,872,2193.224864492,2153.836128316,-43
carcassonne-ucttuned245-vs-ucttuned395-1000its,830,873,2234.628796207,2185.859085442,-43
carcassonne-boltzmann370-vs-boltzmann455-1000its,832,875,2192.756676871,2150.52070914,-43
carcassonne-uct65-vs-uct50-1000its,835,878,2189.433923177,2112.145309296,-43
carcassonne-ucttuned380-vs-ucttuned490-1000its,836,879,2167.200383015,2111.615861027,-43
carcassonne-ucttuned290-vs-ucttuned420-1000its,838,881,2214.390827556,2207.904140095,-43
carcassonne-ucttuned40-vs-ucttuned35-1000its,844,887,2180.933074824,2125.849459891,-43
carcassonne-boltzmann175-vs-boltzmann365-1000its,846,889,2153.949691451,2100.410434712,-43
carcassonne-boltzmann120-vs-boltzmann65-1000its,848,891,2187.231451444,2138.125893455,-43
carcassonne-uct495-vs-uct355-1000its,849,892,2236.561861697,2196.652587815,-43
carcassonne-ucttuned335-vs-ucttuned35-1000its,853,896,2176.719334078,2147.088298989,-43
carcassonne-ucttuned205-vs-ucttuned405-1000its,854,897,2109.96306559,2045.683612113,-43
carcassonne-ucttuned175-vs-ucttuned35-1000its,858,901,2182.218214545,2165.461243566,-43
carcassonne-ucttuned165-vs-ucttuned60-1000its,861,904,2130.172830936,2082.280283592,-43
carcassonne-ucttuned475-vs-ucttuned280-1000its,867,910,2233.18602418,2142.092402682,-43
carcassonne-uct5-vs-uct410-1000its,871,914,2202.156686268,2126.348550802,-43
carcassonne-ucttuned205-vs-ucttuned120-1000its,877,920,2164.852994929,2098.971889388,-43
carcassonne-uct85-vs-uct230-1000its,690,732,2184.892998686,2159.68486304,-42
carcassonne-uct475-vs-uct305-1000its,701,743,2190.215527254,2147.159145851,-42
carcassonne-boltzmann380-vs-boltzmann255-1000its,706,748,2187.544067096,2159.526593346,-42
carcassonne-boltzmann170-vs-boltzmann260-1000its,717,759,2220.184709693,2153.192241514,-42
carcassonne-boltzmann20-vs-boltzmann240-1000its,723,765,2137.477993543,2097.756153176,-42
carcassonne-boltzmann470-vs-boltzmann260-1000its,725,767,2211.945175885,2187.278329417,-42
carcassonne-ucttuned175-vs-ucttuned195-1000its,725,767,2201.766728765,2165.478315453,-42
carcassonne-uct275-vs-uct495-1000its,726,768,2159.492595266,2083.312417702,-42
carcassonne-boltzmann30-vs-boltzmann140-1000its,728,770,2185.890795155,2155.431552843,-42
carcassonne-ucttuned325-vs-ucttuned220-1000its,728,770,2292.59734355,2262.29130244,-42
carcassonne-uct155-vs-uct295-1000its,731,773,2160.861531866,2098.83877418,-42
carcassonne-ucttuned365-vs-ucttuned380-1000its,733,775,2170.841525074,2138.769058164,-42
carcassonne-boltzmann185-vs-boltzmann450-1000its,735,777,2248.64221253,2204.079731503,-42
carcassonne-uct95-vs-uct300-1000its,735,777,2143.334788797,2115.718841248,-42
carcassonne-ucttuned300-vs-ucttuned40-1000its,736,778,2158.736169158,2131.62498917,-42
carcassonne-uct375-vs-uct85-1000its,738,780,2221.901193067,2209.447205064,-42
carcassonne-ucttuned375-vs-ucttuned175-1000its,738,780,2216.730841171,2194.366566102,-42
carcassonne-ucttuned325-vs-ucttuned70-1000its,740,782,2208.184755676,2195.678123993,-42
carcassonne-ucttuned380-vs-ucttuned230-1000its,741,783,2224.493951466,2219.110595096,-42
carcassonne-uct485-vs-uct50-1000its,742,784,2234.424240191,2156.185466562,-42
carcassonne-ucttuned50-vs-ucttuned395-1000its,745,787,2316.333371728,2204.971319637,-42
carcassonne-ucttuned370-vs-ucttuned450-1000its,747,789,2143.828360919,2138.523375518,-42
carcassonne-boltzmann30-vs-boltzmann490-1000its,750,792,2214.165013471,2159.691266833,-42
carcassonne-boltzmann65-vs-boltzmann135-1000its,756,798,2172.558557705,2103.79742134,-42
carcassonne-uct25-vs-uct70-1000its,756,798,2236.28603468,2200.978893001,-42
carcassonne-uct275-vs-uct355-1000its,757,799,2223.846831378,2180.872414058,-42
carcassonne-uct430-vs-uct225-1000its,757,799,2203.774494499,2158.787615821,-42
carcassonne-ucttuned165-vs-ucttuned490-1000its,758,800,2153.479935581,2113.464501092,-42
carcassonne-ucttuned250-vs-ucttuned20-1000its,758,800,2207.433084805,2109.624473168,-42
carcassonne-uct170-vs-uct370-1000its,759,801,2246.940425279,2172.093181551,-42
carcassonne-uct235-vs-uct445-1000its,759,801,2123.670684768,2094.536951364,-42
carcassonne-uct340-vs-uct255-1000its,759,801,2155.543030794,2164.820990741,-42
carcassonne-uct485-vs-uct15-1000its,759,801,2194.039374613,2137.725550378,-42
carcassonne-boltzmann425-vs-boltzmann320-1000its,761,803,2153.816814079,2120.44297841,-42
carcassonne-ucttuned405-vs-ucttuned240-1000its,761,803,2195.728106273,2117.207118271,-42
carcassonne-boltzmann110-vs-boltzmann190-1000its,762,804,2231.245670356,2126.581484903,-42
carcassonne-uct170-vs-uct80-1000its,762,804,2157.969390072,2129.472202989,-42
carcassonne-ucttuned185-vs-ucttuned245-1000its,762,804,2166.840886034,2129.417778316,-42
carcassonne-uct120-vs-uct495-1000its,763,805,2203.358230836,2130.768405393,-42
carcassonne-uct15-vs-uct140-1000its,764,806,2121.358072668,2087.159449318,-42
carcassonne-uct240-vs-uct230-1000its,764,806,2160.105483416,2067.280868073,-42
carcassonne-ucttuned440-vs-ucttuned460-1000its,764,806,2118.004183374,2101.756271992,-42
carcassonne-boltzmann180-vs-boltzmann430-1000its,765,807,2159.183234768,2111.175845025,-42
carcassonne-boltzmann275-vs-boltzmann140-1000its,765,807,2173.949418686,2149.263301321,-42
carcassonne-ucttuned200-vs-ucttuned420-1000its,765,807,2151.66452164,2141.20770534,-42
carcassonne-uct25-vs-uct100-1000its,767,809,2202.296910884,2127.198248179,-42
carcassonne-ucttuned115-vs-ucttuned350-1000its,768,810,2277.205566102,2199.446084067,-42
carcassonne-boltzmann285-vs-boltzmann235-1000its,770,812,2189.946508655,2127.270995013,-42
carcassonne-uct140-vs-uct50-1000its,770,812,2170.430425817,2112.115949233,-42
carcassonne-boltzmann285-vs-boltzmann105-1000its,771,813,2177.792595737,2146.484651905,-42
carcassonne-uct330-vs-uct30-1000its,771,813,2178.616513971,2137.778969225,-42
carcassonne-uct160-vs-uct430-1000its,772,814,2217.009917446,2149.298190127,-42
carcassonne-boltzmann95-vs-boltzmann250-1000its,773,815,2244.940746534,2169.3088852,-42
carcassonne-uct85-vs-uct390-1000its,773,815,2235.177297064,2191.430048361,-42
carcassonne-boltzmann295-vs-boltzmann165-1000its,774,816,2161.35755698,2122.408299124,-42
carcassonne-boltzmann305-vs-boltzmann370-1000its,774,816,2186.379857044,2100.222176438,-42
carcassonne-boltzmann455-vs-boltzmann290-1000its,774,816,2184.204269956,2167.190326199,-42
carcassonne-ucttuned165-vs-ucttuned240-1000its,774,816,2200.156065345,2165.49118336,-42
carcassonne-boltzmann100-vs-boltzmann405-1000its,775,817,2240.778484888,2213.675001248,-42
carcassonne-uct155-vs-uct180-1000its,775,817,2122.256060327,2122.847606636,-42
carcassonne-uct440-vs-uct15-1000its,775,817,2200.459474001,2187.730385642,-42
carcassonne-uct320-vs-uct300-1000its,776,818,2193.636663483,2152.239137711,-42
carcassonne-boltzmann90-vs-boltzmann45-1000its,777,819,2249.820740519,2211.625032487,-42
carcassonne-ucttuned185-vs-ucttuned450-1000its,777,819,2199.94085389,2188.505478728,-42
carcassonne-ucttuned400-vs-ucttuned455-1000its,780,822,2160.018619024,2120.976320647,-42
carcassonne-ucttuned70-vs-ucttuned315-1000its,780,822,2171.53137351,2132.955311245,-42
carcassonne-uct100-vs-uct345-1000its,782,824,2132.223026339,2113.536669113,-42
carcassonne-uct375-vs-uct175-1000its,782,824,2254.851913141,2226.432825526,-42
carcassonne-boltzmann30-vs-boltzmann145-1000its,783,825,2207.583604731,2191.873398912,-42
carcassonne-ucttuned420-vs-ucttuned445-1000its,784,826,2170.749530547,2141.004295585,-42
carcassonne-ucttuned465-vs-ucttuned195-1000its,784,826,2202.967532129,2155.368590159,-42
carcassonne-ucttuned165-vs-ucttuned190-1000its,786,828,2250.847074592,2202.197229714,-42
carcassonne-ucttuned295-vs-ucttuned215-1000its,786,828,2225.375510488,2136.019734887,-42
carcassonne-ucttuned280-vs-ucttuned445-1000its,788,830,2200.461977734,2143.943923883,-42
carcassonne-uct100-vs-uct155-1000its,789,831,2178.635701768,2140.384927161,-42
carcassonne-ucttuned255-vs-ucttuned65-1000its,789,831,2231.954375577,2169.983309124,-42
carcassonne-boltzmann380-vs-boltzmann280-1000its,790,832,2259.566079984,2159.829646203,-42
carcassonne-uct85-vs-uct270-1000its,791,833,2178.8431724,2153.751678661,-42
carcassonne-uct410-vs-uct235-1000its,792,834,2195.827167069,2135.414256564,-42
carcassonne-boltzmann155-vs-boltzmann245-1000its,794,836,2263.431264566,2181.845109427,-42
carcassonne-boltzmann185-vs-boltzmann190-1000its,797,839,2219.746954205,2183.021698954,-42
carcassonne-uct195-vs-uct435-1000its,798,840,2125.778071612,2082.840723756,-42
carcassonne-uct180-vs-uct390-1000its,802,844,2188.234781644,2122.92318436,-42
carcassonne-ucttuned145-vs-ucttuned135-1000its,802,844,2207.73654674,2156.218216878,-42
carcassonne-ucttuned460-vs-ucttuned245-1000its,802,844,2177.504329779,2163.171608556,-42
carcassonne-boltzmann90-vs-boltzmann495-1000its,803,845,2198.076344905,2158.292787995,-42
carcassonne-ucttuned230-vs-ucttuned470-1000its,803,845,2251.444700408,2200.45750262,-42
carcassonne-ucttuned355-vs-ucttuned25-1000its,803,845,2208.614835189,2145.388585316,-42
carcassonne-ucttuned400-vs-ucttuned275-1000its,803,845,2167.95358449,2153.733101125,-42
carcassonne-boltzmann425-vs-boltzmann250-1000its,804,846,2232.050449183,2179.875084624,-42
carcassonne-ucttuned105-vs-ucttuned375-1000its,805,847,2210.186040048,2145.652424553,-42
carcassonne-boltzmann440-vs-boltzmann200-1000its,806,848,2211.387255955,2165.44055293,-42
carcassonne-uct470-vs-uct120-1000its,807,849,2136.734100768,2165.37317635,-42
carcassonne-uct5-vs-uct380-1000its,808,850,2215.99485494,2181.847152956,-42
carcassonne-uct320-vs-uct350-1000its,809,851,2179.849226169,2147.970710104,-42
carcassonne-ucttuned250-vs-ucttuned85-1000its,810,852,2166.865358012,2111.174945548,-42
carcassonne-boltzmann200-vs-boltzmann390-1000its,811,853,2206.503655938,2162.098027708,-42
carcassonne-ucttuned470-vs-ucttuned40-1000its,812,854,2194.137792702,2203.406797471,-42
carcassonne-uct115-vs-uct325-1000its,813,855,2244.484691579,2243.758016606,-42
carcassonne-ucttuned335-vs-ucttuned105-1000its,813,855,2159.833417657,2124.778161615,-42
carcassonne-ucttuned470-vs-ucttuned420-1000its,813,855,2189.835853303,2147.534597572,-42
carcassonne-boltzmann350-vs-boltzmann10-1000its,814,856,2197.128871818,2174.693676767,-42
carcassonne-ucttuned105-vs-ucttuned475-1000its,815,857,2222.668921036,2207.160357743,-42
carcassonne-boltzmann470-vs-boltzmann85-1000its,816,858,2124.842442722,2102.564435363,-42
carcassonne-uct335-vs-uct305-1000its,817,859,2224.563151791,2171.486864094,-42
carcassonne-uct360-vs-uct370-1000its,817,859,2200.798053123,2145.150959307,-42
carcassonne-uct260-vs-uct385-1000its,819,861,2215.705961547,2180.363436371,-42
carcassonne-boltzmann315-vs-boltzmann430-1000its,820,862,2211.942115669,2175.356115447,-42
carcassonne-boltzmann450-vs-boltzmann100-1000its,820,862,2208.049896871,2147.088896188,-42
carcassonne-boltzmann330-vs-boltzmann340-1000its,823,865,2197.787364185,2170.062850864,-42
carcassonne-boltzmann225-vs-boltzmann300-1000its,824,866,2189.877239693,2165.737711348,-42
carcassonne-boltzmann5-vs-boltzmann130-1000its,824,866,2175.502062884,2166.105089486,-42
carcassonne-uct200-vs-uct275-1000its,826,868,2260.183758943,2246.554370446,-42
carcassonne-uct315-vs-uct100-1000its,826,868,2141.604465214,2100.829496063,-42
carcassonne-ucttuned285-vs-ucttuned345-1000its,827,869,2215.532772626,2187.878848228,-42
carcassonne-ucttuned30-vs-ucttuned340-1000its,827,869,2155.23557895,2109.594745834,-42
carcassonne-boltzmann90-vs-boltzmann95-1000its,829,871,2238.42278518,2188.20515453,-42
carcassonne-boltzmann155-vs-boltzmann125-1000its,830,872,2199.455641196,2165.878849215,-42
carcassonne-boltzmann335-vs-boltzmann450-1000its,832,874,2199.038979864,2159.460368862,-42
carcassonne-ucttuned415-vs-ucttuned175-1000its,833,875,2187.918959415,2147.150347271,-42
carcassonne-boltzmann95-vs-boltzmann450-1000its,837,879,2236.676633863,2186.347039587,-42
carcassonne-ucttuned435-vs-ucttuned385-1000its,838,880,2206.680529253,2140.070125517,-42
carcassonne-ucttuned435-vs-ucttuned370-1000its,841,883,2175.399785526,2130.978868583,-42
carcassonne-ucttuned485-vs-ucttuned95-1000its,843,885,2191.580721065,2169.074565007,-42
carcassonne-ucttuned85-vs-ucttuned200-1000its,846,888,2217.480482184,2202.70086504,-42
carcassonne-ucttuned270-vs-ucttuned260-1000its,847,889,2161.864436659,2139.454324459,-42
carcassonne-boltzmann240-vs-boltzmann20-1000its,854,896,2235.919775879,2175.915883632,-42
carcassonne-ucttuned275-vs-ucttuned195-1000its,854,896,2210.027908399,2173.300911571,-42
carcassonne-ucttuned245-vs-ucttuned50-1000its,855,897,2170.697511734,2160.137595825,-42
carcassonne-ucttuned50-vs-ucttuned175-1000its,858,900,2189.079800186,2140.995685676,-42
carcassonne-uct235-vs-uct5-1000its,868,910,2294.395839729,2257.505972918,-42
carcassonne-ucttuned100-vs-ucttuned205-1000its,868,910,2190.187950343,2136.367841263,-42
carcassonne-ucttuned20-vs-ucttuned55-1000its,868,910,2176.588517778,2118.921619995,-42
carcassonne-uct375-vs-uct145-1000its,881,923,2160.848454401,2139.072440998,-42
carcassonne-ucttuned230-vs-ucttuned90-1000its,883,925,2150.006966013,2155.705972893,-42
carcassonne-ucttuned435-vs-ucttuned280-1000its,891,933,2179.923253541,2115.214783118,-42
carcassonne-boltzmann490-vs-boltzmann110-1000its,710,751,2203.448288586,2170.863403066,-41
carcassonne-boltzmann245-vs-boltzmann95-1000its,714,755,2174.250039826,2168.16010023,-41
carcassonne-boltzmann295-vs-boltzmann435-1000its,717,758,2166.162134338,2097.474179263,-41
carcassonne-ucttuned105-vs-ucttuned425-1000its,718,759,2158.746494159,2158.07908214,-41
carcassonne-uct315-vs-uct135-1000its,720,761,2217.696837656,2174.32889729,-41
carcassonne-boltzmann230-vs-boltzmann120-1000its,721,762,2185.249806429,2118.028879634,-41
carcassonne-uct445-vs-uct280-1000its,728,769,2190.324035068,2137.284381664,-41
carcassonne-ucttuned150-vs-ucttuned145-1000its,728,769,2230.47962114,2215.032330597,-41
carcassonne-boltzmann40-vs-boltzmann395-1000its,730,771,2239.24844954,2195.701644318,-41
carcassonne-uct180-vs-uct170-1000its,731,772,2208.459016662,2135.94453757,-41
carcassonne-uct20-vs-uct200-1000its,732,773,2236.419980113,2161.470186001,-41
carcassonne-boltzmann320-vs-boltzmann20-1000its,737,778,2222.997498405,2169.785386364,-41
carcassonne-ucttuned390-vs-ucttuned420-1000its,741,782,2166.929620374,2155.139717573,-41
carcassonne-boltzmann305-vs-boltzmann390-1000its,742,783,2206.007555908,2154.683291762,-41
carcassonne-boltzmann110-vs-boltzmann75-1000its,743,784,2255.660873955,2169.55498698,-41
carcassonne-uct265-vs-uct490-1000its,744,785,2166.718272366,2155.668191576,-41
carcassonne-uct140-vs-uct230-1000its,745,786,2124.923993842,2129.244665704,-41
carcassonne-boltzmann190-vs-boltzmann215-1000its,749,790,2262.48039096,2188.271107052,-41
carcassonne-uct55-vs-uct385-1000its,750,791,2188.099549941,2140.159365608,-41
carcassonne-boltzmann160-vs-boltzmann290-1000its,751,792,2158.786465835,2088.456674812,-41
carcassonne-boltzmann85-vs-boltzmann440-1000its,751,792,2191.950051201,2130.9374738,-41
carcassonne-boltzmann395-vs-boltzmann20-1000its,752,793,2212.982554469,2182.255529237,-41
carcassonne-boltzmann450-vs-boltzmann105-1000its,752,793,2219.518797995,2136.135677518,-41
carcassonne-uct40-vs-uct30-1000its,753,794,2165.046066065,2142.989332938,-41
carcassonne-uct85-vs-uct120-1000its,754,795,2198.719103892,2139.877495609,-41
carcassonne-uct150-vs-uct480-1000its,755,796,2167.964631547,2148.855163248,-41
carcassonne-uct475-vs-uct235-1000its,755,796,2171.07632681,2110.553729607,-41
carcassonne-uct95-vs-uct325-1000its,757,798,2177.171154081,2150.86432542,-41
carcassonne-uct290-vs-uct335-1000its,758,799,2183.6323704,2104.570145312,-41
carcassonne-ucttuned330-vs-ucttuned410-1000its,758,799,2174.126960751,2129.451017878,-41
carcassonne-boltzmann140-vs-boltzmann175-1000its,762,803,2132.107047159,2099.668879362,-41
carcassonne-uct400-vs-uct225-1000its,764,805,2261.107616018,2273.127314278,-41
carcassonne-boltzmann365-vs-boltzmann455-1000its,766,807,2295.250436739,2242.114756035,-41
carcassonne-boltzmann85-vs-boltzmann390-1000its,768,809,2164.609638023,2079.533074995,-41
carcassonne-uct150-vs-uct160-1000its,768,809,2183.292032575,2128.283393013,-41
carcassonne-boltzmann5-vs-boltzmann245-1000its,769,810,2206.058512657,2105.157274057,-41
carcassonne-boltzmann40-vs-boltzmann490-1000its,770,811,2234.956145814,2178.491674358,-41
carcassonne-uct320-vs-uct50-1000its,770,811,2185.707996607,2117.379395841,-41
carcassonne-ucttuned285-vs-ucttuned260-1000its,770,811,2170.471444812,2143.393376692,-41
carcassonne-ucttuned310-vs-ucttuned165-1000its,771,812,2211.625128223,2173.704849391,-41
carcassonne-boltzmann450-vs-boltzmann345-1000its,772,813,2235.892026882,2169.444652679,-41
carcassonne-uct335-vs-uct115-1000its,772,813,2139.778200335,2119.946561788,-41
carcassonne-ucttuned85-vs-ucttuned325-1000its,772,813,2204.122372912,2147.206461899,-41
carcassonne-uct420-vs-uct155-1000its,774,815,2301.823705753,2242.045055564,-41
carcassonne-uct370-vs-uct85-1000its,775,816,2224.168003527,2192.557574125,-41
carcassonne-boltzmann35-vs-boltzmann230-1000its,776,817,2246.666359674,2206.993282851,-41
carcassonne-boltzmann250-vs-boltzmann190-1000its,777,818,2275.151240098,2230.048157855,-41
carcassonne-boltzmann285-vs-boltzmann390-1000its,778,819,2197.700733327,2156.826858533,-41
carcassonne-boltzmann130-vs-boltzmann30-1000its,779,820,2212.501689356,2175.762972832,-41
carcassonne-boltzmann425-vs-boltzmann190-1000its,779,820,2150.603060648,2111.571697577,-41
carcassonne-boltzmann415-vs-boltzmann295-1000its,781,822,2177.086995401,2106.877687809,-41
carcassonne-boltzmann95-vs-boltzmann395-1000its,781,822,2200.542654494,2115.911844754,-41
carcassonne-ucttuned405-vs-ucttuned95-1000its,781,822,2254.100618152,2195.690530733,-41
carcassonne-ucttuned130-vs-ucttuned440-1000its,785,826,2201.164394714,2173.265825615,-41
carcassonne-ucttuned265-vs-ucttuned25-1000its,785,826,2145.603768226,2113.723143624,-41
carcassonne-ucttuned365-vs-ucttuned395-1000its,785,826,2133.388302876,2133.451718384,-41
carcassonne-ucttuned425-vs-ucttuned375-1000its,785,826,2192.497020061,2110.507091659,-41
carcassonne-boltzmann280-vs-boltzmann205-1000its,786,827,2228.853573321,2183.572959528,-41
carcassonne-ucttuned460-vs-ucttuned360-1000its,786,827,2214.842609547,2189.724775467,-41
carcassonne-uct100-vs-uct255-1000its,787,828,2166.934614864,2146.176463555,-41
carcassonne-boltzmann415-vs-boltzmann360-1000its,788,829,2184.494201699,2151.11369739,-41
carcassonne-boltzmann260-vs-boltzmann190-1000its,789,830,2186.10690264,2156.060157248,-41
carcassonne-boltzmann425-vs-boltzmann495-1000its,789,830,2234.724452009,2190.877994083,-41
carcassonne-ucttuned115-vs-ucttuned455-1000its,790,831,2192.040087927,2167.921379051,-41
carcassonne-boltzmann215-vs-boltzmann450-1000its,791,832,2127.623546193,2114.571350391,-41
carcassonne-boltzmann80-vs-boltzmann265-1000its,791,832,2147.231822431,2116.435236011,-41
carcassonne-boltzmann490-vs-boltzmann310-1000its,793,834,2164.531347383,2126.948286503,-41
carcassonne-boltzmann150-vs-boltzmann250-1000its,794,835,2193.088061396,2182.35148427,-41
carcassonne-ucttuned20-vs-ucttuned305-1000its,795,836,2097.743169793,2097.358175828,-41
carcassonne-uct255-vs-uct110-1000its,796,837,2164.695753764,2128.002695803,-41
carcassonne-uct70-vs-uct310-1000its,797,838,2173.290651203,2127.228275715,-41
carcassonne-ucttuned125-vs-ucttuned115-1000its,797,838,2277.283962255,2225.805627779,-41
carcassonne-boltzmann245-vs-boltzmann470-1000its,798,839,2150.784458755,2125.764704421,-41
carcassonne-boltzmann460-vs-boltzmann220-1000its,798,839,2143.823786149,2071.683158029,-41
carcassonne-uct135-vs-uct235-1000its,798,839,2219.426416968,2157.706321636,-41
carcassonne-ucttuned55-vs-ucttuned195-1000its,798,839,2146.31237598,2078.633954962,-41
carcassonne-uct100-vs-uct210-1000its,800,841,2172.526921751,2151.003695712,-41
carcassonne-uct415-vs-uct420-1000its,800,841,2176.631132012,2140.882545062,-41
carcassonne-boltzmann295-vs-boltzmann275-1000its,802,843,2197.887228366,2148.501746161,-41
carcassonne-boltzmann100-vs-boltzmann220-1000its,804,845,2124.649140003,2143.232559482,-41
carcassonne-ucttuned240-vs-ucttuned160-1000its,805,846,2190.856790614,2159.051563328,-41
carcassonne-boltzmann295-vs-boltzmann125-1000its,806,847,2121.326964443,2054.858649186,-41
carcassonne-uct335-vs-uct95-1000its,806,847,2186.151844093,2111.405464268,-41
carcassonne-ucttuned435-vs-ucttuned450-1000its,806,847,2186.353338475,2210.017579027,-41
carcassonne-uct490-vs-uct450-1000its,807,848,2195.732160681,2117.73548033,-41
carcassonne-ucttuned270-vs-ucttuned160-1000its,807,848,2158.259176336,2125.21624609,-41
carcassonne-boltzmann160-vs-boltzmann50-1000its,811,852,2243.335157338,2192.349255024,-41
carcassonne-uct365-vs-uct115-1000its,811,852,2230.514361708,2187.283112841,-41
carcassonne-ucttuned320-vs-ucttuned445-1000its,811,852,2289.477698518,2226.715790121,-41
carcassonne-boltzmann145-vs-boltzmann195-1000its,812,853,2259.644079761,2243.807532382,-41
carcassonne-uct225-vs-uct120-1000its,813,854,2183.612412892,2178.086945517,-41
carcassonne-ucttuned180-vs-ucttuned100-1000its,813,854,2234.356426914,2214.783586286,-41
carcassonne-uct325-vs-uct395-1000its,816,857,2133.650811766,2121.817140953,-41
carcassonne-ucttuned160-vs-ucttuned60-1000its,816,857,2162.374436259,2112.253587889,-41
carcassonne-uct25-vs-uct480-1000its,817,858,2211.798594683,2161.199810522,-41
carcassonne-uct310-vs-uct375-1000its,817,858,2157.266321113,2089.782450316,-41
carcassonne-ucttuned155-vs-ucttuned425-1000its,818,859,2151.419004945,2164.086815214,-41
carcassonne-ucttuned345-vs-ucttuned310-1000its,818,859,2189.652173548,2131.350877755,-41
carcassonne-ucttuned185-vs-ucttuned395-1000its,821,862,2181.834725179,2147.430300218,-41
carcassonne-ucttuned485-vs-ucttuned90-1000its,821,862,2112.113423848,2056.206802239,-41
carcassonne-ucttuned335-vs-ucttuned465-1000its,822,863,2185.046552186,2152.031331345,-41
carcassonne-boltzmann435-vs-boltzmann120-1000its,823,864,2257.252719563,2214.704698024,-41
carcassonne-boltzmann470-vs-boltzmann245-1000its,823,864,2206.190620613,2156.536642807,-41
carcassonne-uct420-vs-uct205-1000its,823,864,2126.82565162,2116.297082091,-41
carcassonne-uct255-vs-uct415-1000its,824,865,2242.217278603,2172.936810945,-41
carcassonne-ucttuned220-vs-ucttuned10-1000its,826,867,2178.453329758,2157.990803293,-41
carcassonne-ucttuned390-vs-ucttuned280-1000its,827,868,2270.045224807,2245.10915488,-41
carcassonne-uct95-vs-uct285-1000its,829,870,2238.997482122,2196.977555476,-41
carcassonne-ucttuned355-vs-ucttuned210-1000its,829,870,2190.537069,2146.92065809,-41
carcassonne-ucttuned455-vs-ucttuned420-1000its,829,870,2225.389825846,2197.497153891,-41
carcassonne-uct490-vs-uct30-1000its,831,872,2150.512742949,2135.801046117,-41
carcassonne-boltzmann160-vs-boltzmann10-1000its,834,875,2220.007589703,2172.574434301,-41
carcassonne-uct370-vs-uct290-1000its,834,875,2218.250934157,2188.379897317,-41
carcassonne-ucttuned300-vs-ucttuned150-1000its,836,877,2230.140986267,2165.363594983,-41
carcassonne-uct255-vs-uct80-1000its,840,881,2201.635550644,2153.000865395,-41
carcassonne-uct435-vs-uct445-1000its,850,891,2188.56717455,2164.024867986,-41
carcassonne-ucttuned120-vs-ucttuned465-1000its,853,894,2215.41063252,2174.670705959,-41
carcassonne-uct250-vs-uct375-1000its,856,897,2174.604531589,2137.102888193,-41
carcassonne-boltzmann170-vs-boltzmann330-1000its,861,902,2221.033251395,2180.316660758,-41
carcassonne-uct235-vs-uct340-1000its,869,910,2267.581811676,2212.960087162,-41
carcassonne-uct220-vs-uct110-1000its,872,913,2159.333303036,2156.755580942,-41
carcassonne-ucttuned150-vs-ucttuned365-1000its,703,743,2132.278043464,2103.524392062,-40
carcassonne-uct475-vs-uct465-1000its,707,747,2253.364076681,2193.312426827,-40
carcassonne-boltzmann420-vs-boltzmann410-1000its,710,750,2225.088833281,2190.714941964,-40
carcassonne-boltzmann95-vs-boltzmann105-1000its,714,754,2222.715770316,2180.859946684,-40
carcassonne-boltzmann425-vs-boltzmann40-1000its,716,756,2211.354482172,2119.913780485,-40
carcassonne-boltzmann480-vs-boltzmann370-1000its,723,763,2180.411385797,2127.693598818,-40
carcassonne-uct265-vs-uct40-1000its,724,764,2247.070839336,2195.401553518,-40
carcassonne-boltzmann85-vs-boltzmann235-1000its,725,765,2177.467555432,2141.87883409,-40
carcassonne-uct165-vs-uct30-1000its,730,770,2155.163268934,2135.685818083,-40
carcassonne-boltzmann125-vs-boltzmann390-1000its,731,771,2218.02325559,2140.365322735,-40
carcassonne-boltzmann130-vs-boltzmann280-1000its,735,775,2198.073941143,2176.090665977,-40
carcassonne-ucttuned385-vs-ucttuned305-1000its,739,779,2212.009380785,2195.247837664,-40
carcassonne-ucttuned240-vs-ucttuned250-1000its,740,780,2196.304662614,2145.26350423,-40
carcassonne-ucttuned175-vs-ucttuned395-1000its,741,781,2201.894154451,2153.326649397,-40
carcassonne-ucttuned355-vs-ucttuned145-1000its,742,782,2187.233627931,2101.328789012,-40
carcassonne-boltzmann190-vs-boltzmann65-1000its,743,783,2201.762299957,2179.749066635,-40
carcassonne-ucttuned265-vs-ucttuned100-1000its,745,785,2136.041252337,2083.432487862,-40
carcassonne-uct65-vs-uct395-1000its,746,786,2181.147557597,2119.258330365,-40
carcassonne-ucttuned300-vs-ucttuned145-1000its,746,786,2211.957460676,2215.388710246,-40
carcassonne-boltzmann390-vs-boltzmann295-1000its,748,788,2125.152380355,2088.093112864,-40
carcassonne-ucttuned270-vs-ucttuned85-1000its,748,788,2169.306131329,2165.065734502,-40
carcassonne-uct355-vs-uct115-1000its,749,789,2231.204586352,2186.818707455,-40
carcassonne-ucttuned375-vs-ucttuned420-1000its,750,790,2311.705452516,2282.156803644,-40
carcassonne-ucttuned300-vs-ucttuned265-1000its,751,791,2222.884032259,2156.978258077,-40
carcassonne-ucttuned190-vs-ucttuned270-1000its,753,793,2201.302791641,2132.152506882,-40
carcassonne-uct310-vs-uct200-1000its,754,794,2228.827339699,2196.381196534,-40
carcassonne-ucttuned275-vs-ucttuned360-1000its,754,794,2115.29032415,2076.747898505,-40
carcassonne-ucttuned210-vs-ucttuned425-1000its,757,797,2181.043292911,2146.517379357,-40
carcassonne-uct135-vs-uct190-1000its,759,799,2209.13601469,2154.849828766,-40
carcassonne-boltzmann125-vs-boltzmann130-1000its,761,801,2188.347112497,2182.65635956,-40
carcassonne-ucttuned400-vs-ucttuned415-1000its,761,801,2157.240174961,2128.47250686,-40
carcassonne-boltzmann210-vs-boltzmann190-1000its,763,803,2147.488118621,2097.403909901,-40
carcassonne-uct195-vs-uct425-1000its,763,803,2218.925700735,2177.722145843,-40
carcassonne-uct240-vs-uct25-1000its,764,804,2311.194302325,2224.387759217,-40
carcassonne-boltzmann230-vs-boltzmann410-1000its,765,805,2206.267311921,2148.618020654,-40
carcassonne-uct350-vs-uct255-1000its,766,806,2177.645880391,2089.096930214,-40
carcassonne-boltzmann360-vs-boltzmann225-1000its,767,807,2215.96975484,2182.184194485,-40
carcassonne-uct15-vs-uct360-1000its,767,807,2232.979826975,2167.576104969,-40
carcassonne-boltzmann45-vs-boltzmann70-1000its,768,808,2143.864217086,2094.425281746,-40
carcassonne-boltzmann215-vs-boltzmann345-1000its,769,809,2164.650590123,2176.163593678,-40
carcassonne-boltzmann435-vs-boltzmann270-1000its,770,810,2169.889728129,2119.661039641,-40
carcassonne-uct150-vs-uct455-1000its,773,813,2147.528062024,2089.596286468,-40
carcassonne-boltzmann390-vs-boltzmann485-1000its,774,814,2266.788381234,2204.360907102,-40
carcassonne-ucttuned100-vs-ucttuned135-1000its,774,814,2233.418997535,2179.843622792,-40
carcassonne-ucttuned180-vs-ucttuned385-1000its,774,814,2270.150186876,2176.188609372,-40
carcassonne-ucttuned235-vs-ucttuned35-1000its,774,814,2145.611867791,2123.603282211,-40
carcassonne-ucttuned320-vs-ucttuned75-1000its,777,817,2159.743590867,2141.691781156,-40
carcassonne-boltzmann175-vs-boltzmann95-1000its,779,819,2185.572490701,2168.20004376,-40
carcassonne-ucttuned250-vs-ucttuned55-1000its,779,819,2224.492273107,2172.060194998,-40
carcassonne-ucttuned390-vs-ucttuned175-1000its,781,821,2223.43865659,2171.686061853,-40
carcassonne-ucttuned450-vs-ucttuned295-1000its,781,821,2107.893494872,2029.036680633,-40
carcassonne-ucttuned225-vs-ucttuned370-1000its,782,822,2223.976468439,2198.403758824,-40
carcassonne-ucttuned465-vs-ucttuned290-1000its,783,823,2165.517991711,2137.293596462,-40
carcassonne-boltzmann75-vs-boltzmann180-1000its,785,825,2186.276780474,2147.799464886,-40
carcassonne-ucttuned120-vs-ucttuned185-1000its,785,825,2231.495918316,2163.544441741,-40
carcassonne-uct430-vs-uct235-1000its,786,826,2215.788604977,2096.27226772,-40
carcassonne-uct440-vs-uct420-1000its,787,827,2222.772471736,2127.619413435,-40
carcassonne-boltzmann350-vs-boltzmann430-1000its,788,828,2241.147502174,2153.389699427,-40
carcassonne-uct165-vs-uct280-1000its,788,828,2222.914257127,2172.237567774,-40
carcassonne-boltzmann10-vs-boltzmann200-1000its,790,830,2168.372338382,2102.544918624,-40
carcassonne-uct40-vs-uct195-1000its,790,830,2159.965757719,2156.210213756,-40
carcassonne-uct300-vs-uct320-1000its,791,831,2172.28373228,2165.347544045,-40
carcassonne-ucttuned360-vs-ucttuned115-1000its,793,833,2217.882690594,2138.645861045,-40
carcassonne-uct420-vs-uct475-1000its,794,834,2199.406097449,2152.786673264,-40
carcassonne-uct30-vs-uct295-1000its,795,835,2214.973717026,2168.550583402,-40
carcassonne-boltzmann10-vs-boltzmann115-1000its,797,837,2137.308511412,2096.851402831,-40
carcassonne-boltzmann455-vs-boltzmann85-1000its,799,839,2184.597881461,2124.756255818,-40
carcassonne-uct315-vs-uct305-1000its,800,840,2169.60717613,2120.62225645,-40
carcassonne-boltzmann385-vs-boltzmann275-1000its,801,841,2195.867089431,2176.593374896,-40
carcassonne-uct115-vs-uct290-1000its,801,841,2236.950528794,2179.441094926,-40
carcassonne-boltzmann100-vs-boltzmann30-1000its,803,843,2210.231844702,2117.077410741,-40
carcassonne-uct335-vs-uct250-1000its,804,844,2165.139184941,2113.081795102,-40
carcassonne-uct355-vs-uct60-1000its,804,844,2320.751625426,2287.42587346,-40
carcassonne-uct485-vs-uct490-1000its,807,847,2206.217828922,2192.344640011,-40
carcassonne-ucttuned200-vs-ucttuned30-1000its,810,850,2180.124387733,2140.683191179,-40
carcassonne-boltzmann350-vs-boltzmann35-1000its,811,851,2149.149676445,2153.955218764,-40
carcassonne-uct85-vs-uct160-1000its,811,851,2248.366588386,2199.449173939,-40
carcassonne-ucttuned65-vs-ucttuned160-1000its,811,851,2231.582993649,2168.21962038,-40
carcassonne-uct305-vs-uct485-1000its,812,852,2255.182060854,2202.582491434,-40
carcassonne-ucttuned35-vs-ucttuned495-1000its,812,852,2184.632964732,2129.526568577,-40
carcassonne-boltzmann165-vs-boltzmann370-1000its,813,853,2224.349303864,2207.303656146,-40
carcassonne-ucttuned75-vs-ucttuned40-1000its,813,853,2204.904621889,2179.683760331,-40
carcassonne-uct340-vs-uct165-1000its,815,855,2302.412041783,2264.677318998,-40
carcassonne-boltzmann25-vs-boltzmann305-1000its,817,857,2204.751512394,2182.36132025,-40
carcassonne-boltzmann450-vs-boltzmann315-1000its,817,857,2189.203308333,2136.071766078,-40
carcassonne-uct395-vs-uct320-1000its,820,860,2240.349027886,2222.912485581,-40
carcassonne-ucttuned450-vs-ucttuned275-1000its,820,860,2224.8901794,2196.961270282,-40
carcassonne-uct290-vs-uct115-1000its,827,867,2111.532835004,2102.189255882,-40
carcassonne-uct400-vs-uct370-1000its,828,868,2125.165810946,2106.763976279,-40
carcassonne-boltzmann250-vs-boltzmann275-1000its,830,870,2212.112628012,2161.160864437,-40
carcassonne-boltzmann130-vs-boltzmann80-1000its,831,871,2168.267653946,2159.525444084,-40
carcassonne-ucttuned200-vs-ucttuned385-1000its,833,873,2214.726700646,2189.273414553,-40
carcassonne-ucttuned495-vs-ucttuned485-1000its,836,876,2242.352244529,2218.487948173,-40
carcassonne-boltzmann205-vs-boltzmann185-1000its,840,880,2185.760680647,2109.83775735,-40
carcassonne-boltzmann475-vs-boltzmann205-1000its,844,884,2284.186344572,2189.4006056,-40
carcassonne-boltzmann300-vs-boltzmann375-1000its,845,885,2204.167819429,2187.423591248,-40
carcassonne-uct425-vs-uct95-1000its,847,887,2167.936062305,2100.462837761,-40
carcassonne-ucttuned370-vs-ucttuned150-1000its,847,887,2329.866317581,2238.516213016,-40
carcassonne-boltzmann390-vs-boltzmann460-1000its,848,888,2237.670047472,2202.109354358,-40
carcassonne-uct465-vs-uct420-1000its,848,888,2155.540704121,2125.63522794,-40
carcassonne-ucttuned40-vs-ucttuned45-1000its,848,888,2128.426335297,2123.167754259,-40
carcassonne-boltzmann135-vs-boltzmann210-1000its,849,889,2214.129518931,2177.662076864,-40
carcassonne-boltzmann355-vs-boltzmann145-1000its,850,890,2121.945294441,2071.67424004,-40
carcassonne-ucttuned365-vs-ucttuned290-1000its,856,896,2167.419533977,2159.283696775,-40
carcassonne-ucttuned45-vs-ucttuned285-1000its,857,897,2155.823677851,2107.457019909,-40
carcassonne-uct140-vs-uct205-1000its,861,901,2253.075514044,2215.775931009,-40
carcassonne-ucttuned295-vs-ucttuned495-1000its,879,919,2165.907478435,2153.058655603,-40
carcassonne-ucttuned430-vs-ucttuned465-1000its,603,642,1834.266896484,1803.607312711,-39
carcassonne-uct95-vs-uct10-1000its,624,663,1745.119975325,1717.720775111,-39
carcassonne-ucttuned315-vs-ucttuned245-1000its,717,756,2130.134511624,2120.155202874,-39
carcassonne-boltzmann100-vs-boltzmann175-1000its,722,761,2224.290237002,2195.452948786,-39
carcassonne-ucttuned120-vs-ucttuned65-1000its,724,763,2263.17746308,2254.304318802,-39
carcassonne-uct235-vs-uct230-1000its,725,764,2158.528979974,2075.09992574,-39
carcassonne-boltzmann415-vs-boltzmann215-1000its,727,766,2175.169251208,2115.085503952,-39
carcassonne-boltzmann325-vs-boltzmann120-1000its,728,767,2105.048873755,2071.645200178,-39
carcassonne-boltzmann485-vs-boltzmann110-1000its,729,768,2225.33201587,2158.393606788,-39
carcassonne-ucttuned130-vs-ucttuned365-1000its,730,769,2181.217606436,2117.508256018,-39
carcassonne-ucttuned405-vs-ucttuned220-1000its,732,771,2193.537142927,2115.802949918,-39
carcassonne-uct455-vs-uct250-1000its,733,772,2146.445757062,2086.503470277,-39
carcassonne-ucttuned425-vs-ucttuned480-1000its,736,775,2169.69534138,2139.146598498,-39
carcassonne-boltzmann150-vs-boltzmann95-1000its,739,778,2225.635509152,2183.865497076,-39
carcassonne-boltzmann25-vs-boltzmann475-1000its,741,780,2202.343003767,2120.222501712,-39
carcassonne-uct385-vs-uct435-1000its,742,781,2215.27537634,2164.521673833,-39
carcassonne-uct480-vs-uct250-1000its,744,783,2112.292346715,2090.34938611,-39
carcassonne-ucttuned355-vs-ucttuned155-1000its,744,783,2252.551631742,2205.208301757,-39
carcassonne-uct90-vs-uct450-1000its,745,784,2211.896224187,2136.012112878,-39
carcassonne-uct295-vs-uct60-1000its,749,788,2217.571355265,2167.537936799,-39
carcassonne-boltzmann230-vs-boltzmann330-1000its,751,790,2182.904996361,2118.344231862,-39
carcassonne-ucttuned160-vs-ucttuned245-1000its,756,795,2184.702995024,2109.630292717,-39
carcassonne-uct320-vs-uct390-1000its,757,796,2224.419367844,2206.174994787,-39
carcassonne-ucttuned460-vs-ucttuned80-1000its,757,796,2196.520562003,2122.516220863,-39
carcassonne-ucttuned215-vs-ucttuned340-1000its,760,799,2231.960661431,2160.415746066,-39
carcassonne-boltzmann275-vs-boltzmann330-1000its,762,801,2230.042295223,2168.242511592,-39
carcassonne-ucttuned215-vs-ucttuned470-1000its,763,802,2242.671226257,2185.834771812,-39
carcassonne-uct50-vs-uct185-1000its,764,803,2204.900090867,2139.779563329,-39
carcassonne-boltzmann310-vs-boltzmann445-1000its,766,805,2208.472427632,2146.681148821,-39
carcassonne-ucttuned85-vs-ucttuned425-1000its,766,805,2212.61627768,2171.101167497,-39
carcassonne-boltzmann300-vs-boltzmann35-1000its,767,806,2211.012883355,2130.999749837,-39
carcassonne-uct490-vs-uct375-1000its,767,806,2214.063914478,2134.074082244,-39
carcassonne-boltzmann195-vs-boltzmann170-1000its,769,808,2219.9007039,2179.276466959,-39
carcassonne-boltzmann440-vs-boltzmann310-1000its,769,808,2171.181892154,2172.387878793,-39
carcassonne-uct340-vs-uct35-1000its,769,808,2284.030706609,2257.675317814,-39
carcassonne-ucttuned40-vs-ucttuned80-1000its,769,808,2318.632051402,2232.787383929,-39
carcassonne-boltzmann105-vs-boltzmann425-1000its,770,809,2286.454172732,2222.673901442,-39
carcassonne-uct60-vs-uct75-1000its,770,809,2120.206600268,2113.914829608,-39
carcassonne-boltzmann370-vs-boltzmann50-1000its,773,812,2258.475797014,2211.98772756,-39
carcassonne-uct425-vs-uct395-1000its,775,814,2189.585950234,2133.94071895,-39
carcassonne-ucttuned25-vs-ucttuned175-1000its,775,814,2181.630052576,2087.631170521,-39
carcassonne-boltzmann220-vs-boltzmann325-1000its,776,815,2164.448699499,2149.982664493,-39
carcassonne-uct315-vs-uct150-1000its,776,815,2181.49911956,2165.41416892,-39
carcassonne-uct440-vs-uct185-1000its,776,815,2169.682081967,2099.961520957,-39
carcassonne-uct105-vs-uct160-1000its,778,817,2153.086421849,2145.219893306,-39
carcassonne-uct280-vs-uct45-1000its,778,817,2164.744152512,2141.231972873,-39
carcassonne-boltzmann250-vs-boltzmann170-1000its,779,818,2203.164777781,2127.943461081,-39
carcassonne-ucttuned415-vs-ucttuned290-1000its,779,818,2137.938229637,2151.591757525,-39
carcassonne-ucttuned485-vs-ucttuned215-1000its,780,819,2154.326903148,2122.285638215,-39
carcassonne-boltzmann5-vs-boltzmann340-1000its,781,820,2118.253550846,2070.899776743,-39
carcassonne-ucttuned365-vs-ucttuned175-1000its,781,820,2182.646539326,2141.815080539,-39
carcassonne-boltzmann205-vs-boltzmann40-1000its,782,821,2377.686340827,2310.698419417,-39
carcassonne-uct345-vs-uct30-1000its,782,821,2232.913564779,2145.629316829,-39
carcassonne-boltzmann380-vs-boltzmann165-1000its,783,822,2268.489012861,2190.953518005,-39
carcassonne-ucttuned120-vs-ucttuned260-1000its,784,823,2162.282480136,2110.314610112,-39
carcassonne-boltzmann85-vs-boltzmann70-1000its,785,824,2150.313924683,2098.60442945,-39
carcassonne-boltzmann95-vs-boltzmann125-1000its,786,825,2336.683508957,2261.50658027,-39
carcassonne-ucttuned190-vs-ucttuned240-1000its,786,825,2144.509313009,2093.235074804,-39
carcassonne-ucttuned110-vs-ucttuned245-1000its,787,826,2183.412830034,2163.922258304,-39
carcassonne-uct165-vs-uct195-1000its,788,827,2244.653946406,2221.481522875,-39
carcassonne-boltzmann455-vs-boltzmann50-1000its,789,828,2202.286639505,2183.367046292,-39
carcassonne-uct340-vs-uct120-1000its,789,828,2248.182528129,2221.760165096,-39
carcassonne-boltzmann490-vs-boltzmann410-1000its,791,830,2210.944591363,2117.45420954,-39
carcassonne-uct145-vs-uct345-1000its,791,830,2174.506453544,2181.648597226,-39
carcassonne-boltzmann120-vs-boltzmann35-1000its,792,831,2181.645750072,2179.457272783,-39
carcassonne-uct20-vs-uct235-1000its,792,831,2153.598102004,2064.448859859,-39
carcassonne-uct460-vs-uct275-1000its,793,832,2208.222281911,2184.905205905,-39
carcassonne-ucttuned325-vs-ucttuned255-1000its,793,832,2233.821283107,2167.441794203,-39
carcassonne-uct105-vs-uct480-1000its,794,833,2214.176898883,2126.635550589,-39
carcassonne-ucttuned190-vs-ucttuned170-1000its,795,834,2174.592191547,2146.845911814,-39
carcassonne-boltzmann135-vs-boltzmann205-1000its,796,835,2268.193110709,2208.603655585,-39
carcassonne-boltzmann150-vs-boltzmann10-1000its,798,837,2275.580053285,2219.91702995,-39
carcassonne-uct475-vs-uct5-1000its,799,838,2227.08025009,2194.749697471,-39
carcassonne-uct430-vs-uct160-1000its,803,842,2176.528951471,2144.10348843,-39
carcassonne-ucttuned215-vs-ucttuned280-1000its,805,844,2222.337182316,2188.167028497,-39
carcassonne-ucttuned470-vs-ucttuned10-1000its,805,844,2138.026791738,2128.029973052,-39
carcassonne-boltzmann245-vs-boltzmann20-1000its,807,846,2191.862590141,2172.122601547,-39
carcassonne-ucttuned310-vs-ucttuned490-1000its,807,846,2223.105493892,2188.742805156,-39
carcassonne-uct235-vs-uct480-1000its,813,852,2191.179043803,2143.81934969,-39
carcassonne-uct330-vs-uct20-1000its,815,854,2268.273040503,2244.913953957,-39
carcassonne-uct155-vs-uct5-1000its,817,856,2195.365976729,2185.029016475,-39
carcassonne-ucttuned475-vs-ucttuned45-1000its,817,856,2136.412698819,2110.71596065,-39
carcassonne-ucttuned185-vs-ucttuned225-1000its,818,857,2158.463606289,2092.780165921,-39
carcassonne-uct375-vs-uct390-1000its,819,858,2168.83290396,2137.329772625,-39
carcassonne-ucttuned440-vs-ucttuned105-1000its,819,858,2254.686944163,2184.138634747,-39
carcassonne-uct455-vs-uct405-1000its,820,859,2188.645260458,2143.085197851,-39
carcassonne-boltzmann305-vs-boltzmann225-1000its,826,865,2190.854733806,2165.864626993,-39
carcassonne-ucttuned210-vs-ucttuned190-1000its,826,865,2200.193361287,2196.388562961,-39
carcassonne-uct165-vs-uct230-1000its,827,866,2179.056846046,2140.569185942,-39
carcassonne-ucttuned15-vs-ucttuned230-1000its,827,866,2229.705708143,2161.36274489,-39
carcassonne-boltzmann290-vs-boltzmann35-1000its,829,868,2260.93755832,2141.526378171,-39
carcassonne-boltzmann485-vs-boltzmann260-1000its,834,873,2259.791809005,2223.867447373,-39
carcassonne-uct440-vs-uct340-1000its,835,874,2187.444183339,2146.541217046,-39
carcassonne-boltzmann45-vs-boltzmann85-1000its,837,876,2237.210479938,2152.571500691,-39
carcassonne-boltzmann150-vs-boltzmann195-1000its,840,879,2294.354450887,2227.900992711,-39
carcassonne-uct105-vs-uct380-1000its,841,880,2238.882287235,2198.386393258,-39
carcassonne-boltzmann10-vs-boltzmann155-1000its,842,881,2145.742344653,2091.046234625,-39
carcassonne-uct20-vs-uct180-1000its,844,883,2226.864815378,2134.605554683,-39
carcassonne-ucttuned370-vs-ucttuned410-1000its,845,884,2183.642358123,2110.68540811,-39
carcassonne-ucttuned385-vs-ucttuned240-1000its,845,884,2257.453707233,2201.204610641,-39
carcassonne-ucttuned410-vs-ucttuned10-1000its,845,884,2212.334187285,2216.835303418,-39
carcassonne-boltzmann380-vs-boltzmann485-1000its,850,889,2227.958186453,2172.324342168,-39
carcassonne-ucttuned365-vs-ucttuned60-1000its,851,890,2215.816370435,2145.374173699,-39
carcassonne-ucttuned240-vs-ucttuned455-1000its,861,900,2265.464307394,2196.126705767,-39
carcassonne-boltzmann445-vs-boltzmann55-1000its,866,905,2215.224089198,2159.207568247,-39
carcassonne-ucttuned30-vs-ucttuned80-1000its,875,914,2274.837743893,2220.560640264,-39
carcassonne-boltzmann50-vs-boltzmann475-1000its,877,916,2213.101317481,2120.740288022,-39
carcassonne-uct315-vs-uct340-1000its,879,918,2230.803249488,2208.965185095,-39
carcassonne-boltzmann300-vs-boltzmann475-1000its,685,723,2239.388902484,2138.331427032,-38
carcassonne-boltzmann490-vs-boltzmann455-1000its,710,748,2270.433053905,2244.437802411,-38
carcassonne-uct275-vs-uct460-1000its,711,749,2243.993965042,2163.115741404,-38
carcassonne-ucttuned485-vs-ucttuned105-1000its,712,750,2114.481741596,2093.625255201,-38
carcassonne-boltzmann110-vs-boltzmann395-1000its,716,754,2190.558947913,2136.781471662,-38
carcassonne-ucttuned165-vs-ucttuned340-1000its,716,754,2230.020185964,2187.796835134,-38
carcassonne-ucttuned265-vs-ucttuned170-1000its,719,757,2129.542747297,2123.535210306,-38
carcassonne-boltzmann35-vs-boltzmann275-1000its,720,758,2223.265241533,2151.248573875,-38
carcassonne-boltzmann270-vs-boltzmann140-1000its,721,759,2143.637198827,2096.693531972,-38
carcassonne-ucttuned40-vs-ucttuned170-1000its,721,759,2166.448556194,2170.930896216,-38
carcassonne-ucttuned455-vs-ucttuned205-1000its,728,766,2207.764176735,2184.289550313,-38
carcassonne-uct480-vs-uct165-1000its,729,767,2191.595722126,2090.570750395,-38
carcassonne-boltzmann140-vs-boltzmann350-1000its,731,769,2235.130746365,2163.708611685,-38
carcassonne-uct230-vs-uct165-1000its,733,771,2266.515058506,2194.335950375,-38
carcassonne-boltzmann255-vs-boltzmann460-1000its,736,774,2194.479033438,2157.944385504,-38
carcassonne-ucttuned130-vs-ucttuned475-1000its,737,775,2191.071416064,2152.096155509,-38
carcassonne-uct160-vs-uct375-1000its,738,776,2141.702195447,2107.287749273,-38
carcassonne-uct410-vs-uct365-1000its,738,776,2206.588819686,2149.454609162,-38
carcassonne-boltzmann235-vs-boltzmann270-1000its,740,778,2224.957591121,2152.440078808,-38
carcassonne-uct460-vs-uct170-1000its,740,778,2191.755164001,2126.890032606,-38
carcassonne-boltzmann190-vs-boltzmann120-1000its,745,783,2159.640215048,2089.844824252,-38
carcassonne-uct315-vs-uct155-1000its,748,786,2149.67684071,2126.137668818,-38
carcassonne-uct215-vs-uct330-1000its,749,787,2165.516292284,2153.488613135,-38
carcassonne-uct485-vs-uct260-1000its,758,796,2141.585335078,2117.143404594,-38
carcassonne-boltzmann360-vs-boltzmann250-1000its,759,797,2109.949991555,2114.600814488,-38
carcassonne-ucttuned415-vs-ucttuned95-1000its,762,800,2187.144696216,2112.285178527,-38
carcassonne-boltzmann265-vs-boltzmann50-1000its,763,801,2196.427355546,2170.657995028,-38
carcassonne-ucttuned60-vs-ucttuned230-1000its,764,802,2229.691451351,2226.61038637,-38
carcassonne-boltzmann435-vs-boltzmann150-1000its,765,803,2203.021015937,2187.723224544,-38
carcassonne-boltzmann70-vs-boltzmann110-1000its,765,803,2166.076738522,2169.563594234,-38
carcassonne-uct130-vs-uct280-1000its,765,803,2287.950775793,2243.182521438,-38
carcassonne-uct255-vs-uct150-1000its,765,803,2202.750174132,2135.641225187,-38
carcassonne-ucttuned80-vs-ucttuned440-1000its,766,804,2176.101412607,2144.272583733,-38
carcassonne-uct415-vs-uct290-1000its,768,806,2150.283033941,2099.459474228,-38
carcassonne-uct465-vs-uct60-1000its,768,806,2307.671955671,2284.260715046,-38
carcassonne-boltzmann345-vs-boltzmann220-1000its,769,807,2155.037829626,2116.761597513,-38
carcassonne-ucttuned400-vs-ucttuned365-1000its,769,807,2075.078267814,2037.289067748,-38
carcassonne-boltzmann460-vs-boltzmann115-1000its,771,809,2209.860174427,2150.296007658,-38
carcassonne-uct305-vs-uct125-1000its,772,810,2192.292225817,2127.159195002,-38
carcassonne-uct15-vs-uct340-1000its,773,811,2202.236346726,2163.09076882,-38
carcassonne-uct65-vs-uct255-1000its,773,811,2268.849377892,2191.931213669,-38
carcassonne-boltzmann315-vs-boltzmann405-1000its,774,812,2195.380291114,2175.181819961,-38
carcassonne-ucttuned45-vs-ucttuned70-1000its,774,812,2201.48154306,2141.65421636,-38
carcassonne-boltzmann280-vs-boltzmann335-1000its,775,813,2210.017573922,2134.766878791,-38
carcassonne-ucttuned140-vs-ucttuned175-1000its,778,816,2198.128144851,2120.348246886,-38
carcassonne-ucttuned300-vs-ucttuned380-1000its,779,817,2143.52358756,2124.191066654,-38
carcassonne-ucttuned340-vs-ucttuned125-1000its,779,817,2133.910207993,2103.584561278,-38
carcassonne-uct415-vs-uct145-1000its,780,818,2186.781782958,2162.348319758,-38
carcassonne-boltzmann395-vs-boltzmann440-1000its,781,819,2162.947379887,2085.872826452,-38
carcassonne-uct490-vs-uct70-1000its,781,819,2229.519760125,2165.155268036,-38
carcassonne-uct295-vs-uct410-1000its,782,820,2198.533462747,2181.834417883,-38
carcassonne-boltzmann125-vs-boltzmann270-1000its,784,822,2114.851677279,2048.416213397,-38
carcassonne-ucttuned255-vs-ucttuned25-1000its,784,822,2285.773626513,2225.903302974,-38
carcassonne-uct295-vs-uct175-1000its,785,823,2211.944231588,2159.151598802,-38
carcassonne-uct395-vs-uct475-1000its,785,823,2197.600116608,2139.690043336,-38
carcassonne-ucttuned35-vs-ucttuned385-1000its,785,823,2209.132059768,2154.805426,-38
carcassonne-boltzmann325-vs-boltzmann450-1000its,786,824,2211.619587169,2166.844844941,-38
carcassonne-ucttuned280-vs-ucttuned330-1000its,786,824,2164.810245052,2142.012400733,-38
carcassonne-boltzmann230-vs-boltzmann385-1000its,787,825,2229.394217858,2206.142716589,-38
carcassonne-ucttuned230-vs-ucttuned130-1000its,787,825,2173.737482827,2172.880443185,-38
carcassonne-uct160-vs-uct120-1000its,788,826,2170.894170408,2149.854896128,-38
carcassonne-ucttuned155-vs-ucttuned200-1000its,788,826,2221.008570824,2143.586858832,-38
carcassonne-uct335-vs-uct40-1000its,790,828,2241.566421178,2164.617203395,-38
carcassonne-uct160-vs-uct135-1000its,791,829,2167.706095381,2150.967775973,-38
carcassonne-ucttuned190-vs-ucttuned285-1000its,791,829,2200.267085769,2166.886991233,-38
carcassonne-ucttuned490-vs-ucttuned305-1000its,792,830,2155.759586073,2103.363494538,-38
carcassonne-ucttuned155-vs-ucttuned125-1000its,793,831,2240.361500162,2149.279900708,-38
carcassonne-uct395-vs-uct440-1000its,794,832,2291.36283393,2221.843785757,-38
carcassonne-uct220-vs-uct495-1000its,797,835,2214.712557931,2151.013061677,-38
carcassonne-uct455-vs-uct450-1000its,797,835,2145.965482739,2081.024391044,-38
carcassonne-ucttuned200-vs-ucttuned140-1000its,797,835,2234.251298063,2215.704629177,-38
carcassonne-ucttuned250-vs-ucttuned185-1000its,797,835,2250.264188283,2186.705447956,-38
carcassonne-boltzmann115-vs-boltzmann290-1000its,798,836,2194.685012741,2187.234890269,-38
carcassonne-boltzmann80-vs-boltzmann380-1000its,799,837,2270.58361748,2223.802447683,-38
carcassonne-ucttuned80-vs-ucttuned480-1000its,799,837,2194.805862488,2144.625961381,-38
carcassonne-uct170-vs-uct145-1000its,800,838,2261.818689007,2190.41600098,-38
carcassonne-uct410-vs-uct190-1000its,800,838,2222.796173405,2161.905665938,-38
carcassonne-uct245-vs-uct355-1000its,801,839,2248.510879446,2207.599922146,-38
carcassonne-ucttuned135-vs-ucttuned360-1000its,801,839,2222.620204837,2167.61156703,-38
carcassonne-ucttuned305-vs-ucttuned495-1000its,801,839,2176.977663824,2110.48207889,-38
carcassonne-ucttuned370-vs-ucttuned475-1000its,801,839,2272.430284577,2212.13814657,-38
carcassonne-ucttuned100-vs-ucttuned385-1000its,804,842,2226.757047582,2174.97121158,-38
carcassonne-boltzmann65-vs-boltzmann250-1000its,805,843,2186.105382227,2121.443008659,-38
carcassonne-uct160-vs-uct425-1000its,805,843,2195.13055059,2158.767277659,-38
carcassonne-uct275-vs-uct20-1000its,805,843,2222.912413844,2203.075762633,-38
carcassonne-ucttuned235-vs-ucttuned155-1000its,806,844,2232.882622266,2193.836533388,-38
carcassonne-uct185-vs-uct340-1000its,808,846,2116.655378262,2103.512501909,-38
carcassonne-ucttuned70-vs-ucttuned35-1000its,808,846,2186.582019374,2119.79433915,-38
carcassonne-boltzmann150-vs-boltzmann360-1000its,811,849,2173.078330942,2108.101643467,-38
carcassonne-uct80-vs-uct150-1000its,812,850,2189.390037269,2185.501198883,-38
carcassonne-ucttuned215-vs-ucttuned35-1000its,812,850,2184.411460603,2155.099950863,-38
carcassonne-ucttuned250-vs-ucttuned45-1000its,814,852,2233.146315307,2218.323211001,-38
carcassonne-ucttuned290-vs-ucttuned45-1000its,814,852,2169.678397984,2136.280243135,-38
carcassonne-boltzmann405-vs-boltzmann155-1000its,815,853,2184.744801433,2151.598541191,-38
carcassonne-uct185-vs-uct320-1000its,815,853,2150.403813565,2090.980616227,-38
carcassonne-uct235-vs-uct425-1000its,816,854,2290.086496298,2248.281465728,-38
carcassonne-boltzmann120-vs-boltzmann290-1000its,817,855,2256.398150571,2193.709266711,-38
carcassonne-uct225-vs-uct285-1000its,818,856,2150.605153748,2119.50148017,-38
carcassonne-uct460-vs-uct110-1000its,818,856,2326.31631038,2263.282489781,-38
carcassonne-ucttuned260-vs-ucttuned295-1000its,819,857,2151.745478782,2081.794995476,-38
carcassonne-uct270-vs-uct125-1000its,822,860,2200.176928909,2174.955745384,-38
carcassonne-ucttuned185-vs-ucttuned305-1000its,822,860,2155.079346548,2109.711703555,-38
carcassonne-ucttuned410-vs-ucttuned35-1000its,823,861,2202.890378934,2137.226299063,-38
carcassonne-ucttuned120-vs-ucttuned70-1000its,824,862,2223.928614337,2138.414604577,-38
carcassonne-boltzmann340-vs-boltzmann5-1000its,825,863,2189.748612003,2148.789641546,-38
carcassonne-ucttuned315-vs-ucttuned365-1000its,825,863,2272.698834494,2241.588594678,-38
carcassonne-ucttuned210-vs-ucttuned200-1000its,826,864,2176.834711295,2123.281392761,-38
carcassonne-boltzmann110-vs-boltzmann355-1000its,829,867,2253.487217026,2196.474890803,-38
carcassonne-uct385-vs-uct225-1000its,830,868,2179.338428171,2130.095958932,-38
carcassonne-uct435-vs-uct265-1000its,831,869,2166.863980808,2102.265601809,-38
carcassonne-boltzmann425-vs-boltzmann105-1000its,832,870,2193.394252492,2183.156184262,-38
carcassonne-uct135-vs-uct345-1000its,833,871,2180.555721711,2139.263646711,-38
carcassonne-uct365-vs-uct455-1000its,833,871,2140.174004229,2160.1702041,-38
carcassonne-ucttuned270-vs-ucttuned310-1000its,834,872,2200.000500203,2132.045303244,-38
carcassonne-ucttuned470-vs-ucttuned150-1000its,834,872,2211.012808882,2179.250985382,-38
carcassonne-boltzmann90-vs-boltzmann5-1000its,836,874,2213.83438803,2200.080453734,-38
carcassonne-boltzmann405-vs-boltzmann400-1000its,844,882,2157.541348846,2135.700931589,-38
carcassonne-uct390-vs-uct260-1000its,846,884,2166.648639431,2159.89210896,-38
carcassonne-boltzmann480-vs-boltzmann100-1000its,847,885,2187.829305457,2179.690791448,-38
carcassonne-boltzmann345-vs-boltzmann235-1000its,848,886,2182.184370937,2136.434281376,-38
carcassonne-ucttuned300-vs-ucttuned195-1000its,852,890,2340.073584703,2320.227257371,-38
carcassonne-ucttuned100-vs-ucttuned20-1000its,853,891,2191.790189417,2201.542524845,-38
carcassonne-boltzmann125-vs-boltzmann340-1000its,854,892,2225.665697727,2180.87228951,-38
carcassonne-uct250-vs-uct65-1000its,858,896,2251.139876906,2231.904047166,-38
carcassonne-boltzmann130-vs-boltzmann345-1000its,862,900,2249.127341369,2193.293392751,-38
carcassonne-boltzmann430-vs-boltzmann475-1000its,864,902,2172.275656605,2161.066186623,-38
carcassonne-boltzmann495-vs-boltzmann200-1000its,866,904,2154.017848561,2124.368729488,-38
carcassonne-uct290-vs-uct355-1000its,868,906,2153.595834468,2113.948317784,-38
carcassonne-uct155-vs-uct330-1000its,876,914,2210.648620611,2097.80650027,-38
carcassonne-boltzmann155-vs-boltzmann160-1000its,877,915,2165.684982718,2166.49213002,-38
carcassonne-uct290-vs-uct455-1000its,888,926,2167.137040016,2126.179952318,-38
carcassonne-boltzmann405-vs-boltzmann370-1000its,652,689,1756.142434361,1705.907118562,-37
carcassonne-boltzmann210-vs-boltzmann310-1000its,702,739,2119.62024099,2058.250984066,-37
carcassonne-boltzmann225-vs-boltzmann195-1000its,704,741,2169.342750184,2145.119587359,-37
carcassonne-uct285-vs-uct420-1000its,711,748,2218.834504111,2203.882545425,-37
carcassonne-uct125-vs-uct425-1000its,714,751,2153.716867825,2173.123121272,-37
carcassonne-uct380-vs-uct205-1000its,723,760,2231.772067502,2151.328451664,-37
carcassonne-uct30-vs-uct65-1000its,726,763,2197.140431596,2141.590716643,-37
carcassonne-boltzmann390-vs-boltzmann25-1000its,728,765,2201.578093769,2176.84276804,-37
carcassonne-boltzmann60-vs-boltzmann490-1000its,728,765,2201.792087288,2144.088377831,-37
carcassonne-boltzmann130-vs-boltzmann110-1000its,734,771,2161.830171452,2126.798303516,-37
carcassonne-ucttuned440-vs-ucttuned305-1000its,734,771,2212.045528303,2184.063851288,-37
carcassonne-uct320-vs-uct145-1000its,739,776,2257.0779306,2227.414753164,-37
carcassonne-boltzmann420-vs-boltzmann205-1000its,741,778,2247.23193019,2170.497590867,-37
carcassonne-ucttuned270-vs-ucttuned435-1000its,743,780,2245.42341076,2188.546246616,-37
carcassonne-boltzmann395-vs-boltzmann5-1000its,745,782,2204.299511977,2153.062991199,-37
carcassonne-ucttuned290-vs-ucttuned310-1000its,745,782,2221.248789152,2147.368057755,-37
carcassonne-uct230-vs-uct175-1000its,746,783,2266.419461192,2206.994525934,-37
carcassonne-uct240-vs-uct340-1000its,747,784,2248.08259555,2174.419877804,-37
carcassonne-ucttuned385-vs-ucttuned265-1000its,747,784,2112.727108176,2030.159413059,-37
carcassonne-uct140-vs-uct375-1000its,748,785,2214.28278263,2188.512213157,-37
carcassonne-ucttuned430-vs-ucttuned105-1000its,748,785,2144.455312091,2109.786035405,-37
carcassonne-uct50-vs-uct160-1000its,750,787,2116.22607652,2129.989562707,-37
carcassonne-uct380-vs-uct410-1000its,752,789,2205.823018774,2209.4397563,-37
carcassonne-uct230-vs-uct405-1000its,753,790,2159.429871675,2113.514476973,-37
carcassonne-boltzmann120-vs-boltzmann230-1000its,755,792,2167.638477529,2077.979938015,-37
carcassonne-ucttuned400-vs-ucttuned475-1000its,755,792,2209.970978508,2164.958561574,-37
carcassonne-boltzmann495-vs-boltzmann140-1000its,757,794,2231.166932486,2131.443777027,-37
carcassonne-boltzmann265-vs-boltzmann150-1000its,758,795,2198.935554942,2162.541133256,-37
carcassonne-uct40-vs-uct60-1000its,758,795,2141.759549887,2106.855184395,-37
carcassonne-uct465-vs-uct450-1000its,759,796,2167.095541493,2100.689249255,-37
carcassonne-boltzmann135-vs-boltzmann155-1000its,760,797,2156.32408966,2130.466037696,-37
carcassonne-boltzmann190-vs-boltzmann380-1000its,761,798,2208.945045573,2160.366685906,-37
carcassonne-uct195-vs-uct60-1000its,761,798,2224.831966611,2187.433175706,-37
carcassonne-ucttuned425-vs-ucttuned370-1000its,761,798,2187.51272928,2172.645212349,-37
carcassonne-boltzmann115-vs-boltzmann215-1000its,762,799,2181.758640501,2168.280446362,-37
carcassonne-ucttuned435-vs-ucttuned340-1000its,763,800,2130.105181239,2117.066385771,-37
carcassonne-ucttuned155-vs-ucttuned195-1000its,764,801,2139.982764181,2162.225374558,-37
carcassonne-boltzmann200-vs-boltzmann295-1000its,765,802,2183.762829376,2135.270855741,-37
carcassonne-boltzmann80-vs-boltzmann230-1000its,765,802,2198.526845625,2194.682748179,-37
carcassonne-boltzmann310-vs-boltzmann245-1000its,766,803,2197.987686345,2175.036043002,-37
carcassonne-boltzmann420-vs-boltzmann55-1000its,766,803,2234.138412205,2179.282070551,-37
carcassonne-boltzmann325-vs-boltzmann95-1000its,768,805,2281.646517433,2231.144205612,-37
carcassonne-uct45-vs-uct5-1000its,768,805,2234.452250702,2171.129783384,-37
carcassonne-boltzmann320-vs-boltzmann425-1000its,769,806,2224.146127208,2132.102998467,-37
carcassonne-uct420-vs-uct150-1000its,769,806,2284.426923904,2233.413653561,-37
carcassonne-boltzmann80-vs-boltzmann335-1000its,771,808,2154.244638178,2139.048311705,-37
carcassonne-boltzmann60-vs-boltzmann25-1000its,772,809,2163.111374424,2114.050294337,-37
carcassonne-uct95-vs-uct110-1000its,772,809,2211.280309599,2176.45435407,-37
carcassonne-ucttuned280-vs-ucttuned140-1000its,772,809,2184.742814559,2131.116861843,-37
carcassonne-boltzmann345-vs-boltzmann35-1000its,775,812,2202.373109442,2132.051835878,-37
carcassonne-boltzmann215-vs-boltzmann175-1000its,777,814,2254.494681236,2215.111541171,-37
carcassonne-boltzmann5-vs-boltzmann415-1000its,777,814,2146.089294152,2114.84296497,-37
carcassonne-ucttuned10-vs-ucttuned50-1000its,777,814,2191.101946566,2143.062644734,-37
carcassonne-ucttuned185-vs-ucttuned230-1000its,777,814,2231.196262336,2194.977952148,-37
carcassonne-boltzmann175-vs-boltzmann135-1000its,778,815,2173.718181876,2156.477203821,-37
carcassonne-uct390-vs-uct335-1000its,778,815,2220.884541886,2170.18689792,-37
carcassonne-ucttuned215-vs-ucttuned155-1000its,779,816,2218.00082588,2192.084794648,-37
carcassonne-boltzmann165-vs-boltzmann175-1000its,781,818,2172.241897757,2148.654654659,-37
carcassonne-boltzmann375-vs-boltzmann480-1000its,781,818,2188.761122318,2200.990633859,-37
carcassonne-uct485-vs-uct45-1000its,781,818,2192.684540105,2182.193077019,-37
carcassonne-ucttuned465-vs-ucttuned125-1000its,781,818,2300.6804598,2197.651576574,-37
carcassonne-boltzmann170-vs-boltzmann485-1000its,784,821,2251.923089449,2204.402458069,-37
carcassonne-boltzmann405-vs-boltzmann325-1000its,784,821,2187.098304113,2167.226067057,-37
carcassonne-uct325-vs-uct435-1000its,784,821,2204.82259699,2177.995717135,-37
carcassonne-ucttuned350-vs-ucttuned105-1000its,784,821,2224.009284361,2192.080828345,-37
carcassonne-boltzmann135-vs-boltzmann250-1000its,785,822,2176.352941052,2148.042739842,-37
carcassonne-uct85-vs-uct470-1000its,785,822,2214.17054571,2171.688379029,-37
carcassonne-ucttuned445-vs-ucttuned475-1000its,786,823,2171.49578458,2153.889703129,-37
carcassonne-ucttuned415-vs-ucttuned260-1000its,787,824,2191.442792979,2172.659617745,-37
carcassonne-boltzmann225-vs-boltzmann20-1000its,789,826,2260.268190102,2184.675939492,-37
carcassonne-uct30-vs-uct330-1000its,790,827,2248.856672354,2242.694086258,-37
carcassonne-uct310-vs-uct80-1000its,790,827,2258.503184553,2177.987638007,-37
carcassonne-ucttuned140-vs-ucttuned275-1000its,790,827,2212.418242375,2144.861552908,-37
carcassonne-boltzmann215-vs-boltzmann265-1000its,791,828,2213.054356396,2171.073054447,-37
carcassonne-boltzmann320-vs-boltzmann470-1000its,791,828,2275.966492009,2249.243429654,-37
carcassonne-ucttuned110-vs-ucttuned135-1000its,791,828,2206.338742567,2175.871779345,-37
carcassonne-boltzmann90-vs-boltzmann350-1000its,792,829,2194.275086056,2134.040160779,-37
carcassonne-uct50-vs-uct385-1000its,792,829,2185.90427256,2191.491656682,-37
carcassonne-ucttuned465-vs-ucttuned185-1000its,792,829,2133.188174526,2080.17924165,-37
carcassonne-boltzmann375-vs-boltzmann130-1000its,793,830,2266.628578443,2203.730729048,-37
carcassonne-ucttuned115-vs-ucttuned490-1000its,793,830,2198.545986836,2169.830544941,-37
carcassonne-boltzmann345-vs-boltzmann255-1000its,795,832,2253.87489247,2215.434350997,-37
carcassonne-uct205-vs-uct35-1000its,796,833,2138.893936913,2128.391391807,-37
carcassonne-uct420-vs-uct140-1000its,796,833,2231.605906373,2174.145829021,-37
carcassonne-boltzmann410-vs-boltzmann180-1000its,797,834,2215.259491952,2140.771336508,-37
carcassonne-uct235-vs-uct15-1000its,797,834,2198.229892703,2140.123636864,-37
carcassonne-uct400-vs-uct185-1000its,797,834,2267.819062635,2231.235024851,-37
carcassonne-boltzmann70-vs-boltzmann390-1000its,798,835,2115.91096203,2072.370794578,-37
carcassonne-boltzmann350-vs-boltzmann470-1000its,799,836,2187.212155566,2147.452953815,-37
carcassonne-uct250-vs-uct410-1000its,799,836,2166.750154867,2160.495459362,-37
carcassonne-uct155-vs-uct160-1000its,800,837,2227.061947234,2189.871587555,-37
carcassonne-ucttuned245-vs-ucttuned320-1000its,800,837,2192.08249844,2139.871397124,-37
carcassonne-ucttuned295-vs-ucttuned210-1000its,800,837,2181.764150258,2161.211919006,-37
carcassonne-ucttuned380-vs-ucttuned185-1000its,800,837,2181.883878797,2174.831684609,-37
carcassonne-ucttuned245-vs-ucttuned55-1000its,802,839,2201.952920543,2181.894320349,-37
carcassonne-boltzmann425-vs-boltzmann230-1000its,803,840,2238.69344569,2204.59140574,-37
carcassonne-uct125-vs-uct35-1000its,803,840,2145.480683488,2101.847634263,-37
carcassonne-boltzmann305-vs-boltzmann30-1000its,804,841,2228.746981385,2183.737577595,-37
carcassonne-ucttuned330-vs-ucttuned165-1000its,804,841,2207.206499466,2184.419314399,-37
carcassonne-ucttuned135-vs-ucttuned215-1000its,805,842,2178.223884575,2166.995200138,-37
carcassonne-ucttuned35-vs-ucttuned75-1000its,805,842,2198.166681073,2154.464906814,-37
carcassonne-boltzmann325-vs-boltzmann25-1000its,806,843,2227.993282478,2230.610562764,-37
carcassonne-ucttuned480-vs-ucttuned135-1000its,808,845,2152.373281521,2096.469184665,-37
carcassonne-ucttuned260-vs-ucttuned25-1000its,810,847,2233.901113486,2166.821747862,-37
carcassonne-ucttuned90-vs-ucttuned105-1000its,810,847,2152.133476433,2106.775065203,-37
carcassonne-uct370-vs-uct10-1000its,812,849,2334.960045447,2306.871910723,-37
carcassonne-boltzmann355-vs-boltzmann420-1000its,815,852,2226.343647479,2161.783973082,-37
carcassonne-boltzmann235-vs-boltzmann20-1000its,816,853,2227.080929881,2148.004152591,-37
carcassonne-boltzmann250-vs-boltzmann85-1000its,816,853,2241.038042068,2174.78546984,-37
carcassonne-uct155-vs-uct255-1000its,816,853,2155.025753903,2119.253469518,-37
carcassonne-boltzmann150-vs-boltzmann255-1000its,817,854,2188.157402556,2158.918174757,-37
carcassonne-boltzmann480-vs-boltzmann205-1000its,817,854,2205.802935362,2197.319627902,-37
carcassonne-uct375-vs-uct40-1000its,818,855,2152.776815944,2121.037068414,-37
carcassonne-uct350-vs-uct460-1000its,821,858,2181.41544051,2162.712808923,-37
carcassonne-uct55-vs-uct425-1000its,821,858,2183.117027487,2173.720998241,-37
carcassonne-ucttuned285-vs-ucttuned360-1000its,821,858,2238.974137599,2177.760712853,-37
carcassonne-boltzmann445-vs-boltzmann405-1000its,822,859,2190.073465554,2131.879110009,-37
carcassonne-uct395-vs-uct20-1000its,822,859,2206.964758137,2179.418912084,-37
carcassonne-ucttuned55-vs-ucttuned420-1000its,822,859,2191.06615817,2186.364869708,-37
carcassonne-uct165-vs-uct220-1000its,823,860,2173.210191497,2116.051585145,-37
carcassonne-uct90-vs-uct195-1000its,823,860,2135.500805131,2085.326278777,-37
carcassonne-ucttuned225-vs-ucttuned160-1000its,823,860,2164.923595905,2132.693309498,-37
carcassonne-boltzmann425-vs-boltzmann5-1000its,824,861,2200.443497475,2204.12122254,-37
carcassonne-uct320-vs-uct375-1000its,824,861,2164.948733103,2128.597580599,-37
carcassonne-boltzmann475-vs-boltzmann120-1000its,825,862,2193.369120844,2145.630782359,-37
carcassonne-boltzmann220-vs-boltzmann80-1000its,828,865,2168.571771788,2150.708999142,-37
carcassonne-uct450-vs-uct355-1000its,829,866,2165.535517457,2109.273465739,-37
carcassonne-uct20-vs-uct480-1000its,830,867,2167.565167688,2134.878244113,-37
carcassonne-ucttuned265-vs-ucttuned355-1000its,832,869,2166.331113138,2122.009794481,-37
carcassonne-uct60-vs-uct475-1000its,833,870,2265.124104127,2250.275072557,-37
carcassonne-ucttuned480-vs-ucttuned220-1000its,834,871,2258.660761153,2255.924516975,-37
carcassonne-uct250-vs-uct110-1000its,835,872,2169.34562371,2144.772772967,-37
carcassonne-ucttuned100-vs-ucttuned225-1000its,836,873,2238.517531999,2172.280870586,-37
carcassonne-ucttuned140-vs-ucttuned5-1000its,837,874,2214.556037074,2153.855360549,-37
carcassonne-boltzmann75-vs-boltzmann420-1000its,838,875,2169.635293017,2120.227617678,-37
carcassonne-uct120-vs-uct430-1000its,841,878,2244.619316228,2210.665230593,-37
carcassonne-uct205-vs-uct445-1000its,843,880,2208.21978834,2187.301556245,-37
carcassonne-boltzmann345-vs-boltzmann395-1000its,845,882,2245.004255073,2239.207474187,-37
carcassonne-uct185-vs-uct30-1000its,845,882,2201.790960913,2118.726486819,-37
carcassonne-ucttuned340-vs-ucttuned55-1000its,847,884,2276.181846143,2199.105099925,-37
carcassonne-uct300-vs-uct15-1000its,851,888,2196.942462433,2209.225873221,-37
carcassonne-ucttuned5-vs-ucttuned190-1000its,852,889,2210.721503104,2118.267419112,-37
carcassonne-uct160-vs-uct360-1000its,854,891,2125.96912128,2050.709119038,-37
carcassonne-ucttuned395-vs-ucttuned95-1000its,856,893,2200.017152957,2163.449472319,-37
carcassonne-uct200-vs-uct190-1000its,879,916,2116.68809047,2072.58332617,-37
carcassonne-ucttuned440-vs-ucttuned75-1000its,881,918,2132.345943686,2128.128057846,-37
carcassonne-uct150-vs-uct100-1000its,898,935,2197.774876002,2083.176691447,-37
carcassonne-ucttuned10-vs-ucttuned15-1000its,906,943,2231.554483156,2183.864778037,-37
carcassonne-ucttuned255-vs-ucttuned450-1000its,704,740,2209.183652292,2203.403527596,-36
carcassonne-boltzmann420-vs-boltzmann40-1000its,718,754,2166.295405691,2150.570610034,-36
carcassonne-uct300-vs-uct415-1000its,722,758,2223.177668321,2153.502836366,-36
carcassonne-boltzmann110-vs-boltzmann120-1000its,726,762,2167.441478732,2095.818071586,-36
carcassonne-uct425-vs-uct405-1000its,728,764,2217.176185931,2244.019585589,-36
carcassonne-boltzmann330-vs-boltzmann210-1000its,732,768,2196.228333146,2175.561621867,-36
carcassonne-boltzmann415-vs-boltzmann115-1000its,737,773,2236.161924759,2220.677551606,-36
carcassonne-uct290-vs-uct180-1000its,737,773,2196.815695194,2131.45268868,-36
carcassonne-uct390-vs-uct265-1000its,737,773,2319.229523337,2263.104269642,-36
carcassonne-uct455-vs-uct335-1000its,738,774,2126.228872917,2065.933659358,-36
carcassonne-boltzmann195-vs-boltzmann430-1000its,739,775,2261.258721106,2217.388643216,-36
carcassonne-ucttuned25-vs-ucttuned200-1000its,740,776,2254.554743398,2165.033874162,-36
carcassonne-ucttuned260-vs-ucttuned285-1000its,740,776,2167.339430847,2130.709350516,-36
carcassonne-ucttuned425-vs-ucttuned460-1000its,740,776,2154.675421842,2085.736153925,-36
carcassonne-boltzmann135-vs-boltzmann430-1000its,744,780,2227.223327634,2154.858882375,-36
carcassonne-uct150-vs-uct445-1000its,745,781,2244.668120341,2202.164903414,-36
carcassonne-boltzmann245-vs-boltzmann115-1000its,746,782,2145.833601859,2111.572175411,-36
carcassonne-ucttuned195-vs-ucttuned360-1000its,746,782,2205.920285662,2187.573707335,-36
carcassonne-uct465-vs-uct325-1000its,747,783,2172.696831597,2141.91188876,-36
carcassonne-uct50-vs-uct445-1000its,748,784,2197.035392523,2159.889964236,-36
carcassonne-boltzmann145-vs-boltzmann375-1000its,753,789,2224.584830086,2214.445870456,-36
carcassonne-uct445-vs-uct335-1000its,759,795,2129.954986048,2113.963135605,-36
carcassonne-uct45-vs-uct95-1000its,760,796,2194.696354473,2131.851296853,-36
carcassonne-ucttuned170-vs-ucttuned305-1000its,761,797,2180.250303298,2110.698063368,-36
carcassonne-ucttuned460-vs-ucttuned335-1000its,761,797,2104.34777005,2134.617194994,-36
carcassonne-uct470-vs-uct445-1000its,763,799,2138.999007785,2087.938153342,-36
carcassonne-ucttuned360-vs-ucttuned355-1000its,765,801,2192.172254896,2172.397070508,-36
carcassonne-boltzmann375-vs-boltzmann485-1000its,767,803,2194.677987347,2136.576038095,-36
carcassonne-boltzmann450-vs-boltzmann445-1000its,768,804,2195.058581019,2144.879766083,-36
carcassonne-boltzmann90-vs-boltzmann125-1000its,768,804,2135.375159831,2094.317548053,-36
carcassonne-ucttuned105-vs-ucttuned305-1000its,769,805,2228.417659558,2181.726193718,-36
carcassonne-boltzmann420-vs-boltzmann360-1000its,771,807,2168.099002689,2128.449104299,-36
carcassonne-boltzmann455-vs-boltzmann420-1000its,771,807,2160.799527505,2146.875797224,-36
carcassonne-boltzmann70-vs-boltzmann195-1000its,771,807,2207.299194208,2193.248611175,-36
carcassonne-boltzmann145-vs-boltzmann335-1000its,772,808,2170.098714017,2087.043382547,-36
carcassonne-uct235-vs-uct120-1000its,776,812,2180.804434431,2121.9020104,-36
carcassonne-ucttuned490-vs-ucttuned215-1000its,776,812,2240.355756195,2185.585969053,-36
carcassonne-uct125-vs-uct110-1000its,777,813,2203.401232014,2152.395273102,-36
carcassonne-boltzmann460-vs-boltzmann330-1000its,778,814,2198.367972508,2174.978932934,-36
carcassonne-ucttuned150-vs-ucttuned355-1000its,778,814,2289.177902954,2242.445765582,-36
carcassonne-boltzmann160-vs-boltzmann340-1000its,779,815,2214.438161621,2097.690467443,-36
carcassonne-ucttuned105-vs-ucttuned255-1000its,779,815,2204.380252604,2122.287030201,-36
carcassonne-ucttuned465-vs-ucttuned495-1000its,779,815,2149.127956393,2168.273017565,-36
carcassonne-boltzmann70-vs-boltzmann80-1000its,780,816,2162.551870263,2135.428333877,-36
carcassonne-uct55-vs-uct215-1000its,780,816,2206.274080886,2193.456797694,-36
carcassonne-ucttuned425-vs-ucttuned195-1000its,780,816,2231.484355375,2186.483625673,-36
carcassonne-uct95-vs-uct365-1000its,781,817,2174.921076803,2108.998651568,-36
carcassonne-boltzmann155-vs-boltzmann435-1000its,782,818,2139.640809272,2104.757888132,-36
carcassonne-boltzmann215-vs-boltzmann100-1000its,783,819,2234.673596942,2167.126296484,-36
carcassonne-boltzmann260-vs-boltzmann430-1000its,783,819,2219.250891524,2143.033098257,-36
carcassonne-uct325-vs-uct410-1000its,784,820,2195.541154641,2121.549349811,-36
carcassonne-boltzmann10-vs-boltzmann65-1000its,785,821,2172.711803202,2129.059997951,-36
carcassonne-ucttuned75-vs-ucttuned405-1000its,785,821,2147.961726286,2131.998910401,-36
carcassonne-ucttuned330-vs-ucttuned60-1000its,786,822,2227.616319644,2155.028611931,-36
carcassonne-uct10-vs-uct105-1000its,787,823,2230.418603123,2129.776147899,-36
carcassonne-uct410-vs-uct155-1000its,788,824,2164.375943639,2146.04999146,-36
carcassonne-boltzmann145-vs-boltzmann365-1000its,789,825,2212.693297505,2105.246896147,-36
carcassonne-boltzmann370-vs-boltzmann460-1000its,789,825,2162.306943949,2124.798781095,-36
carcassonne-ucttuned325-vs-ucttuned390-1000its,789,825,2176.853228131,2158.365783856,-36
carcassonne-uct20-vs-uct185-1000its,791,827,2179.861311381,2118.996219805,-36
carcassonne-ucttuned395-vs-ucttuned275-1000its,791,827,2183.998651415,2147.536321591,-36
carcassonne-ucttuned55-vs-ucttuned405-1000its,792,828,2207.356651132,2117.707219607,-36
carcassonne-uct85-vs-uct5-1000its,793,829,2226.473940268,2198.142827543,-36
carcassonne-boltzmann365-vs-boltzmann210-1000its,794,830,2123.109945276,2111.217865486,-36
carcassonne-uct165-vs-uct390-1000its,794,830,2229.126454279,2218.670263025,-36
carcassonne-uct440-vs-uct305-1000its,794,830,2173.405484702,2162.297808848,-36
carcassonne-ucttuned495-vs-ucttuned65-1000its,795,831,2142.571199426,2129.69697817,-36
carcassonne-uct330-vs-uct415-1000its,796,832,2151.084550045,2117.139633083,-36
carcassonne-ucttuned290-vs-ucttuned285-1000its,796,832,2135.371471627,2108.730726729,-36
carcassonne-ucttuned50-vs-ucttuned75-1000its,796,832,2135.780158935,2095.730061622,-36
carcassonne-ucttuned385-vs-ucttuned60-1000its,797,833,2276.09833441,2248.731016252,-36
carcassonne-uct145-vs-uct235-1000its,798,834,2170.718677826,2174.096336096,-36
carcassonne-uct425-vs-uct205-1000its,799,835,2232.249524971,2157.605135686,-36
carcassonne-uct365-vs-uct410-1000its,801,837,2255.280860561,2166.122574743,-36
carcassonne-ucttuned365-vs-ucttuned340-1000its,802,838,2236.240062942,2204.345171633,-36
carcassonne-boltzmann240-vs-boltzmann145-1000its,803,839,2237.630020614,2190.339283808,-36
carcassonne-ucttuned185-vs-ucttuned365-1000its,803,839,2200.493604004,2178.983225567,-36
carcassonne-uct440-vs-uct75-1000its,804,840,2204.025569457,2103.349761988,-36
carcassonne-uct75-vs-uct310-1000its,804,840,2182.703768878,2167.546006603,-36
carcassonne-ucttuned315-vs-ucttuned145-1000its,804,840,2168.202169895,2129.09224264,-36
carcassonne-boltzmann130-vs-boltzmann310-1000its,806,842,2204.318475317,2122.960986278,-36
carcassonne-ucttuned145-vs-ucttuned440-1000its,807,843,2187.058598377,2144.836438781,-36
carcassonne-boltzmann130-vs-boltzmann395-1000its,810,846,2117.182285952,2073.233242041,-36
carcassonne-uct245-vs-uct15-1000its,810,846,2232.137829514,2214.250580863,-36
carcassonne-boltzmann370-vs-boltzmann115-1000its,811,847,2207.359968178,2168.366971043,-36
carcassonne-boltzmann445-vs-boltzmann365-1000its,811,847,2186.334486359,2151.974752735,-36
carcassonne-ucttuned295-vs-ucttuned180-1000its,813,849,2197.031640861,2141.62192428,-36
carcassonne-boltzmann330-vs-boltzmann385-1000its,814,850,2176.456576172,2135.394577375,-36
carcassonne-uct250-vs-uct245-1000its,814,850,2276.309200027,2183.257100714,-36
carcassonne-ucttuned345-vs-ucttuned5-1000its,814,850,2243.316784473,2197.875438165,-36
carcassonne-boltzmann40-vs-boltzmann360-1000its,816,852,2103.934842217,2093.03967154,-36
carcassonne-ucttuned300-vs-ucttuned245-1000its,817,853,2170.20277103,2111.00615239,-36
carcassonne-boltzmann230-vs-boltzmann350-1000its,819,855,2211.562626214,2160.644103732,-36
carcassonne-uct65-vs-uct225-1000its,819,855,2203.754162226,2115.713957676,-36
carcassonne-boltzmann255-vs-boltzmann105-1000its,821,857,2348.144763235,2274.529886218,-36
carcassonne-boltzmann370-vs-boltzmann475-1000its,821,857,2236.242358255,2205.203192897,-36
carcassonne-boltzmann395-vs-boltzmann180-1000its,822,858,2222.040304999,2161.633802937,-36
carcassonne-uct90-vs-uct380-1000its,822,858,2233.470148083,2176.566980436,-36
carcassonne-uct185-vs-uct465-1000its,823,859,2227.858972258,2192.832369201,-36
carcassonne-ucttuned435-vs-ucttuned425-1000its,824,860,2207.716523196,2133.15996376,-36
carcassonne-uct250-vs-uct40-1000its,825,861,2155.766164348,2143.47966412,-36
carcassonne-ucttuned90-vs-ucttuned140-1000its,826,862,2239.088270735,2134.320010449,-36
carcassonne-uct220-vs-uct210-1000its,828,864,2198.185954248,2188.510025186,-36
carcassonne-ucttuned105-vs-ucttuned110-1000its,829,865,2163.452060479,2080.863269302,-36
carcassonne-uct490-vs-uct120-1000its,830,866,2191.848443875,2121.117639282,-36
carcassonne-ucttuned315-vs-ucttuned70-1000its,830,866,2223.306747768,2178.260205387,-36
carcassonne-ucttuned480-vs-ucttuned265-1000its,830,866,2176.90900309,2154.583493832,-36
carcassonne-boltzmann450-vs-boltzmann15-1000its,831,867,2220.553755038,2133.968260852,-36
carcassonne-uct455-vs-uct105-1000its,831,867,2169.237309575,2135.814109907,-36
carcassonne-ucttuned135-vs-ucttuned395-1000its,831,867,2248.099624818,2203.138698289,-36
carcassonne-boltzmann45-vs-boltzmann220-1000its,832,868,2195.251269643,2158.027169593,-36
carcassonne-ucttuned365-vs-ucttuned320-1000its,832,868,2208.157902425,2161.200872628,-36
carcassonne-uct335-vs-uct300-1000its,833,869,2215.98682084,2140.225999036,-36
carcassonne-uct55-vs-uct295-1000its,834,870,2274.240045355,2252.984818894,-36
carcassonne-ucttuned210-vs-ucttuned365-1000its,834,870,2183.555256673,2140.004276565,-36
carcassonne-boltzmann165-vs-boltzmann25-1000its,836,872,2134.505697631,2133.119946928,-36
carcassonne-ucttuned95-vs-ucttuned235-1000its,836,872,2224.934406015,2193.642151269,-36
carcassonne-boltzmann410-vs-boltzmann140-1000its,837,873,2231.154071558,2180.506183766,-36
carcassonne-uct120-vs-uct400-1000its,839,875,2214.908195931,2156.095735605,-36
carcassonne-ucttuned25-vs-ucttuned460-1000its,839,875,2212.381009663,2132.509087835,-36
carcassonne-ucttuned305-vs-ucttuned135-1000its,841,877,2226.209034858,2198.562363654,-36
carcassonne-boltzmann115-vs-boltzmann250-1000its,842,878,2182.242987193,2153.329698155,-36
carcassonne-uct435-vs-uct55-1000its,848,884,2175.81220402,2142.569038551,-36
carcassonne-uct450-vs-uct10-1000its,848,884,2200.291525661,2101.792532129,-36
carcassonne-ucttuned380-vs-ucttuned495-1000its,849,885,2155.235788746,2127.702315771,-36
carcassonne-ucttuned95-vs-ucttuned435-1000its,849,885,2222.51662833,2191.854998925,-36
carcassonne-boltzmann40-vs-boltzmann225-1000its,853,889,2202.861468448,2139.674382423,-36
carcassonne-ucttuned300-vs-ucttuned400-1000its,853,889,2267.46063244,2161.345210495,-36
carcassonne-ucttuned370-vs-ucttuned35-1000its,853,889,2265.448077149,2191.689832755,-36
carcassonne-uct335-vs-uct445-1000its,855,891,2121.641999224,2101.574685196,-36
carcassonne-ucttuned80-vs-ucttuned300-1000its,856,892,2167.861312174,2131.175038828,-36
carcassonne-uct105-vs-uct10-1000its,859,895,2105.179798802,2124.473841163,-36
carcassonne-uct85-vs-uct320-1000its,861,897,2247.805889071,2220.507518373,-36
carcassonne-boltzmann115-vs-boltzmann200-1000its,863,899,2202.130309616,2152.141593007,-36
carcassonne-uct425-vs-uct40-1000its,873,909,2208.213779193,2147.04731992,-36
carcassonne-uct240-vs-uct200-1000its,875,911,2284.219891269,2189.546440603,-36
carcassonne-uct120-vs-uct435-1000its,877,913,2179.143262231,2111.813006349,-36
carcassonne-uct75-vs-uct25-1000its,896,932,2255.340938185,2202.016777832,-36
carcassonne-uct440-vs-uct235-1000its,930,966,2167.946753051,2164.615102506,-36
carcassonne-uct265-vs-uct440-1000its,734,769,2115.015800409,2076.359627674,-35
carcassonne-boltzmann455-vs-boltzmann330-1000its,737,772,2298.736717796,2225.995890835,-35
carcassonne-ucttuned105-vs-ucttuned50-1000its,737,772,2213.92426298,2190.289978269,-35
carcassonne-boltzmann385-vs-boltzmann230-1000its,740,775,2204.529017652,2180.502251424,-35
carcassonne-uct160-vs-uct240-1000its,743,778,2185.167312361,2158.826196363,-35
carcassonne-boltzmann310-vs-boltzmann145-1000its,744,779,2225.732545191,2157.803085783,-35
carcassonne-boltzmann245-vs-boltzmann75-1000its,745,780,2223.455742932,2120.870210585,-35
carcassonne-ucttuned220-vs-ucttuned335-1000its,745,780,2194.965852314,2155.702015347,-35
carcassonne-uct25-vs-uct315-1000its,747,782,2285.279295434,2205.2463942,-35
carcassonne-ucttuned65-vs-ucttuned460-1000its,747,782,2259.728194534,2180.229813546,-35
carcassonne-uct270-vs-uct350-1000its,749,784,2196.01098865,2150.222661736,-35
carcassonne-boltzmann245-vs-boltzmann455-1000its,752,787,2265.580207447,2176.382537422,-35
carcassonne-boltzmann330-vs-boltzmann305-1000its,752,787,2283.906905346,2206.49803674,-35
carcassonne-boltzmann485-vs-boltzmann395-1000its,752,787,2313.857129386,2240.99416964,-35
carcassonne-ucttuned65-vs-ucttuned170-1000its,753,788,2192.682239603,2162.080973482,-35
carcassonne-ucttuned175-vs-ucttuned385-1000its,754,789,2243.189373009,2169.265838647,-35
carcassonne-ucttuned435-vs-ucttuned400-1000its,754,789,2250.943285749,2204.950369146,-35
carcassonne-uct390-vs-uct305-1000its,758,793,2165.066192996,2140.686864599,-35
carcassonne-ucttuned440-vs-ucttuned180-1000its,759,794,2145.50026904,2067.065595376,-35
carcassonne-ucttuned430-vs-ucttuned215-1000its,760,795,2183.097645432,2164.721453234,-35
carcassonne-ucttuned395-vs-ucttuned150-1000its,762,797,2227.31214673,2189.611483047,-35
carcassonne-uct60-vs-uct135-1000its,763,798,2128.59738861,2098.303060284,-35
carcassonne-ucttuned310-vs-ucttuned140-1000its,763,798,2155.993882912,2145.689809045,-35
carcassonne-uct75-vs-uct20-1000its,764,799,2230.073212197,2146.701552618,-35
carcassonne-boltzmann195-vs-boltzmann320-1000its,765,800,2191.172703209,2138.742714391,-35
carcassonne-boltzmann495-vs-boltzmann160-1000its,767,802,2190.200304634,2195.873476305,-35
carcassonne-boltzmann435-vs-boltzmann465-1000its,771,806,2236.87631258,2208.153097475,-35
carcassonne-boltzmann85-vs-boltzmann255-1000its,773,808,2146.487913109,2069.477904002,-35
carcassonne-uct315-vs-uct380-1000its,773,808,2212.260849934,2181.960242115,-35
carcassonne-ucttuned395-vs-ucttuned100-1000its,773,808,2139.700419113,2094.439825795,-35
carcassonne-boltzmann445-vs-boltzmann25-1000its,775,810,2176.11408882,2161.990915575,-35
carcassonne-ucttuned20-vs-ucttuned430-1000its,775,810,2121.250412453,2039.6380228,-35
carcassonne-ucttuned410-vs-ucttuned280-1000its,775,810,2217.139856669,2190.987538897,-35
carcassonne-boltzmann25-vs-boltzmann430-1000its,776,811,2173.941627518,2144.504737352,-35
carcassonne-uct325-vs-uct10-1000its,776,811,2161.266594427,2142.52109039,-35
carcassonne-ucttuned195-vs-ucttuned470-1000its,776,811,2231.871550232,2140.557909243,-35
carcassonne-ucttuned420-vs-ucttuned135-1000its,777,812,2125.76155294,2104.2524349,-35
carcassonne-ucttuned145-vs-ucttuned450-1000its,778,813,2246.407392369,2197.521641769,-35
carcassonne-boltzmann140-vs-boltzmann230-1000its,779,814,2197.200287714,2147.83031743,-35
carcassonne-uct315-vs-uct365-1000its,779,814,2230.624515457,2177.908165522,-35
carcassonne-ucttuned65-vs-ucttuned235-1000its,780,815,2155.696658443,2140.467809389,-35
carcassonne-ucttuned150-vs-ucttuned325-1000its,781,816,2218.06084184,2156.44338523,-35
carcassonne-boltzmann60-vs-boltzmann205-1000its,782,817,2183.383912976,2157.13311622,-35
carcassonne-uct485-vs-uct245-1000its,786,821,2155.997611229,2138.956394301,-35
carcassonne-ucttuned240-vs-ucttuned85-1000its,786,821,2153.69478154,2108.920633911,-35
carcassonne-uct120-vs-uct355-1000its,788,823,2190.864130441,2162.508062157,-35
carcassonne-uct430-vs-uct30-1000its,788,823,2218.11612426,2179.341240034,-35
carcassonne-boltzmann75-vs-boltzmann395-1000its,789,824,2271.375236851,2200.502363455,-35
carcassonne-uct310-vs-uct425-1000its,789,824,2280.722679824,2264.484839865,-35
carcassonne-boltzmann275-vs-boltzmann225-1000its,790,825,2224.204131366,2182.976152456,-35
carcassonne-uct200-vs-uct405-1000its,791,826,2254.613470894,2182.369335368,-35
carcassonne-ucttuned390-vs-ucttuned230-1000its,791,826,2287.28517401,2230.531238337,-35
carcassonne-boltzmann410-vs-boltzmann155-1000its,793,828,2241.727202058,2149.006013677,-35
carcassonne-uct55-vs-uct365-1000its,794,829,2182.409645677,2154.25230294,-35
carcassonne-uct105-vs-uct125-1000its,796,831,2230.276912688,2179.438976427,-35
carcassonne-boltzmann415-vs-boltzmann150-1000its,797,832,2222.377031436,2179.594846469,-35
carcassonne-ucttuned240-vs-ucttuned65-1000its,800,835,2183.181617618,2144.669803603,-35
carcassonne-boltzmann460-vs-boltzmann55-1000its,802,837,2239.851202433,2226.932001785,-35
carcassonne-boltzmann355-vs-boltzmann200-1000its,803,838,2155.243520523,2102.604724246,-35
carcassonne-ucttuned285-vs-ucttuned85-1000its,804,839,2132.310796248,2095.858805078,-35
carcassonne-ucttuned365-vs-ucttuned25-1000its,804,839,2200.765923461,2155.15876805,-35
carcassonne-ucttuned445-vs-ucttuned345-1000its,806,841,2288.269892627,2220.886673922,-35
carcassonne-ucttuned460-vs-ucttuned275-1000its,806,841,2175.479597514,2143.640055294,-35
carcassonne-ucttuned470-vs-ucttuned275-1000its,806,841,2180.405344544,2193.539196425,-35
carcassonne-ucttuned30-vs-ucttuned135-1000its,807,842,2196.50032591,2146.008950849,-35
carcassonne-boltzmann405-vs-boltzmann265-1000its,808,843,2189.304046041,2154.753032979,-35
carcassonne-uct115-vs-uct430-1000its,808,843,2167.500316563,2130.168322124,-35
carcassonne-uct380-vs-uct470-1000its,808,843,2190.247614558,2093.178548314,-35
carcassonne-boltzmann200-vs-boltzmann370-1000its,810,845,2213.554964264,2165.406039821,-35
carcassonne-ucttuned300-vs-ucttuned350-1000its,811,846,2295.406091087,2270.232168956,-35
carcassonne-boltzmann15-vs-boltzmann370-1000its,812,847,2257.083114162,2239.174998634,-35
carcassonne-ucttuned270-vs-ucttuned205-1000its,813,848,2197.584346131,2167.764308123,-35
carcassonne-boltzmann80-vs-boltzmann260-1000its,814,849,2251.417804522,2195.365345544,-35
carcassonne-ucttuned10-vs-ucttuned400-1000its,815,850,2230.647748296,2195.922455177,-35
carcassonne-ucttuned445-vs-ucttuned495-1000its,815,850,2171.306289411,2136.70848021,-35
carcassonne-boltzmann480-vs-boltzmann195-1000its,817,852,2178.647019494,2156.636757286,-35
carcassonne-ucttuned130-vs-ucttuned290-1000its,818,853,2141.037649802,2081.314222874,-35
carcassonne-ucttuned355-vs-ucttuned30-1000its,819,854,2196.119077375,2150.261955753,-35
carcassonne-uct475-vs-uct55-1000its,820,855,2121.226273442,2071.934100753,-35
carcassonne-uct460-vs-uct190-1000its,821,856,2211.76945555,2178.269886159,-35
carcassonne-ucttuned60-vs-ucttuned240-1000its,821,856,2207.31411523,2158.153392205,-35
carcassonne-boltzmann325-vs-boltzmann265-1000its,822,857,2215.024676905,2187.270642055,-35
carcassonne-boltzmann420-vs-boltzmann340-1000its,823,858,2216.693183431,2176.248630911,-35
carcassonne-ucttuned325-vs-ucttuned200-1000its,824,859,2180.551996851,2150.447472982,-35
carcassonne-uct435-vs-uct310-1000its,825,860,2215.07910641,2185.157733784,-35
carcassonne-boltzmann45-vs-boltzmann415-1000its,830,865,2203.402881219,2117.271035612,-35
carcassonne-uct180-vs-uct465-1000its,830,865,2263.298482126,2199.097648274,-35
carcassonne-uct360-vs-uct55-1000its,830,865,2234.980318706,2182.874198321,-35
carcassonne-uct420-vs-uct290-1000its,830,865,2086.569353545,2053.850347878,-35
carcassonne-boltzmann175-vs-boltzmann15-1000its,831,866,2210.344115931,2181.670163627,-35
carcassonne-boltzmann315-vs-boltzmann35-1000its,832,867,2225.584494631,2163.931996737,-35
carcassonne-ucttuned185-vs-ucttuned285-1000its,835,870,2182.999066426,2150.425102882,-35
carcassonne-boltzmann340-vs-boltzmann425-1000its,836,871,2164.818844381,2139.735382854,-35
carcassonne-uct420-vs-uct40-1000its,836,871,2252.096679869,2216.766249881,-35
carcassonne-ucttuned205-vs-ucttuned450-1000its,838,873,2236.931958394,2176.009706218,-35
carcassonne-boltzmann360-vs-boltzmann195-1000its,839,874,2233.939673003,2172.013889603,-35
carcassonne-ucttuned440-vs-ucttuned350-1000its,840,875,2130.426357271,2080.58171532,-35
carcassonne-boltzmann320-vs-boltzmann300-1000its,841,876,2214.980174052,2197.744635561,-35
carcassonne-uct420-vs-uct170-1000its,841,876,2290.141806692,2262.792030152,-35
carcassonne-boltzmann85-vs-boltzmann105-1000its,842,877,2148.821524072,2090.650355708,-35
carcassonne-ucttuned315-vs-ucttuned420-1000its,842,877,2276.579461057,2253.092226446,-35
carcassonne-uct40-vs-uct475-1000its,844,879,2193.317428394,2129.564885834,-35
carcassonne-boltzmann175-vs-boltzmann225-1000its,848,883,2236.75356036,2187.542428114,-35
carcassonne-boltzmann105-vs-boltzmann330-1000its,849,884,2145.785556412,2121.41171294,-35
carcassonne-boltzmann425-vs-boltzmann245-1000its,856,891,2184.210229358,2135.301676562,-35
carcassonne-ucttuned405-vs-ucttuned20-1000its,887,922,2265.31802764,2152.207577206,-35
carcassonne-uct470-vs-uct375-1000its,899,934,2177.308466802,2098.776444149,-35
carcassonne-ucttuned310-vs-ucttuned340-1000its,933,968,2233.55775511,2158.583322235,-35
carcassonne-boltzmann410-vs-boltzmann280-1000its,641,675,1744.651617175,1737.241773355,-34
carcassonne-ucttuned240-vs-ucttuned75-1000its,682,716,2247.703058202,2186.453604629,-34
carcassonne-uct435-vs-uct165-1000its,685,719,2140.793990807,2190.694748154,-34
carcassonne-boltzmann365-vs-boltzmann255-1000its,700,734,2200.863745384,2152.698556187,-34
carcassonne-boltzmann415-vs-boltzmann90-1000its,707,741,2229.461275362,2195.028223438,-34
carcassonne-boltzmann440-vs-boltzmann315-1000its,716,750,2165.660676034,2134.082340119,-34
carcassonne-uct220-vs-uct15-1000its,725,759,2201.984815868,2186.257375023,-34
carcassonne-uct410-vs-uct370-1000its,725,759,2160.325856022,2122.31146337,-34
carcassonne-boltzmann260-vs-boltzmann360-1000its,732,766,2205.833728312,2130.513869394,-34
carcassonne-ucttuned360-vs-ucttuned490-1000its,736,770,2168.642122236,2090.184396648,-34
carcassonne-boltzmann210-vs-boltzmann245-1000its,737,771,2231.891805092,2160.291634442,-34
carcassonne-uct370-vs-uct120-1000its,741,775,2145.90126298,2147.728137189,-34
carcassonne-ucttuned25-vs-ucttuned485-1000its,742,776,2209.849386546,2172.84852516,-34
carcassonne-uct390-vs-uct135-1000its,743,777,2198.085489511,2183.460472375,-34
carcassonne-boltzmann30-vs-boltzmann345-1000its,744,778,2206.24708935,2097.885958636,-34
carcassonne-boltzmann270-vs-boltzmann495-1000its,745,779,2179.564681936,2115.316441119,-34
carcassonne-ucttuned220-vs-ucttuned315-1000its,748,782,2268.177130399,2181.152876617,-34
carcassonne-ucttuned340-vs-ucttuned115-1000its,748,782,2239.122441232,2200.402499681,-34
carcassonne-boltzmann385-vs-boltzmann105-1000its,749,783,2183.183860482,2160.018310601,-34
carcassonne-uct55-vs-uct165-1000its,751,785,2278.848147042,2269.834935687,-34
carcassonne-uct470-vs-uct45-1000its,754,788,2260.284304438,2174.092474142,-34
carcassonne-boltzmann130-vs-boltzmann190-1000its,757,791,2204.729230321,2133.73837987,-34
carcassonne-boltzmann490-vs-boltzmann325-1000its,757,791,2223.594700803,2182.143182299,-34
carcassonne-ucttuned225-vs-ucttuned210-1000its,758,792,2240.909755552,2200.474565467,-34
carcassonne-ucttuned305-vs-ucttuned320-1000its,759,793,2184.078348203,2107.283332244,-34
carcassonne-ucttuned435-vs-ucttuned70-1000its,759,793,2182.669705073,2134.477330632,-34
carcassonne-boltzmann120-vs-boltzmann20-1000its,760,794,2195.183487279,2166.322971109,-34
carcassonne-boltzmann430-vs-boltzmann345-1000its,760,794,2176.917931192,2156.702190821,-34
carcassonne-ucttuned310-vs-ucttuned95-1000its,760,794,2288.162166689,2225.154528698,-34
carcassonne-uct75-vs-uct390-1000its,763,797,2140.745734007,2142.601295387,-34
carcassonne-ucttuned385-vs-ucttuned45-1000its,763,797,2175.577789664,2111.664770495,-34
carcassonne-uct240-vs-uct120-1000its,765,799,2190.688644086,2091.432792645,-34
carcassonne-uct355-vs-uct335-1000its,765,799,2222.822690364,2162.960316593,-34
carcassonne-uct390-vs-uct240-1000its,765,799,2195.37615398,2127.796731835,-34
carcassonne-uct155-vs-uct260-1000its,766,800,2147.764952959,2118.823457607,-34
carcassonne-uct375-vs-uct405-1000its,766,800,2228.746045129,2188.371102633,-34
carcassonne-boltzmann55-vs-boltzmann305-1000its,767,801,2186.194552259,2130.417991089,-34
carcassonne-ucttuned25-vs-ucttuned115-1000its,767,801,2184.153156097,2107.265475883,-34
carcassonne-ucttuned40-vs-ucttuned490-1000its,768,802,2203.904123835,2204.067600009,-34
carcassonne-uct205-vs-uct190-1000its,769,803,2160.785191646,2158.057461651,-34
carcassonne-boltzmann465-vs-boltzmann260-1000its,770,804,2135.337567611,2102.107240463,-34
carcassonne-boltzmann475-vs-boltzmann325-1000its,770,804,2199.044492153,2158.490992837,-34
carcassonne-boltzmann470-vs-boltzmann315-1000its,771,805,2208.538608804,2187.822955954,-34
carcassonne-ucttuned325-vs-ucttuned295-1000its,771,805,2144.386364406,2116.769275603,-34
carcassonne-uct55-vs-uct480-1000its,773,807,2160.002405731,2137.143419849,-34
carcassonne-boltzmann420-vs-boltzmann455-1000its,774,808,2197.455342424,2115.61265706,-34
carcassonne-ucttuned160-vs-ucttuned370-1000its,774,808,2160.654804565,2177.624252994,-34
carcassonne-ucttuned240-vs-ucttuned310-1000its,775,809,2273.001124857,2248.482978928,-34
carcassonne-ucttuned205-vs-ucttuned480-1000its,776,810,2305.728570332,2225.427814329,-34
carcassonne-ucttuned245-vs-ucttuned440-1000its,777,811,2141.939098269,2116.289468413,-34
carcassonne-ucttuned70-vs-ucttuned405-1000its,777,811,2192.757721552,2148.4866588,-34
carcassonne-boltzmann300-vs-boltzmann430-1000its,778,812,2164.469572814,2151.73098063,-34
carcassonne-boltzmann315-vs-boltzmann285-1000its,778,812,2171.033768395,2103.876827973,-34
carcassonne-uct360-vs-uct280-1000its,778,812,2205.315814127,2198.147317185,-34
carcassonne-uct55-vs-uct270-1000its,778,812,2198.753355111,2125.684070761,-34
carcassonne-boltzmann400-vs-boltzmann430-1000its,779,813,2265.252286244,2209.983705717,-34
carcassonne-uct340-vs-uct65-1000its,779,813,2288.159713994,2241.039689784,-34
carcassonne-ucttuned120-vs-ucttuned5-1000its,781,815,2171.56836259,2136.027784378,-34
carcassonne-uct20-vs-uct280-1000its,782,816,2168.844366774,2114.031751325,-34
carcassonne-uct30-vs-uct225-1000its,783,817,2159.76602455,2119.412340897,-34
carcassonne-ucttuned350-vs-ucttuned305-1000its,783,817,2138.894987839,2105.029489314,-34
carcassonne-boltzmann320-vs-boltzmann210-1000its,784,818,2190.769200837,2158.139748656,-34
carcassonne-ucttuned385-vs-ucttuned90-1000its,785,819,2172.049600901,2216.608652556,-34
carcassonne-boltzmann135-vs-boltzmann75-1000its,786,820,2153.181706763,2094.740567064,-34
carcassonne-uct5-vs-uct270-1000its,786,820,2233.148802008,2189.864902185,-34
carcassonne-uct70-vs-uct370-1000its,786,820,2177.75707552,2175.584392542,-34
carcassonne-ucttuned180-vs-ucttuned235-1000its,787,821,2236.038184884,2171.182627229,-34
carcassonne-boltzmann85-vs-boltzmann480-1000its,788,822,2183.457805829,2146.242690798,-34
carcassonne-ucttuned340-vs-ucttuned425-1000its,788,822,2183.341409678,2153.848884876,-34
carcassonne-uct100-vs-uct300-1000its,789,823,2247.648122678,2266.141194281,-34
carcassonne-uct325-vs-uct240-1000its,789,823,2147.663792907,2076.192776004,-34
carcassonne-uct175-vs-uct35-1000its,790,824,2258.119023538,2197.458614673,-34
carcassonne-uct335-vs-uct110-1000its,792,826,2151.22433661,2095.030138184,-34
carcassonne-ucttuned280-vs-ucttuned395-1000its,792,826,2194.737723534,2128.642708052,-34
carcassonne-ucttuned255-vs-ucttuned465-1000its,794,828,2177.892844227,2128.663684799,-34
carcassonne-boltzmann130-vs-boltzmann490-1000its,795,829,2227.930879553,2194.340133166,-34
carcassonne-uct440-vs-uct295-1000its,795,829,2191.00146109,2198.418649495,-34
carcassonne-boltzmann480-vs-boltzmann390-1000its,796,830,2308.451677501,2213.197306623,-34
carcassonne-ucttuned395-vs-ucttuned310-1000its,796,830,2202.905492606,2130.783936672,-34
carcassonne-boltzmann280-vs-boltzmann5-1000its,797,831,2163.723670158,2133.795292218,-34
carcassonne-boltzmann295-vs-boltzmann310-1000its,797,831,2216.601166219,2227.466548807,-34
carcassonne-uct140-vs-uct475-1000its,797,831,2202.372154472,2179.225798739,-34
carcassonne-ucttuned65-vs-ucttuned15-1000its,797,831,2194.799854017,2177.293885618,-34
carcassonne-ucttuned430-vs-ucttuned385-1000its,798,832,2235.045558818,2194.128324548,-34
carcassonne-ucttuned95-vs-ucttuned35-1000its,798,832,2171.008135624,2115.381468538,-34
carcassonne-boltzmann290-vs-boltzmann30-1000its,799,833,2233.573683903,2199.985623714,-34
carcassonne-boltzmann150-vs-boltzmann405-1000its,801,835,2135.759681316,2075.129767559,-34
carcassonne-boltzmann480-vs-boltzmann170-1000its,801,835,2196.925350567,2178.284779246,-34
carcassonne-ucttuned245-vs-ucttuned95-1000its,801,835,2190.717810057,2145.080437093,-34
carcassonne-uct5-vs-uct235-1000its,804,838,2202.632717724,2171.152999576,-34
carcassonne-ucttuned470-vs-ucttuned395-1000its,804,838,2148.714852232,2074.898951154,-34
carcassonne-boltzmann255-vs-boltzmann145-1000its,805,839,2136.126014143,2102.72313694,-34
carcassonne-boltzmann355-vs-boltzmann325-1000its,810,844,2180.145062317,2126.701517572,-34
carcassonne-uct85-vs-uct275-1000its,810,844,2147.18656418,2105.310635324,-34
carcassonne-boltzmann120-vs-boltzmann190-1000its,811,845,2186.227058383,2196.889591576,-34
carcassonne-boltzmann25-vs-boltzmann35-1000its,812,846,2279.033231634,2224.769409777,-34
carcassonne-uct85-vs-uct50-1000its,812,846,2175.907410703,2113.648970202,-34
carcassonne-ucttuned460-vs-ucttuned115-1000its,813,847,2228.341699973,2193.684955275,-34
carcassonne-ucttuned365-vs-ucttuned200-1000its,815,849,2173.344841217,2137.259530938,-34
carcassonne-uct50-vs-uct215-1000its,816,850,2167.573683626,2151.027811638,-34
carcassonne-uct130-vs-uct55-1000its,817,851,2200.068462087,2170.799236723,-34
carcassonne-ucttuned80-vs-ucttuned135-1000its,817,851,2171.869747786,2104.524549457,-34
carcassonne-ucttuned195-vs-ucttuned345-1000its,819,853,2147.437942404,2123.801389874,-34
carcassonne-uct110-vs-uct495-1000its,820,854,2170.720414318,2140.469526718,-34
carcassonne-uct130-vs-uct485-1000its,820,854,2186.562283527,2098.47078822,-34
carcassonne-boltzmann85-vs-boltzmann245-1000its,821,855,2228.726667316,2195.724715756,-34
carcassonne-uct465-vs-uct105-1000its,821,855,2243.236090682,2194.738533055,-34
carcassonne-ucttuned20-vs-ucttuned180-1000its,821,855,2165.568572014,2097.737430807,-34
carcassonne-uct150-vs-uct140-1000its,822,856,2251.856494676,2199.717044347,-34
carcassonne-boltzmann145-vs-boltzmann480-1000its,826,860,2174.125910456,2137.148437895,-34
carcassonne-ucttuned350-vs-ucttuned155-1000its,826,860,2127.502547149,2083.589912981,-34
carcassonne-ucttuned420-vs-ucttuned345-1000its,826,860,2251.854632719,2221.300842274,-34
carcassonne-ucttuned440-vs-ucttuned250-1000its,828,862,2172.814167747,2145.835392625,-34
carcassonne-boltzmann230-vs-boltzmann405-1000its,829,863,2261.035610628,2213.815310214,-34
carcassonne-boltzmann125-vs-boltzmann195-1000its,832,866,2141.251917497,2125.850498475,-34
carcassonne-uct260-vs-uct95-1000its,835,869,2197.081810898,2184.258292138,-34
carcassonne-uct70-vs-uct405-1000its,836,870,2179.815806596,2136.244790917,-34
carcassonne-ucttuned275-vs-ucttuned250-1000its,836,870,2277.490806898,2216.466591182,-34
carcassonne-uct85-vs-uct40-1000its,840,874,2179.467439425,2145.651466066,-34
carcassonne-boltzmann205-vs-boltzmann265-1000its,842,876,2192.179007253,2158.165572243,-34
carcassonne-ucttuned50-vs-ucttuned335-1000its,843,877,2152.438335864,2117.236143256,-34
carcassonne-boltzmann480-vs-boltzmann295-1000its,845,879,2247.747967284,2220.516513871,-34
carcassonne-uct425-vs-uct230-1000its,845,879,2203.824665129,2152.886173443,-34
carcassonne-uct35-vs-uct330-1000its,861,895,2297.114457856,2238.122113818,-34
carcassonne-ucttuned370-vs-ucttuned105-1000its,864,898,2189.216339801,2188.484035366,-34
carcassonne-uct155-vs-uct80-1000its,868,902,2196.954850018,2123.902995687,-34
carcassonne-ucttuned205-vs-ucttuned10-1000its,871,905,2260.176154386,2170.469326591,-34
carcassonne-ucttuned445-vs-ucttuned460-1000its,871,905,2144.308969371,2123.659540584,-34
carcassonne-uct430-vs-uct420-1000its,886,920,2150.125235331,2093.733755603,-34
carcassonne-ucttuned260-vs-ucttuned215-1000its,913,947,2163.201768797,2147.886048304,-34
carcassonne-boltzmann325-vs-boltzmann475-1000its,984,1018,2248.691500815,2216.218505194,-34
carcassonne-uct405-vs-uct135-1000its,690,723,2209.370890593,2155.927208256,-33
carcassonne-ucttuned260-vs-ucttuned405-1000its,703,736,2221.218595627,2163.446801111,-33
carcassonne-uct240-vs-uct470-1000its,716,749,2212.076520609,2205.543126975,-33
carcassonne-uct195-vs-uct220-1000its,717,750,2241.486462631,2182.480144837,-33
carcassonne-boltzmann80-vs-boltzmann185-1000its,720,753,2163.613631491,2139.323755049,-33
carcassonne-boltzmann460-vs-boltzmann150-1000its,721,754,2147.975984101,2084.244265171,-33
carcassonne-uct285-vs-uct310-1000its,724,757,2250.113315698,2173.932252151,-33
carcassonne-boltzmann135-vs-boltzmann300-1000its,725,758,2215.075975235,2162.774426118,-33
carcassonne-boltzmann470-vs-boltzmann355-1000its,727,760,2199.429452034,2139.436914272,-33
carcassonne-uct380-vs-uct65-1000its,729,762,2186.221409306,2134.465101093,-33
carcassonne-ucttuned455-vs-ucttuned465-1000its,729,762,2138.830949431,2073.870603951,-33
carcassonne-boltzmann400-vs-boltzmann40-1000its,730,763,2246.558932028,2184.495962012,-33
carcassonne-boltzmann320-vs-boltzmann335-1000its,733,766,2146.735867651,2148.794031094,-33
carcassonne-ucttuned240-vs-ucttuned295-1000its,734,767,2183.234665677,2093.625349117,-33
carcassonne-ucttuned380-vs-ucttuned405-1000its,736,769,2219.32413206,2155.47919899,-33
carcassonne-boltzmann455-vs-boltzmann355-1000its,738,771,2158.14386825,2078.230547719,-33
carcassonne-ucttuned335-vs-ucttuned95-1000its,740,773,2292.518984063,2234.320188415,-33
carcassonne-boltzmann155-vs-boltzmann215-1000its,742,775,2312.233962395,2246.422828335,-33
carcassonne-boltzmann85-vs-boltzmann195-1000its,744,777,2161.556716034,2111.22394391,-33
carcassonne-ucttuned470-vs-ucttuned120-1000its,744,777,2216.138779873,2180.928904337,-33
carcassonne-boltzmann390-vs-boltzmann320-1000its,745,778,2184.195765943,2182.616302878,-33
carcassonne-uct195-vs-uct395-1000its,751,784,2244.379032282,2186.879404099,-33
carcassonne-ucttuned95-vs-ucttuned115-1000its,751,784,2167.53391148,2132.76902106,-33
carcassonne-boltzmann115-vs-boltzmann45-1000its,753,786,2184.70480277,2122.080656119,-33
carcassonne-uct485-vs-uct235-1000its,753,786,2267.167902429,2240.711864636,-33
carcassonne-uct480-vs-uct220-1000its,754,787,2166.9681422,2110.3027538,-33
carcassonne-boltzmann240-vs-boltzmann85-1000its,757,790,2209.881417016,2185.704385868,-33
carcassonne-ucttuned20-vs-ucttuned10-1000its,757,790,2129.086687279,2146.373570605,-33
carcassonne-ucttuned465-vs-ucttuned325-1000its,759,792,2185.35985921,2141.870640144,-33
carcassonne-uct440-vs-uct230-1000its,760,793,2225.970489839,2209.058654709,-33
carcassonne-boltzmann255-vs-boltzmann370-1000its,761,794,2239.155557264,2180.717064756,-33
carcassonne-boltzmann345-vs-boltzmann145-1000its,761,794,2240.71715534,2215.106079026,-33
carcassonne-uct130-vs-uct275-1000its,763,796,2240.958514521,2195.183348891,-33
carcassonne-ucttuned5-vs-ucttuned215-1000its,763,796,2183.48994067,2102.043718741,-33
carcassonne-uct55-vs-uct370-1000its,764,797,2192.728241982,2155.200258027,-33
carcassonne-ucttuned475-vs-ucttuned20-1000its,764,797,2163.164968476,2112.113246198,-33
carcassonne-ucttuned295-vs-ucttuned370-1000its,766,799,2252.044346913,2147.784994121,-33
carcassonne-ucttuned305-vs-ucttuned395-1000its,767,800,2233.553796147,2208.870318007,-33
carcassonne-ucttuned390-vs-ucttuned205-1000its,767,800,2168.569698385,2126.108698982,-33
carcassonne-boltzmann405-vs-boltzmann140-1000its,768,801,2171.153222556,2120.322012785,-33
carcassonne-boltzmann90-vs-boltzmann360-1000its,768,801,2133.074786553,2118.584494921,-33
carcassonne-ucttuned390-vs-ucttuned325-1000its,769,802,2161.333612217,2135.392960514,-33
carcassonne-boltzmann230-vs-boltzmann35-1000its,770,803,2273.126495394,2257.405025564,-33
carcassonne-uct435-vs-uct175-1000its,770,803,2199.0786788,2140.372013692,-33
carcassonne-uct380-vs-uct350-1000its,771,804,2155.679877438,2140.202643463,-33
carcassonne-ucttuned225-vs-ucttuned220-1000its,771,804,2163.67252811,2143.0795501,-33
carcassonne-ucttuned90-vs-ucttuned435-1000its,773,806,2203.100537266,2198.453412081,-33
carcassonne-uct285-vs-uct50-1000its,774,807,2255.518203909,2254.802854932,-33
carcassonne-boltzmann250-vs-boltzmann345-1000its,776,809,2149.274915925,2131.273826167,-33
carcassonne-uct135-vs-uct225-1000its,777,810,2155.541049893,2122.801368644,-33
carcassonne-boltzmann15-vs-boltzmann230-1000its,778,811,2205.791163473,2155.968817845,-33
carcassonne-boltzmann435-vs-boltzmann275-1000its,778,811,2161.013015061,2111.250287025,-33
carcassonne-uct420-vs-uct50-1000its,779,812,2206.329532736,2190.530753667,-33
carcassonne-ucttuned135-vs-ucttuned85-1000its,779,812,2255.838736393,2197.278093352,-33
carcassonne-ucttuned320-vs-ucttuned60-1000its,779,812,2231.830562405,2157.917476684,-33
carcassonne-ucttuned475-vs-ucttuned140-1000its,779,812,2230.530559546,2191.178488672,-33
carcassonne-ucttuned465-vs-ucttuned375-1000its,780,813,2157.36398745,2094.037306616,-33
carcassonne-ucttuned350-vs-ucttuned230-1000its,781,814,2171.448505825,2088.508997901,-33
carcassonne-boltzmann125-vs-boltzmann40-1000its,782,815,2242.758543777,2140.187531233,-33
carcassonne-boltzmann340-vs-boltzmann190-1000its,783,816,2225.164919511,2173.801791176,-33
carcassonne-uct10-vs-uct180-1000its,783,816,2178.181476188,2159.022023129,-33
carcassonne-boltzmann20-vs-boltzmann135-1000its,784,817,2212.821501474,2168.362303246,-33
carcassonne-uct320-vs-uct360-1000its,786,819,2219.300821185,2206.136421138,-33
carcassonne-uct350-vs-uct425-1000its,787,820,2198.72172885,2203.881004511,-33
carcassonne-ucttuned265-vs-ucttuned55-1000its,787,820,2147.36521212,2089.750792353,-33
carcassonne-ucttuned470-vs-ucttuned345-1000its,787,820,2187.331918711,2160.703591721,-33
carcassonne-ucttuned200-vs-ucttuned330-1000its,788,821,2208.986568987,2154.66340211,-33
carcassonne-ucttuned295-vs-ucttuned25-1000its,788,821,2253.299196341,2182.716079755,-33
carcassonne-ucttuned470-vs-ucttuned370-1000its,788,821,2205.763347576,2112.798739871,-33
carcassonne-boltzmann185-vs-boltzmann390-1000its,790,823,2149.860720804,2118.490519021,-33
carcassonne-ucttuned210-vs-ucttuned240-1000its,790,823,2143.328941199,2157.35028982,-33
carcassonne-ucttuned430-vs-ucttuned240-1000its,792,825,2236.147404274,2173.421282002,-33
carcassonne-boltzmann230-vs-boltzmann480-1000its,793,826,2174.911927931,2147.463519603,-33
carcassonne-uct220-vs-uct225-1000its,795,828,2174.505182296,2147.419715904,-33
carcassonne-ucttuned295-vs-ucttuned45-1000its,795,828,2173.104444118,2126.608671429,-33
carcassonne-ucttuned110-vs-ucttuned25-1000its,796,829,2176.514725261,2142.132865605,-33
carcassonne-boltzmann35-vs-boltzmann200-1000its,797,830,2200.632387629,2164.064939821,-33
carcassonne-uct495-vs-uct235-1000its,799,832,2163.71392836,2093.940660782,-33
carcassonne-uct165-vs-uct495-1000its,800,833,2202.125079244,2181.37515071,-33
carcassonne-uct325-vs-uct80-1000its,800,833,2231.610079743,2175.495189596,-33
carcassonne-uct90-vs-uct250-1000its,800,833,2175.300640864,2174.424832806,-33
carcassonne-ucttuned175-vs-ucttuned165-1000its,801,834,2172.487044778,2122.047623341,-33
carcassonne-uct255-vs-uct30-1000its,807,840,2238.978233958,2175.686585626,-33
carcassonne-boltzmann485-vs-boltzmann20-1000its,809,842,2169.74465843,2170.708703904,-33
carcassonne-boltzmann205-vs-boltzmann165-1000its,812,845,2139.807256556,2139.879345602,-33
carcassonne-boltzmann475-vs-boltzmann110-1000its,813,846,2240.490865718,2207.765669169,-33
carcassonne-uct220-vs-uct320-1000its,814,847,2209.944087984,2168.601493476,-33
carcassonne-uct455-vs-uct35-1000its,815,848,2223.051228557,2162.764269391,-33
carcassonne-boltzmann200-vs-boltzmann55-1000its,816,849,2291.122364674,2208.880314504,-33
carcassonne-boltzmann475-vs-boltzmann85-1000its,817,850,2209.795838564,2160.915311583,-33
carcassonne-boltzmann485-vs-boltzmann330-1000its,817,850,2188.535527939,2187.087192198,-33
carcassonne-boltzmann245-vs-boltzmann30-1000its,818,851,2153.035864935,2145.719313371,-33
carcassonne-uct110-vs-uct225-1000its,818,851,2219.816299855,2208.806242935,-33
carcassonne-boltzmann100-vs-boltzmann440-1000its,819,852,2156.793211008,2114.867973827,-33
carcassonne-boltzmann470-vs-boltzmann300-1000its,819,852,2124.981596934,2068.778749528,-33
carcassonne-ucttuned155-vs-ucttuned310-1000its,819,852,2238.430498391,2198.098106756,-33
carcassonne-ucttuned410-vs-ucttuned180-1000its,820,853,2144.040931356,2112.188251208,-33
carcassonne-uct250-vs-uct155-1000its,822,855,2178.986437217,2146.288382595,-33
carcassonne-ucttuned205-vs-ucttuned365-1000its,822,855,2163.921549871,2127.05416193,-33
carcassonne-ucttuned235-vs-ucttuned390-1000its,822,855,2122.701068501,2094.306953606,-33
carcassonne-uct230-vs-uct140-1000its,823,856,2156.71835271,2097.613515077,-33
carcassonne-ucttuned490-vs-ucttuned320-1000its,823,856,2144.396768557,2107.31853,-33
carcassonne-ucttuned410-vs-ucttuned255-1000its,826,859,2197.311591992,2184.064739144,-33
carcassonne-ucttuned160-vs-ucttuned170-1000its,827,860,2198.134593041,2174.78875617,-33
carcassonne-ucttuned495-vs-ucttuned460-1000its,828,861,2243.062881775,2168.177464073,-33
carcassonne-ucttuned5-vs-ucttuned435-1000its,828,861,2260.360871438,2213.944166358,-33
carcassonne-uct330-vs-uct305-1000its,830,863,2169.629752112,2125.30531018,-33
carcassonne-ucttuned215-vs-ucttuned200-1000its,830,863,2177.37012475,2115.529516901,-33
carcassonne-boltzmann230-vs-boltzmann450-1000its,832,865,2176.730749119,2155.521726704,-33
carcassonne-ucttuned390-vs-ucttuned15-1000its,832,865,2221.864230446,2189.797298906,-33
carcassonne-uct65-vs-uct450-1000its,833,866,2272.517086006,2215.934979923,-33
carcassonne-ucttuned105-vs-ucttuned225-1000its,834,867,2185.732840726,2182.676073537,-33
carcassonne-ucttuned40-vs-ucttuned275-1000its,836,869,2178.862454342,2134.240926217,-33
carcassonne-boltzmann70-vs-boltzmann345-1000its,840,873,2250.645786547,2181.451814123,-33
carcassonne-uct100-vs-uct450-1000its,840,873,2199.329822621,2163.469015887,-33
carcassonne-uct495-vs-uct280-1000its,840,873,2187.786515743,2187.34015637,-33
carcassonne-uct120-vs-uct380-1000its,844,877,2223.539993235,2173.744914325,-33
carcassonne-uct290-vs-uct135-1000its,844,877,2223.948770408,2147.694739033,-33
carcassonne-ucttuned435-vs-ucttuned245-1000its,845,878,2095.761140802,2098.215250457,-33
carcassonne-uct450-vs-uct45-1000its,846,879,2168.002032957,2126.665641953,-33
carcassonne-ucttuned410-vs-ucttuned40-1000its,846,879,2147.606492083,2169.37750796,-33
carcassonne-ucttuned190-vs-ucttuned250-1000its,849,882,2165.956664985,2117.804653936,-33
carcassonne-boltzmann245-vs-boltzmann145-1000its,852,885,2214.451944627,2151.80778734,-33
carcassonne-boltzmann470-vs-boltzmann20-1000its,852,885,2231.099387614,2208.152868643,-33
carcassonne-uct30-vs-uct455-1000its,855,888,2178.991297508,2124.966583841,-33
carcassonne-boltzmann440-vs-boltzmann150-1000its,859,892,2194.377424861,2170.633767718,-33
carcassonne-uct320-vs-uct190-1000its,879,912,2191.773914919,2150.0767517,-33
carcassonne-ucttuned120-vs-ucttuned265-1000its,883,916,2209.563300517,2132.604735173,-33
carcassonne-ucttuned125-vs-ucttuned140-1000its,909,942,2157.931376161,2105.320449567,-33
carcassonne-ucttuned495-vs-ucttuned325-1000its,598,630,1789.047883652,1737.909807178,-32
carcassonne-boltzmann380-vs-boltzmann120-1000its,707,739,2210.939720526,2174.740184685,-32
carcassonne-uct250-vs-uct205-1000its,711,743,2229.285715972,2188.354860639,-32
carcassonne-boltzmann165-vs-boltzmann170-1000its,712,744,2158.309860985,2100.975346253,-32
carcassonne-boltzmann145-vs-boltzmann465-1000its,716,748,2240.231918675,2189.263662296,-32
carcassonne-boltzmann335-vs-boltzmann220-1000its,728,760,2109.787277457,2044.972526736,-32
carcassonne-ucttuned165-vs-ucttuned205-1000its,733,765,2120.132824726,2115.481786376,-32
carcassonne-uct265-vs-uct110-1000its,736,768,2275.184136159,2248.027124789,-32
carcassonne-boltzmann260-vs-boltzmann50-1000its,737,769,2145.800253655,2133.003618431,-32
carcassonne-uct155-vs-uct385-1000its,737,769,2250.640781928,2188.055886832,-32
carcassonne-uct385-vs-uct325-1000its,738,770,2226.208313737,2138.820075191,-32
carcassonne-boltzmann375-vs-boltzmann410-1000its,742,774,2244.899031206,2211.491081748,-32
carcassonne-uct240-vs-uct330-1000its,742,774,2204.561692105,2185.774522495,-32
carcassonne-ucttuned355-vs-ucttuned175-1000its,743,775,2235.035671124,2188.248912738,-32
carcassonne-boltzmann125-vs-boltzmann80-1000its,745,777,2151.092965219,2087.473852065,-32
carcassonne-uct140-vs-uct280-1000its,745,777,2289.907894794,2247.752414772,-32
carcassonne-uct185-vs-uct65-1000its,745,777,2171.033359736,2101.03993315,-32
carcassonne-ucttuned230-vs-ucttuned125-1000its,746,778,2175.198469353,2121.975411517,-32
carcassonne-uct410-vs-uct275-1000its,747,779,2264.591970182,2225.007757753,-32
carcassonne-boltzmann230-vs-boltzmann115-1000its,748,780,2143.98108017,2071.738947461,-32
carcassonne-boltzmann245-vs-boltzmann125-1000its,748,780,2245.773126539,2198.260697175,-32
carcassonne-boltzmann65-vs-boltzmann495-1000its,748,780,2154.350728821,2136.184517407,-32
carcassonne-uct250-vs-uct195-1000its,748,780,2221.515993719,2217.512775727,-32
carcassonne-boltzmann485-vs-boltzmann385-1000its,751,783,2338.448181565,2252.386995332,-32
carcassonne-boltzmann60-vs-boltzmann480-1000its,756,788,2252.113306064,2252.756040252,-32
carcassonne-boltzmann430-vs-boltzmann480-1000its,758,790,2203.95847069,2163.511188117,-32
carcassonne-ucttuned485-vs-ucttuned320-1000its,758,790,2181.864549014,2140.60555396,-32
carcassonne-uct490-vs-uct335-1000its,759,791,2138.099392775,2082.327896868,-32
carcassonne-boltzmann20-vs-boltzmann445-1000its,760,792,2168.190945944,2129.991929525,-32
carcassonne-uct240-vs-uct115-1000its,760,792,2145.127325108,2083.372765682,-32
carcassonne-uct435-vs-uct325-1000its,764,796,2130.869820629,2104.530446412,-32
carcassonne-boltzmann415-vs-boltzmann270-1000its,766,798,2196.997729576,2153.923302247,-32
carcassonne-ucttuned80-vs-ucttuned250-1000its,766,798,2210.672749924,2148.175494207,-32
carcassonne-boltzmann175-vs-boltzmann260-1000its,768,800,2243.067160316,2210.326446413,-32
carcassonne-boltzmann310-vs-boltzmann130-1000its,768,800,2209.290306529,2211.639345636,-32
carcassonne-boltzmann140-vs-boltzmann110-1000its,770,802,2158.740300651,2105.011983522,-32
carcassonne-uct365-vs-uct75-1000its,770,802,2202.801910359,2183.354877438,-32
carcassonne-ucttuned340-vs-ucttuned230-1000its,772,804,2218.328172329,2192.354556547,-32
carcassonne-uct120-vs-uct350-1000its,773,805,2159.609666956,2132.95234973,-32
carcassonne-uct260-vs-uct330-1000its,773,805,2252.118258868,2216.681740134,-32
carcassonne-uct330-vs-uct205-1000its,773,805,2158.084738229,2131.224310447,-32
carcassonne-uct105-vs-uct340-1000its,774,806,2246.866863592,2177.46841611,-32
carcassonne-uct300-vs-uct330-1000its,774,806,2192.87422354,2127.679446266,-32
carcassonne-ucttuned350-vs-ucttuned50-1000its,774,806,2169.719046629,2136.593555403,-32
carcassonne-boltzmann270-vs-boltzmann260-1000its,776,808,2159.427870999,2133.327569256,-32
carcassonne-boltzmann280-vs-boltzmann470-1000its,776,808,2167.488762649,2148.735263938,-32
carcassonne-boltzmann355-vs-boltzmann425-1000its,777,809,2134.591721947,2105.272064232,-32
carcassonne-uct280-vs-uct50-1000its,777,809,2186.108392422,2164.057030938,-32
carcassonne-ucttuned90-vs-ucttuned360-1000its,777,809,2140.989157373,2107.435145018,-32
carcassonne-ucttuned285-vs-ucttuned365-1000its,778,810,2223.236181342,2133.657527449,-32
carcassonne-ucttuned265-vs-ucttuned365-1000its,779,811,2206.193210531,2191.560837603,-32
carcassonne-ucttuned315-vs-ucttuned50-1000its,780,812,2170.0888604,2142.228259725,-32
carcassonne-uct100-vs-uct410-1000its,781,813,2222.349379731,2180.909469454,-32
carcassonne-uct225-vs-uct140-1000its,781,813,2144.283634514,2135.518641056,-32
carcassonne-boltzmann480-vs-boltzmann135-1000its,782,814,2282.554289165,2234.282460767,-32
carcassonne-ucttuned225-vs-ucttuned320-1000its,783,815,2194.234860188,2192.917022136,-32
carcassonne-ucttuned330-vs-ucttuned405-1000its,784,816,2185.033204546,2117.419489391,-32
carcassonne-ucttuned445-vs-ucttuned365-1000its,787,819,2237.86341967,2176.050790587,-32
carcassonne-boltzmann495-vs-boltzmann325-1000its,788,820,2231.902039926,2190.177577521,-32
carcassonne-boltzmann65-vs-boltzmann305-1000its,789,821,2256.811198465,2226.125172003,-32
carcassonne-uct95-vs-uct80-1000its,790,822,2203.730393232,2131.66751806,-32
carcassonne-ucttuned125-vs-ucttuned195-1000its,790,822,2175.962234308,2141.843390365,-32
carcassonne-ucttuned275-vs-ucttuned80-1000its,793,825,2168.046593463,2057.773573114,-32
carcassonne-uct245-vs-uct45-1000its,794,826,2180.375824029,2198.040527676,-32
carcassonne-boltzmann450-vs-boltzmann325-1000its,795,827,2181.036534924,2159.963717802,-32
carcassonne-ucttuned470-vs-ucttuned210-1000its,795,827,2225.21697344,2190.543359542,-32
carcassonne-ucttuned350-vs-ucttuned55-1000its,796,828,2230.044689006,2191.698509373,-32
carcassonne-boltzmann290-vs-boltzmann140-1000its,797,829,2223.901886946,2162.78700692,-32
carcassonne-uct275-vs-uct300-1000its,797,829,2237.433686211,2201.053139086,-32
carcassonne-uct40-vs-uct105-1000its,797,829,2180.876997634,2188.106188432,-32
carcassonne-ucttuned110-vs-ucttuned290-1000its,798,830,2204.611373248,2155.551096986,-32
carcassonne-ucttuned130-vs-ucttuned350-1000its,798,830,2221.101031786,2172.401513621,-32
carcassonne-uct150-vs-uct275-1000its,800,832,2230.538475038,2187.416587704,-32
carcassonne-uct295-vs-uct40-1000its,802,834,2140.424558585,2095.899099749,-32
carcassonne-uct440-vs-uct255-1000its,802,834,2156.927258611,2102.824850149,-32
carcassonne-boltzmann360-vs-boltzmann445-1000its,803,835,2233.248990012,2171.581561739,-32
carcassonne-ucttuned250-vs-ucttuned155-1000its,803,835,2263.968157224,2193.858590143,-32
carcassonne-boltzmann430-vs-boltzmann225-1000its,805,837,2282.23756804,2224.070531944,-32
carcassonne-ucttuned5-vs-ucttuned360-1000its,806,838,2224.223815002,2129.259588038,-32
carcassonne-ucttuned35-vs-ucttuned405-1000its,807,839,2179.157672302,2145.215608738,-32
carcassonne-boltzmann425-vs-boltzmann220-1000its,808,840,2182.568172737,2141.159001327,-32
carcassonne-uct180-vs-uct430-1000its,809,841,2210.010053909,2188.070937009,-32
carcassonne-ucttuned45-vs-ucttuned310-1000its,809,841,2312.899402213,2248.527701106,-32
carcassonne-boltzmann15-vs-boltzmann40-1000its,810,842,2183.022319513,2134.668616879,-32
carcassonne-boltzmann80-vs-boltzmann35-1000its,810,842,2226.631073461,2156.963440033,-32
carcassonne-ucttuned105-vs-ucttuned220-1000its,813,845,2235.097736845,2180.130429825,-32
carcassonne-ucttuned465-vs-ucttuned430-1000its,813,845,2164.690779406,2130.371012801,-32
carcassonne-ucttuned470-vs-ucttuned50-1000its,813,845,2318.674673089,2263.938864001,-32
carcassonne-boltzmann150-vs-boltzmann70-1000its,815,847,2221.612810205,2153.34707142,-32
carcassonne-boltzmann235-vs-boltzmann180-1000its,815,847,2223.917287783,2138.576915946,-32
carcassonne-ucttuned215-vs-ucttuned330-1000its,815,847,2194.360917864,2144.468212784,-32
carcassonne-ucttuned85-vs-ucttuned390-1000its,818,850,2132.83486933,2090.606662986,-32
carcassonne-uct405-vs-uct215-1000its,820,852,2213.359922954,2239.635968615,-32
carcassonne-ucttuned210-vs-ucttuned70-1000its,820,852,2237.173607037,2125.463411784,-32
carcassonne-boltzmann450-vs-boltzmann420-1000its,824,856,2237.591242086,2195.286796419,-32
carcassonne-ucttuned155-vs-ucttuned340-1000its,824,856,2157.439911096,2128.605243525,-32
carcassonne-ucttuned155-vs-ucttuned490-1000its,824,856,2198.239947008,2125.432906319,-32
carcassonne-ucttuned430-vs-ucttuned35-1000its,824,856,2173.125799433,2157.119039808,-32
carcassonne-boltzmann25-vs-boltzmann15-1000its,825,857,2198.265533457,2192.416363212,-32
carcassonne-boltzmann475-vs-boltzmann80-1000its,825,857,2312.208685576,2270.899247415,-32
carcassonne-uct290-vs-uct345-1000its,826,858,2156.265310771,2107.221170551,-32
carcassonne-uct75-vs-uct105-1000its,826,858,2191.368600767,2117.595996882,-32
carcassonne-ucttuned180-vs-ucttuned335-1000its,826,858,2244.544384768,2199.889482395,-32
carcassonne-uct190-vs-uct120-1000its,827,859,2169.063351709,2136.476641998,-32
carcassonne-uct275-vs-uct450-1000its,833,865,2188.488266792,2130.371947556,-32
carcassonne-boltzmann15-vs-boltzmann50-1000its,837,869,2265.936168772,2185.602473588,-32
carcassonne-boltzmann395-vs-boltzmann225-1000its,837,869,2248.19115339,2154.156858219,-32
carcassonne-boltzmann440-vs-boltzmann410-1000its,837,869,2161.158027335,2126.8305225,-32
carcassonne-ucttuned430-vs-ucttuned195-1000its,840,872,2236.285185899,2133.526124975,-32
carcassonne-ucttuned135-vs-ucttuned60-1000its,843,875,2149.024980133,2154.458081914,-32
carcassonne-uct195-vs-uct55-1000its,844,876,2275.949579504,2211.67348711,-32
carcassonne-uct350-vs-uct160-1000its,848,880,2210.810542035,2175.877300462,-32
carcassonne-uct405-vs-uct475-1000its,852,884,2160.753571546,2107.876875821,-32
carcassonne-uct20-vs-uct450-1000its,853,885,2242.16862191,2212.857242556,-32
carcassonne-ucttuned145-vs-ucttuned190-1000its,854,886,2209.759651002,2149.466291968,-32
carcassonne-boltzmann425-vs-boltzmann430-1000its,857,889,2247.2087175,2186.255094712,-32
carcassonne-ucttuned295-vs-ucttuned255-1000its,861,893,2290.43509801,2244.608833163,-32
carcassonne-boltzmann80-vs-boltzmann340-1000its,862,894,2222.208104305,2200.821731247,-32
carcassonne-uct295-vs-uct415-1000its,864,896,2201.945738221,2151.289202794,-32
carcassonne-boltzmann375-vs-boltzmann55-1000its,865,897,2242.214559649,2214.460737892,-32
carcassonne-ucttuned435-vs-ucttuned100-1000its,876,908,2258.552678993,2137.257137595,-32
carcassonne-uct375-vs-uct10-1000its,960,992,2197.571718766,2161.173144987,-32
carcassonne-uct70-vs-uct210-1000its,960,992,2137.986944124,2094.497185746,-32
carcassonne-uct345-vs-uct125-1000its,972,1004,2155.539078315,2116.224500849,-32
carcassonne-uct330-vs-uct425-1000its,589,620,1757.152828266,1711.993878824,-31
carcassonne-boltzmann65-vs-boltzmann90-1000its,695,726,2169.106772701,2154.954299151,-31
carcassonne-uct65-vs-uct320-1000its,698,729,2248.963126703,2212.180016811,-31
carcassonne-boltzmann430-vs-boltzmann105-1000its,703,734,2230.197640396,2177.771802924,-31
carcassonne-boltzmann355-vs-boltzmann130-1000its,727,758,2190.258657981,2151.097739133,-31
carcassonne-uct315-vs-uct360-1000its,732,763,2109.571119737,2087.897846701,-31
carcassonne-uct190-vs-uct430-1000its,734,765,2206.427930538,2178.002318018,-31
carcassonne-uct475-vs-uct60-1000its,736,767,2163.868950939,2105.849357787,-31
carcassonne-boltzmann360-vs-boltzmann430-1000its,737,768,2184.517976451,2107.099837213,-31
carcassonne-boltzmann385-vs-boltzmann75-1000its,738,769,2208.482715077,2170.326446405,-31
carcassonne-boltzmann140-vs-boltzmann120-1000its,739,770,2236.450154767,2145.357123324,-31
carcassonne-boltzmann115-vs-boltzmann350-1000its,743,774,2116.707945262,2054.475134689,-31
carcassonne-boltzmann160-vs-boltzmann315-1000its,743,774,2216.458324066,2185.126721412,-31
carcassonne-uct115-vs-uct495-1000its,746,777,2192.59694199,2175.149407641,-31
carcassonne-uct350-vs-uct195-1000its,746,777,2203.672258498,2138.830298127,-31
carcassonne-uct345-vs-uct70-1000its,748,779,2153.558692732,2094.884517969,-31
carcassonne-uct490-vs-uct40-1000its,748,779,2188.169012154,2134.246120999,-31
carcassonne-ucttuned395-vs-ucttuned55-1000its,749,780,2154.653912769,2110.142812616,-31
carcassonne-ucttuned85-vs-ucttuned135-1000its,750,781,2192.34729087,2115.9096131,-31
carcassonne-uct55-vs-uct375-1000its,751,782,2190.742164612,2107.61286822,-31
carcassonne-uct410-vs-uct140-1000its,753,784,2161.233374986,2152.36345274,-31
carcassonne-boltzmann280-vs-boltzmann130-1000its,754,785,2157.089287029,2118.232244525,-31
carcassonne-uct445-vs-uct205-1000its,754,785,2164.819113011,2110.329044689,-31
carcassonne-boltzmann170-vs-boltzmann400-1000its,755,786,2200.375861168,2128.01510342,-31
carcassonne-uct435-vs-uct345-1000its,755,786,2208.654735499,2185.790853657,-31
carcassonne-uct265-vs-uct75-1000its,757,788,2189.369635144,2183.890288819,-31
carcassonne-uct230-vs-uct395-1000its,758,789,2205.55286181,2165.678019998,-31
carcassonne-ucttuned335-vs-ucttuned380-1000its,758,789,2130.242027288,2091.346432895,-31
carcassonne-boltzmann260-vs-boltzmann75-1000its,759,790,2146.705442132,2121.142101427,-31
carcassonne-boltzmann495-vs-boltzmann370-1000its,761,792,2172.848952268,2137.783381297,-31
carcassonne-uct200-vs-uct245-1000its,763,794,2153.774037112,2046.052799962,-31
carcassonne-boltzmann290-vs-boltzmann150-1000its,764,795,2298.462784674,2257.670810424,-31
carcassonne-uct20-vs-uct130-1000its,764,795,2222.647949977,2173.653115334,-31
carcassonne-ucttuned270-vs-ucttuned265-1000its,765,796,2226.704225694,2158.392422777,-31
carcassonne-uct220-vs-uct305-1000its,767,798,2215.618252995,2229.877357634,-31
carcassonne-ucttuned480-vs-ucttuned210-1000its,767,798,2186.12721084,2128.156996301,-31
carcassonne-boltzmann420-vs-boltzmann335-1000its,770,801,2213.170467483,2175.033116242,-31
carcassonne-boltzmann385-vs-boltzmann460-1000its,771,802,2186.891440681,2154.840907652,-31
carcassonne-uct335-vs-uct290-1000its,771,802,2192.431521651,2158.45881545,-31
carcassonne-ucttuned110-vs-ucttuned120-1000its,771,802,2103.702178717,2068.929710807,-31
carcassonne-boltzmann225-vs-boltzmann415-1000its,772,803,2194.699939815,2189.072008974,-31
carcassonne-uct415-vs-uct195-1000its,772,803,2186.224457228,2121.857401604,-31
carcassonne-boltzmann235-vs-boltzmann330-1000its,774,805,2213.454192978,2124.071337932,-31
carcassonne-boltzmann95-vs-boltzmann205-1000its,774,805,2176.582430689,2136.599781282,-31
carcassonne-boltzmann135-vs-boltzmann25-1000its,776,807,2182.555427348,2154.202371802,-31
carcassonne-uct280-vs-uct365-1000its,776,807,2155.944307445,2118.341754591,-31
carcassonne-uct120-vs-uct450-1000its,777,808,2160.017568498,2105.141187828,-31
carcassonne-uct20-vs-uct460-1000its,778,809,2184.44116854,2092.111660571,-31
carcassonne-boltzmann135-vs-boltzmann50-1000its,779,810,2180.852189867,2146.437975129,-31
carcassonne-ucttuned5-vs-ucttuned340-1000its,780,811,2223.490683136,2186.812201888,-31
carcassonne-boltzmann60-vs-boltzmann495-1000its,783,814,2179.016254675,2141.124958231,-31
carcassonne-uct280-vs-uct420-1000its,783,814,2167.992461893,2141.82471392,-31
carcassonne-ucttuned205-vs-ucttuned390-1000its,783,814,2187.760283028,2160.24924705,-31
carcassonne-ucttuned85-vs-ucttuned45-1000its,786,817,2152.693583786,2101.191138396,-31
carcassonne-boltzmann105-vs-boltzmann280-1000its,787,818,2153.173865966,2073.643346313,-31
carcassonne-uct475-vs-uct445-1000its,787,818,2148.351381763,2120.371033761,-31
carcassonne-boltzmann355-vs-boltzmann75-1000its,788,819,2201.491729072,2167.831922361,-31
carcassonne-boltzmann380-vs-boltzmann355-1000its,788,819,2203.269123092,2184.363664331,-31
carcassonne-uct75-vs-uct80-1000its,788,819,2152.829330619,2138.879829272,-31
carcassonne-boltzmann230-vs-boltzmann105-1000its,790,821,2151.959816811,2088.668091248,-31
carcassonne-boltzmann340-vs-boltzmann25-1000its,790,821,2216.912614709,2194.602370858,-31
carcassonne-ucttuned100-vs-ucttuned120-1000its,790,821,2181.357471778,2160.117666123,-31
carcassonne-boltzmann175-vs-boltzmann320-1000its,792,823,2214.673627734,2199.962274268,-31
carcassonne-boltzmann45-vs-boltzmann135-1000its,793,824,2161.247236254,2133.650868705,-31
carcassonne-uct310-vs-uct260-1000its,793,824,2204.678769417,2123.476445091,-31
carcassonne-uct35-vs-uct110-1000its,793,824,2206.117887484,2129.886655625,-31
carcassonne-uct40-vs-uct345-1000its,793,824,2280.065489414,2233.826544992,-31
carcassonne-uct475-vs-uct405-1000its,793,824,2129.464436185,2075.035584143,-31
carcassonne-ucttuned420-vs-ucttuned460-1000its,793,824,2162.917530864,2131.559088775,-31
carcassonne-uct180-vs-uct15-1000its,794,825,2201.119038341,2132.214135747,-31
carcassonne-boltzmann240-vs-boltzmann450-1000its,795,826,2126.850500725,2107.466207605,-31
carcassonne-ucttuned245-vs-ucttuned290-1000its,795,826,2170.83554531,2145.626489051,-31
carcassonne-ucttuned430-vs-ucttuned370-1000its,796,827,2304.763897647,2251.270291079,-31
carcassonne-boltzmann145-vs-boltzmann110-1000its,797,828,2234.951064968,2196.771644886,-31
carcassonne-uct265-vs-uct80-1000its,797,828,2160.388814857,2113.22453266,-31
carcassonne-ucttuned280-vs-ucttuned100-1000its,797,828,2213.139516441,2139.547482814,-31
carcassonne-ucttuned385-vs-ucttuned220-1000its,797,828,2235.022475865,2167.917600739,-31
carcassonne-ucttuned85-vs-ucttuned235-1000its,798,829,2218.532225863,2139.759448247,-31
carcassonne-uct355-vs-uct285-1000its,800,831,2182.14186852,2141.785212978,-31
carcassonne-uct460-vs-uct345-1000its,800,831,2199.998593875,2164.631333454,-31
carcassonne-ucttuned105-vs-ucttuned55-1000its,801,832,2288.96314006,2233.994060126,-31
carcassonne-ucttuned125-vs-ucttuned325-1000its,801,832,2180.72544011,2138.38751432,-31
carcassonne-ucttuned90-vs-ucttuned285-1000its,802,833,2212.092470426,2157.729072919,-31
carcassonne-ucttuned460-vs-ucttuned140-1000its,805,836,2215.220149842,2171.304150976,-31
carcassonne-boltzmann40-vs-boltzmann155-1000its,806,837,2260.013930728,2194.488760663,-31
carcassonne-boltzmann470-vs-boltzmann90-1000its,806,837,2177.846242362,2133.181539297,-31
carcassonne-uct300-vs-uct425-1000its,807,838,2327.671920034,2260.733418044,-31
carcassonne-ucttuned95-vs-ucttuned360-1000its,808,839,2215.977997296,2167.633380675,-31
carcassonne-boltzmann490-vs-boltzmann265-1000its,809,840,2195.453310728,2175.095838069,-31
carcassonne-ucttuned235-vs-ucttuned300-1000its,809,840,2142.387389685,2100.260408836,-31
carcassonne-boltzmann175-vs-boltzmann240-1000its,810,841,2117.003485439,2084.054507824,-31
carcassonne-uct200-vs-uct430-1000its,811,842,2190.751038716,2149.598445229,-31
carcassonne-ucttuned245-vs-ucttuned385-1000its,811,842,2182.79723022,2138.616577951,-31
carcassonne-boltzmann130-vs-boltzmann390-1000its,812,843,2146.005507505,2100.824656358,-31
carcassonne-uct155-vs-uct70-1000its,812,843,2184.787960385,2125.127738453,-31
carcassonne-ucttuned105-vs-ucttuned25-1000its,812,843,2222.278755187,2181.623608854,-31
carcassonne-uct170-vs-uct380-1000its,813,844,2260.870200982,2255.098437098,-31
carcassonne-ucttuned480-vs-ucttuned435-1000its,813,844,2215.142248847,2199.202025899,-31
carcassonne-uct90-vs-uct495-1000its,814,845,2177.685866921,2172.401636489,-31
carcassonne-ucttuned345-vs-ucttuned25-1000its,815,846,2151.355833723,2131.319369263,-31
carcassonne-uct100-vs-uct35-1000its,816,847,2186.995451231,2162.728443239,-31
carcassonne-uct70-vs-uct175-1000its,816,847,2215.781204191,2116.433522304,-31
carcassonne-ucttuned140-vs-ucttuned60-1000its,816,847,2165.57026638,2121.465793733,-31
carcassonne-ucttuned305-vs-ucttuned490-1000its,817,848,2211.631827251,2158.843267304,-31
carcassonne-ucttuned365-vs-ucttuned325-1000its,817,848,2212.484911334,2137.586601467,-31
carcassonne-boltzmann400-vs-boltzmann295-1000its,819,850,2204.118935566,2161.656172961,-31
carcassonne-ucttuned40-vs-ucttuned110-1000its,819,850,2227.595942916,2167.478959042,-31
carcassonne-boltzmann230-vs-boltzmann25-1000its,820,851,2175.620036844,2168.777771783,-31
carcassonne-uct475-vs-uct315-1000its,820,851,2141.229152323,2090.380528178,-31
carcassonne-ucttuned95-vs-ucttuned165-1000its,820,851,2199.490049589,2162.080393685,-31
carcassonne-uct215-vs-uct345-1000its,824,855,2125.850549623,2128.127992902,-31
carcassonne-ucttuned345-vs-ucttuned50-1000its,824,855,2161.064148678,2125.722143348,-31
carcassonne-boltzmann410-vs-boltzmann215-1000its,826,857,2161.375068854,2153.781677995,-31
carcassonne-uct55-vs-uct80-1000its,827,858,2237.787128142,2225.094452631,-31
carcassonne-boltzmann110-vs-boltzmann170-1000its,828,859,2204.370661119,2161.559966231,-31
carcassonne-uct405-vs-uct310-1000its,828,859,2154.356374157,2154.036275721,-31
carcassonne-ucttuned220-vs-ucttuned410-1000its,828,859,2188.202162103,2142.208312397,-31
carcassonne-ucttuned385-vs-ucttuned140-1000its,828,859,2291.125510688,2256.041749151,-31
carcassonne-ucttuned200-vs-ucttuned340-1000its,829,860,2200.819186294,2180.353277952,-31
carcassonne-ucttuned200-vs-ucttuned215-1000its,830,861,2264.779801288,2214.741633421,-31
carcassonne-ucttuned375-vs-ucttuned285-1000its,830,861,2262.163480176,2220.550728296,-31
carcassonne-ucttuned5-vs-ucttuned445-1000its,830,861,2210.310101628,2150.756279157,-31
carcassonne-uct290-vs-uct55-1000its,833,864,2175.65292012,2141.845706293,-31
carcassonne-ucttuned455-vs-ucttuned325-1000its,833,864,2120.484253585,2118.349365053,-31
carcassonne-uct365-vs-uct55-1000its,836,867,2168.461385025,2126.349697214,-31
carcassonne-boltzmann215-vs-boltzmann365-1000its,839,870,2173.85707405,2166.152957807,-31
carcassonne-ucttuned470-vs-ucttuned45-1000its,839,870,2169.432110309,2133.050617853,-31
carcassonne-ucttuned320-vs-ucttuned65-1000its,840,871,2202.468300663,2166.028162867,-31
carcassonne-ucttuned425-vs-ucttuned270-1000its,844,875,2220.447100657,2167.702018763,-31
carcassonne-uct255-vs-uct300-1000its,846,877,2258.223442606,2193.674253761,-31
carcassonne-uct450-vs-uct420-1000its,849,880,2222.491113762,2170.826006015,-31
carcassonne-uct460-vs-uct75-1000its,853,884,2174.826240459,2139.2445401,-31
carcassonne-ucttuned315-vs-ucttuned225-1000its,855,886,2163.473877181,2162.623289566,-31
carcassonne-uct260-vs-uct45-1000its,856,887,2158.890476442,2150.324239908,-31
carcassonne-uct280-vs-uct10-1000its,857,888,2225.113113756,2216.1841087,-31
carcassonne-ucttuned140-vs-ucttuned40-1000its,863,894,2156.159678815,2124.968911021,-31
carcassonne-ucttuned20-vs-ucttuned165-1000its,868,899,2150.136010098,2112.409827642,-31
carcassonne-boltzmann495-vs-boltzmann10-1000its,873,904,2175.978342104,2099.352702639,-31
carcassonne-uct420-vs-uct145-1000its,877,908,2162.682656298,2097.174381878,-31
carcassonne-ucttuned225-vs-ucttuned10-1000its,882,913,2177.135479172,2121.64490146,-31
carcassonne-uct170-vs-uct210-1000its,884,915,2204.66988049,2134.643406669,-31
carcassonne-uct70-vs-uct190-1000its,893,924,2142.160344989,2097.446819329,-31
carcassonne-boltzmann105-vs-boltzmann290-1000its,896,927,2179.066359965,2152.528619795,-31
carcassonne-ucttuned5-vs-ucttuned95-1000its,896,927,2277.749175761,2216.899600199,-31
carcassonne-boltzmann15-vs-boltzmann480-1000its,897,928,2167.30850674,2112.318770237,-31
carcassonne-ucttuned445-vs-ucttuned250-1000its,671,701,1769.482477608,1781.760854839,-30
carcassonne-uct220-vs-uct25-1000its,699,729,2226.94953371,2184.712569827,-30
carcassonne-boltzmann30-vs-boltzmann155-1000its,703,733,2185.824863574,2140.509311436,-30
carcassonne-boltzmann360-vs-boltzmann375-1000its,712,742,2184.063184966,2128.397633238,-30
carcassonne-ucttuned160-vs-ucttuned355-1000its,715,745,2221.71677972,2177.054308245,-30
carcassonne-boltzmann335-vs-boltzmann290-1000its,721,751,2166.314044586,2109.880146382,-30
carcassonne-ucttuned395-vs-ucttuned10-1000its,721,751,2165.498795473,2122.005878423,-30
carcassonne-uct265-vs-uct185-1000its,722,752,2254.202500068,2180.815942429,-30
carcassonne-boltzmann75-vs-boltzmann195-1000its,724,754,2229.441965823,2171.986984668,-30
carcassonne-boltzmann355-vs-boltzmann465-1000its,725,755,2118.724584154,2095.174311373,-30
carcassonne-boltzmann180-vs-boltzmann315-1000its,726,756,2168.493641057,2090.708198527,-30
carcassonne-boltzmann90-vs-boltzmann225-1000its,728,758,2181.253122165,2118.020729554,-30
carcassonne-uct475-vs-uct260-1000its,731,761,2180.437171297,2126.706293511,-30
carcassonne-boltzmann345-vs-boltzmann170-1000its,734,764,2185.047347467,2165.988628247,-30
carcassonne-boltzmann325-vs-boltzmann180-1000its,735,765,2168.75169312,2123.161418921,-30
carcassonne-boltzmann280-vs-boltzmann240-1000its,741,771,2190.865082374,2142.789488462,-30
carcassonne-uct125-vs-uct375-1000its,741,771,2136.951897999,2127.810810859,-30
carcassonne-boltzmann120-vs-boltzmann485-1000its,743,773,2247.880849174,2172.911196925,-30
carcassonne-boltzmann115-vs-boltzmann125-1000its,745,775,2233.424240849,2176.14317833,-30
carcassonne-uct50-vs-uct235-1000its,745,775,2213.758880661,2172.175328767,-30
carcassonne-boltzmann25-vs-boltzmann440-1000its,747,777,2154.366139879,2116.711546653,-30
carcassonne-boltzmann70-vs-boltzmann490-1000its,747,777,2288.358123858,2246.992638406,-30
carcassonne-boltzmann445-vs-boltzmann150-1000its,748,778,2160.249952626,2134.294505507,-30
carcassonne-uct85-vs-uct135-1000its,748,778,2175.015737133,2126.596179402,-30
carcassonne-ucttuned220-vs-ucttuned470-1000its,748,778,2241.261619298,2200.566226936,-30
carcassonne-boltzmann360-vs-boltzmann440-1000its,749,779,2224.96994011,2191.940719234,-30
carcassonne-boltzmann150-vs-boltzmann165-1000its,750,780,2202.727469068,2147.610027987,-30
carcassonne-ucttuned215-vs-ucttuned310-1000its,750,780,2250.541049872,2209.549630128,-30
carcassonne-boltzmann370-vs-boltzmann45-1000its,751,781,2182.998670419,2180.614130121,-30
carcassonne-uct220-vs-uct40-1000its,754,784,2146.974463307,2134.611690669,-30
carcassonne-uct425-vs-uct185-1000its,758,788,2199.422347224,2168.713032719,-30
carcassonne-ucttuned160-vs-ucttuned365-1000its,758,788,2196.927545344,2159.33286068,-30
carcassonne-boltzmann115-vs-boltzmann485-1000its,761,791,2194.669754971,2127.421230788,-30
carcassonne-boltzmann155-vs-boltzmann270-1000its,761,791,2205.887902514,2135.721161891,-30
carcassonne-boltzmann315-vs-boltzmann175-1000its,764,794,2208.031583622,2163.133477231,-30
carcassonne-ucttuned275-vs-ucttuned55-1000its,764,794,2211.253699555,2157.093270373,-30
carcassonne-boltzmann305-vs-boltzmann135-1000its,767,797,2123.20564603,2087.501800835,-30
carcassonne-boltzmann450-vs-boltzmann150-1000its,767,797,2141.901172754,2152.132355196,-30
carcassonne-uct265-vs-uct300-1000its,767,797,2121.72768944,2104.657691126,-30
carcassonne-boltzmann310-vs-boltzmann325-1000its,769,799,2216.621802516,2164.369999421,-30
carcassonne-boltzmann380-vs-boltzmann240-1000its,769,799,2232.555390502,2181.330089134,-30
carcassonne-uct390-vs-uct330-1000its,769,799,2258.987730126,2188.017097397,-30
carcassonne-ucttuned285-vs-ucttuned215-1000its,769,799,2165.541811319,2077.361634939,-30
carcassonne-ucttuned465-vs-ucttuned70-1000its,769,799,2203.690124649,2146.562748981,-30
carcassonne-boltzmann265-vs-boltzmann400-1000its,770,800,2192.271916853,2131.668683191,-30
carcassonne-boltzmann70-vs-boltzmann65-1000its,771,801,2191.355581496,2169.831008204,-30
carcassonne-ucttuned10-vs-ucttuned30-1000its,771,801,2222.116193471,2195.339334603,-30
carcassonne-ucttuned395-vs-ucttuned105-1000its,771,801,2154.285354955,2125.297504471,-30
carcassonne-boltzmann230-vs-boltzmann470-1000its,774,804,2168.352617847,2166.159789021,-30
carcassonne-uct310-vs-uct475-1000its,774,804,2203.390511664,2176.824469801,-30
carcassonne-uct405-vs-uct295-1000its,774,804,2219.419137417,2179.422654658,-30
carcassonne-ucttuned180-vs-ucttuned410-1000its,774,804,2174.91970139,2161.200765934,-30
carcassonne-ucttuned125-vs-ucttuned275-1000its,776,806,2192.555955049,2104.585841117,-30
carcassonne-ucttuned55-vs-ucttuned425-1000its,776,806,2245.860582882,2186.108270696,-30
carcassonne-boltzmann100-vs-boltzmann455-1000its,778,808,2208.642151194,2147.588892984,-30
carcassonne-boltzmann480-vs-boltzmann40-1000its,778,808,2265.535214708,2181.109464202,-30
carcassonne-uct310-vs-uct330-1000its,778,808,2181.608782771,2155.650406387,-30
carcassonne-ucttuned180-vs-ucttuned415-1000its,778,808,2242.38069517,2189.964071367,-30
carcassonne-boltzmann55-vs-boltzmann170-1000its,781,811,2228.393937493,2175.019772354,-30
carcassonne-boltzmann280-vs-boltzmann155-1000its,782,812,2194.350038364,2175.62803403,-30
carcassonne-ucttuned90-vs-ucttuned365-1000its,782,812,2160.088831576,2056.746391138,-30
carcassonne-ucttuned385-vs-ucttuned190-1000its,787,817,2207.357117598,2127.674010363,-30
carcassonne-ucttuned345-vs-ucttuned190-1000its,789,819,2200.766948032,2178.406880228,-30
carcassonne-uct115-vs-uct455-1000its,790,820,2200.190864493,2126.558517355,-30
carcassonne-ucttuned250-vs-ucttuned210-1000its,790,820,2224.969949515,2176.615235282,-30
carcassonne-ucttuned395-vs-ucttuned380-1000its,790,820,2157.647355939,2141.107478139,-30
carcassonne-boltzmann375-vs-boltzmann490-1000its,791,821,2211.472147015,2185.093590227,-30
carcassonne-boltzmann75-vs-boltzmann220-1000its,791,821,2176.017793109,2100.999099515,-30
carcassonne-uct315-vs-uct170-1000its,791,821,2112.456752945,2078.147721856,-30
carcassonne-ucttuned295-vs-ucttuned5-1000its,792,822,2161.333898742,2114.452927534,-30
carcassonne-uct65-vs-uct490-1000its,793,823,2171.91305742,2142.209845668,-30
carcassonne-uct205-vs-uct90-1000its,794,824,2224.582840071,2187.241164375,-30
carcassonne-ucttuned75-vs-ucttuned120-1000its,794,824,2207.683565903,2164.684943998,-30
carcassonne-uct305-vs-uct185-1000its,795,825,2179.539313281,2147.160015478,-30
carcassonne-ucttuned135-vs-ucttuned50-1000its,795,825,2203.524508366,2175.916846848,-30
carcassonne-ucttuned140-vs-ucttuned470-1000its,795,825,2201.360418515,2124.553688792,-30
carcassonne-boltzmann75-vs-boltzmann250-1000its,796,826,2257.548054975,2148.767123092,-30
carcassonne-boltzmann460-vs-boltzmann245-1000its,797,827,2266.271424131,2228.310239774,-30
carcassonne-boltzmann330-vs-boltzmann130-1000its,798,828,2250.264963276,2230.210398072,-30
carcassonne-uct115-vs-uct90-1000its,798,828,2161.458533049,2129.770035322,-30
carcassonne-uct270-vs-uct265-1000its,798,828,2188.411169648,2162.787253785,-30
carcassonne-boltzmann235-vs-boltzmann190-1000its,799,829,2147.010566283,2097.434083503,-30
carcassonne-uct250-vs-uct95-1000its,799,829,2273.244237664,2217.543578385,-30
carcassonne-uct170-vs-uct105-1000its,800,830,2141.251141293,2159.047927101,-30
carcassonne-uct475-vs-uct400-1000its,800,830,2165.572107397,2138.725062118,-30
carcassonne-ucttuned465-vs-ucttuned105-1000its,803,833,2188.184132566,2159.125172109,-30
carcassonne-boltzmann110-vs-boltzmann165-1000its,805,835,2185.594029606,2149.157751207,-30
carcassonne-boltzmann25-vs-boltzmann160-1000its,805,835,2206.293494629,2148.669257712,-30
carcassonne-boltzmann195-vs-boltzmann130-1000its,806,836,2200.096402168,2112.952355348,-30
carcassonne-uct390-vs-uct65-1000its,806,836,2249.962263176,2175.108189455,-30
carcassonne-boltzmann190-vs-boltzmann450-1000its,807,837,2159.631222497,2139.701118985,-30
carcassonne-uct495-vs-uct100-1000its,807,837,2163.762351658,2139.081171204,-30
carcassonne-boltzmann15-vs-boltzmann165-1000its,808,838,2223.00797899,2175.508250705,-30
carcassonne-uct20-vs-uct120-1000its,808,838,2203.977747965,2147.46212924,-30
carcassonne-uct200-vs-uct145-1000its,808,838,2213.552414204,2157.781163807,-30
carcassonne-ucttuned250-vs-ucttuned240-1000its,808,838,2154.184553234,2125.470127229,-30
carcassonne-ucttuned335-vs-ucttuned285-1000its,808,838,2176.59754311,2184.758318551,-30
carcassonne-uct380-vs-uct180-1000its,809,839,2169.483321668,2114.606307938,-30
carcassonne-ucttuned220-vs-ucttuned140-1000its,809,839,2187.368348845,2122.081588998,-30
carcassonne-boltzmann305-vs-boltzmann355-1000its,810,840,2166.172117661,2106.252229397,-30
carcassonne-uct465-vs-uct375-1000its,810,840,2095.423368464,2104.967794626,-30
carcassonne-boltzmann380-vs-boltzmann175-1000its,811,841,2154.523156666,2151.273242052,-30
carcassonne-uct30-vs-uct115-1000its,811,841,2233.844898358,2169.237144287,-30
carcassonne-uct150-vs-uct45-1000its,812,842,2106.864506876,2100.92250749,-30
carcassonne-boltzmann235-vs-boltzmann450-1000its,815,845,2192.497414185,2152.357944896,-30
carcassonne-uct495-vs-uct35-1000its,815,845,2209.827637881,2176.488669711,-30
carcassonne-uct70-vs-uct165-1000its,815,845,2142.733685491,2153.909976671,-30
carcassonne-uct310-vs-uct495-1000its,817,847,2217.020750412,2175.114200712,-30
carcassonne-ucttuned160-vs-ucttuned35-1000its,817,847,2178.758804835,2147.059757174,-30
carcassonne-uct240-vs-uct110-1000its,819,849,2224.942386201,2154.890170921,-30
carcassonne-boltzmann170-vs-boltzmann495-1000its,821,851,2210.161198702,2147.257199284,-30
carcassonne-uct365-vs-uct445-1000its,822,852,2205.263855793,2172.623044701,-30
carcassonne-uct115-vs-uct490-1000its,823,853,2194.835106799,2168.469112605,-30
carcassonne-ucttuned220-vs-ucttuned385-1000its,824,854,2195.823022496,2153.627362392,-30
carcassonne-uct25-vs-uct240-1000its,826,856,2244.989877106,2177.325668196,-30
carcassonne-ucttuned120-vs-ucttuned180-1000its,826,856,2172.934509046,2122.972958675,-30
carcassonne-uct130-vs-uct400-1000its,827,857,2170.203123956,2135.993809035,-30
carcassonne-uct460-vs-uct50-1000its,827,857,2152.371465677,2076.316071058,-30
carcassonne-ucttuned55-vs-ucttuned180-1000its,828,858,2183.085568383,2141.078982238,-30
carcassonne-uct420-vs-uct390-1000its,829,859,2257.091013371,2206.268672596,-30
carcassonne-ucttuned125-vs-ucttuned420-1000its,833,863,2175.432749722,2087.68889103,-30
carcassonne-ucttuned295-vs-ucttuned145-1000its,833,863,2221.084237322,2158.219242405,-30
carcassonne-ucttuned300-vs-ucttuned110-1000its,833,863,2208.021114551,2141.790622086,-30
carcassonne-uct25-vs-uct300-1000its,834,864,2264.955577718,2212.468320031,-30
carcassonne-uct415-vs-uct320-1000its,834,864,2151.35929,2120.790446369,-30
carcassonne-uct485-vs-uct120-1000its,834,864,2143.214296832,2117.816659812,-30
carcassonne-uct210-vs-uct415-1000its,835,865,2187.268448794,2148.223825621,-30
carcassonne-uct90-vs-uct410-1000its,836,866,2201.233582324,2184.229146708,-30
carcassonne-boltzmann125-vs-boltzmann235-1000its,838,868,2220.538096495,2208.589702298,-30
carcassonne-ucttuned385-vs-ucttuned345-1000its,839,869,2126.769989045,2099.012145754,-30
carcassonne-boltzmann40-vs-boltzmann95-1000its,840,870,2110.451579448,2085.700784998,-30
carcassonne-boltzmann375-vs-boltzmann445-1000its,842,872,2220.31751868,2127.404453373,-30
carcassonne-boltzmann440-vs-boltzmann5-1000its,842,872,2145.761379201,2123.593317887,-30
carcassonne-ucttuned340-vs-ucttuned185-1000its,843,873,2256.275991376,2172.115889156,-30
carcassonne-ucttuned190-vs-ucttuned315-1000its,845,875,2172.535862217,2145.955882327,-30
carcassonne-ucttuned10-vs-ucttuned315-1000its,846,876,2227.212354748,2150.793259337,-30
carcassonne-ucttuned55-vs-ucttuned460-1000its,853,883,2240.479755714,2229.631159061,-30
carcassonne-boltzmann95-vs-boltzmann290-1000its,859,889,2217.891799672,2165.197710297,-30
carcassonne-ucttuned435-vs-ucttuned260-1000its,877,907,2227.087321816,2185.394856281,-30
carcassonne-boltzmann390-vs-boltzmann230-1000its,886,916,2189.22672017,2156.239833108,-30
carcassonne-boltzmann320-vs-boltzmann290-1000its,693,722,2181.242013801,2125.755904055,-29
carcassonne-boltzmann90-vs-boltzmann355-1000its,712,741,2217.954222662,2175.666314396,-29
carcassonne-uct190-vs-uct345-1000its,716,745,2128.162119448,2122.28751887,-29
carcassonne-boltzmann445-vs-boltzmann470-1000its,720,749,2302.886893296,2236.889270743,-29
carcassonne-uct35-vs-uct40-1000its,728,757,2176.591870965,2133.553025834,-29
carcassonne-uct245-vs-uct315-1000its,730,759,2291.4247438,2250.950211456,-29
carcassonne-uct225-vs-uct315-1000its,732,761,2291.108873989,2235.742876374,-29
carcassonne-boltzmann25-vs-boltzmann100-1000its,737,766,2157.308874153,2129.141565412,-29
carcassonne-ucttuned365-vs-ucttuned190-1000its,738,767,2234.382555354,2226.022098931,-29
carcassonne-uct385-vs-uct245-1000its,739,768,2172.212208278,2110.929956991,-29
carcassonne-boltzmann480-vs-boltzmann140-1000its,741,770,2154.42076636,2148.258291101,-29
carcassonne-ucttuned325-vs-ucttuned85-1000its,742,771,2216.986614928,2145.075238422,-29
carcassonne-boltzmann235-vs-boltzmann5-1000its,745,774,2165.0014654,2133.561650085,-29
carcassonne-uct185-vs-uct455-1000its,745,774,2185.90164091,2151.320532751,-29
carcassonne-uct245-vs-uct100-1000its,745,774,2184.552990065,2128.457154036,-29
carcassonne-uct270-vs-uct230-1000its,745,774,2152.261686755,2093.014079022,-29
carcassonne-uct140-vs-uct35-1000its,746,775,2203.384910175,2175.78707719,-29
carcassonne-uct240-vs-uct385-1000its,746,775,2171.551915966,2129.595308831,-29
carcassonne-uct335-vs-uct455-1000its,748,777,2157.068333837,2138.273046878,-29
carcassonne-ucttuned220-vs-ucttuned320-1000its,749,778,2117.654017094,2094.878137308,-29
carcassonne-uct460-vs-uct395-1000its,753,782,2224.651291075,2130.100061199,-29
carcassonne-boltzmann105-vs-boltzmann390-1000its,756,785,2134.303601135,2067.438272723,-29
carcassonne-ucttuned165-vs-ucttuned355-1000its,756,785,2179.874823274,2118.594871418,-29
carcassonne-ucttuned345-vs-ucttuned335-1000its,756,785,2246.996229446,2194.370635306,-29
carcassonne-uct455-vs-uct460-1000its,757,786,2168.449980596,2153.152099004,-29
carcassonne-ucttuned165-vs-ucttuned375-1000its,757,786,2147.327448962,2104.528276225,-29
carcassonne-ucttuned90-vs-ucttuned55-1000its,758,787,2197.240013735,2132.551640401,-29
carcassonne-ucttuned95-vs-ucttuned275-1000its,758,787,2207.234226638,2161.622071521,-29
carcassonne-boltzmann320-vs-boltzmann415-1000its,759,788,2143.875110212,2115.793912643,-29
carcassonne-boltzmann360-vs-boltzmann355-1000its,760,789,2199.876229947,2169.502952883,-29
carcassonne-uct210-vs-uct260-1000its,760,789,2231.821046016,2184.42178872,-29
carcassonne-ucttuned115-vs-ucttuned70-1000its,760,789,2194.907355788,2135.237673998,-29
carcassonne-ucttuned435-vs-ucttuned320-1000its,760,789,2218.815723758,2172.120749147,-29
carcassonne-boltzmann240-vs-boltzmann195-1000its,762,791,2245.32477272,2195.211675209,-29
carcassonne-ucttuned105-vs-ucttuned130-1000its,762,791,2193.329741037,2155.913591299,-29
carcassonne-boltzmann465-vs-boltzmann100-1000its,764,793,2183.071726843,2118.239089809,-29
carcassonne-ucttuned410-vs-ucttuned155-1000its,764,793,2163.955454267,2158.184575903,-29
carcassonne-boltzmann465-vs-boltzmann485-1000its,765,794,2177.72530403,2153.980708592,-29
carcassonne-boltzmann300-vs-boltzmann490-1000its,766,795,2098.796386597,2056.003553949,-29
carcassonne-ucttuned285-vs-ucttuned270-1000its,766,795,2128.219204529,2117.80170291,-29
carcassonne-ucttuned375-vs-ucttuned495-1000its,766,795,2199.361078418,2132.047412464,-29
carcassonne-boltzmann50-vs-boltzmann330-1000its,768,797,2177.781134864,2121.444722398,-29
carcassonne-boltzmann105-vs-boltzmann185-1000its,769,798,2201.738534955,2141.646356611,-29
carcassonne-boltzmann480-vs-boltzmann90-1000its,769,798,2178.276895455,2173.042123162,-29
carcassonne-boltzmann100-vs-boltzmann160-1000its,770,799,2168.688209147,2113.512635475,-29
carcassonne-ucttuned220-vs-ucttuned430-1000its,772,801,2211.428215937,2122.693582722,-29
carcassonne-uct470-vs-uct415-1000its,773,802,2184.711238634,2133.074808199,-29
carcassonne-ucttuned175-vs-ucttuned390-1000its,775,804,2201.43485439,2164.511823587,-29
carcassonne-ucttuned200-vs-ucttuned65-1000its,775,804,2180.265746931,2141.548099303,-29
carcassonne-boltzmann195-vs-boltzmann375-1000its,776,805,2227.786858108,2182.768922925,-29
carcassonne-boltzmann350-vs-boltzmann205-1000its,776,805,2156.977510338,2124.805456058,-29
carcassonne-uct110-vs-uct125-1000its,776,805,2179.751398628,2126.133786491,-29
carcassonne-ucttuned160-vs-ucttuned475-1000its,776,805,2245.059637356,2169.350761197,-29
carcassonne-ucttuned495-vs-ucttuned165-1000its,776,805,2218.35469283,2191.356571511,-29
carcassonne-uct335-vs-uct235-1000its,777,806,2175.204527799,2103.1007567,-29
carcassonne-boltzmann370-vs-boltzmann415-1000its,778,807,2140.67431344,2084.980942537,-29
carcassonne-uct135-vs-uct485-1000its,780,809,2182.082910336,2107.65407715,-29
carcassonne-uct460-vs-uct120-1000its,780,809,2139.530125432,2088.094776373,-29
carcassonne-uct90-vs-uct235-1000its,781,810,2231.409476796,2145.57230501,-29
carcassonne-uct235-vs-uct345-1000its,782,811,2225.47978025,2167.558769823,-29
carcassonne-uct25-vs-uct325-1000its,782,811,2175.185457057,2139.224251175,-29
carcassonne-ucttuned140-vs-ucttuned250-1000its,783,812,2174.592839893,2174.927497322,-29
carcassonne-uct365-vs-uct275-1000its,786,815,2229.715452382,2171.488653269,-29
carcassonne-boltzmann415-vs-boltzmann430-1000its,788,817,2168.15496441,2161.160113225,-29
carcassonne-uct400-vs-uct145-1000its,788,817,2206.552855796,2177.120604076,-29
carcassonne-ucttuned180-vs-ucttuned305-1000its,789,818,2188.03913976,2168.606620261,-29
carcassonne-ucttuned80-vs-ucttuned190-1000its,789,818,2189.900965712,2129.164177037,-29
carcassonne-ucttuned360-vs-ucttuned70-1000its,790,819,2083.682889907,2037.950858454,-29
carcassonne-boltzmann275-vs-boltzmann455-1000its,791,820,2221.313629404,2160.806673556,-29
carcassonne-boltzmann5-vs-boltzmann370-1000its,792,821,2252.150028166,2180.915030364,-29
carcassonne-ucttuned60-vs-ucttuned430-1000its,794,823,2190.027902981,2148.737951722,-29
carcassonne-boltzmann265-vs-boltzmann170-1000its,795,824,2191.97973629,2151.309289739,-29
carcassonne-boltzmann95-vs-boltzmann335-1000its,795,824,2180.371528525,2142.323155546,-29
carcassonne-boltzmann150-vs-boltzmann20-1000its,797,826,2313.814842098,2290.856523363,-29
carcassonne-boltzmann280-vs-boltzmann170-1000its,798,827,2185.504430327,2152.681908924,-29
carcassonne-uct260-vs-uct10-1000its,798,827,2192.844850966,2154.075911503,-29
carcassonne-boltzmann165-vs-boltzmann450-1000its,799,828,2216.639725549,2157.892326854,-29
carcassonne-uct425-vs-uct280-1000its,802,831,2215.937176381,2232.548678855,-29
carcassonne-boltzmann270-vs-boltzmann420-1000its,803,832,2191.157963903,2127.073442929,-29
carcassonne-ucttuned455-vs-ucttuned165-1000its,803,832,2220.116294675,2094.512631007,-29
carcassonne-boltzmann475-vs-boltzmann90-1000its,804,833,2197.363151185,2186.916973445,-29
carcassonne-ucttuned140-vs-ucttuned305-1000its,804,833,2211.947713349,2183.719039339,-29
carcassonne-uct325-vs-uct150-1000its,805,834,2172.276803436,2186.476637436,-29
carcassonne-boltzmann35-vs-boltzmann450-1000its,806,835,2149.502575849,2081.735137353,-29
carcassonne-ucttuned420-vs-ucttuned320-1000its,807,836,2178.328947804,2115.744597559,-29
carcassonne-ucttuned235-vs-ucttuned485-1000its,808,837,2199.936909689,2134.646119217,-29
carcassonne-boltzmann380-vs-boltzmann105-1000its,809,838,2204.901603191,2202.159582688,-29
carcassonne-uct185-vs-uct170-1000its,809,838,2250.24967589,2235.945211416,-29
carcassonne-boltzmann420-vs-boltzmann175-1000its,810,839,2244.90003702,2174.367329351,-29
carcassonne-boltzmann150-vs-boltzmann425-1000its,812,841,2190.178334188,2131.082316911,-29
carcassonne-uct295-vs-uct115-1000its,812,841,2284.572220335,2188.313870579,-29
carcassonne-uct320-vs-uct395-1000its,812,841,2157.984688494,2117.424843041,-29
carcassonne-ucttuned430-vs-ucttuned490-1000its,812,841,2178.390268954,2151.382424152,-29
carcassonne-boltzmann290-vs-boltzmann320-1000its,813,842,2212.853386079,2201.338265566,-29
carcassonne-uct150-vs-uct15-1000its,817,846,2154.740206142,2160.996375189,-29
carcassonne-uct370-vs-uct335-1000its,817,846,2220.728718411,2138.305604158,-29
carcassonne-uct55-vs-uct135-1000its,817,846,2225.0350374,2128.09549482,-29
carcassonne-ucttuned345-vs-ucttuned105-1000its,817,846,2209.341906053,2186.509536991,-29
carcassonne-boltzmann75-vs-boltzmann370-1000its,819,848,2298.412401958,2242.653217818,-29
carcassonne-boltzmann85-vs-boltzmann360-1000its,820,849,2154.718555505,2120.82021757,-29
carcassonne-ucttuned95-vs-ucttuned460-1000its,820,849,2192.635040725,2183.762764577,-29
carcassonne-uct380-vs-uct145-1000its,821,850,2136.975701137,2072.916255453,-29
carcassonne-ucttuned395-vs-ucttuned475-1000its,821,850,2176.427459525,2150.96757408,-29
carcassonne-ucttuned280-vs-ucttuned420-1000its,822,851,2318.058249358,2275.816743291,-29
carcassonne-boltzmann365-vs-boltzmann440-1000its,823,852,2177.164835809,2125.096701901,-29
carcassonne-uct305-vs-uct440-1000its,824,853,2185.225351597,2142.547370672,-29
carcassonne-ucttuned385-vs-ucttuned150-1000its,824,853,2263.01583736,2199.24564135,-29
carcassonne-uct175-vs-uct490-1000its,825,854,2167.335233338,2102.681862585,-29
carcassonne-boltzmann345-vs-boltzmann320-1000its,827,856,2199.003717896,2169.308494363,-29
carcassonne-boltzmann120-vs-boltzmann465-1000its,828,857,2172.814147453,2116.940292038,-29
carcassonne-boltzmann70-vs-boltzmann60-1000its,828,857,2147.537209332,2186.255515933,-29
carcassonne-uct250-vs-uct465-1000its,828,857,2244.681924464,2186.883974588,-29
carcassonne-ucttuned310-vs-ucttuned175-1000its,828,857,2314.288429327,2243.749550053,-29
carcassonne-boltzmann265-vs-boltzmann125-1000its,831,860,2205.815611486,2183.204009705,-29
carcassonne-boltzmann80-vs-boltzmann50-1000its,832,861,2188.420683389,2199.538490351,-29
carcassonne-uct50-vs-uct180-1000its,834,863,2197.797294863,2109.72665329,-29
carcassonne-ucttuned295-vs-ucttuned60-1000its,834,863,2200.960386222,2113.239422795,-29
carcassonne-ucttuned355-vs-ucttuned20-1000its,835,864,2203.029532556,2173.547307983,-29
carcassonne-ucttuned70-vs-ucttuned360-1000its,836,865,2230.449692302,2236.573572518,-29
carcassonne-boltzmann5-vs-boltzmann80-1000its,837,866,2153.520781902,2108.363448087,-29
carcassonne-ucttuned455-vs-ucttuned300-1000its,837,866,2199.344516842,2142.277403665,-29
carcassonne-uct50-vs-uct90-1000its,838,867,2291.293371766,2276.018361133,-29
carcassonne-ucttuned40-vs-ucttuned270-1000its,840,869,2155.920816285,2124.528696578,-29
carcassonne-ucttuned355-vs-ucttuned165-1000its,844,873,2180.997268969,2155.248691523,-29
carcassonne-boltzmann125-vs-boltzmann225-1000its,847,876,2296.070099044,2242.774472117,-29
carcassonne-ucttuned265-vs-ucttuned85-1000its,848,877,2236.459939535,2134.324879953,-29
carcassonne-uct60-vs-uct410-1000its,851,880,2312.681908219,2270.966090242,-29
carcassonne-ucttuned365-vs-ucttuned315-1000its,851,880,2182.282698319,2129.001244371,-29
carcassonne-ucttuned270-vs-ucttuned110-1000its,853,882,2164.262748466,2142.883356773,-29
carcassonne-ucttuned280-vs-ucttuned55-1000its,853,882,2104.401478849,2056.971546633,-29
carcassonne-uct25-vs-uct65-1000its,854,883,2194.16851973,2135.10207108,-29
carcassonne-ucttuned60-vs-ucttuned485-1000its,855,884,2319.336574059,2214.213511798,-29
carcassonne-ucttuned410-vs-ucttuned260-1000its,856,885,2155.288568078,2127.292480517,-29
carcassonne-ucttuned70-vs-ucttuned465-1000its,856,885,2202.891337494,2188.847255652,-29
carcassonne-ucttuned445-vs-ucttuned80-1000its,859,888,2154.952898261,2134.909590931,-29
carcassonne-ucttuned230-vs-ucttuned95-1000its,862,891,2171.904466879,2136.657310435,-29
carcassonne-boltzmann20-vs-boltzmann85-1000its,863,892,2218.057134465,2199.020151274,-29
carcassonne-ucttuned350-vs-ucttuned435-1000its,865,894,2240.455861081,2179.372950169,-29
carcassonne-ucttuned135-vs-ucttuned400-1000its,944,973,2161.635679862,2140.741026609,-29
carcassonne-boltzmann175-vs-boltzmann100-1000its,554,582,1747.959150604,1692.706375994,-28
carcassonne-uct305-vs-uct495-1000its,611,639,1707.669839667,1659.832827715,-28
carcassonne-boltzmann85-vs-boltzmann330-1000its,708,736,2231.939863281,2170.607472768,-28
carcassonne-ucttuned440-vs-ucttuned140-1000its,710,738,2204.318775864,2138.939840913,-28
carcassonne-boltzmann70-vs-boltzmann385-1000its,719,747,2166.037289475,2135.358757704,-28
carcassonne-boltzmann410-vs-boltzmann335-1000its,720,748,2161.550347933,2162.193950813,-28
carcassonne-ucttuned460-vs-ucttuned395-1000its,720,748,2166.926159651,2085.197182217,-28
carcassonne-boltzmann390-vs-boltzmann470-1000its,726,754,2315.638597672,2275.844095632,-28
carcassonne-uct495-vs-uct185-1000its,729,757,2267.908578958,2239.823824259,-28
carcassonne-ucttuned475-vs-ucttuned90-1000its,732,760,2201.193766442,2156.491855853,-28
carcassonne-boltzmann10-vs-boltzmann360-1000its,733,761,2196.228017309,2187.182736378,-28
carcassonne-boltzmann110-vs-boltzmann335-1000its,733,761,2138.552339821,2116.807851422,-28
carcassonne-uct45-vs-uct410-1000its,735,763,2229.04004995,2155.185456834,-28
carcassonne-ucttuned275-vs-ucttuned315-1000its,738,766,2137.782351197,2119.367956272,-28
carcassonne-boltzmann120-vs-boltzmann320-1000its,742,770,2232.394600171,2162.370761965,-28
carcassonne-uct180-vs-uct335-1000its,746,774,2271.376587825,2195.762897331,-28
carcassonne-ucttuned230-vs-ucttuned175-1000its,746,774,2170.362439302,2081.275913908,-28
carcassonne-ucttuned65-vs-ucttuned315-1000its,746,774,2145.88114439,2133.080663388,-28
carcassonne-boltzmann465-vs-boltzmann195-1000its,750,778,2172.282465673,2135.856611177,-28
carcassonne-boltzmann380-vs-boltzmann110-1000its,753,781,2235.541108781,2201.755407356,-28
carcassonne-uct300-vs-uct200-1000its,754,782,2181.163228804,2155.565751874,-28
carcassonne-boltzmann225-vs-boltzmann80-1000its,756,784,2201.131756198,2136.107320611,-28
carcassonne-ucttuned130-vs-ucttuned80-1000its,758,786,2214.563491852,2123.956934991,-28
carcassonne-ucttuned260-vs-ucttuned200-1000its,758,786,2241.448962959,2220.216326171,-28
carcassonne-boltzmann340-vs-boltzmann285-1000its,760,788,2232.829378472,2146.403571104,-28
carcassonne-ucttuned465-vs-ucttuned215-1000its,761,789,2207.597190564,2180.185270216,-28
carcassonne-uct235-vs-uct215-1000its,762,790,2209.939186022,2173.075880273,-28
carcassonne-ucttuned340-vs-ucttuned160-1000its,763,791,2185.33681562,2135.092516873,-28
carcassonne-uct215-vs-uct340-1000its,764,792,2251.1276459,2194.969014811,-28
carcassonne-boltzmann395-vs-boltzmann205-1000its,765,793,2165.592057842,2167.351255382,-28
carcassonne-boltzmann440-vs-boltzmann145-1000its,765,793,2208.398058065,2137.800774778,-28
carcassonne-boltzmann140-vs-boltzmann165-1000its,768,796,2138.780573972,2104.297932326,-28
carcassonne-boltzmann140-vs-boltzmann390-1000its,773,801,2185.903907651,2135.536723508,-28
carcassonne-boltzmann440-vs-boltzmann20-1000its,773,801,2348.447266878,2308.236517972,-28
carcassonne-uct55-vs-uct250-1000its,778,806,2154.473679947,2132.10147686,-28
carcassonne-ucttuned440-vs-ucttuned470-1000its,778,806,2167.164176929,2156.60083905,-28
carcassonne-uct345-vs-uct115-1000its,779,807,2257.317569274,2224.59751903,-28
carcassonne-uct325-vs-uct75-1000its,781,809,2172.920669394,2135.992993423,-28
carcassonne-ucttuned395-vs-ucttuned160-1000its,781,809,2233.120926447,2205.654695773,-28
carcassonne-boltzmann250-vs-boltzmann45-1000its,782,810,2180.400668841,2162.4485996,-28
carcassonne-ucttuned245-vs-ucttuned495-1000its,782,810,2194.758524328,2143.759266257,-28
carcassonne-boltzmann425-vs-boltzmann350-1000its,783,811,2239.729986312,2180.839493924,-28
carcassonne-ucttuned380-vs-ucttuned340-1000its,784,812,2156.103576332,2128.975556155,-28
carcassonne-boltzmann140-vs-boltzmann250-1000its,785,813,2280.998771522,2256.218434137,-28
carcassonne-boltzmann250-vs-boltzmann495-1000its,785,813,2154.974056626,2132.346630846,-28
carcassonne-ucttuned185-vs-ucttuned485-1000its,785,813,2124.368494443,2088.997206243,-28
carcassonne-boltzmann425-vs-boltzmann10-1000its,786,814,2187.390555709,2083.220868618,-28
carcassonne-uct225-vs-uct200-1000its,786,814,2216.401222992,2187.628185628,-28
carcassonne-boltzmann460-vs-boltzmann390-1000its,788,816,2128.037363642,2149.816997537,-28
carcassonne-boltzmann230-vs-boltzmann180-1000its,789,817,2249.974562954,2171.955015755,-28
carcassonne-boltzmann435-vs-boltzmann320-1000its,789,817,2149.605633445,2048.82017697,-28
carcassonne-uct135-vs-uct85-1000its,789,817,2150.581507862,2139.913942226,-28
carcassonne-uct355-vs-uct235-1000its,789,817,2246.555253115,2212.864380926,-28
carcassonne-ucttuned485-vs-ucttuned400-1000its,789,817,2152.754150468,2085.303369333,-28
carcassonne-boltzmann250-vs-boltzmann155-1000its,790,818,2115.443212573,2088.147674574,-28
carcassonne-boltzmann375-vs-boltzmann395-1000its,790,818,2175.388746709,2118.73934565,-28
carcassonne-uct95-vs-uct405-1000its,790,818,2245.248432785,2190.666664901,-28
carcassonne-uct435-vs-uct415-1000its,791,819,2265.098879027,2214.299002737,-28
carcassonne-ucttuned305-vs-ucttuned170-1000its,791,819,2133.587536333,2105.77077655,-28
carcassonne-ucttuned70-vs-ucttuned160-1000its,791,819,2193.119595738,2186.417511037,-28
carcassonne-boltzmann60-vs-boltzmann105-1000its,792,820,2202.636955499,2213.517906436,-28
carcassonne-uct25-vs-uct175-1000its,792,820,2159.704684616,2085.049702737,-28
carcassonne-uct425-vs-uct190-1000its,793,821,2134.734112591,2079.960111395,-28
carcassonne-boltzmann495-vs-boltzmann365-1000its,794,822,2088.170937439,2047.767821699,-28
carcassonne-uct10-vs-uct285-1000its,794,822,2210.514784839,2199.115408522,-28
carcassonne-ucttuned220-vs-ucttuned495-1000its,794,822,2217.196837286,2156.017184965,-28
carcassonne-boltzmann220-vs-boltzmann420-1000its,795,823,2214.026840871,2126.588314268,-28
carcassonne-ucttuned260-vs-ucttuned135-1000its,795,823,2231.119334882,2204.268433276,-28
carcassonne-ucttuned485-vs-ucttuned330-1000its,795,823,2195.893412251,2126.949783951,-28
carcassonne-boltzmann245-vs-boltzmann365-1000its,797,825,2241.608377736,2165.355431806,-28
carcassonne-ucttuned295-vs-ucttuned430-1000its,797,825,2161.765875545,2152.768690517,-28
carcassonne-uct150-vs-uct470-1000its,798,826,2175.164444578,2146.894994653,-28
carcassonne-uct25-vs-uct400-1000its,800,828,2176.784662987,2121.88123514,-28
carcassonne-uct265-vs-uct155-1000its,800,828,2144.058421622,2090.299754656,-28
carcassonne-uct75-vs-uct415-1000its,800,828,2252.365848661,2215.972987513,-28
carcassonne-boltzmann330-vs-boltzmann475-1000its,801,829,2168.030763506,2141.723292949,-28
carcassonne-uct130-vs-uct25-1000its,801,829,2140.963229257,2105.400018083,-28
carcassonne-boltzmann140-vs-boltzmann395-1000its,802,830,2187.235119412,2133.259939587,-28
carcassonne-uct50-vs-uct460-1000its,802,830,2213.283184194,2154.402587082,-28
carcassonne-boltzmann455-vs-boltzmann40-1000its,805,833,2148.708346626,2108.013757947,-28
carcassonne-ucttuned235-vs-ucttuned360-1000its,806,834,2182.189932781,2163.312492716,-28
carcassonne-ucttuned330-vs-ucttuned150-1000its,806,834,2143.964573255,2140.156465839,-28
carcassonne-boltzmann145-vs-boltzmann135-1000its,808,836,2198.956056615,2174.247771042,-28
carcassonne-boltzmann495-vs-boltzmann60-1000its,808,836,2185.270339615,2121.943859302,-28
carcassonne-uct120-vs-uct220-1000its,808,836,2141.772441827,2140.047595142,-28
carcassonne-uct475-vs-uct425-1000its,808,836,2229.415582969,2157.254179443,-28
carcassonne-boltzmann135-vs-boltzmann150-1000its,810,838,2187.511889305,2177.763021319,-28
carcassonne-boltzmann150-vs-boltzmann75-1000its,810,838,2150.878150009,2138.521367302,-28
carcassonne-boltzmann165-vs-boltzmann75-1000its,812,840,2256.12904602,2181.314753283,-28
carcassonne-boltzmann50-vs-boltzmann70-1000its,812,840,2237.251070841,2168.646279857,-28
carcassonne-uct460-vs-uct480-1000its,812,840,2266.886572691,2204.614444316,-28
carcassonne-boltzmann460-vs-boltzmann395-1000its,813,841,2189.247525331,2144.31916975,-28
carcassonne-boltzmann415-vs-boltzmann265-1000its,815,843,2230.369403932,2158.598545019,-28
carcassonne-boltzmann390-vs-boltzmann265-1000its,816,844,2187.080634715,2116.57100053,-28
carcassonne-ucttuned115-vs-ucttuned185-1000its,816,844,2213.254299133,2177.207853896,-28
carcassonne-ucttuned310-vs-ucttuned245-1000its,816,844,2194.536816282,2141.194418589,-28
carcassonne-ucttuned205-vs-ucttuned280-1000its,817,845,2212.13547453,2183.163328859,-28
carcassonne-uct170-vs-uct235-1000its,818,846,2142.73458839,2104.201765143,-28
carcassonne-uct70-vs-uct115-1000its,821,849,2140.107263873,2081.37282739,-28
carcassonne-boltzmann40-vs-boltzmann10-1000its,822,850,2315.674381737,2263.182108088,-28
carcassonne-uct100-vs-uct315-1000its,822,850,2189.355524002,2134.453646424,-28
carcassonne-uct245-vs-uct60-1000its,823,851,2225.163733489,2154.856619945,-28
carcassonne-uct355-vs-uct270-1000its,823,851,2254.115334733,2198.143867,-28
carcassonne-uct85-vs-uct295-1000its,824,852,2226.784211728,2178.032512839,-28
carcassonne-ucttuned380-vs-ucttuned260-1000its,826,854,2182.029893738,2178.624888735,-28
carcassonne-uct455-vs-uct155-1000its,827,855,2227.808249169,2186.870573675,-28
carcassonne-ucttuned175-vs-ucttuned340-1000its,827,855,2128.115169526,2138.43733273,-28
carcassonne-ucttuned395-vs-ucttuned460-1000its,827,855,2201.344835163,2170.520555488,-28
carcassonne-ucttuned105-vs-ucttuned195-1000its,829,857,2180.001183496,2117.68052077,-28
carcassonne-ucttuned305-vs-ucttuned400-1000its,829,857,2211.822169515,2129.058357679,-28
carcassonne-boltzmann50-vs-boltzmann225-1000its,833,861,2154.797023011,2107.382824462,-28
carcassonne-uct300-vs-uct430-1000its,833,861,2246.870621546,2199.98722982,-28
carcassonne-ucttuned390-vs-ucttuned75-1000its,833,861,2140.889513023,2130.270877482,-28
carcassonne-ucttuned165-vs-ucttuned430-1000its,834,862,2192.524131267,2118.295100994,-28
carcassonne-ucttuned55-vs-ucttuned365-1000its,835,863,2209.827795254,2175.311644127,-28
carcassonne-ucttuned335-vs-ucttuned80-1000its,837,865,2169.004087198,2141.918735815,-28
carcassonne-ucttuned365-vs-ucttuned480-1000its,838,866,2170.390660581,2116.407536075,-28
carcassonne-ucttuned455-vs-ucttuned240-1000its,838,866,2191.331450652,2150.891945398,-28
carcassonne-boltzmann410-vs-boltzmann80-1000its,839,867,2221.912351016,2190.148178835,-28
carcassonne-boltzmann60-vs-boltzmann405-1000its,839,867,2200.335886994,2158.85600481,-28
carcassonne-uct115-vs-uct420-1000its,839,867,2245.204544979,2208.914812802,-28
carcassonne-boltzmann385-vs-boltzmann130-1000its,840,868,2158.776990778,2110.069318006,-28
carcassonne-ucttuned430-vs-ucttuned160-1000its,840,868,2284.033106374,2212.025098252,-28
carcassonne-uct360-vs-uct170-1000its,842,870,2226.391883851,2204.577479718,-28
carcassonne-uct150-vs-uct360-1000its,845,873,2110.212191084,2073.182916145,-28
carcassonne-uct125-vs-uct380-1000its,848,876,2202.252963185,2148.471216547,-28
carcassonne-uct195-vs-uct405-1000its,850,878,2175.782870868,2124.180917419,-28
carcassonne-uct315-vs-uct435-1000its,853,881,2098.296771331,2070.589634239,-28
carcassonne-boltzmann385-vs-boltzmann485-1000its,860,888,2231.471125407,2169.348036901,-28
carcassonne-ucttuned295-vs-ucttuned65-1000its,860,888,2195.767791048,2155.657888071,-28
carcassonne-uct250-vs-uct265-1000its,865,893,2202.26702493,2124.011974085,-28
carcassonne-ucttuned80-vs-ucttuned340-1000its,865,893,2217.61662179,2173.70981565,-28
carcassonne-ucttuned25-vs-ucttuned405-1000its,870,898,2285.149309057,2229.642245638,-28
carcassonne-ucttuned335-vs-ucttuned280-1000its,870,898,2180.73203192,2143.669278255,-28
carcassonne-uct425-vs-uct150-1000its,873,901,2126.757536206,2084.684637569,-28
carcassonne-uct150-vs-uct300-1000its,874,902,2221.924781397,2174.150701057,-28
carcassonne-ucttuned260-vs-ucttuned320-1000its,875,903,2187.472856217,2180.211247564,-28
carcassonne-uct330-vs-uct155-1000its,905,933,2254.752649617,2155.462541233,-28
carcassonne-boltzmann155-vs-boltzmann200-1000its,695,722,2161.742527548,2106.783629687,-27
carcassonne-ucttuned480-vs-ucttuned350-1000its,696,723,2144.052058277,2119.584296865,-27
carcassonne-boltzmann320-vs-boltzmann365-1000its,710,737,2202.592654188,2115.762054443,-27
carcassonne-ucttuned495-vs-ucttuned425-1000its,711,738,2223.566637814,2153.815473065,-27
carcassonne-boltzmann440-vs-boltzmann485-1000its,714,741,2273.778728144,2200.100523302,-27
carcassonne-uct150-vs-uct490-1000its,727,754,2160.766654965,2090.094137439,-27
carcassonne-uct200-vs-uct195-1000its,728,755,2206.95286453,2204.272664767,-27
carcassonne-boltzmann10-vs-boltzmann470-1000its,729,756,2235.859634822,2176.849066713,-27
carcassonne-ucttuned415-vs-ucttuned135-1000its,731,758,2268.765270838,2217.839882298,-27
carcassonne-ucttuned275-vs-ucttuned330-1000its,732,759,2217.114713016,2164.142666752,-27
carcassonne-boltzmann30-vs-boltzmann355-1000its,736,763,2239.380918988,2205.480970571,-27
carcassonne-boltzmann455-vs-boltzmann265-1000its,736,763,2162.285970121,2208.668432273,-27
carcassonne-boltzmann400-vs-boltzmann115-1000its,740,767,2160.455000082,2143.577861902,-27
carcassonne-boltzmann450-vs-boltzmann405-1000its,742,769,2200.044721397,2142.930677389,-27
carcassonne-ucttuned225-vs-ucttuned465-1000its,742,769,2191.338758332,2147.919633864,-27
carcassonne-boltzmann380-vs-boltzmann50-1000its,744,771,2157.500855122,2141.490600832,-27
carcassonne-ucttuned185-vs-ucttuned435-1000its,747,774,2254.32094139,2219.073669416,-27
carcassonne-uct195-vs-uct115-1000its,748,775,2213.494103744,2156.38449417,-27
carcassonne-uct315-vs-uct200-1000its,748,775,2226.293606165,2213.187696344,-27
carcassonne-boltzmann150-vs-boltzmann270-1000its,749,776,2197.499212258,2151.852254029,-27
carcassonne-uct355-vs-uct425-1000its,750,777,2163.026185977,2081.691941592,-27
carcassonne-boltzmann200-vs-boltzmann195-1000its,751,778,2214.476992947,2192.602426837,-27
carcassonne-boltzmann415-vs-boltzmann290-1000its,752,779,2258.22590222,2255.003177039,-27
carcassonne-boltzmann90-vs-boltzmann80-1000its,753,780,2220.730784418,2156.183106688,-27
carcassonne-ucttuned195-vs-ucttuned455-1000its,753,780,2263.696282078,2224.050203174,-27
carcassonne-ucttuned330-vs-ucttuned470-1000its,753,780,2213.35436063,2139.440859058,-27
carcassonne-boltzmann360-vs-boltzmann275-1000its,754,781,2193.737116641,2147.047457517,-27
carcassonne-uct360-vs-uct445-1000its,754,781,2192.23519323,2174.882713042,-27
carcassonne-uct120-vs-uct265-1000its,755,782,2225.504787507,2164.969107784,-27
carcassonne-ucttuned185-vs-ucttuned105-1000its,755,782,2193.415889106,2179.868483828,-27
carcassonne-boltzmann340-vs-boltzmann465-1000its,757,784,2208.457213512,2143.092650722,-27
carcassonne-uct175-vs-uct30-1000its,757,784,2165.195360422,2125.964218926,-27
carcassonne-uct55-vs-uct330-1000its,757,784,2154.224958722,2097.55308468,-27
carcassonne-ucttuned325-vs-ucttuned170-1000its,758,785,2241.677746777,2155.131111513,-27
carcassonne-ucttuned235-vs-ucttuned270-1000its,759,786,2210.702456849,2211.712345037,-27
carcassonne-boltzmann250-vs-boltzmann220-1000its,761,788,2180.154554757,2163.236416933,-27
carcassonne-ucttuned40-vs-ucttuned155-1000its,761,788,2186.047605139,2133.838085419,-27
carcassonne-ucttuned345-vs-ucttuned55-1000its,763,790,2193.754463934,2124.759285021,-27
carcassonne-uct260-vs-uct35-1000its,766,793,2257.559764593,2200.766144599,-27
carcassonne-ucttuned430-vs-ucttuned175-1000its,768,795,2240.535614897,2170.742915902,-27
carcassonne-boltzmann450-vs-boltzmann60-1000its,770,797,2278.117811907,2247.100354687,-27
carcassonne-uct30-vs-uct430-1000its,770,797,2267.511044862,2201.123275268,-27
carcassonne-uct205-vs-uct70-1000its,771,798,2202.629951165,2179.768290225,-27
carcassonne-uct435-vs-uct450-1000its,774,801,2163.691262729,2116.919910921,-27
carcassonne-boltzmann400-vs-boltzmann65-1000its,775,802,2246.43202624,2180.251832965,-27
carcassonne-boltzmann295-vs-boltzmann210-1000its,776,803,2274.622550675,2192.489270435,-27
carcassonne-ucttuned490-vs-ucttuned115-1000its,776,803,2171.121977618,2096.379057771,-27
carcassonne-uct380-vs-uct30-1000its,778,805,2127.015150303,2149.860992585,-27
carcassonne-boltzmann415-vs-boltzmann330-1000its,780,807,2187.99564125,2149.869384013,-27
carcassonne-boltzmann90-vs-boltzmann335-1000its,782,809,2140.224143833,2098.264113682,-27
carcassonne-boltzmann180-vs-boltzmann335-1000its,783,810,2156.075458557,2125.312308456,-27
carcassonne-boltzmann45-vs-boltzmann165-1000its,784,811,2211.725123303,2171.821650527,-27
carcassonne-boltzmann345-vs-boltzmann150-1000its,785,812,2240.238034237,2199.020748453,-27
carcassonne-uct200-vs-uct170-1000its,785,812,2157.993594256,2120.026348189,-27
carcassonne-ucttuned10-vs-ucttuned140-1000its,785,812,2226.162422709,2145.244987433,-27
carcassonne-uct400-vs-uct240-1000its,786,813,2177.439559011,2106.005772278,-27
carcassonne-ucttuned235-vs-ucttuned465-1000its,786,813,2230.748038558,2198.765917667,-27
carcassonne-uct470-vs-uct125-1000its,787,814,2209.348813105,2106.789743171,-27
carcassonne-boltzmann415-vs-boltzmann280-1000its,788,815,2224.243638852,2177.729549232,-27
carcassonne-uct315-vs-uct40-1000its,790,817,2212.167607956,2154.753370007,-27
carcassonne-boltzmann220-vs-boltzmann320-1000its,792,819,2248.155627066,2209.008365648,-27
carcassonne-ucttuned345-vs-ucttuned285-1000its,792,819,2213.649794949,2154.924560699,-27
carcassonne-boltzmann305-vs-boltzmann195-1000its,793,820,2167.947730964,2123.268034658,-27
carcassonne-uct450-vs-uct130-1000its,793,820,2207.395133324,2156.025318271,-27
carcassonne-ucttuned95-vs-ucttuned445-1000its,794,821,2270.919894094,2208.426659037,-27
carcassonne-uct110-vs-uct355-1000its,795,822,2270.659889664,2218.363462645,-27
carcassonne-uct370-vs-uct475-1000its,797,824,2189.410081268,2154.490520855,-27
carcassonne-ucttuned180-vs-ucttuned360-1000its,797,824,2178.93221571,2123.994062049,-27
carcassonne-uct110-vs-uct365-1000its,800,827,2206.572442478,2192.949459728,-27
carcassonne-ucttuned245-vs-ucttuned10-1000its,801,828,2179.635956274,2115.512284669,-27
carcassonne-boltzmann15-vs-boltzmann265-1000its,804,831,2243.350054607,2215.265130689,-27
carcassonne-ucttuned315-vs-ucttuned430-1000its,805,832,2304.483562075,2205.120307189,-27
carcassonne-ucttuned450-vs-ucttuned300-1000its,805,832,2201.398436293,2190.921184675,-27
carcassonne-uct220-vs-uct265-1000its,807,834,2268.213113027,2181.2264966,-27
carcassonne-uct345-vs-uct225-1000its,811,838,2144.604401669,2134.687278076,-27
carcassonne-ucttuned430-vs-ucttuned460-1000its,811,838,2229.775320773,2171.012952861,-27
carcassonne-ucttuned75-vs-ucttuned195-1000its,812,839,2174.873992543,2179.011491742,-27
carcassonne-boltzmann315-vs-boltzmann60-1000its,813,840,2157.694821019,2154.126791286,-27
carcassonne-boltzmann80-vs-boltzmann140-1000its,814,841,2216.13095225,2191.594238038,-27
carcassonne-boltzmann350-vs-boltzmann380-1000its,816,843,2186.167500118,2114.466456146,-27
carcassonne-ucttuned370-vs-ucttuned335-1000its,816,843,2233.504786303,2195.268156921,-27
carcassonne-boltzmann260-vs-boltzmann475-1000its,817,844,2250.519106011,2227.271788918,-27
carcassonne-ucttuned345-vs-ucttuned115-1000its,818,845,2231.096129116,2208.146662529,-27
carcassonne-boltzmann20-vs-boltzmann65-1000its,819,846,2187.002623262,2152.075951704,-27
carcassonne-boltzmann275-vs-boltzmann360-1000its,819,846,2194.987138224,2167.545016875,-27
carcassonne-boltzmann240-vs-boltzmann35-1000its,820,847,2191.135331667,2155.195293105,-27
carcassonne-uct390-vs-uct115-1000its,820,847,2246.312041485,2209.901991266,-27
carcassonne-ucttuned310-vs-ucttuned160-1000its,820,847,2197.057301125,2160.111433486,-27
carcassonne-boltzmann45-vs-boltzmann470-1000its,822,849,2189.876114015,2150.606952283,-27
carcassonne-boltzmann85-vs-boltzmann230-1000its,823,850,2180.248763308,2159.00238417,-27
carcassonne-uct180-vs-uct255-1000its,823,850,2149.840912808,2133.44745437,-27
carcassonne-uct265-vs-uct445-1000its,823,850,2252.479457634,2232.070084624,-27
carcassonne-ucttuned110-vs-ucttuned345-1000its,824,851,2219.661676852,2186.904623435,-27
carcassonne-uct100-vs-uct445-1000its,826,853,2108.152794468,2097.889046796,-27
carcassonne-uct325-vs-uct380-1000its,826,853,2183.265076115,2134.704008064,-27
carcassonne-uct345-vs-uct275-1000its,827,854,2225.37512393,2157.144887791,-27
carcassonne-ucttuned100-vs-ucttuned5-1000its,827,854,2201.965371293,2185.466267952,-27
carcassonne-ucttuned250-vs-ucttuned475-1000its,828,855,2204.552564784,2139.490947775,-27
carcassonne-ucttuned455-vs-ucttuned475-1000its,828,855,2169.337453185,2179.548262632,-27
carcassonne-uct75-vs-uct60-1000its,829,856,2230.755244069,2189.280100585,-27
carcassonne-uct380-vs-uct280-1000its,831,858,2198.746473845,2147.346741951,-27
carcassonne-uct350-vs-uct170-1000its,832,859,2213.248823246,2152.631511015,-27
carcassonne-uct65-vs-uct415-1000its,835,862,2220.622325315,2137.257562671,-27
carcassonne-ucttuned295-vs-ucttuned350-1000its,837,864,2216.624037304,2120.58237423,-27
carcassonne-boltzmann170-vs-boltzmann275-1000its,839,866,2202.432611893,2158.408482675,-27
carcassonne-ucttuned370-vs-ucttuned50-1000its,839,866,2196.87893251,2131.777414992,-27
carcassonne-uct330-vs-uct455-1000its,843,870,2166.328574278,2122.517503159,-27
carcassonne-boltzmann365-vs-boltzmann390-1000its,845,872,2180.752295131,2109.445650062,-27
carcassonne-uct80-vs-uct195-1000its,845,872,2302.740202803,2250.304002521,-27
carcassonne-ucttuned250-vs-ucttuned135-1000its,849,876,2139.84348507,2111.165058152,-27
carcassonne-boltzmann230-vs-boltzmann360-1000its,851,878,2255.930328822,2210.78076804,-27
carcassonne-ucttuned100-vs-ucttuned285-1000its,851,878,2172.414613665,2152.422424662,-27
carcassonne-boltzmann325-vs-boltzmann465-1000its,854,881,2162.326596301,2108.864527157,-27
carcassonne-ucttuned70-vs-ucttuned140-1000its,857,884,2235.678576665,2200.294869591,-27
carcassonne-uct80-vs-uct405-1000its,865,892,2214.416170884,2171.160448433,-27
carcassonne-uct105-vs-uct15-1000its,869,896,2234.307343167,2224.706678537,-27
carcassonne-uct415-vs-uct70-1000its,879,906,2287.215844925,2223.186310185,-27
carcassonne-ucttuned340-vs-ucttuned5-1000its,879,906,2210.771399818,2169.364079379,-27
carcassonne-uct30-vs-uct495-1000its,880,907,2248.646730483,2141.337026828,-27
carcassonne-ucttuned145-vs-ucttuned85-1000its,884,911,2200.58340804,2139.432154752,-27
carcassonne-ucttuned155-vs-ucttuned15-1000its,899,926,2262.324605507,2224.759823869,-27
carcassonne-ucttuned45-vs-ucttuned315-1000its,907,934,2244.953637529,2216.318328145,-27
carcassonne-uct140-vs-uct95-1000its,909,936,2173.358994634,2132.232823224,-27
carcassonne-ucttuned275-vs-ucttuned305-1000its,956,983,2210.768494547,2137.544182031,-27
carcassonne-uct375-vs-uct415-1000its,685,711,1730.150939621,1727.334071563,-26
carcassonne-boltzmann435-vs-boltzmann475-1000its,710,736,2202.532465393,2172.175605214,-26
carcassonne-uct305-vs-uct95-1000its,717,743,2201.503689103,2145.193343951,-26
carcassonne-boltzmann125-vs-boltzmann215-1000its,718,744,2167.331682039,2109.338788439,-26
carcassonne-uct310-vs-uct295-1000its,719,745,2126.547175986,2098.487887748,-26
carcassonne-uct55-vs-uct335-1000its,719,745,2226.975028121,2192.350302051,-26
carcassonne-ucttuned260-vs-ucttuned245-1000its,720,746,2193.807645281,2129.945393047,-26
carcassonne-boltzmann270-vs-boltzmann155-1000its,724,750,2151.146335839,2129.959510137,-26
carcassonne-ucttuned350-vs-ucttuned490-1000its,727,753,2231.465547988,2219.841621154,-26
carcassonne-boltzmann420-vs-boltzmann470-1000its,731,757,2264.808478512,2209.096794874,-26
carcassonne-ucttuned230-vs-ucttuned75-1000its,731,757,2159.672861831,2154.844373029,-26
carcassonne-boltzmann375-vs-boltzmann140-1000its,747,773,2255.777180412,2208.753352482,-26
carcassonne-uct215-vs-uct40-1000its,749,775,2181.584536406,2176.548873872,-26
carcassonne-uct140-vs-uct470-1000its,755,781,2152.345691163,2135.796602817,-26
carcassonne-uct205-vs-uct135-1000its,755,781,2177.41840191,2172.531431609,-26
carcassonne-boltzmann410-vs-boltzmann245-1000its,756,782,2237.011334258,2215.410237355,-26
carcassonne-boltzmann435-vs-boltzmann115-1000its,757,783,2218.687038739,2161.159135933,-26
carcassonne-boltzmann135-vs-boltzmann355-1000its,759,785,2250.94291295,2237.923270675,-26
carcassonne-uct75-vs-uct250-1000its,759,785,2157.247802223,2143.366334809,-26
carcassonne-ucttuned290-vs-ucttuned315-1000its,759,785,2252.982731934,2196.188400704,-26
carcassonne-boltzmann480-vs-boltzmann405-1000its,760,786,2159.055529901,2122.675106725,-26
carcassonne-ucttuned345-vs-ucttuned225-1000its,761,787,2216.703457243,2152.397488036,-26
carcassonne-uct330-vs-uct25-1000its,763,789,2167.878529812,2126.468745092,-26
carcassonne-ucttuned150-vs-ucttuned400-1000its,764,790,2189.959547783,2172.620594071,-26
carcassonne-ucttuned480-vs-ucttuned65-1000its,765,791,2270.419994441,2227.427100745,-26
carcassonne-ucttuned50-vs-ucttuned170-1000its,767,793,2217.62869594,2200.805627297,-26
carcassonne-ucttuned440-vs-ucttuned360-1000its,771,797,2218.650173603,2155.30325096,-26
carcassonne-ucttuned210-vs-ucttuned20-1000its,772,798,2192.944290996,2121.542897385,-26
carcassonne-uct425-vs-uct115-1000its,773,799,2201.597019894,2129.189841756,-26
carcassonne-ucttuned145-vs-ucttuned230-1000its,773,799,2239.950607932,2197.098380967,-26
carcassonne-boltzmann165-vs-boltzmann390-1000its,776,802,2250.311785686,2217.706013866,-26
carcassonne-boltzmann280-vs-boltzmann220-1000its,776,802,2150.891114722,2134.63273935,-26
carcassonne-boltzmann325-vs-boltzmann275-1000its,776,802,2126.427137565,2075.748155311,-26
carcassonne-uct80-vs-uct285-1000its,776,802,2229.095952788,2195.764968504,-26
carcassonne-ucttuned220-vs-ucttuned5-1000its,776,802,2157.121754744,2133.932683086,-26
carcassonne-ucttuned85-vs-ucttuned95-1000its,778,804,2235.549706466,2211.533302702,-26
carcassonne-boltzmann335-vs-boltzmann70-1000its,780,806,2221.702144292,2170.714811828,-26
carcassonne-boltzmann35-vs-boltzmann65-1000its,780,806,2167.313471221,2102.501649146,-26
carcassonne-boltzmann305-vs-boltzmann405-1000its,781,807,2169.362312081,2138.089799616,-26
carcassonne-uct360-vs-uct180-1000its,784,810,2143.285847068,2086.557394672,-26
carcassonne-uct185-vs-uct255-1000its,785,811,2201.332991555,2160.671518143,-26
carcassonne-ucttuned375-vs-ucttuned445-1000its,785,811,2257.675370841,2226.492245584,-26
carcassonne-boltzmann275-vs-boltzmann395-1000its,786,812,2278.376748744,2243.851433311,-26
carcassonne-boltzmann300-vs-boltzmann325-1000its,787,813,2258.355376792,2226.856435884,-26
carcassonne-uct200-vs-uct320-1000its,787,813,2142.201103798,2111.974895733,-26
carcassonne-uct370-vs-uct430-1000its,787,813,2221.400123838,2121.589550396,-26
carcassonne-uct280-vs-uct205-1000its,791,817,2244.120619847,2204.824318771,-26
carcassonne-uct95-vs-uct420-1000its,792,818,2238.96505589,2188.481228746,-26
carcassonne-uct365-vs-uct330-1000its,794,820,2183.885231816,2157.801004565,-26
carcassonne-ucttuned30-vs-ucttuned100-1000its,794,820,2241.168890041,2142.659726417,-26
carcassonne-boltzmann345-vs-boltzmann190-1000its,795,821,2181.151193194,2137.557849888,-26
carcassonne-boltzmann390-vs-boltzmann170-1000its,795,821,2225.699000524,2189.456186903,-26
carcassonne-uct445-vs-uct55-1000its,795,821,2182.928228615,2153.714163947,-26
carcassonne-ucttuned485-vs-ucttuned360-1000its,795,821,2172.634941133,2133.555867913,-26
carcassonne-boltzmann200-vs-boltzmann410-1000its,796,822,2252.685457705,2173.764545294,-26
carcassonne-ucttuned110-vs-ucttuned305-1000its,796,822,2200.751346759,2167.88748065,-26
carcassonne-boltzmann355-vs-boltzmann35-1000its,798,824,2145.116834629,2111.105889932,-26
carcassonne-boltzmann445-vs-boltzmann380-1000its,798,824,2163.820740211,2142.246836427,-26
carcassonne-boltzmann50-vs-boltzmann310-1000its,798,824,2266.933378212,2188.399940972,-26
carcassonne-uct260-vs-uct445-1000its,798,824,2197.799183946,2171.853405635,-26
carcassonne-ucttuned335-vs-ucttuned100-1000its,799,825,2197.81985186,2105.263076988,-26
carcassonne-boltzmann395-vs-boltzmann60-1000its,800,826,2223.628535102,2216.287560631,-26
carcassonne-uct110-vs-uct185-1000its,800,826,2196.70594464,2140.09533415,-26
carcassonne-ucttuned125-vs-ucttuned415-1000its,800,826,2188.835305466,2158.783349816,-26
carcassonne-ucttuned190-vs-ucttuned445-1000its,800,826,2195.345336532,2182.500024431,-26
carcassonne-ucttuned440-vs-ucttuned60-1000its,801,827,2196.616460497,2144.288262346,-26
carcassonne-ucttuned165-vs-ucttuned155-1000its,802,828,2182.549299855,2112.433547646,-26
carcassonne-ucttuned15-vs-ucttuned365-1000its,803,829,2177.210113396,2109.976784259,-26
carcassonne-ucttuned255-vs-ucttuned460-1000its,803,829,2201.552974465,2139.264536712,-26
carcassonne-ucttuned435-vs-ucttuned155-1000its,803,829,2175.623886942,2130.012660749,-26
carcassonne-boltzmann425-vs-boltzmann130-1000its,804,830,2261.443674668,2202.75014625,-26
carcassonne-boltzmann425-vs-boltzmann270-1000its,804,830,2257.308882374,2221.75250994,-26
carcassonne-boltzmann475-vs-boltzmann355-1000its,804,830,2140.495850088,2122.153176309,-26
carcassonne-boltzmann450-vs-boltzmann460-1000its,805,831,2204.502037248,2156.818575344,-26
carcassonne-uct395-vs-uct120-1000its,805,831,2294.42701326,2226.040902172,-26
carcassonne-boltzmann190-vs-boltzmann405-1000its,806,832,2196.506869747,2159.331651437,-26
carcassonne-uct35-vs-uct120-1000its,806,832,2172.296381565,2136.785108807,-26
carcassonne-boltzmann90-vs-boltzmann480-1000its,807,833,2213.774263564,2157.656769285,-26
carcassonne-uct15-vs-uct145-1000its,807,833,2152.000877953,2109.756956904,-26
carcassonne-uct455-vs-uct120-1000its,810,836,2233.778254239,2193.400038738,-26
carcassonne-ucttuned255-vs-ucttuned370-1000its,810,836,2153.423458546,2113.152875266,-26
carcassonne-uct205-vs-uct340-1000its,811,837,2192.294707279,2149.083000552,-26
carcassonne-ucttuned70-vs-ucttuned370-1000its,811,837,2163.4459154,2154.00797348,-26
carcassonne-uct425-vs-uct390-1000its,812,838,2255.822089934,2185.599903425,-26
carcassonne-boltzmann130-vs-boltzmann235-1000its,813,839,2193.834707228,2148.266687211,-26
carcassonne-uct495-vs-uct455-1000its,813,839,2198.456678727,2149.106067932,-26
carcassonne-boltzmann455-vs-boltzmann130-1000its,815,841,2114.676906817,2079.219906204,-26
carcassonne-ucttuned295-vs-ucttuned355-1000its,816,842,2253.693681794,2199.659644897,-26
carcassonne-uct40-vs-uct340-1000its,818,844,2155.318999572,2084.142215495,-26
carcassonne-uct45-vs-uct250-1000its,818,844,2142.146489946,2116.721028052,-26
carcassonne-ucttuned150-vs-ucttuned410-1000its,818,844,2239.376987959,2239.576455854,-26
carcassonne-boltzmann350-vs-boltzmann345-1000its,819,845,2243.370093217,2225.953438671,-26
carcassonne-uct215-vs-uct470-1000its,819,845,2174.437082242,2149.390271283,-26
carcassonne-boltzmann310-vs-boltzmann320-1000its,822,848,2178.821182489,2140.625028969,-26
carcassonne-ucttuned435-vs-ucttuned295-1000its,824,850,2223.184205294,2159.047256932,-26
carcassonne-boltzmann425-vs-boltzmann95-1000its,826,852,2099.871817181,2097.636999021,-26
carcassonne-uct155-vs-uct175-1000its,827,853,2248.874530058,2237.081014943,-26
carcassonne-ucttuned380-vs-ucttuned235-1000its,827,853,2180.098636615,2123.119979426,-26
carcassonne-uct470-vs-uct365-1000its,828,854,2162.405178109,2099.944832295,-26
carcassonne-uct365-vs-uct135-1000its,830,856,2187.400758345,2160.861755772,-26
carcassonne-boltzmann175-vs-boltzmann425-1000its,833,859,2194.409468778,2160.546782584,-26
carcassonne-ucttuned445-vs-ucttuned150-1000its,838,864,2160.941681223,2143.397573153,-26
carcassonne-boltzmann320-vs-boltzmann265-1000its,839,865,2185.91400487,2155.438988141,-26
carcassonne-uct265-vs-uct475-1000its,840,866,2222.20385796,2118.778574249,-26
carcassonne-boltzmann340-vs-boltzmann125-1000its,841,867,2279.056775351,2197.03117335,-26
carcassonne-uct275-vs-uct5-1000its,844,870,2170.959714438,2152.93585998,-26
carcassonne-uct310-vs-uct275-1000its,845,871,2140.370152521,2090.614183932,-26
carcassonne-ucttuned470-vs-ucttuned55-1000its,846,872,2190.186431731,2155.215379144,-26
carcassonne-uct440-vs-uct270-1000its,847,873,2201.754675966,2118.303149222,-26
carcassonne-uct20-vs-uct475-1000its,849,875,2228.886747243,2172.870136966,-26
carcassonne-ucttuned250-vs-ucttuned365-1000its,853,879,2206.117874478,2142.874588841,-26
carcassonne-boltzmann100-vs-boltzmann190-1000its,856,882,2275.669734045,2224.069462335,-26
carcassonne-boltzmann30-vs-boltzmann130-1000its,856,882,2223.105404196,2174.499004467,-26
carcassonne-ucttuned185-vs-ucttuned130-1000its,860,886,2137.251284451,2148.091650712,-26
carcassonne-uct105-vs-uct20-1000its,864,890,2306.559465797,2262.973853264,-26
carcassonne-uct205-vs-uct255-1000its,864,890,2204.193460691,2129.595320434,-26
carcassonne-uct200-vs-uct105-1000its,865,891,2241.952438358,2201.967939346,-26
carcassonne-uct5-vs-uct170-1000its,866,892,2227.054347913,2194.064445797,-26
carcassonne-uct470-vs-uct100-1000its,867,893,2139.635027329,2129.446914248,-26
carcassonne-boltzmann325-vs-boltzmann50-1000its,868,894,2229.870973497,2188.243803745,-26
carcassonne-ucttuned155-vs-ucttuned130-1000its,880,906,2239.558655758,2198.025751231,-26
carcassonne-boltzmann40-vs-boltzmann190-1000its,881,907,2186.139762928,2161.480423351,-26
carcassonne-ucttuned115-vs-ucttuned260-1000its,882,908,2196.959301486,2140.391900583,-26
carcassonne-uct395-vs-uct415-1000its,921,947,2183.26243471,2140.606910658,-26
carcassonne-uct245-vs-uct455-1000its,715,740,2211.146972166,2148.548975587,-25
carcassonne-boltzmann445-vs-boltzmann495-1000its,717,742,2233.315417897,2179.14069772,-25
carcassonne-boltzmann120-vs-boltzmann280-1000its,719,744,2193.050623244,2116.009240257,-25
carcassonne-uct305-vs-uct270-1000its,719,744,2185.588847309,2112.410888046,-25
carcassonne-uct80-vs-uct335-1000its,722,747,2170.389917644,2131.040020014,-25
carcassonne-boltzmann300-vs-boltzmann275-1000its,725,750,2179.225687154,2141.012257556,-25
carcassonne-boltzmann495-vs-boltzmann225-1000its,725,750,2180.313051368,2085.281839897,-25
carcassonne-ucttuned335-vs-ucttuned55-1000its,725,750,2150.405379465,2089.482571137,-25
carcassonne-boltzmann170-vs-boltzmann295-1000its,728,753,2110.567644588,2059.449722392,-25
carcassonne-boltzmann70-vs-boltzmann145-1000its,732,757,2194.938166282,2152.085116148,-25
carcassonne-uct175-vs-uct355-1000its,734,759,2262.096880675,2173.559917678,-25
carcassonne-uct45-vs-uct365-1000its,734,759,2194.106287484,2135.770231656,-25
carcassonne-boltzmann250-vs-boltzmann480-1000its,735,760,2216.96841006,2186.4089997,-25
carcassonne-boltzmann40-vs-boltzmann325-1000its,739,764,2181.40137332,2115.824427402,-25
carcassonne-boltzmann215-vs-boltzmann130-1000its,741,766,2258.573274067,2206.560571714,-25
carcassonne-ucttuned160-vs-ucttuned490-1000its,743,768,2201.698678389,2137.74757527,-25
carcassonne-uct155-vs-uct480-1000its,748,773,2201.436700512,2158.267061892,-25
carcassonne-ucttuned320-vs-ucttuned15-1000its,751,776,2187.921658551,2153.555085075,-25
carcassonne-ucttuned325-vs-ucttuned355-1000its,751,776,2256.273993619,2220.181546309,-25
carcassonne-ucttuned465-vs-ucttuned130-1000its,751,776,2160.442296236,2129.860014801,-25
carcassonne-uct280-vs-uct100-1000its,753,778,2166.738679039,2113.619233181,-25
carcassonne-uct435-vs-uct395-1000its,753,778,2174.144271571,2181.512207162,-25
carcassonne-ucttuned380-vs-ucttuned95-1000its,753,778,2137.423681699,2080.977697787,-25
carcassonne-boltzmann70-vs-boltzmann140-1000its,754,779,2243.668261323,2182.170247238,-25
carcassonne-uct275-vs-uct235-1000its,755,780,2157.55957185,2118.043688399,-25
carcassonne-boltzmann45-vs-boltzmann460-1000its,756,781,2214.257940205,2194.074094096,-25
carcassonne-boltzmann130-vs-boltzmann365-1000its,757,782,2184.212224921,2133.485376342,-25
carcassonne-boltzmann80-vs-boltzmann250-1000its,758,783,2232.446628906,2178.269799993,-25
carcassonne-uct80-vs-uct310-1000its,758,783,2197.686140202,2154.175954895,-25
carcassonne-ucttuned165-vs-ucttuned285-1000its,758,783,2211.926913533,2135.128853885,-25
carcassonne-uct125-vs-uct435-1000its,760,785,2161.49688661,2138.611151596,-25
carcassonne-uct385-vs-uct475-1000its,762,787,2246.750563267,2211.298001392,-25
carcassonne-boltzmann230-vs-boltzmann150-1000its,763,788,2152.340154474,2123.080300479,-25
carcassonne-uct130-vs-uct15-1000its,763,788,2170.206350499,2101.811169297,-25
carcassonne-ucttuned135-vs-ucttuned95-1000its,763,788,2215.345454376,2133.023142412,-25
carcassonne-boltzmann405-vs-boltzmann440-1000its,764,789,2205.213557345,2166.443903259,-25
carcassonne-ucttuned345-vs-ucttuned80-1000its,765,790,2189.767681925,2179.543716735,-25
carcassonne-ucttuned130-vs-ucttuned445-1000its,766,791,2243.839952731,2181.62148358,-25
carcassonne-uct265-vs-uct435-1000its,767,792,2210.341285013,2169.792011728,-25
carcassonne-ucttuned365-vs-ucttuned425-1000its,767,792,2126.000276321,2110.141215952,-25
carcassonne-uct340-vs-uct280-1000its,769,794,2152.534930526,2125.785914127,-25
carcassonne-uct480-vs-uct495-1000its,769,794,2301.833725858,2187.142012406,-25
carcassonne-ucttuned385-vs-ucttuned425-1000its,769,794,2190.402594417,2172.874695248,-25
carcassonne-boltzmann275-vs-boltzmann285-1000its,770,795,2190.736180853,2122.190879269,-25
carcassonne-ucttuned465-vs-ucttuned190-1000its,770,795,2179.584752561,2220.325902631,-25
carcassonne-boltzmann140-vs-boltzmann10-1000its,773,798,2221.420105187,2173.522158839,-25
carcassonne-boltzmann335-vs-boltzmann40-1000its,774,799,2146.713767143,2094.319019139,-25
carcassonne-ucttuned200-vs-ucttuned355-1000its,774,799,2224.352838646,2175.487323295,-25
carcassonne-ucttuned60-vs-ucttuned80-1000its,774,799,2146.94962307,2111.697293996,-25
carcassonne-boltzmann310-vs-boltzmann385-1000its,777,802,2243.896825441,2193.927097961,-25
carcassonne-uct200-vs-uct375-1000its,777,802,2140.226017508,2099.07989982,-25
carcassonne-ucttuned110-vs-ucttuned490-1000its,778,803,2216.76371088,2139.460149228,-25
carcassonne-boltzmann30-vs-boltzmann335-1000its,780,805,2169.752791739,2133.889705907,-25
carcassonne-boltzmann40-vs-boltzmann290-1000its,780,805,2273.610928589,2182.310101241,-25
carcassonne-uct340-vs-uct410-1000its,781,806,2227.83288168,2235.010538818,-25
carcassonne-ucttuned320-vs-ucttuned485-1000its,782,807,2181.394109706,2129.48896773,-25
carcassonne-ucttuned485-vs-ucttuned425-1000its,783,808,2195.608739188,2169.6124835,-25
carcassonne-boltzmann105-vs-boltzmann155-1000its,784,809,2211.856360986,2157.671725173,-25
carcassonne-uct455-vs-uct15-1000its,785,810,2235.074949192,2203.84932646,-25
carcassonne-ucttuned35-vs-ucttuned80-1000its,786,811,2142.439197787,2088.53379842,-25
carcassonne-uct30-vs-uct300-1000its,787,812,2165.851590368,2097.359530836,-25
carcassonne-ucttuned255-vs-ucttuned440-1000its,787,812,2167.343251451,2130.664348277,-25
carcassonne-uct275-vs-uct10-1000its,788,813,2207.088012547,2164.329126524,-25
carcassonne-uct55-vs-uct200-1000its,789,814,2113.744963342,2065.908886471,-25
carcassonne-ucttuned395-vs-ucttuned15-1000its,789,814,2165.092632536,2146.982876669,-25
carcassonne-boltzmann210-vs-boltzmann145-1000its,790,815,2252.886456341,2226.129240697,-25
carcassonne-uct110-vs-uct150-1000its,790,815,2119.765426359,2106.274575345,-25
carcassonne-ucttuned125-vs-ucttuned345-1000its,790,815,2169.980027568,2127.928367297,-25
carcassonne-uct85-vs-uct420-1000its,791,816,2139.365637889,2085.739643186,-25
carcassonne-uct115-vs-uct350-1000its,792,817,2218.315779825,2189.413589791,-25
carcassonne-ucttuned190-vs-ucttuned145-1000its,792,817,2119.770110334,2060.803159291,-25
carcassonne-boltzmann90-vs-boltzmann345-1000its,794,819,2131.810813524,2128.619870014,-25
carcassonne-uct380-vs-uct110-1000its,794,819,2222.870902389,2135.168396589,-25
carcassonne-ucttuned295-vs-ucttuned100-1000its,794,819,2230.849185572,2184.93788074,-25
carcassonne-boltzmann425-vs-boltzmann15-1000its,795,820,2187.349404195,2185.341833312,-25
carcassonne-boltzmann425-vs-boltzmann185-1000its,795,820,2224.365689913,2199.127427107,-25
carcassonne-boltzmann5-vs-boltzmann140-1000its,795,820,2203.976648678,2179.799398998,-25
carcassonne-uct380-vs-uct400-1000its,796,821,2238.867845984,2150.134485814,-25
carcassonne-uct280-vs-uct185-1000its,798,823,2197.399949215,2145.187670972,-25
carcassonne-uct360-vs-uct340-1000its,798,823,2220.040018911,2118.919339569,-25
carcassonne-uct315-vs-uct375-1000its,799,824,2119.552248608,2107.288550045,-25
carcassonne-ucttuned460-vs-ucttuned135-1000its,801,826,2173.219856208,2149.37420148,-25
carcassonne-boltzmann220-vs-boltzmann150-1000its,802,827,2202.856323007,2197.849728945,-25
carcassonne-ucttuned470-vs-ucttuned410-1000its,802,827,2241.701347903,2185.153533809,-25
carcassonne-uct425-vs-uct275-1000its,804,829,2139.081700503,2110.452136032,-25
carcassonne-boltzmann275-vs-boltzmann50-1000its,805,830,2207.840337398,2143.813819084,-25
carcassonne-boltzmann470-vs-boltzmann490-1000its,805,830,2152.977094159,2101.413345296,-25
carcassonne-uct95-vs-uct210-1000its,805,830,2174.341883238,2146.110092123,-25
carcassonne-ucttuned15-vs-ucttuned170-1000its,805,830,2212.308274311,2176.225042452,-25
carcassonne-uct105-vs-uct60-1000its,806,831,2152.018875371,2104.435760676,-25
carcassonne-uct320-vs-uct285-1000its,806,831,2300.526252756,2247.805164794,-25
carcassonne-boltzmann300-vs-boltzmann320-1000its,807,832,2272.918937913,2169.016130122,-25
carcassonne-boltzmann35-vs-boltzmann370-1000its,807,832,2221.648276679,2169.793281274,-25
carcassonne-ucttuned490-vs-ucttuned415-1000its,807,832,2296.624920664,2281.046447445,-25
carcassonne-ucttuned80-vs-ucttuned325-1000its,807,832,2254.757633347,2213.314833209,-25
carcassonne-boltzmann210-vs-boltzmann335-1000its,808,833,2174.163072275,2131.534274171,-25
carcassonne-uct150-vs-uct325-1000its,809,834,2258.752986439,2216.360462752,-25
carcassonne-boltzmann285-vs-boltzmann160-1000its,810,835,2140.310743827,2143.976696223,-25
carcassonne-uct200-vs-uct360-1000its,810,835,2165.986754592,2153.17525784,-25
carcassonne-ucttuned180-vs-ucttuned425-1000its,810,835,2221.725330432,2170.691685621,-25
carcassonne-boltzmann405-vs-boltzmann5-1000its,811,836,2279.642501634,2228.853150385,-25
carcassonne-uct420-vs-uct465-1000its,811,836,2150.3381432,2093.290206379,-25
carcassonne-ucttuned255-vs-ucttuned5-1000its,811,836,2118.778876034,2104.396749672,-25
carcassonne-ucttuned435-vs-ucttuned305-1000its,811,836,2210.632294457,2144.810418753,-25
carcassonne-ucttuned220-vs-ucttuned450-1000its,813,838,2243.274094235,2162.364907586,-25
carcassonne-ucttuned490-vs-ucttuned420-1000its,814,839,2167.475955022,2105.070323483,-25
carcassonne-boltzmann195-vs-boltzmann215-1000its,815,840,2197.80533771,2161.508802615,-25
carcassonne-boltzmann295-vs-boltzmann105-1000its,815,840,2167.763549066,2146.771255709,-25
carcassonne-uct65-vs-uct360-1000its,820,845,2152.228187669,2106.076996772,-25
carcassonne-boltzmann365-vs-boltzmann200-1000its,821,846,2184.844824184,2164.276777346,-25
carcassonne-uct465-vs-uct240-1000its,821,846,2125.328402617,2116.084550351,-25
carcassonne-ucttuned360-vs-ucttuned435-1000its,821,846,2276.992670657,2249.196807606,-25
carcassonne-boltzmann455-vs-boltzmann45-1000its,822,847,2238.897872494,2202.887987379,-25
carcassonne-boltzmann365-vs-boltzmann425-1000its,826,851,2236.43977988,2172.938259577,-25
carcassonne-uct105-vs-uct135-1000its,826,851,2197.826575875,2109.78104885,-25
carcassonne-uct185-vs-uct460-1000its,826,851,2194.881318131,2148.956119501,-25
carcassonne-uct465-vs-uct70-1000its,827,852,2168.924675065,2149.551748453,-25
carcassonne-ucttuned20-vs-ucttuned190-1000its,830,855,2164.205585148,2090.149532539,-25
carcassonne-boltzmann465-vs-boltzmann310-1000its,832,857,2222.614611722,2178.503666046,-25
carcassonne-boltzmann5-vs-boltzmann300-1000its,833,858,2153.370495233,2112.415533554,-25
carcassonne-ucttuned195-vs-ucttuned380-1000its,835,860,2223.984335028,2224.218040966,-25
carcassonne-boltzmann310-vs-boltzmann360-1000its,838,863,2228.777479018,2189.023390693,-25
carcassonne-ucttuned490-vs-ucttuned210-1000its,838,863,2238.872686148,2163.299058383,-25
carcassonne-ucttuned425-vs-ucttuned395-1000its,841,866,2185.611362819,2146.060876603,-25
carcassonne-boltzmann275-vs-boltzmann215-1000its,842,867,2169.473121937,2119.140319342,-25
carcassonne-ucttuned100-vs-ucttuned480-1000its,842,867,2255.970873653,2231.550016405,-25
carcassonne-ucttuned485-vs-ucttuned395-1000its,844,869,2202.670421171,2147.72292597,-25
carcassonne-ucttuned285-vs-ucttuned5-1000its,847,872,2176.731109808,2171.001199558,-25
carcassonne-ucttuned110-vs-ucttuned220-1000its,848,873,2187.024084869,2139.426731931,-25
carcassonne-uct275-vs-uct110-1000its,852,877,2218.383771008,2184.37943574,-25
carcassonne-ucttuned205-vs-ucttuned45-1000its,852,877,2101.839300311,2069.092945559,-25
carcassonne-uct15-vs-uct465-1000its,853,878,2181.409887044,2166.569320018,-25
carcassonne-ucttuned5-vs-ucttuned260-1000its,855,880,2188.72308108,2164.540366784,-25
carcassonne-uct480-vs-uct215-1000its,857,882,2173.909946559,2146.900636751,-25
carcassonne-uct490-vs-uct10-1000its,857,882,2208.610922215,2186.470391039,-25
carcassonne-ucttuned375-vs-ucttuned395-1000its,859,884,2232.32690869,2205.824452203,-25
carcassonne-uct455-vs-uct110-1000its,863,888,2215.830554212,2165.585027589,-25
carcassonne-boltzmann45-vs-boltzmann190-1000its,864,889,2269.248619072,2252.751076315,-25
carcassonne-uct265-vs-uct170-1000its,866,891,2196.889945124,2138.465778906,-25
carcassonne-ucttuned230-vs-ucttuned215-1000its,868,893,2190.537792892,2201.579183931,-25
carcassonne-ucttuned80-vs-ucttuned255-1000its,870,895,2158.563945277,2130.122994565,-25
carcassonne-boltzmann15-vs-boltzmann300-1000its,880,905,2216.608716232,2154.687210583,-25
carcassonne-uct495-vs-uct160-1000its,880,905,2143.247213652,2120.922933751,-25
carcassonne-ucttuned495-vs-ucttuned465-1000its,881,906,2201.888094114,2187.232364822,-25
carcassonne-boltzmann445-vs-boltzmann165-1000its,883,908,2253.415953711,2210.782574282,-25
carcassonne-ucttuned290-vs-ucttuned455-1000its,886,911,2221.173673351,2181.298310009,-25
carcassonne-boltzmann15-vs-boltzmann380-1000its,892,917,2198.889552127,2140.505285834,-25
carcassonne-ucttuned375-vs-ucttuned45-1000its,904,929,2223.316701758,2171.555704092,-25
carcassonne-ucttuned10-vs-ucttuned410-1000its,906,931,2175.782203591,2164.769991609,-25
carcassonne-ucttuned470-vs-ucttuned30-1000its,927,952,2191.908145939,2137.309961957,-25
carcassonne-boltzmann410-vs-boltzmann295-1000its,702,726,2238.062247289,2178.319781801,-24
carcassonne-uct470-vs-uct335-1000its,703,727,2233.479577113,2189.493352922,-24
carcassonne-boltzmann395-vs-boltzmann155-1000its,721,745,2145.969300183,2067.723274954,-24
carcassonne-boltzmann325-vs-boltzmann150-1000its,729,753,2202.62628252,2169.352842737,-24
carcassonne-boltzmann465-vs-boltzmann420-1000its,730,754,2206.82164684,2180.2349438,-24
carcassonne-ucttuned230-vs-ucttuned100-1000its,733,757,2237.101599206,2150.401930752,-24
carcassonne-ucttuned230-vs-ucttuned495-1000its,740,764,2216.89370526,2151.9898147,-24
carcassonne-uct240-vs-uct355-1000its,741,765,2150.913083844,2116.425626699,-24
carcassonne-uct390-vs-uct385-1000its,743,767,2188.10647645,2130.216722594,-24
carcassonne-boltzmann45-vs-boltzmann260-1000its,745,769,2226.561364938,2223.659117152,-24
carcassonne-boltzmann390-vs-boltzmann380-1000its,750,774,2182.036665944,2150.858757666,-24
carcassonne-ucttuned170-vs-ucttuned395-1000its,753,777,2217.958543079,2173.709166981,-24
carcassonne-uct240-vs-uct105-1000its,758,782,2159.66309626,2122.042612517,-24
carcassonne-ucttuned90-vs-ucttuned175-1000its,758,782,2219.075459626,2198.812605287,-24
carcassonne-uct295-vs-uct25-1000its,759,783,2231.283150361,2163.820893287,-24
carcassonne-boltzmann145-vs-boltzmann80-1000its,760,784,2244.197782589,2214.668822795,-24
carcassonne-boltzmann330-vs-boltzmann410-1000its,760,784,2199.279693448,2134.312810698,-24
carcassonne-uct295-vs-uct360-1000its,760,784,2215.950782201,2161.743228343,-24
carcassonne-boltzmann115-vs-boltzmann5-1000its,761,785,2217.115597153,2214.178356774,-24
carcassonne-ucttuned270-vs-ucttuned170-1000its,762,786,2246.685809536,2126.392444219,-24
carcassonne-boltzmann15-vs-boltzmann430-1000its,763,787,2141.536558163,2094.446378402,-24
carcassonne-boltzmann225-vs-boltzmann470-1000its,764,788,2177.275288577,2117.891645107,-24
carcassonne-uct135-vs-uct340-1000its,764,788,2226.925360815,2166.408911394,-24
carcassonne-boltzmann400-vs-boltzmann290-1000its,765,789,2194.716784936,2194.291040451,-24
carcassonne-ucttuned475-vs-ucttuned460-1000its,765,789,2156.737324218,2113.241976048,-24
carcassonne-ucttuned455-vs-ucttuned415-1000its,766,790,2154.904449371,2146.222615357,-24
carcassonne-boltzmann220-vs-boltzmann345-1000its,767,791,2284.766046886,2231.854269374,-24
carcassonne-uct300-vs-uct190-1000its,768,792,2209.462903619,2160.927842505,-24
carcassonne-ucttuned435-vs-ucttuned170-1000its,768,792,2227.17617491,2187.195503891,-24
carcassonne-boltzmann225-vs-boltzmann280-1000its,769,793,2229.255917176,2176.577073662,-24
carcassonne-boltzmann410-vs-boltzmann230-1000its,770,794,2129.306910722,2079.608970219,-24
carcassonne-uct210-vs-uct290-1000its,770,794,2313.500299165,2273.030925231,-24
carcassonne-uct395-vs-uct235-1000its,770,794,2134.135897387,2163.240601636,-24
carcassonne-uct220-vs-uct290-1000its,771,795,2195.431976419,2129.662635729,-24
carcassonne-boltzmann155-vs-boltzmann495-1000its,773,797,2182.687355872,2180.578859733,-24
carcassonne-boltzmann225-vs-boltzmann45-1000its,773,797,2196.181068889,2164.908505733,-24
carcassonne-boltzmann345-vs-boltzmann45-1000its,773,797,2195.191588886,2158.194706968,-24
carcassonne-ucttuned175-vs-ucttuned455-1000its,774,798,2245.640418325,2163.794718525,-24
carcassonne-uct435-vs-uct340-1000its,775,799,2179.612202471,2113.720383808,-24
carcassonne-boltzmann280-vs-boltzmann60-1000its,777,801,2233.325626171,2134.8849349,-24
carcassonne-ucttuned325-vs-ucttuned350-1000its,778,802,2153.24361867,2068.000634016,-24
carcassonne-boltzmann175-vs-boltzmann385-1000its,779,803,2191.051458579,2155.612046649,-24
carcassonne-boltzmann490-vs-boltzmann25-1000its,779,803,2217.12594052,2162.659492661,-24
carcassonne-uct50-vs-uct410-1000its,780,804,2180.593949489,2140.194541778,-24
carcassonne-boltzmann310-vs-boltzmann460-1000its,781,805,2223.559585896,2162.936112901,-24
carcassonne-ucttuned55-vs-ucttuned470-1000its,781,805,2191.050119099,2163.351131997,-24
carcassonne-boltzmann490-vs-boltzmann420-1000its,782,806,2264.907735653,2210.211653777,-24
carcassonne-boltzmann160-vs-boltzmann215-1000its,783,807,2205.306218686,2168.786278367,-24
carcassonne-uct125-vs-uct140-1000its,783,807,2264.094622692,2218.815453773,-24
carcassonne-uct225-vs-uct270-1000its,783,807,2202.61236901,2130.203835332,-24
carcassonne-boltzmann215-vs-boltzmann20-1000its,785,809,2155.47376971,2099.40409506,-24
carcassonne-uct385-vs-uct235-1000its,785,809,2158.949423055,2116.105685739,-24
carcassonne-ucttuned135-vs-ucttuned45-1000its,785,809,2183.103967727,2178.503802888,-24
carcassonne-ucttuned480-vs-ucttuned490-1000its,788,812,2235.186738543,2254.577245169,-24
carcassonne-uct290-vs-uct95-1000its,789,813,2256.256193871,2182.791035264,-24
carcassonne-boltzmann360-vs-boltzmann30-1000its,790,814,2166.036519988,2141.421372726,-24
carcassonne-boltzmann390-vs-boltzmann155-1000its,790,814,2199.2594339,2157.371113237,-24
carcassonne-ucttuned145-vs-ucttuned330-1000its,791,815,2166.186540142,2151.881447601,-24
carcassonne-boltzmann430-vs-boltzmann250-1000its,793,817,2254.260705527,2174.846170871,-24
carcassonne-boltzmann490-vs-boltzmann225-1000its,793,817,2247.859779302,2174.862869274,-24
carcassonne-boltzmann200-vs-boltzmann130-1000its,794,818,2246.337592278,2191.083933924,-24
carcassonne-boltzmann350-vs-boltzmann400-1000its,794,818,2199.52007656,2152.637764142,-24
carcassonne-boltzmann170-vs-boltzmann370-1000its,795,819,2224.345623204,2197.018389764,-24
carcassonne-boltzmann255-vs-boltzmann485-1000its,796,820,2221.09087025,2148.196564646,-24
carcassonne-boltzmann110-vs-boltzmann10-1000its,797,821,2253.268177275,2214.239836522,-24
carcassonne-uct220-vs-uct235-1000its,797,821,2134.246944005,2064.468976487,-24
carcassonne-boltzmann245-vs-boltzmann480-1000its,800,824,2180.51251811,2071.794550037,-24
carcassonne-boltzmann480-vs-boltzmann275-1000its,800,824,2211.068869611,2146.946720864,-24
carcassonne-uct495-vs-uct140-1000its,800,824,2236.131367742,2223.056792037,-24
carcassonne-boltzmann280-vs-boltzmann175-1000its,802,826,2203.831764476,2193.289247567,-24
carcassonne-uct160-vs-uct270-1000its,802,826,2184.492587169,2130.98889782,-24
carcassonne-ucttuned290-vs-ucttuned360-1000its,802,826,2321.389486008,2239.292731416,-24
carcassonne-ucttuned305-vs-ucttuned240-1000its,802,826,2133.991163424,2110.140745899,-24
carcassonne-uct300-vs-uct165-1000its,804,828,2216.667743505,2183.611680272,-24
carcassonne-uct25-vs-uct275-1000its,805,829,2181.0573051,2135.667125883,-24
carcassonne-boltzmann195-vs-boltzmann20-1000its,806,830,2278.578993009,2205.591470645,-24
carcassonne-uct115-vs-uct70-1000its,806,830,2259.451341256,2220.09941556,-24
carcassonne-uct420-vs-uct445-1000its,806,830,2148.563801271,2156.517068336,-24
carcassonne-uct105-vs-uct385-1000its,807,831,2274.176048829,2183.43593216,-24
carcassonne-uct360-vs-uct20-1000its,807,831,2168.839290127,2175.49473005,-24
carcassonne-boltzmann255-vs-boltzmann70-1000its,808,832,2126.436012038,2106.58337778,-24
carcassonne-boltzmann265-vs-boltzmann350-1000its,808,832,2190.762870774,2155.715535156,-24
carcassonne-uct130-vs-uct405-1000its,808,832,2257.499967873,2215.820242688,-24
carcassonne-ucttuned315-vs-ucttuned455-1000its,809,833,2190.652172544,2135.201025953,-24
carcassonne-ucttuned190-vs-ucttuned30-1000its,810,834,2224.965935595,2166.24344911,-24
carcassonne-ucttuned270-vs-ucttuned210-1000its,810,834,2188.346452301,2121.726987275,-24
carcassonne-ucttuned230-vs-ucttuned285-1000its,814,838,2185.248387032,2158.94474164,-24
carcassonne-ucttuned440-vs-ucttuned335-1000its,814,838,2179.534221381,2141.933396958,-24
carcassonne-uct35-vs-uct205-1000its,815,839,2188.23249686,2125.266543721,-24
carcassonne-uct95-vs-uct470-1000its,816,840,2252.595045512,2218.058420636,-24
carcassonne-ucttuned210-vs-ucttuned275-1000its,817,841,2179.44731549,2132.77545821,-24
carcassonne-ucttuned395-vs-ucttuned465-1000its,817,841,2176.228055259,2145.173922401,-24
carcassonne-boltzmann45-vs-boltzmann80-1000its,818,842,2239.024297649,2172.232107536,-24
carcassonne-ucttuned290-vs-ucttuned275-1000its,818,842,2153.500300473,2111.31869834,-24
carcassonne-ucttuned400-vs-ucttuned360-1000its,818,842,2173.218395403,2124.043959972,-24
carcassonne-ucttuned35-vs-ucttuned335-1000its,819,843,2168.040508773,2108.10448359,-24
carcassonne-ucttuned370-vs-ucttuned45-1000its,820,844,2106.602690808,2074.517820042,-24
carcassonne-boltzmann185-vs-boltzmann425-1000its,823,847,2193.43595005,2137.581216196,-24
carcassonne-uct440-vs-uct310-1000its,823,847,2266.566743838,2219.808683082,-24
carcassonne-ucttuned130-vs-ucttuned40-1000its,823,847,2237.803840664,2218.168759864,-24
carcassonne-ucttuned275-vs-ucttuned270-1000its,825,849,2182.862343695,2168.685493572,-24
carcassonne-boltzmann320-vs-boltzmann175-1000its,826,850,2160.666319829,2117.878902607,-24
carcassonne-uct220-vs-uct415-1000its,826,850,2238.726378163,2151.013082569,-24
carcassonne-ucttuned200-vs-ucttuned135-1000its,826,850,2220.044892233,2158.087420579,-24
carcassonne-ucttuned80-vs-ucttuned235-1000its,826,850,2223.351361078,2196.094995339,-24
carcassonne-ucttuned490-vs-ucttuned25-1000its,827,851,2172.774660212,2063.509706283,-24
carcassonne-uct345-vs-uct195-1000its,828,852,2164.718705007,2115.486226336,-24
carcassonne-uct360-vs-uct40-1000its,829,853,2218.151446913,2164.258518355,-24
carcassonne-uct5-vs-uct375-1000its,829,853,2145.657713263,2127.45472998,-24
carcassonne-boltzmann495-vs-boltzmann300-1000its,830,854,2189.553600377,2123.723480532,-24
carcassonne-uct40-vs-uct170-1000its,830,854,2096.403383153,2078.580515051,-24
carcassonne-ucttuned450-vs-ucttuned80-1000its,831,855,2189.379818873,2164.177594533,-24
carcassonne-boltzmann30-vs-boltzmann440-1000its,832,856,2194.102675243,2188.126745183,-24
carcassonne-ucttuned175-vs-ucttuned15-1000its,832,856,2205.236371112,2137.524647083,-24
carcassonne-uct410-vs-uct80-1000its,834,858,2203.770029274,2199.264076732,-24
carcassonne-ucttuned345-vs-ucttuned70-1000its,834,858,2172.402529193,2164.399250854,-24
carcassonne-ucttuned305-vs-ucttuned5-1000its,835,859,2208.473329821,2176.217391067,-24
carcassonne-ucttuned360-vs-ucttuned425-1000its,836,860,2182.526821129,2172.699045158,-24
carcassonne-uct130-vs-uct415-1000its,839,863,2181.423395094,2131.923912271,-24
carcassonne-boltzmann240-vs-boltzmann355-1000its,840,864,2198.22491837,2155.437175685,-24
carcassonne-uct255-vs-uct290-1000its,841,865,2200.320992387,2142.229188845,-24
carcassonne-uct395-vs-uct230-1000its,841,865,2221.026534981,2170.970033031,-24
carcassonne-ucttuned140-vs-ucttuned465-1000its,841,865,2229.491008378,2195.850083821,-24
carcassonne-ucttuned85-vs-ucttuned150-1000its,842,866,2226.609875614,2154.422077354,-24
carcassonne-uct245-vs-uct25-1000its,843,867,2220.63348943,2172.382351828,-24
carcassonne-uct35-vs-uct295-1000its,843,867,2206.015388803,2169.956666673,-24
carcassonne-ucttuned140-vs-ucttuned180-1000its,844,868,2177.739647647,2150.35606109,-24
carcassonne-boltzmann10-vs-boltzmann125-1000its,846,870,2214.390549982,2120.827862753,-24
carcassonne-uct150-vs-uct230-1000its,846,870,2195.998949736,2154.055965352,-24
carcassonne-ucttuned355-vs-ucttuned15-1000its,846,870,2187.65759486,2116.232952468,-24
carcassonne-boltzmann190-vs-boltzmann115-1000its,847,871,2222.482257876,2129.793466719,-24
carcassonne-uct465-vs-uct425-1000its,847,871,2194.041452634,2162.357866016,-24
carcassonne-ucttuned210-vs-ucttuned430-1000its,848,872,2130.399264227,2113.772437359,-24
carcassonne-boltzmann235-vs-boltzmann280-1000its,853,877,2240.88537839,2213.300345161,-24
carcassonne-uct310-vs-uct40-1000its,853,877,2198.724346449,2160.033641849,-24
carcassonne-boltzmann165-vs-boltzmann305-1000its,857,881,2143.109529677,2127.559862082,-24
carcassonne-ucttuned440-vs-ucttuned185-1000its,857,881,2185.033996621,2121.764646617,-24
carcassonne-boltzmann310-vs-boltzmann55-1000its,866,890,2213.14060843,2133.421684801,-24
carcassonne-uct480-vs-uct235-1000its,876,900,2242.81883808,2192.223346161,-24
carcassonne-uct245-vs-uct185-1000its,885,909,2326.732611318,2279.154635094,-24
carcassonne-ucttuned395-vs-ucttuned70-1000its,893,917,2219.619135371,2191.47949205,-24
carcassonne-uct495-vs-uct290-1000its,907,931,2252.940285869,2139.902621385,-24
carcassonne-ucttuned25-vs-ucttuned105-1000its,932,956,2148.290509158,2089.135750575,-24
carcassonne-boltzmann490-vs-boltzmann45-1000its,591,614,1747.372524836,1714.506482321,-23
carcassonne-boltzmann410-vs-boltzmann40-1000its,659,682,1823.16296451,1769.095839814,-23
carcassonne-boltzmann415-vs-boltzmann325-1000its,721,744,2189.929039443,2110.175940214,-23
carcassonne-boltzmann335-vs-boltzmann15-1000its,722,745,2154.80435162,2130.689529292,-23
carcassonne-uct260-vs-uct325-1000its,727,750,2214.051903082,2130.198222116,-23
carcassonne-boltzmann150-vs-boltzmann495-1000its,734,757,2206.379798948,2199.692532034,-23
carcassonne-ucttuned5-vs-ucttuned265-1000its,735,758,2165.980156636,2120.202923325,-23
carcassonne-boltzmann405-vs-boltzmann335-1000its,740,763,2145.862591509,2114.771211305,-23
carcassonne-uct335-vs-uct265-1000its,743,766,2169.956659817,2099.806473757,-23
carcassonne-uct315-vs-uct45-1000its,746,769,2156.564026789,2092.723963467,-23
carcassonne-ucttuned270-vs-ucttuned220-1000its,747,770,2164.339538206,2126.761679308,-23
carcassonne-uct20-vs-uct260-1000its,748,771,2189.203484816,2163.065343615,-23
carcassonne-boltzmann325-vs-boltzmann40-1000its,750,773,2160.347359175,2136.349116088,-23
carcassonne-boltzmann90-vs-boltzmann75-1000its,752,775,2195.918422422,2136.732845582,-23
carcassonne-boltzmann325-vs-boltzmann225-1000its,753,776,2157.112724757,2124.953666985,-23
carcassonne-boltzmann385-vs-boltzmann125-1000its,754,777,2220.97473044,2145.181218178,-23
carcassonne-boltzmann490-vs-boltzmann330-1000its,754,777,2219.502100103,2155.856654572,-23
carcassonne-boltzmann50-vs-boltzmann60-1000its,754,777,2214.209037712,2114.830251151,-23
carcassonne-uct435-vs-uct350-1000its,756,779,2264.23608861,2193.410203099,-23
carcassonne-uct425-vs-uct340-1000its,760,783,2210.666316658,2175.393829364,-23
carcassonne-ucttuned415-vs-ucttuned50-1000its,760,783,2170.235464579,2091.995583077,-23
carcassonne-uct480-vs-uct180-1000its,761,784,2143.601165387,2097.965752603,-23
carcassonne-boltzmann355-vs-boltzmann370-1000its,763,786,2227.663283678,2216.164987812,-23
carcassonne-uct260-vs-uct105-1000its,766,789,2250.612089271,2234.841919617,-23
carcassonne-boltzmann425-vs-boltzmann280-1000its,767,790,2215.635633307,2165.560341639,-23
carcassonne-uct320-vs-uct275-1000its,767,790,2156.686987748,2099.786727719,-23
carcassonne-ucttuned50-vs-ucttuned210-1000its,767,790,2196.890869132,2130.057609079,-23
carcassonne-ucttuned195-vs-ucttuned445-1000its,769,792,2191.275658851,2146.305576325,-23
carcassonne-uct280-vs-uct220-1000its,770,793,2224.410171924,2205.239053984,-23
carcassonne-uct345-vs-uct410-1000its,771,794,2198.374892334,2132.814938528,-23
carcassonne-boltzmann270-vs-boltzmann55-1000its,773,796,2227.303291953,2215.854989381,-23
carcassonne-uct30-vs-uct145-1000its,773,796,2194.082674018,2145.259484176,-23
carcassonne-uct40-vs-uct350-1000its,774,797,2167.201223651,2099.317371637,-23
carcassonne-uct370-vs-uct410-1000its,778,801,2222.229737211,2175.679671532,-23
carcassonne-uct75-vs-uct260-1000its,778,801,2269.358757162,2231.516426711,-23
carcassonne-ucttuned340-vs-ucttuned465-1000its,778,801,2206.720646498,2143.712485029,-23
carcassonne-boltzmann380-vs-boltzmann470-1000its,779,802,2151.391935116,2084.470435514,-23
carcassonne-uct360-vs-uct60-1000its,779,802,2124.005438042,2117.600130185,-23
carcassonne-boltzmann70-vs-boltzmann475-1000its,780,803,2146.255789107,2134.573536364,-23
carcassonne-uct275-vs-uct260-1000its,780,803,2144.890177037,2106.620425172,-23
carcassonne-ucttuned100-vs-ucttuned215-1000its,780,803,2185.24153499,2103.888926259,-23
carcassonne-uct25-vs-uct350-1000its,782,805,2130.188899906,2081.063235521,-23
carcassonne-uct435-vs-uct355-1000its,782,805,2115.765124325,2102.301925186,-23
carcassonne-ucttuned380-vs-ucttuned415-1000its,784,807,2184.667809252,2139.612756194,-23
carcassonne-ucttuned410-vs-ucttuned450-1000its,784,807,2220.484093735,2179.111462378,-23
carcassonne-boltzmann145-vs-boltzmann115-1000its,785,808,2109.365069305,2068.833970638,-23
carcassonne-ucttuned350-vs-ucttuned250-1000its,785,808,2225.536697288,2194.49343789,-23
carcassonne-uct460-vs-uct185-1000its,786,809,2143.236785878,2114.19136928,-23
carcassonne-uct370-vs-uct390-1000its,787,810,2243.029960053,2195.855280921,-23
carcassonne-uct90-vs-uct490-1000its,787,810,2226.912854923,2123.614282781,-23
carcassonne-ucttuned65-vs-ucttuned495-1000its,787,810,2287.038219253,2220.45298729,-23
carcassonne-uct420-vs-uct210-1000its,788,811,2164.908977857,2133.614794343,-23
carcassonne-uct255-vs-uct450-1000its,790,813,2235.780920078,2163.260760304,-23
carcassonne-boltzmann215-vs-boltzmann370-1000its,791,814,2173.878129044,2169.473142665,-23
carcassonne-uct405-vs-uct160-1000its,791,814,2205.333743806,2165.170081244,-23
carcassonne-boltzmann220-vs-boltzmann285-1000its,794,817,2227.933797026,2194.996026875,-23
carcassonne-ucttuned365-vs-ucttuned130-1000its,794,817,2225.496126356,2150.569468684,-23
carcassonne-boltzmann270-vs-boltzmann275-1000its,795,818,2178.893810964,2133.293617588,-23
carcassonne-ucttuned65-vs-ucttuned275-1000its,795,818,2186.243721325,2128.726430526,-23
carcassonne-boltzmann220-vs-boltzmann270-1000its,797,820,2195.273673725,2167.124952669,-23
carcassonne-uct355-vs-uct245-1000its,797,820,2230.640212816,2158.633744706,-23
carcassonne-uct460-vs-uct295-1000its,797,820,2176.142521701,2104.040846296,-23
carcassonne-ucttuned255-vs-ucttuned125-1000its,797,820,2184.271666707,2142.679970052,-23
carcassonne-boltzmann205-vs-boltzmann80-1000its,798,821,2255.990278448,2168.331675256,-23
carcassonne-boltzmann225-vs-boltzmann30-1000its,798,821,2135.329844279,2096.543828949,-23
carcassonne-ucttuned200-vs-ucttuned260-1000its,798,821,2175.303788599,2142.334303667,-23
carcassonne-ucttuned185-vs-ucttuned255-1000its,800,823,2192.537213922,2149.297436322,-23
carcassonne-boltzmann430-vs-boltzmann90-1000its,801,824,2084.860336616,2060.383288207,-23
carcassonne-ucttuned40-vs-ucttuned345-1000its,801,824,2271.906498607,2185.079302507,-23
carcassonne-ucttuned440-vs-ucttuned50-1000its,801,824,2115.730460795,2075.645638235,-23
carcassonne-boltzmann270-vs-boltzmann380-1000its,802,825,2186.427826719,2119.006611799,-23
carcassonne-boltzmann375-vs-boltzmann425-1000its,802,825,2125.077686372,2094.797501939,-23
carcassonne-boltzmann125-vs-boltzmann140-1000its,803,826,2180.582439666,2155.181148374,-23
carcassonne-uct360-vs-uct470-1000its,803,826,2179.908930038,2112.319868308,-23
carcassonne-boltzmann375-vs-boltzmann435-1000its,804,827,2218.365028718,2181.532541257,-23
carcassonne-ucttuned415-vs-ucttuned30-1000its,804,827,2277.420677557,2228.893018328,-23
carcassonne-uct370-vs-uct270-1000its,805,828,2210.311567877,2138.473218907,-23
carcassonne-ucttuned5-vs-ucttuned70-1000its,805,828,2115.577408152,2073.867362852,-23
carcassonne-uct30-vs-uct15-1000its,808,831,2169.794350555,2088.15898327,-23
carcassonne-uct85-vs-uct65-1000its,808,831,2231.603137407,2193.300305199,-23
carcassonne-boltzmann230-vs-boltzmann170-1000its,809,832,2241.661433438,2154.655467908,-23
carcassonne-uct245-vs-uct400-1000its,809,832,2199.853303628,2142.010625003,-23
carcassonne-uct320-vs-uct85-1000its,809,832,2231.602184444,2197.785056893,-23
carcassonne-boltzmann100-vs-boltzmann155-1000its,810,833,2209.222988831,2198.714414306,-23
carcassonne-boltzmann225-vs-boltzmann70-1000its,810,833,2274.42807799,2239.984103614,-23
carcassonne-ucttuned270-vs-ucttuned390-1000its,810,833,2206.559456015,2150.902019324,-23
carcassonne-boltzmann445-vs-boltzmann125-1000its,811,834,2164.562786456,2166.19068263,-23
carcassonne-boltzmann410-vs-boltzmann420-1000its,812,835,2150.620706927,2120.373863438,-23
carcassonne-uct245-vs-uct180-1000its,814,837,2132.38544779,2123.276379642,-23
carcassonne-boltzmann70-vs-boltzmann235-1000its,815,838,2217.512066869,2199.007463262,-23
carcassonne-uct10-vs-uct20-1000its,817,840,2262.031669061,2211.243819944,-23
carcassonne-uct330-vs-uct300-1000its,819,842,2263.669757327,2209.790780786,-23
carcassonne-boltzmann435-vs-boltzmann420-1000its,820,843,2271.87426794,2216.515711253,-23
carcassonne-uct55-vs-uct245-1000its,821,844,2261.689296862,2192.204558129,-23
carcassonne-ucttuned225-vs-ucttuned325-1000its,821,844,2213.423070401,2163.651186197,-23
carcassonne-boltzmann165-vs-boltzmann455-1000its,822,845,2112.193073027,2085.404081917,-23
carcassonne-ucttuned210-vs-ucttuned15-1000its,824,847,2179.064114775,2132.230880066,-23
carcassonne-uct310-vs-uct320-1000its,825,848,2194.272581953,2104.214877907,-23
carcassonne-uct455-vs-uct85-1000its,826,849,2245.254970766,2179.549584507,-23
carcassonne-ucttuned455-vs-ucttuned180-1000its,826,849,2208.783510266,2168.585448443,-23
carcassonne-uct140-vs-uct120-1000its,827,850,2205.705405632,2097.833193477,-23
carcassonne-uct485-vs-uct375-1000its,828,851,2169.354898777,2142.235461715,-23
carcassonne-ucttuned230-vs-ucttuned65-1000its,830,853,2167.38439035,2108.921191067,-23
carcassonne-ucttuned285-vs-ucttuned25-1000its,830,853,2091.061890223,2090.369315747,-23
carcassonne-boltzmann195-vs-boltzmann230-1000its,832,855,2200.159890924,2142.232149452,-23
carcassonne-uct210-vs-uct350-1000its,833,856,2209.903401524,2167.583925173,-23
carcassonne-uct360-vs-uct10-1000its,833,856,2274.467725531,2205.063187905,-23
carcassonne-boltzmann50-vs-boltzmann370-1000its,834,857,2274.318146449,2248.628256486,-23
carcassonne-ucttuned260-vs-ucttuned60-1000its,834,857,2241.74986484,2186.280655793,-23
carcassonne-boltzmann75-vs-boltzmann25-1000its,835,858,2136.034604447,2116.862181337,-23
carcassonne-uct80-vs-uct20-1000its,836,859,2170.619792666,2140.959103931,-23
carcassonne-ucttuned430-vs-ucttuned470-1000its,838,861,2150.042640507,2095.103595188,-23
carcassonne-uct115-vs-uct80-1000its,839,862,2200.402099371,2184.043283358,-23
carcassonne-ucttuned105-vs-ucttuned160-1000its,839,862,2280.068075519,2221.130427148,-23
carcassonne-ucttuned295-vs-ucttuned380-1000its,839,862,2253.90638038,2243.24145602,-23
carcassonne-uct295-vs-uct165-1000its,840,863,2141.852568043,2120.216980363,-23
carcassonne-uct410-vs-uct375-1000its,840,863,2259.829663531,2162.247079291,-23
carcassonne-ucttuned255-vs-ucttuned45-1000its,840,863,2177.474032671,2148.545207766,-23
carcassonne-boltzmann240-vs-boltzmann45-1000its,844,867,2153.956977493,2136.359211119,-23
carcassonne-uct390-vs-uct325-1000its,845,868,2245.220737181,2181.338903449,-23
carcassonne-uct425-vs-uct305-1000its,846,869,2192.149134287,2188.594467627,-23
carcassonne-uct460-vs-uct20-1000its,847,870,2154.716346551,2143.362493943,-23
carcassonne-ucttuned390-vs-ucttuned380-1000its,849,872,2189.085678276,2152.285432844,-23
carcassonne-boltzmann430-vs-boltzmann305-1000its,851,874,2204.866247386,2158.245667676,-23
carcassonne-uct90-vs-uct315-1000its,851,874,2168.973231214,2103.428012466,-23
carcassonne-ucttuned325-vs-ucttuned415-1000its,851,874,2199.12283455,2150.942002402,-23
carcassonne-uct405-vs-uct165-1000its,854,877,2181.948601888,2132.822086531,-23
carcassonne-uct265-vs-uct100-1000its,860,883,2141.727637251,2115.733891213,-23
carcassonne-ucttuned175-vs-ucttuned150-1000its,862,885,2155.670154842,2086.866991842,-23
carcassonne-ucttuned165-vs-ucttuned85-1000its,867,890,2198.205404604,2143.78726558,-23
carcassonne-ucttuned400-vs-ucttuned135-1000its,888,911,2271.656298002,2233.308222142,-23
carcassonne-uct370-vs-uct50-1000its,900,923,2183.45705939,2143.290795184,-23
carcassonne-uct310-vs-uct305-1000its,703,725,2216.607793933,2193.733922624,-22
carcassonne-uct390-vs-uct15-1000its,704,726,2207.253939406,2167.591089607,-22
carcassonne-uct370-vs-uct460-1000its,710,732,2178.957005361,2128.584506174,-22
carcassonne-boltzmann140-vs-boltzmann355-1000its,726,748,2189.451749386,2151.875369855,-22
carcassonne-boltzmann440-vs-boltzmann220-1000its,733,755,2207.785154689,2160.149948175,-22
carcassonne-boltzmann220-vs-boltzmann60-1000its,734,756,2185.406366135,2140.97238751,-22
carcassonne-ucttuned400-vs-ucttuned105-1000its,740,762,2185.66133918,2098.76625742,-22
carcassonne-boltzmann85-vs-boltzmann375-1000its,748,770,2180.658127976,2136.366968678,-22
carcassonne-boltzmann120-vs-boltzmann30-1000its,752,774,2165.044832396,2100.637577115,-22
carcassonne-ucttuned430-vs-ucttuned210-1000its,753,775,2152.486059892,2111.699594612,-22
carcassonne-boltzmann50-vs-boltzmann455-1000its,754,776,2286.804370571,2221.386877274,-22
carcassonne-ucttuned205-vs-ucttuned25-1000its,758,780,2228.797578104,2144.208984595,-22
carcassonne-boltzmann360-vs-boltzmann320-1000its,760,782,2136.063082029,2150.805757935,-22
carcassonne-uct190-vs-uct230-1000its,761,783,2234.480088671,2128.206101909,-22
carcassonne-boltzmann365-vs-boltzmann325-1000its,763,785,2231.335074965,2167.404600547,-22
carcassonne-uct250-vs-uct480-1000its,763,785,2189.191627407,2121.467086391,-22
carcassonne-boltzmann410-vs-boltzmann110-1000its,765,787,2131.92014596,2094.618221031,-22
carcassonne-uct305-vs-uct445-1000its,765,787,2248.652657078,2197.968259005,-22
carcassonne-boltzmann240-vs-boltzmann70-1000its,766,788,2181.079622419,2128.958403372,-22
carcassonne-boltzmann330-vs-boltzmann255-1000its,767,789,2157.797392697,2116.74911992,-22
carcassonne-boltzmann360-vs-boltzmann120-1000its,767,789,2239.787559637,2143.73756192,-22
carcassonne-boltzmann495-vs-boltzmann120-1000its,767,789,2235.221786987,2146.301605338,-22
carcassonne-uct195-vs-uct130-1000its,768,790,2226.240112333,2167.666488969,-22
carcassonne-boltzmann180-vs-boltzmann350-1000its,769,791,2247.242959508,2188.412370799,-22
carcassonne-ucttuned260-vs-ucttuned425-1000its,769,791,2194.571326169,2153.554619177,-22
carcassonne-uct180-vs-uct190-1000its,771,793,2257.480528495,2188.765457056,-22
carcassonne-ucttuned430-vs-ucttuned250-1000its,772,794,2153.16659159,2100.256883775,-22
carcassonne-boltzmann125-vs-boltzmann415-1000its,774,796,2166.437902606,2122.37766318,-22
carcassonne-ucttuned215-vs-ucttuned140-1000its,775,797,2201.679246953,2144.48432615,-22
carcassonne-uct265-vs-uct340-1000its,776,798,2224.853506699,2173.06031095,-22
carcassonne-uct360-vs-uct390-1000its,776,798,2166.44118505,2136.004137792,-22
carcassonne-uct330-vs-uct65-1000its,777,799,2255.068716572,2231.468764976,-22
carcassonne-ucttuned235-vs-ucttuned430-1000its,777,799,2187.266294782,2143.630872637,-22
carcassonne-boltzmann290-vs-boltzmann245-1000its,778,800,2227.413660638,2196.822758145,-22
carcassonne-uct175-vs-uct470-1000its,778,800,2273.557690995,2202.443660192,-22
carcassonne-ucttuned305-vs-ucttuned420-1000its,778,800,2135.423246386,2120.886562891,-22
carcassonne-ucttuned350-vs-ucttuned355-1000its,778,800,2227.433990932,2158.47293021,-22
carcassonne-boltzmann410-vs-boltzmann460-1000its,779,801,2255.024862813,2207.491050661,-22
carcassonne-ucttuned230-vs-ucttuned180-1000its,779,801,2195.434734488,2131.250632395,-22
carcassonne-boltzmann355-vs-boltzmann285-1000its,781,803,2154.058530744,2100.149135425,-22
carcassonne-ucttuned265-vs-ucttuned325-1000its,782,804,2187.336172134,2158.733836304,-22
carcassonne-uct290-vs-uct450-1000its,783,805,2184.011765841,2166.694235913,-22
carcassonne-ucttuned265-vs-ucttuned190-1000its,783,805,2227.261093796,2199.323761133,-22
carcassonne-ucttuned450-vs-ucttuned455-1000its,783,805,2226.386221685,2124.171982961,-22
carcassonne-boltzmann430-vs-boltzmann155-1000its,784,806,2164.227973802,2167.828277207,-22
carcassonne-boltzmann465-vs-boltzmann55-1000its,784,806,2148.959316534,2112.448783049,-22
carcassonne-boltzmann490-vs-boltzmann185-1000its,785,807,2211.74976966,2161.70677934,-22
carcassonne-boltzmann490-vs-boltzmann120-1000its,786,808,2162.168275991,2130.73503489,-22
carcassonne-ucttuned425-vs-ucttuned275-1000its,787,809,2220.25347237,2178.545417252,-22
carcassonne-boltzmann30-vs-boltzmann220-1000its,788,810,2159.394250514,2117.90328625,-22
carcassonne-ucttuned445-vs-ucttuned70-1000its,788,810,2176.149887835,2073.718410051,-22
carcassonne-boltzmann405-vs-boltzmann35-1000its,789,811,2231.181643798,2198.261075886,-22
carcassonne-uct240-vs-uct465-1000its,789,811,2195.984929019,2155.673139577,-22
carcassonne-uct135-vs-uct480-1000its,790,812,2153.741456962,2128.955459062,-22
carcassonne-ucttuned495-vs-ucttuned265-1000its,792,814,2234.352032588,2200.714886108,-22
carcassonne-boltzmann60-vs-boltzmann460-1000its,793,815,2191.830548039,2181.330862864,-22
carcassonne-ucttuned120-vs-ucttuned360-1000its,793,815,2238.796688332,2198.286826385,-22
carcassonne-uct105-vs-uct100-1000its,794,816,2192.577159752,2171.458951605,-22
carcassonne-uct150-vs-uct305-1000its,794,816,2231.095571154,2182.687819982,-22
carcassonne-uct295-vs-uct185-1000its,795,817,2195.213205316,2129.769912761,-22
carcassonne-uct320-vs-uct40-1000its,795,817,2315.609299158,2251.51900002,-22
carcassonne-ucttuned155-vs-ucttuned160-1000its,795,817,2241.254878938,2204.917068084,-22
carcassonne-ucttuned180-vs-ucttuned375-1000its,795,817,2207.597509505,2162.318515613,-22
carcassonne-boltzmann380-vs-boltzmann410-1000its,796,818,2142.772356458,2098.301176151,-22
carcassonne-uct410-vs-uct85-1000its,797,819,2178.745814497,2164.980186538,-22
carcassonne-uct140-vs-uct485-1000its,798,820,2238.01498724,2187.679289244,-22
carcassonne-uct220-vs-uct375-1000its,799,821,2134.986443949,2149.431787276,-22
carcassonne-uct420-vs-uct195-1000its,799,821,2170.10872787,2095.807244834,-22
carcassonne-ucttuned110-vs-ucttuned140-1000its,799,821,2153.555912914,2131.456988543,-22
carcassonne-uct260-vs-uct15-1000its,800,822,2256.598672084,2178.504781992,-22
carcassonne-uct455-vs-uct425-1000its,800,822,2230.363851504,2169.639404668,-22
carcassonne-boltzmann70-vs-boltzmann375-1000its,802,824,2189.269013421,2122.094227174,-22
carcassonne-boltzmann115-vs-boltzmann70-1000its,803,825,2151.693912085,2147.942843712,-22
carcassonne-ucttuned160-vs-ucttuned140-1000its,803,825,2201.622057025,2182.220310674,-22
carcassonne-boltzmann275-vs-boltzmann415-1000its,804,826,2178.027145888,2146.78682328,-22
carcassonne-boltzmann335-vs-boltzmann470-1000its,805,827,2192.28170413,2117.550458887,-22
carcassonne-ucttuned345-vs-ucttuned320-1000its,805,827,2180.626282825,2137.425429303,-22
carcassonne-boltzmann205-vs-boltzmann75-1000its,806,828,2206.372609154,2162.217747494,-22
carcassonne-uct475-vs-uct230-1000its,806,828,2232.703084592,2186.650767032,-22
carcassonne-ucttuned330-vs-ucttuned130-1000its,806,828,2170.128738766,2134.62359698,-22
carcassonne-uct340-vs-uct45-1000its,807,829,2187.869922627,2148.591995945,-22
carcassonne-uct120-vs-uct110-1000its,808,830,2251.702747793,2180.35922449,-22
carcassonne-uct390-vs-uct35-1000its,808,830,2215.185188673,2176.283590483,-22
carcassonne-ucttuned270-vs-ucttuned465-1000its,808,830,2179.040032674,2184.632918404,-22
carcassonne-uct40-vs-uct135-1000its,809,831,2195.606837502,2188.173422897,-22
carcassonne-uct60-vs-uct460-1000its,810,832,2216.262892477,2141.61172449,-22
carcassonne-uct340-vs-uct495-1000its,811,833,2129.694858132,2118.225762316,-22
carcassonne-boltzmann245-vs-boltzmann485-1000its,812,834,2204.29947507,2138.698285783,-22
carcassonne-uct50-vs-uct175-1000its,814,836,2168.516343392,2105.349409469,-22
carcassonne-boltzmann400-vs-boltzmann305-1000its,815,837,2291.432690144,2247.721578588,-22
carcassonne-ucttuned170-vs-ucttuned185-1000its,815,837,2198.457166878,2126.549402469,-22
carcassonne-boltzmann180-vs-boltzmann280-1000its,818,840,2125.015333724,2100.912427898,-22
carcassonne-ucttuned135-vs-ucttuned30-1000its,818,840,2215.566377383,2189.247799277,-22
carcassonne-ucttuned150-vs-ucttuned120-1000its,818,840,2189.691240556,2192.417511072,-22
carcassonne-ucttuned245-vs-ucttuned70-1000its,818,840,2119.864945971,2049.680289317,-22
carcassonne-boltzmann210-vs-boltzmann85-1000its,820,842,2245.222025571,2229.509178847,-22
carcassonne-uct395-vs-uct430-1000its,820,842,2220.531737624,2181.734848026,-22
carcassonne-ucttuned445-vs-ucttuned330-1000its,820,842,2184.977925108,2134.420511649,-22
carcassonne-ucttuned140-vs-ucttuned390-1000its,821,843,2150.285808623,2089.994625316,-22
carcassonne-ucttuned145-vs-ucttuned5-1000its,821,843,2169.888900393,2138.811294296,-22
carcassonne-ucttuned465-vs-ucttuned370-1000its,821,843,2187.698656128,2172.13368759,-22
carcassonne-ucttuned210-vs-ucttuned230-1000its,825,847,2243.995591513,2178.194971969,-22
carcassonne-ucttuned295-vs-ucttuned335-1000its,825,847,2155.193405952,2129.30945096,-22
carcassonne-boltzmann415-vs-boltzmann420-1000its,826,848,2172.574064496,2115.507045563,-22
carcassonne-ucttuned365-vs-ucttuned350-1000its,826,848,2235.826604475,2181.7585334,-22
carcassonne-ucttuned180-vs-ucttuned480-1000its,830,852,2188.217715514,2170.728840305,-22
carcassonne-uct190-vs-uct15-1000its,831,853,2196.409887718,2156.674140871,-22
carcassonne-ucttuned445-vs-ucttuned360-1000its,831,853,2115.799440174,2141.81664481,-22
carcassonne-boltzmann490-vs-boltzmann235-1000its,832,854,2295.692259449,2197.956089757,-22
carcassonne-boltzmann160-vs-boltzmann115-1000its,833,855,2201.226228835,2152.949835113,-22
carcassonne-ucttuned130-vs-ucttuned335-1000its,833,855,2214.796811933,2166.685143903,-22
carcassonne-ucttuned185-vs-ucttuned155-1000its,833,855,2178.556646076,2177.717262121,-22
carcassonne-uct90-vs-uct65-1000its,835,857,2239.11638411,2186.691501231,-22
carcassonne-ucttuned185-vs-ucttuned335-1000its,836,858,2135.659592715,2086.162181601,-22
carcassonne-uct460-vs-uct435-1000its,837,859,2160.786969409,2129.646063883,-22
carcassonne-uct345-vs-uct25-1000its,838,860,2210.426377043,2188.290066614,-22
carcassonne-boltzmann340-vs-boltzmann75-1000its,840,862,2193.673105016,2160.609072069,-22
carcassonne-uct105-vs-uct305-1000its,840,862,2140.679538818,2108.414654109,-22
carcassonne-uct360-vs-uct420-1000its,841,863,2160.997516997,2124.553398342,-22
carcassonne-ucttuned170-vs-ucttuned130-1000its,841,863,2155.466984044,2145.102915898,-22
carcassonne-ucttuned285-vs-ucttuned315-1000its,845,867,2182.36654283,2134.262750859,-22
carcassonne-ucttuned5-vs-ucttuned50-1000its,845,867,2105.799026176,2062.058244996,-22
carcassonne-uct220-vs-uct490-1000its,846,868,2164.719077897,2123.913484787,-22
carcassonne-boltzmann425-vs-boltzmann400-1000its,850,872,2145.283835205,2120.933243402,-22
carcassonne-uct340-vs-uct370-1000its,850,872,2130.436718699,2109.6197836,-22
carcassonne-uct370-vs-uct155-1000its,850,872,2248.830566971,2196.87692535,-22
carcassonne-ucttuned275-vs-ucttuned495-1000its,855,877,2318.923026929,2270.056306257,-22
carcassonne-ucttuned270-vs-ucttuned280-1000its,856,878,2267.800624475,2216.913946628,-22
carcassonne-uct50-vs-uct130-1000its,859,881,2242.09646697,2186.668683613,-22
carcassonne-uct200-vs-uct15-1000its,863,885,2215.284746095,2198.628157953,-22
carcassonne-uct375-vs-uct45-1000its,865,887,2144.76015045,2122.036796259,-22
carcassonne-uct415-vs-uct380-1000its,865,887,2166.398160871,2152.619479298,-22
carcassonne-boltzmann80-vs-boltzmann20-1000its,876,898,2253.77872312,2239.717886414,-22
carcassonne-uct155-vs-uct130-1000its,877,899,2152.989359149,2103.450335162,-22
carcassonne-ucttuned490-vs-ucttuned430-1000its,885,907,2275.325900624,2189.604987617,-22
carcassonne-ucttuned330-vs-ucttuned210-1000its,889,911,2203.907569917,2121.590640635,-22
carcassonne-uct335-vs-uct185-1000its,890,912,2232.600594517,2160.34487756,-22
carcassonne-ucttuned265-vs-ucttuned255-1000its,890,912,2220.92369337,2204.065099801,-22
carcassonne-uct260-vs-uct305-1000its,891,913,2203.089171111,2189.446534171,-22
carcassonne-uct45-vs-uct455-1000its,908,930,2233.245983288,2191.295312212,-22
carcassonne-uct110-vs-uct410-1000its,913,935,2211.740177303,2159.298802395,-22
carcassonne-ucttuned90-vs-ucttuned170-1000its,924,946,2145.796931947,2106.489164147,-22
carcassonne-boltzmann175-vs-boltzmann150-1000its,651,672,1814.749687799,1789.813297733,-21
carcassonne-boltzmann195-vs-boltzmann460-1000its,711,732,2271.981527667,2210.592278794,-21
carcassonne-ucttuned360-vs-ucttuned45-1000its,712,733,2136.201017519,2087.796695206,-21
carcassonne-ucttuned405-vs-ucttuned330-1000its,717,738,2210.016239743,2198.648949905,-21
carcassonne-boltzmann90-vs-boltzmann145-1000its,736,757,2234.210509767,2171.775686403,-21
carcassonne-uct260-vs-uct265-1000its,736,757,2291.484677684,2240.16423722,-21
carcassonne-ucttuned335-vs-ucttuned160-1000its,739,760,2157.019161433,2113.282115623,-21
carcassonne-boltzmann470-vs-boltzmann250-1000its,743,764,2167.339281734,2140.305180216,-21
carcassonne-ucttuned295-vs-ucttuned365-1000its,743,764,2214.610515564,2148.721756913,-21
carcassonne-uct190-vs-uct170-1000its,748,769,2155.596571301,2122.033295667,-21
carcassonne-uct20-vs-uct80-1000its,749,770,2263.331156171,2187.529676061,-21
carcassonne-boltzmann390-vs-boltzmann40-1000its,750,771,2204.488378474,2166.851740087,-21
carcassonne-boltzmann165-vs-boltzmann215-1000its,751,772,2221.819113989,2156.268993182,-21
carcassonne-boltzmann55-vs-boltzmann460-1000its,753,774,2193.542645333,2181.82367139,-21
carcassonne-uct320-vs-uct315-1000its,754,775,2157.153909386,2100.738846563,-21
carcassonne-ucttuned170-vs-ucttuned250-1000its,754,775,2134.909819137,2093.807635201,-21
carcassonne-uct105-vs-uct235-1000its,760,781,2192.970902388,2184.522002533,-21
carcassonne-uct170-vs-uct450-1000its,760,781,2226.859395644,2143.193302774,-21
carcassonne-ucttuned280-vs-ucttuned155-1000its,762,783,2113.244779007,2088.40393893,-21
carcassonne-boltzmann230-vs-boltzmann55-1000its,763,784,2196.907818591,2166.328978796,-21
carcassonne-uct380-vs-uct275-1000its,763,784,2251.514581285,2226.009261947,-21
carcassonne-uct225-vs-uct30-1000its,764,785,2196.523476138,2128.754527752,-21
carcassonne-uct410-vs-uct30-1000its,767,788,2250.775055549,2217.609104964,-21
carcassonne-uct305-vs-uct370-1000its,768,789,2184.729661071,2155.591473009,-21
carcassonne-uct170-vs-uct225-1000its,770,791,2179.010766142,2163.674836877,-21
carcassonne-uct310-vs-uct105-1000its,771,792,2163.610431348,2136.467784499,-21
carcassonne-boltzmann140-vs-boltzmann345-1000its,772,793,2215.944537514,2176.704361656,-21
carcassonne-uct265-vs-uct235-1000its,772,793,2171.220520843,2156.932182292,-21
carcassonne-ucttuned75-vs-ucttuned340-1000its,773,794,2276.432252043,2224.681910174,-21
carcassonne-uct410-vs-uct90-1000its,775,796,2203.292146535,2159.816000531,-21
carcassonne-ucttuned110-vs-ucttuned425-1000its,775,796,2207.76896671,2124.755535243,-21
carcassonne-ucttuned360-vs-ucttuned265-1000its,776,797,2221.12167119,2229.61950289,-21
carcassonne-boltzmann275-vs-boltzmann180-1000its,779,800,2164.822473349,2132.490854506,-21
carcassonne-boltzmann360-vs-boltzmann235-1000its,779,800,2149.712272409,2137.950636316,-21
carcassonne-ucttuned115-vs-ucttuned220-1000its,779,800,2161.762532995,2112.693851725,-21
carcassonne-ucttuned145-vs-ucttuned125-1000its,779,800,2205.217795508,2153.232585499,-21
carcassonne-boltzmann380-vs-boltzmann250-1000its,780,801,2191.606268767,2140.102180627,-21
carcassonne-uct155-vs-uct190-1000its,782,803,2213.030358069,2181.518808979,-21
carcassonne-boltzmann285-vs-boltzmann335-1000its,784,805,2211.511954302,2178.387307095,-21
carcassonne-uct355-vs-uct310-1000its,785,806,2245.168336206,2175.903092622,-21
carcassonne-uct420-vs-uct380-1000its,786,807,2267.555655968,2178.475700377,-21
carcassonne-boltzmann100-vs-boltzmann85-1000its,787,808,2145.407149602,2090.109121392,-21
carcassonne-uct360-vs-uct150-1000its,787,808,2228.421189488,2116.304811466,-21
carcassonne-uct140-vs-uct215-1000its,788,809,2209.456383574,2152.993385651,-21
carcassonne-uct415-vs-uct280-1000its,789,810,2290.204133525,2211.100575586,-21
carcassonne-boltzmann360-vs-boltzmann65-1000its,791,812,2152.229445389,2116.980149469,-21
carcassonne-uct315-vs-uct245-1000its,791,812,2137.036354556,2109.505960297,-21
carcassonne-uct230-vs-uct160-1000its,792,813,2158.292065549,2118.149271178,-21
carcassonne-ucttuned470-vs-ucttuned445-1000its,792,813,2177.693648215,2138.022730528,-21
carcassonne-boltzmann205-vs-boltzmann295-1000its,793,814,2174.377560702,2140.56947048,-21
carcassonne-boltzmann245-vs-boltzmann300-1000its,793,814,2185.545572769,2147.150510709,-21
carcassonne-boltzmann450-vs-boltzmann35-1000its,793,814,2134.568602356,2092.510141069,-21
carcassonne-boltzmann250-vs-boltzmann235-1000its,794,815,2196.831461441,2175.95740423,-21
carcassonne-ucttuned310-vs-ucttuned55-1000its,794,815,2202.443787753,2202.484826991,-21
carcassonne-ucttuned215-vs-ucttuned195-1000its,796,817,2319.56434148,2245.057010474,-21
carcassonne-ucttuned280-vs-ucttuned145-1000its,796,817,2171.275601241,2129.016734918,-21
carcassonne-boltzmann340-vs-boltzmann230-1000its,798,819,2282.248051526,2255.147448744,-21
carcassonne-ucttuned490-vs-ucttuned60-1000its,798,819,2170.428344442,2122.481300684,-21
carcassonne-boltzmann115-vs-boltzmann195-1000its,799,820,2186.899268677,2159.708897427,-21
carcassonne-boltzmann325-vs-boltzmann85-1000its,799,820,2229.621989464,2208.655697236,-21
carcassonne-boltzmann70-vs-boltzmann5-1000its,799,820,2146.750863133,2135.596435602,-21
carcassonne-ucttuned105-vs-ucttuned460-1000its,799,820,2217.602855472,2178.402900822,-21
carcassonne-ucttuned170-vs-ucttuned350-1000its,799,820,2179.733063428,2135.593650081,-21
carcassonne-boltzmann120-vs-boltzmann430-1000its,800,821,2160.400847577,2160.724420758,-21
carcassonne-boltzmann400-vs-boltzmann495-1000its,800,821,2219.520789149,2170.688949451,-21
carcassonne-boltzmann400-vs-boltzmann100-1000its,802,823,2130.298555575,2093.703793048,-21
carcassonne-ucttuned465-vs-ucttuned110-1000its,803,824,2190.141223193,2151.648895634,-21
carcassonne-ucttuned70-vs-ucttuned200-1000its,803,824,2193.656206673,2143.156872742,-21
carcassonne-boltzmann245-vs-boltzmann350-1000its,804,825,2182.937114992,2121.435786782,-21
carcassonne-uct325-vs-uct305-1000its,804,825,2160.33061579,2123.841660076,-21
carcassonne-ucttuned50-vs-ucttuned375-1000its,804,825,2277.308877441,2224.136998728,-21
carcassonne-boltzmann285-vs-boltzmann355-1000its,805,826,2157.881460206,2116.166060673,-21
carcassonne-ucttuned460-vs-ucttuned130-1000its,809,830,2194.610609649,2133.452669572,-21
carcassonne-boltzmann260-vs-boltzmann325-1000its,810,831,2187.912153754,2124.978020173,-21
carcassonne-boltzmann60-vs-boltzmann375-1000its,810,831,2157.238924195,2135.299929614,-21
carcassonne-uct250-vs-uct10-1000its,810,831,2183.48270057,2152.648619876,-21
carcassonne-uct445-vs-uct360-1000its,810,831,2237.84299841,2169.105143872,-21
carcassonne-ucttuned465-vs-ucttuned160-1000its,811,832,2189.061177343,2193.420344584,-21
carcassonne-boltzmann175-vs-boltzmann355-1000its,812,833,2101.415805415,2080.547202022,-21
carcassonne-uct5-vs-uct275-1000its,812,833,2202.419298963,2163.831846419,-21
carcassonne-ucttuned105-vs-ucttuned205-1000its,812,833,2140.276862372,2084.792365038,-21
carcassonne-uct30-vs-uct345-1000its,813,834,2177.042207229,2163.958254162,-21
carcassonne-boltzmann145-vs-boltzmann60-1000its,814,835,2191.175111737,2138.39873263,-21
carcassonne-uct195-vs-uct20-1000its,816,837,2225.727424568,2196.045621767,-21
carcassonne-ucttuned355-vs-ucttuned345-1000its,816,837,2260.685791305,2158.697953853,-21
carcassonne-uct260-vs-uct155-1000its,817,838,2226.863556594,2140.575662266,-21
carcassonne-boltzmann15-vs-boltzmann140-1000its,818,839,2246.536704329,2210.482315244,-21
carcassonne-boltzmann290-vs-boltzmann55-1000its,818,839,2181.501620194,2148.142674647,-21
carcassonne-ucttuned65-vs-ucttuned325-1000its,818,839,2156.426080068,2143.946023444,-21
carcassonne-uct335-vs-uct150-1000its,819,840,2252.615146457,2230.01074547,-21
carcassonne-ucttuned405-vs-ucttuned395-1000its,819,840,2281.71228266,2252.264172192,-21
carcassonne-ucttuned90-vs-ucttuned190-1000its,820,841,2232.119728223,2187.817926236,-21
carcassonne-boltzmann450-vs-boltzmann80-1000its,823,844,2124.721982174,2091.689746173,-21
carcassonne-ucttuned135-vs-ucttuned90-1000its,823,844,2231.461978081,2135.152351249,-21
carcassonne-ucttuned100-vs-ucttuned35-1000its,824,845,2142.71734092,2111.011938956,-21
carcassonne-ucttuned215-vs-ucttuned25-1000its,824,845,2194.692171485,2146.428677592,-21
carcassonne-ucttuned255-vs-ucttuned365-1000its,825,846,2276.357533112,2249.641108668,-21
carcassonne-uct270-vs-uct240-1000its,826,847,2230.480899728,2203.809202808,-21
carcassonne-boltzmann460-vs-boltzmann480-1000its,827,848,2189.379814039,2116.727041419,-21
carcassonne-ucttuned135-vs-ucttuned465-1000its,829,850,2164.057974166,2089.408779331,-21
carcassonne-boltzmann155-vs-boltzmann360-1000its,830,851,2237.730823136,2207.289957443,-21
carcassonne-uct50-vs-uct465-1000its,831,852,2207.898112138,2142.835045805,-21
carcassonne-ucttuned35-vs-ucttuned185-1000its,831,852,2174.573162267,2114.25145335,-21
carcassonne-uct10-vs-uct80-1000its,834,855,2208.135669572,2137.854071242,-21
carcassonne-ucttuned310-vs-ucttuned150-1000its,835,856,2240.123712349,2203.102067634,-21
carcassonne-boltzmann85-vs-boltzmann15-1000its,836,857,2188.725598104,2175.092976692,-21
carcassonne-ucttuned185-vs-ucttuned400-1000its,836,857,2142.688256634,2093.701985076,-21
carcassonne-ucttuned280-vs-ucttuned135-1000its,836,857,2248.407334937,2204.299328103,-21
carcassonne-uct470-vs-uct280-1000its,837,858,2180.192017504,2124.516910579,-21
carcassonne-ucttuned485-vs-ucttuned285-1000its,845,866,2224.746936223,2182.351307292,-21
carcassonne-boltzmann365-vs-boltzmann375-1000its,846,867,2252.313051036,2211.40188201,-21
carcassonne-uct280-vs-uct65-1000its,846,867,2197.414895653,2154.217570117,-21
carcassonne-ucttuned25-vs-ucttuned240-1000its,847,868,2228.948770172,2203.397788332,-21
carcassonne-ucttuned385-vs-ucttuned455-1000its,849,870,2201.269413949,2157.144828103,-21
carcassonne-boltzmann340-vs-boltzmann215-1000its,852,873,2239.72161805,2168.455567054,-21
carcassonne-boltzmann370-vs-boltzmann95-1000its,854,875,2188.062352206,2121.522140483,-21
carcassonne-ucttuned130-vs-ucttuned325-1000its,855,876,2258.868032281,2177.48298396,-21
carcassonne-ucttuned320-vs-ucttuned155-1000its,856,877,2174.894781454,2146.177141428,-21
carcassonne-ucttuned180-vs-ucttuned25-1000its,858,879,2234.158479119,2188.885897484,-21
carcassonne-boltzmann45-vs-boltzmann250-1000its,860,881,2174.824021712,2152.092074779,-21
carcassonne-uct375-vs-uct305-1000its,866,887,2264.638590659,2220.543937464,-21
carcassonne-ucttuned175-vs-ucttuned180-1000its,866,887,2207.540565295,2183.020038357,-21
carcassonne-uct200-vs-uct90-1000its,868,889,2265.325429646,2216.896043926,-21
carcassonne-uct200-vs-uct10-1000its,871,892,2173.538824144,2145.121674825,-21
carcassonne-uct450-vs-uct365-1000its,872,893,2195.471413998,2134.704391256,-21
carcassonne-ucttuned480-vs-ucttuned410-1000its,895,916,2265.212530655,2199.86680638,-21
carcassonne-ucttuned395-vs-ucttuned305-1000its,924,945,2233.155157415,2210.921058528,-21
carcassonne-uct280-vs-uct380-1000its,954,975,2240.14538435,2193.366845771,-21
carcassonne-ucttuned155-vs-ucttuned475-1000its,582,602,1785.028529956,1792.279645305,-20
carcassonne-ucttuned150-vs-ucttuned70-1000its,711,731,2216.305291535,2223.01375378,-20
carcassonne-boltzmann230-vs-boltzmann425-1000its,725,745,2218.010637079,2192.189096424,-20
carcassonne-uct205-vs-uct285-1000its,728,748,2171.63322721,2136.558271909,-20
carcassonne-ucttuned120-vs-ucttuned370-1000its,728,748,2124.23781389,2103.001245776,-20
carcassonne-ucttuned80-vs-ucttuned210-1000its,735,755,2180.108185113,2156.507786748,-20
carcassonne-uct250-vs-uct365-1000its,737,757,2174.868237796,2173.409873323,-20
carcassonne-boltzmann205-vs-boltzmann15-1000its,740,760,2156.787682254,2114.533913184,-20
carcassonne-uct15-vs-uct405-1000its,746,766,2210.752901822,2167.152783318,-20
carcassonne-boltzmann245-vs-boltzmann110-1000its,748,768,2153.206163381,2093.953997402,-20
carcassonne-boltzmann310-vs-boltzmann60-1000its,750,770,2165.578889049,2114.599998109,-20
carcassonne-boltzmann495-vs-boltzmann255-1000its,753,773,2178.05259861,2102.154408383,-20
carcassonne-uct320-vs-uct235-1000its,753,773,2223.211558694,2181.579771642,-20
carcassonne-ucttuned110-vs-ucttuned395-1000its,757,777,2153.799187865,2086.031233606,-20
carcassonne-uct280-vs-uct290-1000its,758,778,2154.291069619,2109.783682652,-20
carcassonne-uct70-vs-uct160-1000its,764,784,2205.198930281,2168.619369475,-20
carcassonne-ucttuned65-vs-ucttuned105-1000its,764,784,2148.101464901,2124.653643608,-20
carcassonne-uct340-vs-uct70-1000its,765,785,2148.836269864,2095.200402842,-20
carcassonne-uct40-vs-uct230-1000its,766,786,2178.331542865,2150.453663056,-20
carcassonne-boltzmann335-vs-boltzmann230-1000its,767,787,2305.55424351,2210.96232557,-20
carcassonne-boltzmann365-vs-boltzmann475-1000its,767,787,2185.123938089,2111.691400582,-20
carcassonne-boltzmann270-vs-boltzmann130-1000its,768,788,2175.944738629,2131.570108331,-20
carcassonne-boltzmann265-vs-boltzmann15-1000its,770,790,2178.61803281,2161.786319506,-20
carcassonne-ucttuned455-vs-ucttuned410-1000its,770,790,2173.871279799,2135.610210307,-20
carcassonne-ucttuned235-vs-ucttuned210-1000its,771,791,2147.070937519,2087.766907661,-20
carcassonne-ucttuned315-vs-ucttuned290-1000its,771,791,2213.911713753,2139.907131339,-20
carcassonne-uct190-vs-uct195-1000its,772,792,2218.947532713,2143.900636677,-20
carcassonne-boltzmann275-vs-boltzmann425-1000its,773,793,2187.60002796,2152.234698488,-20
carcassonne-ucttuned355-vs-ucttuned200-1000its,773,793,2217.950403882,2191.249349673,-20
carcassonne-uct125-vs-uct420-1000its,775,795,2187.715496161,2136.534017158,-20
carcassonne-boltzmann100-vs-boltzmann460-1000its,777,797,2213.504288847,2174.352011593,-20
carcassonne-boltzmann435-vs-boltzmann325-1000its,777,797,2162.790878082,2103.993843863,-20
carcassonne-uct185-vs-uct385-1000its,777,797,2150.866178658,2129.688864661,-20
carcassonne-boltzmann345-vs-boltzmann360-1000its,778,798,2222.778438001,2179.615582869,-20
carcassonne-boltzmann145-vs-boltzmann400-1000its,779,799,2257.675960823,2209.44356035,-20
carcassonne-ucttuned225-vs-ucttuned390-1000its,779,799,2232.990908897,2184.062087623,-20
carcassonne-ucttuned115-vs-ucttuned375-1000its,780,800,2190.526768954,2154.926383097,-20
carcassonne-boltzmann265-vs-boltzmann40-1000its,781,801,2267.667080504,2264.003121017,-20
carcassonne-boltzmann315-vs-boltzmann245-1000its,782,802,2185.299503911,2136.558039196,-20
carcassonne-boltzmann365-vs-boltzmann485-1000its,782,802,2165.548131331,2124.794607727,-20
carcassonne-ucttuned405-vs-ucttuned100-1000its,782,802,2162.304176879,2146.08034589,-20
carcassonne-uct15-vs-uct225-1000its,783,803,2223.420993617,2175.670862322,-20
carcassonne-boltzmann355-vs-boltzmann385-1000its,785,805,2198.174009298,2097.03678613,-20
carcassonne-ucttuned430-vs-ucttuned390-1000its,785,805,2185.228320222,2158.207305247,-20
carcassonne-boltzmann235-vs-boltzmann110-1000its,786,806,2224.103270166,2187.26165284,-20
carcassonne-boltzmann230-vs-boltzmann40-1000its,787,807,2225.891415274,2130.400593135,-20
carcassonne-ucttuned420-vs-ucttuned250-1000its,787,807,2215.64597869,2176.867617035,-20
carcassonne-boltzmann190-vs-boltzmann130-1000its,788,808,2220.266914118,2152.320008235,-20
carcassonne-uct195-vs-uct225-1000its,788,808,2176.97436827,2138.123371762,-20
carcassonne-uct470-vs-uct115-1000its,788,808,2161.412622983,2136.331507664,-20
carcassonne-boltzmann300-vs-boltzmann140-1000its,789,809,2204.588013161,2165.317611036,-20
carcassonne-uct420-vs-uct400-1000its,790,810,2126.045873431,2122.485325038,-20
carcassonne-ucttuned175-vs-ucttuned250-1000its,790,810,2203.963235452,2177.287534011,-20
carcassonne-boltzmann495-vs-boltzmann360-1000its,791,811,2173.247814313,2132.014462595,-20
carcassonne-uct285-vs-uct385-1000its,793,813,2185.552510537,2107.434318835,-20
carcassonne-uct490-vs-uct150-1000its,793,813,2150.2591393,2097.224450756,-20
carcassonne-ucttuned120-vs-ucttuned345-1000its,793,813,2225.733690014,2160.613310538,-20
carcassonne-boltzmann100-vs-boltzmann385-1000its,794,814,2286.254158896,2238.791308356,-20
carcassonne-ucttuned420-vs-ucttuned115-1000its,794,814,2202.580054487,2173.522126679,-20
carcassonne-boltzmann305-vs-boltzmann5-1000its,797,817,2194.623908169,2176.625335201,-20
carcassonne-uct120-vs-uct315-1000its,797,817,2148.707688625,2136.162059789,-20
carcassonne-uct395-vs-uct285-1000its,797,817,2204.434080829,2148.802663793,-20
carcassonne-boltzmann40-vs-boltzmann385-1000its,798,818,2206.581737254,2156.857639745,-20
carcassonne-boltzmann435-vs-boltzmann90-1000its,798,818,2238.851006808,2192.314289059,-20
carcassonne-ucttuned485-vs-ucttuned125-1000its,798,818,2177.299910101,2144.661217642,-20
carcassonne-boltzmann195-vs-boltzmann250-1000its,799,819,2263.12649602,2161.166979617,-20
carcassonne-ucttuned230-vs-ucttuned50-1000its,799,819,2147.539645481,2149.385411372,-20
carcassonne-ucttuned275-vs-ucttuned170-1000its,799,819,2198.830289168,2126.472560008,-20
carcassonne-ucttuned35-vs-ucttuned280-1000its,801,821,2211.934498874,2213.437962748,-20
carcassonne-boltzmann25-vs-boltzmann55-1000its,803,823,2139.798212344,2123.946732698,-20
carcassonne-boltzmann10-vs-boltzmann55-1000its,805,825,2294.975973885,2235.987277148,-20
carcassonne-boltzmann340-vs-boltzmann395-1000its,805,825,2222.71809597,2159.204900993,-20
carcassonne-boltzmann270-vs-boltzmann75-1000its,807,827,2142.433322362,2098.902682162,-20
carcassonne-ucttuned420-vs-ucttuned290-1000its,807,827,2136.896998791,2082.606548332,-20
carcassonne-boltzmann480-vs-boltzmann400-1000its,809,829,2202.599399926,2104.952280425,-20
carcassonne-uct200-vs-uct115-1000its,809,829,2195.059992528,2166.097327972,-20
carcassonne-boltzmann415-vs-boltzmann120-1000its,810,830,2214.029827647,2171.753410337,-20
carcassonne-boltzmann75-vs-boltzmann485-1000its,810,830,2206.650984689,2154.684713822,-20
carcassonne-uct160-vs-uct470-1000its,810,830,2152.735255124,2128.597158233,-20
carcassonne-ucttuned415-vs-ucttuned170-1000its,810,830,2191.57471892,2160.77612602,-20
carcassonne-ucttuned75-vs-ucttuned300-1000its,810,830,2256.858023053,2236.161794605,-20
carcassonne-uct170-vs-uct50-1000its,811,831,2206.562029348,2189.271519149,-20
carcassonne-uct315-vs-uct495-1000its,812,832,2171.692619892,2133.281924182,-20
carcassonne-boltzmann155-vs-boltzmann470-1000its,813,833,2181.36946275,2108.70107362,-20
carcassonne-uct290-vs-uct315-1000its,814,834,2328.412937863,2262.926365383,-20
carcassonne-uct65-vs-uct315-1000its,814,834,2219.553004461,2137.080144005,-20
carcassonne-ucttuned465-vs-ucttuned455-1000its,815,835,2168.095989395,2139.467373721,-20
carcassonne-boltzmann180-vs-boltzmann285-1000its,816,836,2190.890865532,2127.928212886,-20
carcassonne-uct255-vs-uct135-1000its,816,836,2194.325033624,2174.689441584,-20
carcassonne-boltzmann365-vs-boltzmann175-1000its,817,837,2164.652982327,2154.930460364,-20
carcassonne-ucttuned330-vs-ucttuned195-1000its,818,838,2134.462822868,2118.406617884,-20
carcassonne-boltzmann310-vs-boltzmann210-1000its,820,840,2175.246962573,2149.968049756,-20
carcassonne-uct370-vs-uct455-1000its,822,842,2292.343473299,2202.769970086,-20
carcassonne-ucttuned155-vs-ucttuned430-1000its,822,842,2291.592007433,2233.813918143,-20
carcassonne-boltzmann360-vs-boltzmann205-1000its,823,843,2210.581675612,2172.995570402,-20
carcassonne-boltzmann185-vs-boltzmann250-1000its,826,846,2202.395010301,2151.048266786,-20
carcassonne-boltzmann300-vs-boltzmann225-1000its,826,846,2209.080126367,2219.832812476,-20
carcassonne-uct355-vs-uct320-1000its,826,846,2150.314863021,2110.709091247,-20
carcassonne-ucttuned250-vs-ucttuned195-1000its,826,846,2239.478525774,2192.457016997,-20
carcassonne-uct170-vs-uct320-1000its,828,848,2144.567026284,2141.607797185,-20
carcassonne-uct290-vs-uct160-1000its,828,848,2174.544768615,2141.09330333,-20
carcassonne-uct295-vs-uct190-1000its,829,849,2181.523154703,2086.159254319,-20
carcassonne-uct155-vs-uct120-1000its,830,850,2123.266052882,2102.104839935,-20
carcassonne-ucttuned85-vs-ucttuned20-1000its,830,850,2240.48942515,2187.40999085,-20
carcassonne-ucttuned185-vs-ucttuned310-1000its,835,855,2227.262039748,2134.130301078,-20
carcassonne-ucttuned35-vs-ucttuned115-1000its,836,856,2142.47354174,2092.522046124,-20
carcassonne-ucttuned305-vs-ucttuned385-1000its,838,858,2205.082644409,2173.23366945,-20
carcassonne-ucttuned300-vs-ucttuned415-1000its,839,859,2178.458659409,2122.982291775,-20
carcassonne-ucttuned470-vs-ucttuned60-1000its,839,859,2171.878476251,2160.079668261,-20
carcassonne-uct480-vs-uct110-1000its,844,864,2150.408433641,2122.998245211,-20
carcassonne-boltzmann405-vs-boltzmann165-1000its,845,865,2206.97572923,2154.756074503,-20
carcassonne-uct285-vs-uct210-1000its,846,866,2180.653606565,2140.51862287,-20
carcassonne-ucttuned345-vs-ucttuned450-1000its,848,868,2228.087205988,2154.48961384,-20
carcassonne-boltzmann85-vs-boltzmann5-1000its,852,872,2259.085452924,2206.141889069,-20
carcassonne-ucttuned400-vs-ucttuned295-1000its,853,873,2208.467243656,2140.61835224,-20
carcassonne-ucttuned270-vs-ucttuned25-1000its,854,874,2169.659260784,2141.67675862,-20
carcassonne-boltzmann20-vs-boltzmann155-1000its,857,877,2134.375677269,2093.486620645,-20
carcassonne-uct200-vs-uct180-1000its,859,879,2150.46339465,2106.457800238,-20
carcassonne-ucttuned485-vs-ucttuned135-1000its,859,879,2205.489293915,2133.453174554,-20
carcassonne-ucttuned135-vs-ucttuned290-1000its,860,880,2173.754848849,2093.924151764,-20
carcassonne-boltzmann140-vs-boltzmann375-1000its,861,881,2216.82040365,2171.140554747,-20
carcassonne-boltzmann290-vs-boltzmann185-1000its,861,881,2170.836646797,2124.948199376,-20
carcassonne-ucttuned470-vs-ucttuned175-1000its,862,882,2227.710665843,2160.433415984,-20
carcassonne-boltzmann230-vs-boltzmann340-1000its,863,883,2238.874843308,2165.927356864,-20
carcassonne-ucttuned205-vs-ucttuned340-1000its,863,883,2176.12063401,2155.502296204,-20
carcassonne-ucttuned395-vs-ucttuned130-1000its,866,886,2199.421004679,2206.491071651,-20
carcassonne-boltzmann450-vs-boltzmann165-1000its,875,895,2155.82514134,2084.793315938,-20
carcassonne-ucttuned170-vs-ucttuned225-1000its,877,897,2189.749784535,2163.07561686,-20
carcassonne-uct230-vs-uct430-1000its,882,902,2206.870852254,2210.488915034,-20
carcassonne-uct205-vs-uct435-1000its,887,907,2241.732304689,2208.660517349,-20
carcassonne-ucttuned310-vs-ucttuned410-1000its,967,987,2168.253116064,2121.975336965,-20
carcassonne-uct490-vs-uct230-1000its,709,728,2210.242656036,2150.154542895,-19
carcassonne-boltzmann405-vs-boltzmann475-1000its,711,730,2141.439613779,2117.230834603,-19
carcassonne-boltzmann180-vs-boltzmann270-1000its,715,734,2145.66601576,2093.674853113,-19
carcassonne-uct495-vs-uct385-1000its,715,734,2114.02582738,2099.45010784,-19
carcassonne-ucttuned370-vs-ucttuned440-1000its,719,738,2178.658223631,2112.326113287,-19
carcassonne-ucttuned470-vs-ucttuned475-1000its,720,739,2135.766530107,2128.884573715,-19
carcassonne-boltzmann310-vs-boltzmann190-1000its,726,745,2189.936957496,2146.866494345,-19
carcassonne-ucttuned290-vs-ucttuned305-1000its,728,747,2224.434688764,2158.380010821,-19
carcassonne-boltzmann65-vs-boltzmann395-1000its,730,749,2191.799644785,2143.433179424,-19
carcassonne-uct425-vs-uct430-1000its,730,749,2182.463596355,2174.556151112,-19
carcassonne-uct465-vs-uct205-1000its,739,758,2236.867569476,2174.608726373,-19
carcassonne-boltzmann335-vs-boltzmann325-1000its,740,759,2230.941320397,2159.726810843,-19
carcassonne-boltzmann170-vs-boltzmann445-1000its,745,764,2242.608738569,2198.444792492,-19
carcassonne-boltzmann385-vs-boltzmann90-1000its,747,766,2202.405771061,2195.462818448,-19
carcassonne-boltzmann400-vs-boltzmann335-1000its,750,769,2159.348879994,2136.532916249,-19
carcassonne-uct155-vs-uct60-1000its,751,770,2155.790780208,2135.383934196,-19
carcassonne-boltzmann445-vs-boltzmann45-1000its,752,771,2145.277842961,2112.647090366,-19
carcassonne-boltzmann200-vs-boltzmann230-1000its,753,772,2201.491409795,2137.264175271,-19
carcassonne-uct270-vs-uct105-1000its,753,772,2139.681356619,2134.53073228,-19
carcassonne-ucttuned120-vs-ucttuned385-1000its,755,774,2188.17882761,2116.21352466,-19
carcassonne-boltzmann400-vs-boltzmann260-1000its,758,777,2235.321400156,2198.194433484,-19
carcassonne-boltzmann465-vs-boltzmann410-1000its,758,777,2131.841941737,2108.470244675,-19
carcassonne-ucttuned215-vs-ucttuned240-1000its,759,778,2199.402474364,2146.305151514,-19
carcassonne-boltzmann190-vs-boltzmann320-1000its,760,779,2236.998444001,2159.142573128,-19
carcassonne-boltzmann480-vs-boltzmann450-1000its,760,779,2235.232168586,2177.143997594,-19
carcassonne-uct80-vs-uct165-1000its,760,779,2236.47525468,2197.785528126,-19
carcassonne-boltzmann370-vs-boltzmann490-1000its,762,781,2191.352507087,2115.085111007,-19
carcassonne-uct300-vs-uct175-1000its,762,781,2183.188475003,2141.49810747,-19
carcassonne-ucttuned145-vs-ucttuned275-1000its,765,784,2173.120763098,2128.189238183,-19
carcassonne-uct325-vs-uct245-1000its,766,785,2194.528246083,2140.917223013,-19
carcassonne-ucttuned275-vs-ucttuned365-1000its,766,785,2278.633809664,2203.78595812,-19
carcassonne-boltzmann470-vs-boltzmann115-1000its,768,787,2160.726241901,2119.605790126,-19
carcassonne-ucttuned185-vs-ucttuned410-1000its,769,788,2209.774879303,2139.003269138,-19
carcassonne-ucttuned280-vs-ucttuned190-1000its,769,788,2136.301206386,2070.933254685,-19
carcassonne-boltzmann210-vs-boltzmann395-1000its,770,789,2201.759330095,2144.082712559,-19
carcassonne-boltzmann250-vs-boltzmann205-1000its,770,789,2168.495516966,2143.324725129,-19
carcassonne-uct205-vs-uct230-1000its,770,789,2175.457405268,2075.941915199,-19
carcassonne-uct195-vs-uct350-1000its,771,790,2174.040829772,2165.290944692,-19
carcassonne-ucttuned75-vs-ucttuned450-1000its,771,790,2203.284929472,2170.459350006,-19
carcassonne-ucttuned145-vs-ucttuned445-1000its,772,791,2206.45287271,2172.269728907,-19
carcassonne-ucttuned360-vs-ucttuned380-1000its,772,791,2241.367929909,2221.889600711,-19
carcassonne-boltzmann145-vs-boltzmann320-1000its,774,793,2228.18828489,2160.171723361,-19
carcassonne-boltzmann15-vs-boltzmann465-1000its,774,793,2197.45655357,2147.012971637,-19
carcassonne-ucttuned55-vs-ucttuned440-1000its,775,794,2131.846757437,2112.630019078,-19
carcassonne-uct165-vs-uct270-1000its,777,796,2169.551159767,2165.078181727,-19
carcassonne-uct175-vs-uct450-1000its,777,796,2182.449213206,2110.839907979,-19
carcassonne-ucttuned185-vs-ucttuned280-1000its,777,796,2159.822453412,2114.510312969,-19
carcassonne-boltzmann450-vs-boltzmann260-1000its,778,797,2167.308944527,2113.928244966,-19
carcassonne-uct380-vs-uct345-1000its,779,798,2173.597068978,2131.253215333,-19
carcassonne-uct335-vs-uct260-1000its,781,800,2127.841755842,2094.211809667,-19
carcassonne-uct145-vs-uct335-1000its,783,802,2162.432648003,2114.600669923,-19
carcassonne-uct375-vs-uct50-1000its,786,805,2224.004818266,2159.84045215,-19
carcassonne-boltzmann485-vs-boltzmann70-1000its,787,806,2295.159417112,2223.321077889,-19
carcassonne-ucttuned190-vs-ucttuned365-1000its,787,806,2147.566418454,2109.214682065,-19
carcassonne-ucttuned475-vs-ucttuned230-1000its,787,806,2171.630956958,2165.67351099,-19
carcassonne-uct400-vs-uct375-1000its,788,807,2170.862806719,2155.528004277,-19
carcassonne-boltzmann415-vs-boltzmann450-1000its,789,808,2153.11400226,2081.755457748,-19
carcassonne-ucttuned380-vs-ucttuned305-1000its,789,808,2159.390591748,2120.33244873,-19
carcassonne-uct80-vs-uct365-1000its,790,809,2228.906812799,2186.673545687,-19
carcassonne-ucttuned385-vs-ucttuned490-1000its,791,810,2195.750202818,2119.122191465,-19
carcassonne-uct210-vs-uct235-1000its,792,811,2124.991115159,2066.531351267,-19
carcassonne-ucttuned350-vs-ucttuned480-1000its,792,811,2206.272155719,2174.313327837,-19
carcassonne-boltzmann250-vs-boltzmann175-1000its,794,813,2179.910698762,2140.213547611,-19
carcassonne-boltzmann360-vs-boltzmann435-1000its,794,813,2240.133395933,2164.615109007,-19
carcassonne-boltzmann315-vs-boltzmann105-1000its,795,814,2183.636557601,2148.390128253,-19
carcassonne-ucttuned5-vs-ucttuned155-1000its,795,814,2204.412869767,2187.024339759,-19
carcassonne-boltzmann230-vs-boltzmann110-1000its,796,815,2227.911867973,2193.852093594,-19
carcassonne-boltzmann335-vs-boltzmann195-1000its,796,815,2193.735834921,2128.724258302,-19
carcassonne-uct60-vs-uct435-1000its,800,819,2208.418966427,2132.620330324,-19
carcassonne-ucttuned110-vs-ucttuned250-1000its,800,819,2174.446041449,2108.922426137,-19
carcassonne-boltzmann475-vs-boltzmann115-1000its,801,820,2263.391080436,2212.240170057,-19
carcassonne-ucttuned365-vs-ucttuned440-1000its,801,820,2163.596091871,2127.387030785,-19
carcassonne-boltzmann125-vs-boltzmann155-1000its,803,822,2257.487311666,2196.829108317,-19
carcassonne-boltzmann165-vs-boltzmann285-1000its,804,823,2140.445983108,2122.496317603,-19
carcassonne-ucttuned460-vs-ucttuned315-1000its,804,823,2237.773566913,2193.398756924,-19
carcassonne-boltzmann335-vs-boltzmann235-1000its,805,824,2193.228370915,2149.712916981,-19
carcassonne-uct400-vs-uct40-1000its,807,826,2207.792288755,2165.476419325,-19
carcassonne-ucttuned265-vs-ucttuned115-1000its,808,827,2161.0565965,2073.619574989,-19
carcassonne-ucttuned395-vs-ucttuned490-1000its,809,828,2213.356701308,2108.591059392,-19
carcassonne-boltzmann485-vs-boltzmann15-1000its,810,829,2212.703948102,2185.992336228,-19
carcassonne-ucttuned315-vs-ucttuned395-1000its,810,829,2171.765104661,2161.731806675,-19
carcassonne-boltzmann15-vs-boltzmann410-1000its,811,830,2214.073416227,2090.627636418,-19
carcassonne-uct115-vs-uct155-1000its,811,830,2140.215377635,2101.861165497,-19
carcassonne-uct250-vs-uct125-1000its,811,830,2205.620941754,2124.013030894,-19
carcassonne-ucttuned300-vs-ucttuned340-1000its,811,830,2256.57305904,2223.007466312,-19
carcassonne-boltzmann305-vs-boltzmann255-1000its,812,831,2217.174120992,2169.76767882,-19
carcassonne-boltzmann445-vs-boltzmann50-1000its,812,831,2223.978872334,2170.75830216,-19
carcassonne-uct35-vs-uct310-1000its,812,831,2174.798452822,2156.060459757,-19
carcassonne-ucttuned150-vs-ucttuned220-1000its,812,831,2177.228377235,2170.99989933,-19
carcassonne-ucttuned90-vs-ucttuned430-1000its,813,832,2253.924823706,2222.872193187,-19
carcassonne-uct25-vs-uct375-1000its,814,833,2169.819054969,2102.81456918,-19
carcassonne-uct170-vs-uct395-1000its,817,836,2152.137180517,2072.876615756,-19
carcassonne-ucttuned30-vs-ucttuned150-1000its,817,836,2145.266107266,2103.597675635,-19
carcassonne-boltzmann450-vs-boltzmann475-1000its,818,837,2259.879805675,2164.639848809,-19
carcassonne-uct390-vs-uct410-1000its,818,837,2199.850794868,2136.052333073,-19
carcassonne-ucttuned405-vs-ucttuned185-1000its,818,837,2233.289947541,2185.694832862,-19
carcassonne-uct245-vs-uct430-1000its,819,838,2173.675492102,2140.219050322,-19
carcassonne-ucttuned380-vs-ucttuned475-1000its,819,838,2233.788426033,2202.604807351,-19
carcassonne-ucttuned120-vs-ucttuned140-1000its,820,839,2236.41714513,2159.079988862,-19
carcassonne-ucttuned440-vs-ucttuned345-1000its,821,840,2169.02042089,2128.849081286,-19
carcassonne-boltzmann355-vs-boltzmann485-1000its,823,842,2290.210758274,2218.736326501,-19
carcassonne-ucttuned180-vs-ucttuned210-1000its,823,842,2207.828893725,2128.029755886,-19
carcassonne-uct165-vs-uct475-1000its,825,844,2198.87889822,2169.068563994,-19
carcassonne-ucttuned35-vs-ucttuned420-1000its,828,847,2162.694798554,2110.442993245,-19
carcassonne-ucttuned75-vs-ucttuned125-1000its,828,847,2292.114462702,2258.079615965,-19
carcassonne-boltzmann365-vs-boltzmann15-1000its,829,848,2261.590269631,2227.267220142,-19
carcassonne-ucttuned450-vs-ucttuned335-1000its,829,848,2211.929858886,2172.435214784,-19
carcassonne-uct395-vs-uct40-1000its,832,851,2169.295152469,2145.031747192,-19
carcassonne-boltzmann320-vs-boltzmann305-1000its,833,852,2189.378583972,2142.652329843,-19
carcassonne-uct460-vs-uct490-1000its,833,852,2208.246168553,2161.106085564,-19
carcassonne-ucttuned220-vs-ucttuned420-1000its,834,853,2157.044460795,2130.002751991,-19
carcassonne-uct315-vs-uct350-1000its,836,855,2167.409654222,2150.123593964,-19
carcassonne-uct205-vs-uct240-1000its,837,856,2226.950074601,2182.454471138,-19
carcassonne-uct55-vs-uct40-1000its,839,858,2192.897201995,2147.509198514,-19
carcassonne-ucttuned230-vs-ucttuned200-1000its,840,859,2256.892205696,2195.6686022,-19
carcassonne-uct145-vs-uct130-1000its,842,861,2144.10428373,2109.818767462,-19
carcassonne-uct415-vs-uct270-1000its,842,861,2227.079777271,2127.207169019,-19
carcassonne-uct175-vs-uct310-1000its,843,862,2188.142361382,2139.518142913,-19
carcassonne-boltzmann50-vs-boltzmann260-1000its,844,863,2225.699897637,2187.475728519,-19
carcassonne-boltzmann65-vs-boltzmann190-1000its,844,863,2200.471180377,2122.643219713,-19
carcassonne-ucttuned300-vs-ucttuned50-1000its,846,865,2149.37973523,2122.095886951,-19
carcassonne-uct415-vs-uct265-1000its,847,866,2190.517488108,2109.053820318,-19
carcassonne-ucttuned100-vs-ucttuned30-1000its,848,867,2275.327846202,2270.531256449,-19
carcassonne-ucttuned490-vs-ucttuned75-1000its,849,868,2250.335190422,2237.847080205,-19
carcassonne-boltzmann350-vs-boltzmann5-1000its,850,869,2150.310330554,2179.054645089,-19
carcassonne-ucttuned75-vs-ucttuned470-1000its,851,870,2194.931680504,2168.713549789,-19
carcassonne-boltzmann15-vs-boltzmann150-1000its,854,873,2220.499761109,2149.778097646,-19
carcassonne-uct415-vs-uct170-1000its,854,873,2187.980389931,2143.540617756,-19
carcassonne-uct75-vs-uct140-1000its,855,874,2243.744992198,2169.473368517,-19
carcassonne-boltzmann85-vs-boltzmann490-1000its,857,876,2259.112785048,2201.194121236,-19
carcassonne-ucttuned340-vs-ucttuned65-1000its,859,878,2246.838451803,2162.476757086,-19
carcassonne-uct465-vs-uct355-1000its,861,880,2231.724622979,2205.879377062,-19
carcassonne-ucttuned230-vs-ucttuned10-1000its,861,880,2159.381752896,2114.665295183,-19
carcassonne-boltzmann35-vs-boltzmann25-1000its,863,882,2250.95258292,2180.184424383,-19
carcassonne-ucttuned55-vs-ucttuned270-1000its,863,882,2184.693699418,2130.733149036,-19
carcassonne-ucttuned160-vs-ucttuned455-1000its,867,886,2258.183960706,2191.824738053,-19
carcassonne-ucttuned390-vs-ucttuned260-1000its,867,886,2178.080398972,2168.697667936,-19
carcassonne-boltzmann280-vs-boltzmann85-1000its,868,887,2144.371133159,2117.943194027,-19
carcassonne-ucttuned370-vs-ucttuned100-1000its,868,887,2165.350597666,2106.996708095,-19
carcassonne-uct270-vs-uct370-1000its,872,891,2099.392420665,2081.958761303,-19
carcassonne-uct475-vs-uct330-1000its,873,892,2156.137293403,2114.720381363,-19
carcassonne-ucttuned85-vs-ucttuned320-1000its,878,897,2158.421016091,2142.219020137,-19
carcassonne-boltzmann270-vs-boltzmann300-1000its,889,908,2194.782668275,2147.366664079,-19
carcassonne-ucttuned370-vs-ucttuned250-1000its,892,911,2225.42776965,2196.342844717,-19
carcassonne-boltzmann465-vs-boltzmann405-1000its,896,915,2201.866590978,2182.032179141,-19
carcassonne-ucttuned160-vs-ucttuned95-1000its,898,917,2164.638671726,2133.039269505,-19
carcassonne-uct390-vs-uct55-1000its,900,919,2149.357617443,2063.421834635,-19
carcassonne-uct305-vs-uct155-1000its,937,956,2165.583605095,2181.797759655,-19
carcassonne-boltzmann460-vs-boltzmann485-1000its,689,707,2211.111926728,2173.260961945,-18
carcassonne-uct445-vs-uct45-1000its,693,711,2276.896049212,2204.12378014,-18
carcassonne-ucttuned255-vs-ucttuned135-1000its,733,751,2312.318846392,2245.821498353,-18
carcassonne-uct455-vs-uct125-1000its,734,752,2133.137267524,2079.75691118,-18
carcassonne-uct225-vs-uct250-1000its,735,753,2262.951134414,2193.675611488,-18
carcassonne-ucttuned410-vs-ucttuned415-1000its,736,754,2282.343785925,2212.693853514,-18
carcassonne-boltzmann465-vs-boltzmann415-1000its,738,756,2195.852859858,2198.531900862,-18
carcassonne-uct490-vs-uct345-1000its,748,766,2197.254317057,2197.440863944,-18
carcassonne-boltzmann155-vs-boltzmann480-1000its,750,768,2208.658347849,2145.576988328,-18
carcassonne-boltzmann490-vs-boltzmann440-1000its,750,768,2141.102925735,2113.88536387,-18
carcassonne-uct145-vs-uct265-1000its,751,769,2204.730289378,2138.895965136,-18
carcassonne-uct175-vs-uct225-1000its,751,769,2242.869737205,2191.609650705,-18
carcassonne-uct275-vs-uct40-1000its,753,771,2152.012325992,2115.237744079,-18
carcassonne-ucttuned60-vs-ucttuned345-1000its,755,773,2148.374983882,2091.572422951,-18
carcassonne-boltzmann405-vs-boltzmann205-1000its,756,774,2162.151890381,2080.430494601,-18
carcassonne-uct375-vs-uct345-1000its,758,776,2129.789590283,2076.847237552,-18
carcassonne-ucttuned90-vs-ucttuned95-1000its,758,776,2257.520097194,2185.381661772,-18
carcassonne-ucttuned320-vs-ucttuned240-1000its,759,777,2186.390494667,2109.503577482,-18
carcassonne-ucttuned95-vs-ucttuned175-1000its,759,777,2233.253394001,2155.582303611,-18
carcassonne-uct300-vs-uct255-1000its,760,778,2215.936296128,2172.24715336,-18
carcassonne-ucttuned90-vs-ucttuned210-1000its,761,779,2222.544340544,2153.973670824,-18
carcassonne-boltzmann270-vs-boltzmann235-1000its,766,784,2155.618583987,2104.999080966,-18
carcassonne-uct290-vs-uct155-1000its,766,784,2223.793585561,2191.359221365,-18
carcassonne-boltzmann315-vs-boltzmann265-1000its,768,786,2171.89495045,2166.223641198,-18
carcassonne-uct320-vs-uct120-1000its,768,786,2194.749592535,2123.342363579,-18
carcassonne-uct440-vs-uct260-1000its,768,786,2166.55702448,2163.320615808,-18
carcassonne-ucttuned380-vs-ucttuned50-1000its,770,788,2179.176866943,2155.199461934,-18
carcassonne-boltzmann180-vs-boltzmann120-1000its,771,789,2204.812385232,2227.979251875,-18
carcassonne-ucttuned190-vs-ucttuned95-1000its,772,790,2156.725470573,2140.991221882,-18
carcassonne-ucttuned300-vs-ucttuned470-1000its,772,790,2237.289165997,2184.280294395,-18
carcassonne-boltzmann115-vs-boltzmann480-1000its,773,791,2162.854603279,2125.345746309,-18
carcassonne-ucttuned215-vs-ucttuned445-1000its,775,793,2213.801342815,2154.183691377,-18
carcassonne-boltzmann125-vs-boltzmann310-1000its,776,794,2156.922529353,2136.731115416,-18
carcassonne-boltzmann225-vs-boltzmann105-1000its,776,794,2212.200511856,2170.250552763,-18
carcassonne-uct395-vs-uct240-1000its,777,795,2257.160184628,2199.579956544,-18
carcassonne-ucttuned270-vs-ucttuned495-1000its,777,795,2210.903597535,2146.038211445,-18
carcassonne-boltzmann335-vs-boltzmann440-1000its,778,796,2187.827820375,2164.133227354,-18
carcassonne-boltzmann245-vs-boltzmann305-1000its,779,797,2173.458833959,2135.44228975,-18
carcassonne-boltzmann435-vs-boltzmann495-1000its,779,797,2263.515047273,2222.602802123,-18
carcassonne-uct140-vs-uct190-1000its,779,797,2187.279451757,2166.518024505,-18
carcassonne-uct185-vs-uct130-1000its,779,797,2128.786527978,2144.68180934,-18
carcassonne-uct310-vs-uct440-1000its,779,797,2197.014056406,2156.03324973,-18
carcassonne-boltzmann355-vs-boltzmann430-1000its,780,798,2284.699168262,2225.114745452,-18
carcassonne-boltzmann220-vs-boltzmann485-1000its,781,799,2172.838527578,2072.381127187,-18
carcassonne-ucttuned160-vs-ucttuned220-1000its,781,799,2155.74837781,2114.53712913,-18
carcassonne-ucttuned475-vs-ucttuned375-1000its,781,799,2190.205610101,2101.078346417,-18
carcassonne-boltzmann470-vs-boltzmann215-1000its,782,800,2142.814647108,2088.101915259,-18
carcassonne-uct100-vs-uct10-1000its,783,801,2179.852353665,2133.884851951,-18
carcassonne-boltzmann405-vs-boltzmann40-1000its,788,806,2195.962356246,2153.998932079,-18
carcassonne-ucttuned430-vs-ucttuned320-1000its,788,806,2134.063492314,2087.379188841,-18
carcassonne-uct495-vs-uct200-1000its,789,807,2223.582617736,2173.490888048,-18
carcassonne-uct205-vs-uct165-1000its,790,808,2312.375167058,2273.561686626,-18
carcassonne-ucttuned280-vs-ucttuned470-1000its,790,808,2136.746331653,2092.071271656,-18
carcassonne-boltzmann245-vs-boltzmann310-1000its,791,809,2172.15520728,2165.903864528,-18
carcassonne-boltzmann480-vs-boltzmann375-1000its,791,809,2230.142005889,2197.504662975,-18
carcassonne-ucttuned160-vs-ucttuned375-1000its,791,809,2243.509124957,2211.552031404,-18
carcassonne-boltzmann345-vs-boltzmann15-1000its,792,810,2209.900682743,2136.857803383,-18
carcassonne-ucttuned370-vs-ucttuned225-1000its,792,810,2188.237338442,2176.121279094,-18
carcassonne-uct170-vs-uct465-1000its,795,813,2160.527249715,2114.917881141,-18
carcassonne-uct250-vs-uct180-1000its,795,813,2176.055462442,2155.963711659,-18
carcassonne-uct435-vs-uct10-1000its,795,813,2113.279058869,2080.001575507,-18
carcassonne-boltzmann180-vs-boltzmann125-1000its,796,814,2176.813130953,2148.564616939,-18
carcassonne-ucttuned115-vs-ucttuned50-1000its,798,816,2200.389940305,2171.185713294,-18
carcassonne-ucttuned310-vs-ucttuned40-1000its,798,816,2244.363770203,2214.113025697,-18
carcassonne-uct435-vs-uct210-1000its,801,819,2130.505883582,2149.403593974,-18
carcassonne-uct270-vs-uct450-1000its,802,820,2213.23478796,2122.101594997,-18
carcassonne-uct240-vs-uct315-1000its,803,821,2240.164979615,2180.523271792,-18
carcassonne-boltzmann235-vs-boltzmann380-1000its,804,822,2192.834684055,2138.838271769,-18
carcassonne-ucttuned255-vs-ucttuned480-1000its,804,822,2243.660320342,2186.530286163,-18
carcassonne-boltzmann275-vs-boltzmann485-1000its,805,823,2161.683382048,2129.937893972,-18
carcassonne-ucttuned220-vs-ucttuned25-1000its,805,823,2229.218123081,2172.484838132,-18
carcassonne-ucttuned160-vs-ucttuned40-1000its,806,824,2246.564748599,2223.203583015,-18
carcassonne-uct385-vs-uct150-1000its,807,825,2191.383618175,2102.999806789,-18
carcassonne-ucttuned380-vs-ucttuned210-1000its,807,825,2171.40619022,2109.64513754,-18
carcassonne-ucttuned355-vs-ucttuned235-1000its,808,826,2176.323636877,2158.149838257,-18
carcassonne-boltzmann170-vs-boltzmann310-1000its,809,827,2166.922652016,2122.592499692,-18
carcassonne-uct65-vs-uct155-1000its,810,828,2206.958085744,2163.70183006,-18
carcassonne-boltzmann175-vs-boltzmann110-1000its,812,830,2213.642851414,2175.998245143,-18
carcassonne-ucttuned480-vs-ucttuned180-1000its,812,830,2192.094986083,2156.432878456,-18
carcassonne-boltzmann220-vs-boltzmann460-1000its,813,831,2167.321001025,2086.505779036,-18
carcassonne-uct490-vs-uct270-1000its,813,831,2144.675152198,2131.225156561,-18
carcassonne-boltzmann360-vs-boltzmann90-1000its,814,832,2233.93624964,2195.193524252,-18
carcassonne-ucttuned190-vs-ucttuned370-1000its,814,832,2165.211379693,2119.211370439,-18
carcassonne-ucttuned195-vs-ucttuned215-1000its,817,835,2235.642523785,2162.60558679,-18
carcassonne-uct480-vs-uct10-1000its,818,836,2240.445397156,2185.232900051,-18
carcassonne-boltzmann175-vs-boltzmann125-1000its,819,837,2265.040497099,2245.814280848,-18
carcassonne-uct160-vs-uct330-1000its,820,838,2223.544994332,2171.027931517,-18
carcassonne-uct315-vs-uct430-1000its,820,838,2213.136455207,2178.982577233,-18
carcassonne-ucttuned260-vs-ucttuned255-1000its,820,838,2213.179841609,2143.616717294,-18
carcassonne-uct170-vs-uct245-1000its,821,839,2230.542609492,2194.413522623,-18
carcassonne-uct420-vs-uct130-1000its,822,840,2143.2252076,2099.180239937,-18
carcassonne-uct15-vs-uct490-1000its,824,842,2200.727264513,2129.475824359,-18
carcassonne-boltzmann475-vs-boltzmann5-1000its,825,843,2188.225996911,2175.024684849,-18
carcassonne-uct165-vs-uct290-1000its,825,843,2143.240535619,2096.168500578,-18
carcassonne-boltzmann330-vs-boltzmann350-1000its,826,844,2201.45109674,2153.531570027,-18
carcassonne-ucttuned265-vs-ucttuned65-1000its,826,844,2196.564887608,2130.22048078,-18
carcassonne-uct405-vs-uct465-1000its,827,845,2220.702940133,2155.968690683,-18
carcassonne-boltzmann460-vs-boltzmann360-1000its,829,847,2198.407391539,2137.916412808,-18
carcassonne-uct215-vs-uct350-1000its,829,847,2299.186136758,2265.507796261,-18
carcassonne-boltzmann305-vs-boltzmann80-1000its,830,848,2129.469946942,2123.974052798,-18
carcassonne-boltzmann255-vs-boltzmann325-1000its,832,850,2220.731532809,2246.959385956,-18
carcassonne-uct80-vs-uct65-1000its,832,850,2217.407799922,2172.536391464,-18
carcassonne-ucttuned165-vs-ucttuned50-1000its,835,853,2149.683619597,2121.842630473,-18
carcassonne-uct280-vs-uct135-1000its,836,854,2230.626143788,2204.494634909,-18
carcassonne-ucttuned300-vs-ucttuned290-1000its,836,854,2200.131840232,2183.094894247,-18
carcassonne-ucttuned345-vs-ucttuned305-1000its,837,855,2227.518691171,2200.799252039,-18
carcassonne-ucttuned390-vs-ucttuned195-1000its,837,855,2175.282652117,2129.970488865,-18
carcassonne-uct310-vs-uct240-1000its,838,856,2206.61132392,2129.287530157,-18
carcassonne-uct165-vs-uct10-1000its,841,859,2201.284411769,2166.467658648,-18
carcassonne-ucttuned305-vs-ucttuned225-1000its,841,859,2173.86008256,2144.245160712,-18
carcassonne-boltzmann110-vs-boltzmann330-1000its,842,860,2211.665278516,2203.304807107,-18
carcassonne-uct450-vs-uct445-1000its,843,861,2163.159257909,2136.454643271,-18
carcassonne-ucttuned55-vs-ucttuned495-1000its,843,861,2182.761411144,2196.123008815,-18
carcassonne-uct290-vs-uct305-1000its,844,862,2194.212334937,2174.565748999,-18
carcassonne-uct10-vs-uct465-1000its,845,863,2187.379843316,2130.577025334,-18
carcassonne-uct490-vs-uct245-1000its,845,863,2174.177272267,2080.240132491,-18
carcassonne-ucttuned370-vs-ucttuned155-1000its,845,863,2157.652256929,2135.544940636,-18
carcassonne-boltzmann365-vs-boltzmann430-1000its,846,864,2164.662444943,2169.091544034,-18
carcassonne-uct125-vs-uct410-1000its,847,865,2142.272379235,2099.95317228,-18
carcassonne-ucttuned235-vs-ucttuned5-1000its,847,865,2216.663008386,2175.991935125,-18
carcassonne-ucttuned450-vs-ucttuned160-1000its,848,866,2178.630766247,2115.062141877,-18
carcassonne-boltzmann40-vs-boltzmann205-1000its,849,867,2234.070070078,2176.207901664,-18
carcassonne-boltzmann495-vs-boltzmann435-1000its,851,869,2325.025814269,2266.997490496,-18
carcassonne-uct210-vs-uct175-1000its,852,870,2170.12104246,2155.149192511,-18
carcassonne-ucttuned295-vs-ucttuned225-1000its,852,870,2174.331829795,2128.450146474,-18
carcassonne-ucttuned375-vs-ucttuned385-1000its,856,874,2230.395976807,2160.541577872,-18
carcassonne-ucttuned330-vs-ucttuned320-1000its,864,882,2202.029365911,2172.850221047,-18
carcassonne-uct50-vs-uct405-1000its,879,897,2196.759546972,2143.176418839,-18
carcassonne-ucttuned60-vs-ucttuned20-1000its,890,908,2216.963770708,2176.797401589,-18
carcassonne-uct255-vs-uct395-1000its,896,914,2183.604397089,2153.158386303,-18
carcassonne-ucttuned450-vs-ucttuned395-1000its,618,635,1730.707155932,1722.877694935,-17
carcassonne-boltzmann200-vs-boltzmann450-1000its,681,698,2237.791169306,2199.310735334,-17
carcassonne-boltzmann385-vs-boltzmann30-1000its,695,712,2234.794378383,2179.129951759,-17
carcassonne-boltzmann270-vs-boltzmann425-1000its,698,715,2187.915590349,2157.392814279,-17
carcassonne-uct285-vs-uct370-1000its,705,722,2131.59951868,2106.887794492,-17
carcassonne-boltzmann140-vs-boltzmann485-1000its,711,728,2180.925177551,2102.559446522,-17
carcassonne-boltzmann230-vs-boltzmann420-1000its,726,743,2232.961581958,2162.050300833,-17
carcassonne-ucttuned460-vs-ucttuned470-1000its,745,762,2196.904746572,2189.584098495,-17
carcassonne-boltzmann295-vs-boltzmann430-1000its,748,765,2269.309279301,2169.244986879,-17
carcassonne-uct40-vs-uct130-1000its,748,765,2216.293519403,2138.696521345,-17
carcassonne-boltzmann105-vs-boltzmann270-1000its,750,767,2168.053981991,2110.113481406,-17
carcassonne-uct345-vs-uct95-1000its,752,769,2219.483272946,2174.174382741,-17
carcassonne-uct305-vs-uct190-1000its,753,770,2197.679698569,2146.629109102,-17
carcassonne-ucttuned300-vs-ucttuned95-1000its,754,771,2173.736919378,2149.313114041,-17
carcassonne-ucttuned275-vs-ucttuned175-1000its,758,775,2222.387030819,2176.618679624,-17
carcassonne-ucttuned310-vs-ucttuned450-1000its,758,775,2218.573593212,2207.980767232,-17
carcassonne-ucttuned390-vs-ucttuned35-1000its,758,775,2105.548350732,2120.555969518,-17
carcassonne-boltzmann290-vs-boltzmann315-1000its,768,785,2199.575823659,2157.123524703,-17
carcassonne-boltzmann210-vs-boltzmann470-1000its,769,786,2188.15304348,2164.510262595,-17
carcassonne-boltzmann460-vs-boltzmann65-1000its,770,787,2285.648347019,2204.271143013,-17
carcassonne-uct170-vs-uct375-1000its,770,787,2188.575673367,2188.566469426,-17
carcassonne-uct120-vs-uct275-1000its,772,789,2181.915627228,2148.422341566,-17
carcassonne-uct185-vs-uct285-1000its,772,789,2279.182455193,2234.355084633,-17
carcassonne-boltzmann150-vs-boltzmann245-1000its,773,790,2142.456452187,2082.147837563,-17
carcassonne-boltzmann465-vs-boltzmann215-1000its,773,790,2206.286352211,2162.223343701,-17
carcassonne-uct100-vs-uct80-1000its,773,790,2172.517892577,2149.873604577,-17
carcassonne-uct350-vs-uct270-1000its,774,791,2254.283010614,2203.943069083,-17
carcassonne-ucttuned465-vs-ucttuned10-1000its,774,791,2117.580895503,2058.730134294,-17
carcassonne-boltzmann460-vs-boltzmann165-1000its,775,792,2139.647793281,2113.629278289,-17
carcassonne-uct35-vs-uct90-1000its,777,794,2246.517356863,2207.721313273,-17
carcassonne-uct40-vs-uct75-1000its,778,795,2240.415755627,2168.735678871,-17
carcassonne-ucttuned240-vs-ucttuned205-1000its,779,796,2230.941902809,2122.075234704,-17
carcassonne-ucttuned345-vs-ucttuned110-1000its,779,796,2146.702311027,2123.420962742,-17
carcassonne-uct125-vs-uct270-1000its,782,799,2167.008116725,2119.875399397,-17
carcassonne-ucttuned200-vs-ucttuned400-1000its,782,799,2165.728653238,2150.925929472,-17
carcassonne-uct490-vs-uct100-1000its,783,800,2093.050598537,2080.112322222,-17
carcassonne-uct430-vs-uct445-1000its,784,801,2172.536754392,2149.905672709,-17
carcassonne-uct105-vs-uct360-1000its,786,803,2200.880676857,2141.95162531,-17
carcassonne-uct65-vs-uct380-1000its,786,803,2179.448068989,2117.865794539,-17
carcassonne-uct245-vs-uct465-1000its,788,805,2187.251704954,2116.121120839,-17
carcassonne-uct280-vs-uct385-1000its,789,806,2185.812269105,2142.297590825,-17
carcassonne-uct110-vs-uct40-1000its,791,808,2191.267824165,2187.221731582,-17
carcassonne-boltzmann280-vs-boltzmann405-1000its,792,809,2231.050744139,2155.307471301,-17
carcassonne-uct190-vs-uct105-1000its,792,809,2145.568838971,2112.904767762,-17
carcassonne-boltzmann370-vs-boltzmann135-1000its,793,810,2196.800342341,2166.288464265,-17
carcassonne-uct185-vs-uct80-1000its,793,810,2199.884143204,2108.766326243,-17
carcassonne-ucttuned110-vs-ucttuned210-1000its,794,811,2250.721111816,2203.753458351,-17
carcassonne-boltzmann340-vs-boltzmann420-1000its,795,812,2231.717107007,2184.13084028,-17
carcassonne-boltzmann255-vs-boltzmann445-1000its,796,813,2221.963528001,2169.530152478,-17
carcassonne-uct495-vs-uct315-1000its,796,813,2215.772979677,2160.077363191,-17
carcassonne-boltzmann465-vs-boltzmann385-1000its,798,815,2205.291426054,2161.264987259,-17
carcassonne-uct255-vs-uct480-1000its,798,815,2152.29974325,2103.258520156,-17
carcassonne-ucttuned80-vs-ucttuned55-1000its,798,815,2227.347659564,2185.271605499,-17
carcassonne-boltzmann105-vs-boltzmann80-1000its,799,816,2153.840922249,2153.259748843,-17
carcassonne-boltzmann285-vs-boltzmann315-1000its,799,816,2157.054458969,2132.439413783,-17
carcassonne-uct50-vs-uct425-1000its,799,816,2142.018930078,2159.267566707,-17
carcassonne-uct250-vs-uct210-1000its,801,818,2128.796848647,2089.242240076,-17
carcassonne-uct470-vs-uct270-1000its,801,818,2181.621570356,2113.319439569,-17
carcassonne-ucttuned95-vs-ucttuned70-1000its,801,818,2198.388890049,2173.059688399,-17
carcassonne-boltzmann350-vs-boltzmann440-1000its,802,819,2148.673029395,2113.55850123,-17
carcassonne-boltzmann405-vs-boltzmann290-1000its,802,819,2150.016029767,2118.475118804,-17
carcassonne-uct325-vs-uct170-1000its,802,819,2221.493818228,2170.777265915,-17
carcassonne-uct410-vs-uct135-1000its,803,820,2208.008157197,2148.528688881,-17
carcassonne-boltzmann375-vs-boltzmann85-1000its,805,822,2220.059706677,2188.835800664,-17
carcassonne-uct205-vs-uct150-1000its,805,822,2113.838298489,2105.263856405,-17
carcassonne-boltzmann55-vs-boltzmann150-1000its,806,823,2197.000937475,2157.817103326,-17
carcassonne-ucttuned90-vs-ucttuned490-1000its,806,823,2195.385895584,2169.318968388,-17
carcassonne-uct450-vs-uct385-1000its,807,824,2227.48950057,2167.30025785,-17
carcassonne-boltzmann300-vs-boltzmann305-1000its,808,825,2229.910406652,2181.065509873,-17
carcassonne-uct465-vs-uct50-1000its,808,825,2162.330421579,2144.786575917,-17
carcassonne-ucttuned130-vs-ucttuned105-1000its,808,825,2209.48593554,2173.607048193,-17
carcassonne-ucttuned470-vs-ucttuned245-1000its,810,827,2191.471937196,2168.135376578,-17
carcassonne-boltzmann15-vs-boltzmann400-1000its,811,828,2218.71501085,2180.984157492,-17
carcassonne-boltzmann20-vs-boltzmann430-1000its,811,828,2200.989492811,2200.084670289,-17
carcassonne-uct25-vs-uct80-1000its,812,829,2172.38925528,2133.517570594,-17
carcassonne-boltzmann235-vs-boltzmann255-1000its,814,831,2189.852139867,2163.935769371,-17
carcassonne-ucttuned260-vs-ucttuned345-1000its,814,831,2201.333617586,2166.379370065,-17
carcassonne-uct155-vs-uct485-1000its,817,834,2160.423613833,2103.299227648,-17
carcassonne-uct20-vs-uct225-1000its,817,834,2145.859770251,2090.436334959,-17
carcassonne-uct215-vs-uct50-1000its,818,835,2198.479866104,2159.084059369,-17
carcassonne-ucttuned105-vs-ucttuned350-1000its,820,837,2272.632934023,2239.530167394,-17
carcassonne-uct410-vs-uct390-1000its,822,839,2188.08188606,2176.158673078,-17
carcassonne-uct360-vs-uct215-1000its,823,840,2235.559562802,2172.424495778,-17
carcassonne-ucttuned245-vs-ucttuned125-1000its,823,840,2264.815676341,2181.288497818,-17
carcassonne-uct170-vs-uct45-1000its,825,842,2244.294795308,2237.884642703,-17
carcassonne-boltzmann100-vs-boltzmann95-1000its,827,844,2217.318899014,2122.882092969,-17
carcassonne-uct450-vs-uct430-1000its,827,844,2188.68972923,2169.055368778,-17
carcassonne-uct95-vs-uct185-1000its,828,845,2183.379339654,2123.36547873,-17
carcassonne-ucttuned265-vs-ucttuned435-1000its,828,845,2278.466109139,2186.579642383,-17
carcassonne-uct115-vs-uct470-1000its,831,848,2188.3490215,2148.112338634,-17
carcassonne-uct345-vs-uct425-1000its,831,848,2160.337294706,2081.144889286,-17
carcassonne-boltzmann395-vs-boltzmann390-1000its,832,849,2208.854056689,2171.939436893,-17
carcassonne-uct450-vs-uct345-1000its,832,849,2169.477949725,2163.04276708,-17
carcassonne-ucttuned305-vs-ucttuned460-1000its,832,849,2190.212049898,2181.602465735,-17
carcassonne-ucttuned290-vs-ucttuned40-1000its,833,850,2238.586761162,2173.92028411,-17
carcassonne-boltzmann310-vs-boltzmann135-1000its,834,851,2196.214314901,2150.909109508,-17
carcassonne-uct430-vs-uct205-1000its,834,851,2182.599502001,2163.81706398,-17
carcassonne-uct340-vs-uct175-1000its,836,853,2205.153110934,2172.985451518,-17
carcassonne-boltzmann60-vs-boltzmann240-1000its,837,854,2256.514041437,2167.09984677,-17
carcassonne-uct130-vs-uct185-1000its,837,854,2178.780231803,2125.50250433,-17
carcassonne-uct65-vs-uct170-1000its,839,856,2135.024354312,2069.01804587,-17
carcassonne-boltzmann150-vs-boltzmann280-1000its,840,857,2157.531842473,2092.899745957,-17
carcassonne-uct295-vs-uct55-1000its,840,857,2250.559049993,2197.922007302,-17
carcassonne-uct410-vs-uct420-1000its,840,857,2189.715422232,2178.692113909,-17
carcassonne-boltzmann405-vs-boltzmann100-1000its,846,863,2148.953713008,2122.637576354,-17
carcassonne-ucttuned205-vs-ucttuned115-1000its,846,863,2158.63387821,2139.702386356,-17
carcassonne-ucttuned100-vs-ucttuned110-1000its,847,864,2256.414188572,2199.743167921,-17
carcassonne-ucttuned260-vs-ucttuned300-1000its,848,865,2217.571638292,2175.494975001,-17
carcassonne-boltzmann295-vs-boltzmann370-1000its,849,866,2127.339978233,2075.611477574,-17
carcassonne-uct320-vs-uct385-1000its,849,866,2228.152315081,2095.082862548,-17
carcassonne-boltzmann15-vs-boltzmann95-1000its,851,868,2232.558281209,2165.631777897,-17
carcassonne-ucttuned495-vs-ucttuned145-1000its,853,870,2146.989684965,2104.21360206,-17
carcassonne-boltzmann410-vs-boltzmann475-1000its,856,873,2191.056288721,2170.110019012,-17
carcassonne-ucttuned70-vs-ucttuned480-1000its,856,873,2181.037671533,2147.025442879,-17
carcassonne-uct360-vs-uct175-1000its,858,875,2196.661029966,2166.54881872,-17
carcassonne-ucttuned165-vs-ucttuned65-1000its,858,875,2179.574355689,2121.761063382,-17
carcassonne-uct390-vs-uct295-1000its,859,876,2190.248867876,2105.575858981,-17
carcassonne-ucttuned245-vs-ucttuned325-1000its,860,877,2118.272284547,2135.402836489,-17
carcassonne-boltzmann130-vs-boltzmann335-1000its,866,883,2212.065937227,2162.675909806,-17
carcassonne-ucttuned175-vs-ucttuned45-1000its,869,886,2154.076657589,2135.170436899,-17
carcassonne-uct385-vs-uct135-1000its,870,887,2147.89926133,2116.659028321,-17
carcassonne-uct435-vs-uct320-1000its,886,903,2160.353099881,2155.391265572,-17
carcassonne-boltzmann60-vs-boltzmann20-1000its,891,908,2157.357638345,2143.910679003,-17
carcassonne-ucttuned375-vs-ucttuned105-1000its,892,909,2147.806810382,2154.474811397,-17
carcassonne-ucttuned490-vs-ucttuned70-1000its,897,914,2210.307472272,2132.216522732,-17
carcassonne-boltzmann205-vs-boltzmann310-1000its,666,682,2146.192315008,2129.777195048,-16
carcassonne-ucttuned170-vs-ucttuned115-1000its,693,709,2161.62310046,2125.784335995,-16
carcassonne-boltzmann260-vs-boltzmann205-1000its,702,718,2130.69899975,2098.229422892,-16
carcassonne-boltzmann365-vs-boltzmann370-1000its,732,748,2245.458598978,2202.92704696,-16
carcassonne-boltzmann235-vs-boltzmann125-1000its,734,750,2219.989002114,2203.488949043,-16
carcassonne-boltzmann340-vs-boltzmann115-1000its,740,756,2193.782396826,2150.309087655,-16
carcassonne-boltzmann85-vs-boltzmann45-1000its,741,757,2220.786255608,2189.156183632,-16
carcassonne-uct105-vs-uct260-1000its,745,761,2167.656689675,2125.31728917,-16
carcassonne-ucttuned450-vs-ucttuned115-1000its,746,762,2214.083655682,2207.059544451,-16
carcassonne-boltzmann185-vs-boltzmann75-1000its,754,770,2130.142132576,2095.04058877,-16
carcassonne-uct240-vs-uct305-1000its,755,771,2221.941875477,2155.007684651,-16
carcassonne-boltzmann185-vs-boltzmann285-1000its,756,772,2177.891558264,2108.995472433,-16
carcassonne-boltzmann310-vs-boltzmann365-1000its,756,772,2195.387004244,2161.869977475,-16
carcassonne-boltzmann440-vs-boltzmann435-1000its,757,773,2158.42494936,2181.737856858,-16
carcassonne-boltzmann245-vs-boltzmann280-1000its,760,776,2197.530260645,2091.853138077,-16
carcassonne-boltzmann180-vs-boltzmann400-1000its,762,778,2172.496907912,2139.574133581,-16
carcassonne-boltzmann310-vs-boltzmann150-1000its,763,779,2209.260816346,2144.86972216,-16
carcassonne-boltzmann460-vs-boltzmann275-1000its,763,779,2177.648401598,2171.39969962,-16
carcassonne-uct70-vs-uct390-1000its,763,779,2124.853251774,2091.989083083,-16
carcassonne-boltzmann355-vs-boltzmann470-1000its,764,780,2157.420098873,2102.24522453,-16
carcassonne-boltzmann445-vs-boltzmann5-1000its,764,780,2196.308693919,2203.823016867,-16
carcassonne-uct390-vs-uct455-1000its,766,782,2223.516776545,2165.405646239,-16
carcassonne-uct315-vs-uct185-1000its,767,783,2155.121117994,2116.669052357,-16
carcassonne-uct405-vs-uct435-1000its,767,783,2133.566292969,2119.297553731,-16
carcassonne-boltzmann330-vs-boltzmann175-1000its,769,785,2204.036520374,2168.23326861,-16
carcassonne-boltzmann485-vs-boltzmann445-1000its,769,785,2186.429645777,2163.273908984,-16
carcassonne-boltzmann340-vs-boltzmann45-1000its,770,786,2207.089399487,2149.394529626,-16
carcassonne-ucttuned195-vs-ucttuned150-1000its,770,786,2144.711979577,2079.100055089,-16
carcassonne-boltzmann245-vs-boltzmann10-1000its,773,789,2154.903507021,2153.104631997,-16
carcassonne-ucttuned300-vs-ucttuned410-1000its,773,789,2166.937538754,2096.739471395,-16
carcassonne-boltzmann380-vs-boltzmann245-1000its,774,790,2168.374215706,2134.189682993,-16
carcassonne-ucttuned440-vs-ucttuned55-1000its,774,790,2185.343220602,2195.309110724,-16
carcassonne-ucttuned450-vs-ucttuned325-1000its,774,790,2172.016537836,2161.92820928,-16
carcassonne-uct435-vs-uct390-1000its,775,791,2212.699791056,2152.659158699,-16
carcassonne-ucttuned465-vs-ucttuned205-1000its,775,791,2230.586066403,2165.737284717,-16
carcassonne-boltzmann340-vs-boltzmann400-1000its,776,792,2229.590319572,2154.25782178,-16
carcassonne-uct250-vs-uct25-1000its,776,792,2210.744856374,2210.617458189,-16
carcassonne-ucttuned480-vs-ucttuned35-1000its,776,792,2252.945720867,2227.178990999,-16
carcassonne-uct245-vs-uct125-1000its,777,793,2228.415852781,2198.085610258,-16
carcassonne-uct455-vs-uct150-1000its,777,793,2134.738634371,2086.3961663,-16
carcassonne-ucttuned465-vs-ucttuned460-1000its,777,793,2200.960106737,2160.769684682,-16
carcassonne-ucttuned70-vs-ucttuned120-1000its,779,795,2246.731594736,2222.326584997,-16
carcassonne-uct180-vs-uct445-1000its,780,796,2155.711181791,2088.763279983,-16
carcassonne-ucttuned115-vs-ucttuned35-1000its,781,797,2112.844122186,2086.33703735,-16
carcassonne-boltzmann235-vs-boltzmann410-1000its,782,798,2209.774643519,2175.061411604,-16
carcassonne-uct215-vs-uct210-1000its,783,799,2201.165416778,2140.005980513,-16
carcassonne-uct225-vs-uct280-1000its,783,799,2162.752224216,2114.710266397,-16
carcassonne-ucttuned395-vs-ucttuned340-1000its,783,799,2213.951482575,2147.741286486,-16
carcassonne-uct215-vs-uct220-1000its,784,800,2202.682427342,2175.382156817,-16
carcassonne-boltzmann260-vs-boltzmann465-1000its,787,803,2203.753662921,2178.188084772,-16
carcassonne-boltzmann335-vs-boltzmann120-1000its,787,803,2186.579963391,2142.469161831,-16
carcassonne-boltzmann125-vs-boltzmann175-1000its,790,806,2257.297784985,2264.18988233,-16
carcassonne-boltzmann470-vs-boltzmann185-1000its,790,806,2155.862606406,2091.249896821,-16
carcassonne-uct250-vs-uct370-1000its,790,806,2240.745177529,2217.27020331,-16
carcassonne-ucttuned280-vs-ucttuned90-1000its,790,806,2210.933858203,2161.876920964,-16
carcassonne-ucttuned405-vs-ucttuned385-1000its,790,806,2248.928179474,2183.363772817,-16
carcassonne-ucttuned130-vs-ucttuned260-1000its,791,807,2155.572601268,2123.012433909,-16
carcassonne-ucttuned335-vs-ucttuned320-1000its,791,807,2192.003527558,2118.307189054,-16
carcassonne-ucttuned425-vs-ucttuned310-1000its,791,807,2187.055953166,2103.246440511,-16
carcassonne-ucttuned445-vs-ucttuned45-1000its,792,808,2140.58939618,2098.470417939,-16
carcassonne-ucttuned485-vs-ucttuned340-1000its,792,808,2179.804956887,2149.158799224,-16
carcassonne-boltzmann445-vs-boltzmann335-1000its,793,809,2195.696930905,2183.671290233,-16
carcassonne-uct365-vs-uct485-1000its,793,809,2349.582091834,2256.289946539,-16
carcassonne-uct395-vs-uct435-1000its,793,809,2212.410587483,2176.309161651,-16
carcassonne-ucttuned225-vs-ucttuned60-1000its,793,809,2212.350532222,2141.944896111,-16
carcassonne-uct295-vs-uct30-1000its,794,810,2223.02399201,2185.418245873,-16
carcassonne-boltzmann245-vs-boltzmann440-1000its,795,811,2202.262045467,2173.889409762,-16
carcassonne-ucttuned100-vs-ucttuned290-1000its,795,811,2223.053122457,2176.565760762,-16
carcassonne-ucttuned100-vs-ucttuned330-1000its,795,811,2188.198657336,2137.432423735,-16
carcassonne-boltzmann155-vs-boltzmann55-1000its,798,814,2210.738924715,2142.453463999,-16
carcassonne-boltzmann285-vs-boltzmann30-1000its,798,814,2182.108455272,2163.095440402,-16
carcassonne-ucttuned95-vs-ucttuned390-1000its,798,814,2205.116623404,2154.242175416,-16
carcassonne-ucttuned130-vs-ucttuned460-1000its,799,815,2230.91943012,2165.221556292,-16
carcassonne-uct375-vs-uct290-1000its,800,816,2163.618418447,2146.867614281,-16
carcassonne-boltzmann160-vs-boltzmann300-1000its,802,818,2130.622772702,2091.896481908,-16
carcassonne-boltzmann280-vs-boltzmann450-1000its,802,818,2111.955103534,2090.826731151,-16
carcassonne-boltzmann335-vs-boltzmann425-1000its,802,818,2256.471081875,2228.539061152,-16
carcassonne-ucttuned355-vs-ucttuned90-1000its,802,818,2217.455487595,2186.468270404,-16
carcassonne-uct130-vs-uct270-1000its,805,821,2228.962219971,2181.400608991,-16
carcassonne-boltzmann165-vs-boltzmann290-1000its,806,822,2205.949090891,2156.509984549,-16
carcassonne-boltzmann455-vs-boltzmann280-1000its,806,822,2174.266091487,2120.890482534,-16
carcassonne-uct460-vs-uct95-1000its,807,823,2216.482330679,2134.425064301,-16
carcassonne-boltzmann250-vs-boltzmann5-1000its,808,824,2222.405845825,2162.348402517,-16
carcassonne-ucttuned35-vs-ucttuned440-1000its,808,824,2174.584190416,2139.333655517,-16
carcassonne-ucttuned460-vs-ucttuned90-1000its,808,824,2223.70736204,2207.68138999,-16
carcassonne-uct400-vs-uct230-1000its,809,825,2137.407271576,2143.002767295,-16
carcassonne-uct70-vs-uct495-1000its,809,825,2103.660974974,2111.665266731,-16
carcassonne-uct200-vs-uct250-1000its,810,826,2183.764717938,2156.465937782,-16
carcassonne-ucttuned365-vs-ucttuned370-1000its,810,826,2178.498854601,2122.78562152,-16
carcassonne-uct420-vs-uct35-1000its,811,827,2117.014169634,2072.746029212,-16
carcassonne-uct365-vs-uct255-1000its,812,828,2232.099009929,2181.538994151,-16
carcassonne-boltzmann465-vs-boltzmann400-1000its,813,829,2185.125613578,2128.343571015,-16
carcassonne-uct20-vs-uct370-1000its,813,829,2232.650180564,2203.508447173,-16
carcassonne-uct355-vs-uct160-1000its,814,830,2225.724495535,2132.002060406,-16
carcassonne-boltzmann170-vs-boltzmann85-1000its,815,831,2158.167811294,2114.98053198,-16
carcassonne-uct15-vs-uct105-1000its,815,831,2247.432193391,2201.02349645,-16
carcassonne-boltzmann165-vs-boltzmann60-1000its,816,832,2198.471746659,2172.227407716,-16
carcassonne-uct105-vs-uct375-1000its,816,832,2172.686842071,2090.861692047,-16
carcassonne-uct275-vs-uct165-1000its,816,832,2171.169781551,2113.928027543,-16
carcassonne-uct455-vs-uct80-1000its,816,832,2201.92909246,2164.431608953,-16
carcassonne-uct70-vs-uct415-1000its,816,832,2198.839561078,2107.230930331,-16
carcassonne-boltzmann45-vs-boltzmann400-1000its,817,833,2138.907653426,2120.992292161,-16
carcassonne-ucttuned110-vs-ucttuned470-1000its,817,833,2224.742417278,2157.759889489,-16
carcassonne-boltzmann125-vs-boltzmann30-1000its,819,835,2130.889161153,2067.712602881,-16
carcassonne-boltzmann260-vs-boltzmann270-1000its,819,835,2186.635097476,2137.37919073,-16
carcassonne-boltzmann65-vs-boltzmann155-1000its,819,835,2221.431937108,2142.289701049,-16
carcassonne-uct130-vs-uct210-1000its,820,836,2251.489807761,2173.751560388,-16
carcassonne-boltzmann330-vs-boltzmann120-1000its,821,837,2252.838618286,2204.835326887,-16
carcassonne-ucttuned125-vs-ucttuned165-1000its,821,837,2096.726770589,2077.778166141,-16
carcassonne-ucttuned15-vs-ucttuned150-1000its,821,837,2168.322945629,2103.777541261,-16
carcassonne-ucttuned450-vs-ucttuned365-1000its,821,837,2190.181276273,2180.118813449,-16
carcassonne-boltzmann325-vs-boltzmann200-1000its,825,841,2213.369715264,2170.394595168,-16
carcassonne-uct200-vs-uct20-1000its,826,842,2190.553208171,2138.057077879,-16
carcassonne-boltzmann245-vs-boltzmann35-1000its,827,843,2208.055562938,2167.160445764,-16
carcassonne-uct205-vs-uct225-1000its,827,843,2226.868249725,2196.010932022,-16
carcassonne-ucttuned175-vs-ucttuned160-1000its,829,845,2213.720792931,2158.19257281,-16
carcassonne-uct310-vs-uct430-1000its,830,846,2273.736033236,2214.019882756,-16
carcassonne-ucttuned145-vs-ucttuned260-1000its,831,847,2253.823899218,2189.425798907,-16
carcassonne-ucttuned335-vs-ucttuned450-1000its,833,849,2277.33017746,2247.694491692,-16
carcassonne-boltzmann95-vs-boltzmann330-1000its,834,850,2165.771353305,2156.740093571,-16
carcassonne-ucttuned400-vs-ucttuned450-1000its,834,850,2216.617206024,2167.402216684,-16
carcassonne-ucttuned325-vs-ucttuned300-1000its,835,851,2160.585656454,2117.445099031,-16
carcassonne-boltzmann310-vs-boltzmann335-1000its,837,853,2251.430418472,2216.715029514,-16
carcassonne-boltzmann470-vs-boltzmann420-1000its,837,853,2238.216571636,2210.769119427,-16
carcassonne-boltzmann385-vs-boltzmann175-1000its,838,854,2214.586792445,2141.99215108,-16
carcassonne-boltzmann480-vs-boltzmann200-1000its,838,854,2222.471163617,2139.232440874,-16
carcassonne-uct120-vs-uct55-1000its,839,855,2211.571057598,2145.624842191,-16
carcassonne-uct235-vs-uct380-1000its,840,856,2209.059514179,2189.26520699,-16
carcassonne-uct90-vs-uct170-1000its,840,856,2214.156395014,2156.756478192,-16
carcassonne-uct100-vs-uct280-1000its,842,858,2160.23575778,2124.479066871,-16
carcassonne-uct75-vs-uct345-1000its,845,861,2131.054573218,2100.14783835,-16
carcassonne-uct420-vs-uct335-1000its,847,863,2259.460630689,2214.45401046,-16
carcassonne-boltzmann220-vs-boltzmann265-1000its,851,867,2234.521077048,2188.860298594,-16
carcassonne-ucttuned150-vs-ucttuned190-1000its,856,872,2219.674079955,2167.422219094,-16
carcassonne-ucttuned120-vs-ucttuned10-1000its,858,874,2150.1623492,2118.214754688,-16
carcassonne-uct225-vs-uct5-1000its,859,875,2220.558283044,2167.147794785,-16
carcassonne-ucttuned170-vs-ucttuned320-1000its,859,875,2241.307112144,2193.613109714,-16
carcassonne-uct5-vs-uct110-1000its,861,877,2201.122914003,2135.754041929,-16
carcassonne-uct420-vs-uct350-1000its,862,878,2250.198848072,2218.676917593,-16
carcassonne-ucttuned445-vs-ucttuned85-1000its,864,880,2263.131217536,2185.015705339,-16
carcassonne-ucttuned330-vs-ucttuned275-1000its,867,883,2168.178181314,2088.424023431,-16
carcassonne-uct15-vs-uct10-1000its,868,884,2169.911815365,2086.307793094,-16
carcassonne-ucttuned485-vs-ucttuned450-1000its,868,884,2190.452045712,2187.35957111,-16
carcassonne-ucttuned350-vs-ucttuned20-1000its,869,885,2160.501778516,2099.106976116,-16
carcassonne-boltzmann155-vs-boltzmann5-1000its,875,891,2150.808421967,2111.597120335,-16
carcassonne-ucttuned390-vs-ucttuned10-1000its,878,894,2213.881141039,2128.614319255,-16
carcassonne-ucttuned280-vs-ucttuned45-1000its,881,897,2174.771919402,2144.462566376,-16
carcassonne-uct385-vs-uct35-1000its,910,926,2228.373262568,2186.949448512,-16
carcassonne-ucttuned355-vs-ucttuned205-1000its,924,940,2242.316505418,2207.53041572,-16
carcassonne-ucttuned165-vs-ucttuned440-1000its,557,572,1806.085533282,1736.706508144,-15
carcassonne-uct225-vs-uct470-1000its,615,630,1838.130647419,1778.358803354,-15
carcassonne-boltzmann390-vs-boltzmann260-1000its,633,648,1721.558960939,1706.987557281,-15
carcassonne-boltzmann490-vs-boltzmann30-1000its,689,704,2212.86833521,2187.073418279,-15
carcassonne-boltzmann320-vs-boltzmann400-1000its,691,706,2199.629309958,2176.347021405,-15
carcassonne-boltzmann90-vs-boltzmann485-1000its,712,727,2290.976054986,2216.6022278,-15
carcassonne-uct485-vs-uct370-1000its,717,732,2228.692414838,2177.491959131,-15
carcassonne-uct265-vs-uct425-1000its,719,734,2152.064617787,2133.576212497,-15
carcassonne-uct490-vs-uct350-1000its,721,736,2147.476680373,2119.582310117,-15
carcassonne-ucttuned180-vs-ucttuned435-1000its,724,739,2192.970464139,2094.120167491,-15
carcassonne-boltzmann425-vs-boltzmann240-1000its,726,741,2169.855171713,2153.718270499,-15
carcassonne-uct405-vs-uct245-1000its,727,742,2229.886736541,2142.434562679,-15
carcassonne-ucttuned465-vs-ucttuned385-1000its,736,751,2209.446213773,2142.692597379,-15
carcassonne-uct220-vs-uct150-1000its,738,753,2199.43537501,2160.648335139,-15
carcassonne-ucttuned165-vs-ucttuned80-1000its,738,753,2211.364851178,2187.466776989,-15
carcassonne-boltzmann445-vs-boltzmann480-1000its,739,754,2139.840753184,2059.898436375,-15
carcassonne-boltzmann320-vs-boltzmann5-1000its,743,758,2230.415056364,2204.323912245,-15
carcassonne-ucttuned265-vs-ucttuned150-1000its,743,758,2209.021913883,2153.934004701,-15
carcassonne-boltzmann455-vs-boltzmann55-1000its,745,760,2232.905432465,2188.412338133,-15
carcassonne-uct290-vs-uct75-1000its,746,761,2157.682751103,2139.234955188,-15
carcassonne-ucttuned140-vs-ucttuned125-1000its,747,762,2232.257667249,2180.526801175,-15
carcassonne-boltzmann325-vs-boltzmann460-1000its,748,763,2196.917018779,2180.503164793,-15
carcassonne-ucttuned345-vs-ucttuned485-1000its,748,763,2162.64125024,2149.146472202,-15
carcassonne-boltzmann490-vs-boltzmann400-1000its,750,765,2174.843014695,2121.817253648,-15
carcassonne-boltzmann295-vs-boltzmann265-1000its,755,770,2228.701867841,2160.715626341,-15
carcassonne-uct50-vs-uct265-1000its,757,772,2109.739212882,2090.312513801,-15
carcassonne-uct490-vs-uct55-1000its,761,776,2133.645137517,2106.38170332,-15
carcassonne-ucttuned115-vs-ucttuned135-1000its,762,777,2178.763159647,2112.955729322,-15
carcassonne-uct475-vs-uct350-1000its,766,781,2173.288647976,2099.427031386,-15
carcassonne-ucttuned385-vs-ucttuned355-1000its,768,783,2193.902516219,2144.627653168,-15
carcassonne-ucttuned470-vs-ucttuned415-1000its,768,783,2149.175105484,2151.961638605,-15
carcassonne-boltzmann360-vs-boltzmann60-1000its,769,784,2200.360355548,2171.894982805,-15
carcassonne-boltzmann460-vs-boltzmann365-1000its,769,784,2139.153722327,2121.300471106,-15
carcassonne-uct100-vs-uct200-1000its,769,784,2176.496276517,2158.092195837,-15
carcassonne-uct220-vs-uct90-1000its,769,784,2189.735788979,2101.450946151,-15
carcassonne-boltzmann280-vs-boltzmann20-1000its,771,786,2179.902630339,2124.942116662,-15
carcassonne-boltzmann495-vs-boltzmann250-1000its,772,787,2170.334004591,2102.927210376,-15
carcassonne-ucttuned120-vs-ucttuned105-1000its,774,789,2151.397792436,2137.689572259,-15
carcassonne-ucttuned355-vs-ucttuned180-1000its,775,790,2196.056073698,2115.136335262,-15
carcassonne-uct335-vs-uct135-1000its,777,792,2141.017902805,2094.970101652,-15
carcassonne-ucttuned305-vs-ucttuned330-1000its,777,792,2244.269222949,2196.38495138,-15
carcassonne-ucttuned400-vs-ucttuned85-1000its,777,792,2198.103058315,2156.652881595,-15
carcassonne-boltzmann330-vs-boltzmann225-1000its,779,794,2228.786832231,2225.086198149,-15
carcassonne-uct255-vs-uct425-1000its,779,794,2182.758494316,2139.655842634,-15
carcassonne-ucttuned355-vs-ucttuned140-1000its,780,795,2158.152161245,2108.779580981,-15
carcassonne-boltzmann385-vs-boltzmann160-1000its,781,796,2232.384179917,2206.261593944,-15
carcassonne-uct5-vs-uct425-1000its,781,796,2217.350352787,2155.694738814,-15
carcassonne-ucttuned310-vs-ucttuned375-1000its,781,796,2235.813670722,2199.708523428,-15
carcassonne-uct250-vs-uct55-1000its,782,797,2270.543272872,2204.391976717,-15
carcassonne-boltzmann250-vs-boltzmann435-1000its,783,798,2164.333143713,2135.679190493,-15
carcassonne-ucttuned65-vs-ucttuned435-1000its,783,798,2170.911736793,2093.414256812,-15
carcassonne-boltzmann480-vs-boltzmann365-1000its,784,799,2120.132967452,2149.707947069,-15
carcassonne-uct105-vs-uct120-1000its,784,799,2219.126312907,2164.877202655,-15
carcassonne-uct355-vs-uct410-1000its,784,799,2216.965815783,2182.625300123,-15
carcassonne-ucttuned190-vs-ucttuned160-1000its,785,800,2134.442183478,2095.690895119,-15
carcassonne-boltzmann370-vs-boltzmann165-1000its,786,801,2258.509431553,2252.321544857,-15
carcassonne-ucttuned105-vs-ucttuned285-1000its,787,802,2237.664888571,2197.94988519,-15
carcassonne-ucttuned340-vs-ucttuned75-1000its,787,802,2174.296799569,2155.609098438,-15
carcassonne-ucttuned410-vs-ucttuned220-1000its,787,802,2173.819356281,2127.19092359,-15
carcassonne-ucttuned425-vs-ucttuned250-1000its,787,802,2175.405885205,2170.468103801,-15
carcassonne-uct240-vs-uct445-1000its,788,803,2204.919897557,2192.137033405,-15
carcassonne-uct460-vs-uct45-1000its,788,803,2275.59137985,2235.557597035,-15
carcassonne-boltzmann400-vs-boltzmann375-1000its,789,804,2180.315400611,2130.188296354,-15
carcassonne-ucttuned200-vs-ucttuned315-1000its,789,804,2159.659326207,2115.458994707,-15
carcassonne-ucttuned210-vs-ucttuned450-1000its,789,804,2243.460668709,2140.327520825,-15
carcassonne-ucttuned405-vs-ucttuned310-1000its,789,804,2213.350856794,2166.760314239,-15
carcassonne-boltzmann120-vs-boltzmann450-1000its,790,805,2214.550593932,2172.299022872,-15
carcassonne-boltzmann250-vs-boltzmann105-1000its,790,805,2177.111002618,2158.594180082,-15
carcassonne-uct300-vs-uct130-1000its,790,805,2201.647659275,2167.390075171,-15
carcassonne-boltzmann270-vs-boltzmann455-1000its,791,806,2200.546173898,2148.040918676,-15
carcassonne-uct145-vs-uct480-1000its,791,806,2248.469002336,2154.81706934,-15
carcassonne-uct150-vs-uct165-1000its,791,806,2179.619224731,2126.590931532,-15
carcassonne-ucttuned70-vs-ucttuned40-1000its,791,806,2173.692584174,2127.623095078,-15
carcassonne-uct240-vs-uct265-1000its,792,807,2134.15966376,2142.660650695,-15
carcassonne-boltzmann210-vs-boltzmann130-1000its,793,808,2147.810784798,2124.118222262,-15
carcassonne-ucttuned455-vs-ucttuned435-1000its,793,808,2187.700076937,2135.017733529,-15
carcassonne-uct440-vs-uct195-1000its,794,809,2163.771167449,2122.833666593,-15
carcassonne-ucttuned275-vs-ucttuned100-1000its,794,809,2141.982618383,2121.651366322,-15
carcassonne-ucttuned440-vs-ucttuned300-1000its,794,809,2186.332371192,2174.555507892,-15
carcassonne-ucttuned300-vs-ucttuned105-1000its,795,810,2142.767682087,2067.613401259,-15
carcassonne-boltzmann45-vs-boltzmann10-1000its,796,811,2226.385517104,2162.02969139,-15
carcassonne-ucttuned340-vs-ucttuned80-1000its,797,812,2170.539699156,2134.464288896,-15
carcassonne-boltzmann330-vs-boltzmann460-1000its,798,813,2201.135401544,2134.580004767,-15
carcassonne-uct120-vs-uct135-1000its,798,813,2196.794473961,2147.608530095,-15
carcassonne-uct225-vs-uct435-1000its,798,813,2166.608637743,2113.9682619,-15
carcassonne-uct415-vs-uct365-1000its,798,813,2171.167279629,2071.581530648,-15
carcassonne-ucttuned65-vs-ucttuned465-1000its,799,814,2211.527082965,2212.395858484,-15
carcassonne-uct430-vs-uct255-1000its,800,815,2220.556877522,2156.918401076,-15
carcassonne-boltzmann55-vs-boltzmann330-1000its,801,816,2175.47253981,2149.767538676,-15
carcassonne-uct165-vs-uct235-1000its,801,816,2207.667539338,2168.746249289,-15
carcassonne-boltzmann145-vs-boltzmann90-1000its,802,817,2220.7242227,2127.608114658,-15
carcassonne-ucttuned190-vs-ucttuned245-1000its,802,817,2130.824380622,2139.201000497,-15
carcassonne-boltzmann295-vs-boltzmann35-1000its,806,821,2215.169952205,2195.58740404,-15
carcassonne-boltzmann475-vs-boltzmann265-1000its,806,821,2248.689440759,2179.708683531,-15
carcassonne-ucttuned230-vs-ucttuned160-1000its,810,825,2222.218768667,2180.013169149,-15
carcassonne-boltzmann120-vs-boltzmann480-1000its,811,826,2165.821131402,2139.196455414,-15
carcassonne-ucttuned445-vs-ucttuned290-1000its,811,826,2180.987704694,2139.507387461,-15
carcassonne-ucttuned475-vs-ucttuned125-1000its,811,826,2194.889927152,2138.077733374,-15
carcassonne-uct70-vs-uct430-1000its,812,827,2206.993476192,2116.0013104,-15
carcassonne-boltzmann475-vs-boltzmann10-1000its,813,828,2145.880699499,2110.883893087,-15
carcassonne-uct225-vs-uct50-1000its,813,828,2147.636573782,2151.847343443,-15
carcassonne-uct445-vs-uct210-1000its,813,828,2182.093223786,2137.083599888,-15
carcassonne-ucttuned365-vs-ucttuned445-1000its,813,828,2165.777643532,2139.210806543,-15
carcassonne-uct285-vs-uct10-1000its,814,829,2167.56790386,2164.908222241,-15
carcassonne-uct400-vs-uct485-1000its,814,829,2158.657530206,2118.368394234,-15
carcassonne-uct470-vs-uct440-1000its,814,829,2233.27733164,2199.269035658,-15
carcassonne-ucttuned140-vs-ucttuned240-1000its,814,829,2164.395944903,2133.254287745,-15
carcassonne-ucttuned30-vs-ucttuned35-1000its,814,829,2267.434567221,2223.246824953,-15
carcassonne-uct465-vs-uct385-1000its,815,830,2242.991412992,2229.59759586,-15
carcassonne-boltzmann270-vs-boltzmann395-1000its,816,831,2162.496410042,2132.38082542,-15
carcassonne-uct425-vs-uct355-1000its,816,831,2214.187886684,2134.388341682,-15
carcassonne-ucttuned290-vs-ucttuned60-1000its,816,831,2167.381645894,2105.987404191,-15
carcassonne-boltzmann465-vs-boltzmann210-1000its,817,832,2141.270005566,2118.127957903,-15
carcassonne-boltzmann300-vs-boltzmann110-1000its,819,834,2103.26380574,2110.70140856,-15
carcassonne-uct100-vs-uct40-1000its,821,836,2138.196616454,2127.2808247,-15
carcassonne-ucttuned10-vs-ucttuned110-1000its,821,836,2205.427960885,2152.061015183,-15
carcassonne-ucttuned295-vs-ucttuned275-1000its,822,837,2209.048138821,2161.225641349,-15
carcassonne-boltzmann205-vs-boltzmann290-1000its,825,840,2174.983104921,2174.674965076,-15
carcassonne-boltzmann200-vs-boltzmann320-1000its,826,841,2200.482912705,2199.402277611,-15
carcassonne-uct315-vs-uct115-1000its,826,841,2186.819356535,2140.767804344,-15
carcassonne-uct45-vs-uct440-1000its,826,841,2194.358382124,2146.758226417,-15
carcassonne-ucttuned70-vs-ucttuned470-1000its,828,843,2205.00274868,2114.806778738,-15
carcassonne-ucttuned375-vs-ucttuned280-1000its,831,846,2181.165897349,2138.909394403,-15
carcassonne-boltzmann140-vs-boltzmann405-1000its,833,848,2179.641463814,2097.637930946,-15
carcassonne-uct340-vs-uct90-1000its,834,849,2245.775133847,2228.578977609,-15
carcassonne-uct180-vs-uct300-1000its,835,850,2204.430371229,2179.063181511,-15
carcassonne-ucttuned145-vs-ucttuned475-1000its,840,855,2282.51977235,2230.912063399,-15
carcassonne-uct250-vs-uct285-1000its,843,858,2186.367686471,2190.320129209,-15
carcassonne-uct20-vs-uct165-1000its,844,859,2187.291980296,2142.953079474,-15
carcassonne-ucttuned65-vs-ucttuned230-1000its,845,860,2207.776362876,2199.601172259,-15
carcassonne-uct15-vs-uct335-1000its,846,861,2174.643546758,2156.263451089,-15
carcassonne-ucttuned35-vs-ucttuned25-1000its,846,861,2231.324730844,2164.556092458,-15
carcassonne-ucttuned350-vs-ucttuned270-1000its,847,862,2163.954424267,2149.140536041,-15
carcassonne-ucttuned400-vs-ucttuned215-1000its,848,863,2228.725465579,2198.910989449,-15
carcassonne-ucttuned50-vs-ucttuned135-1000its,848,863,2166.008574095,2137.734868306,-15
carcassonne-boltzmann400-vs-boltzmann75-1000its,851,866,2253.362629198,2213.523759642,-15
carcassonne-ucttuned425-vs-ucttuned440-1000its,852,867,2189.749854046,2191.254668404,-15
carcassonne-uct290-vs-uct5-1000its,854,869,2225.330894609,2202.36595064,-15
carcassonne-uct295-vs-uct220-1000its,854,869,2232.211277047,2170.783208089,-15
carcassonne-uct370-vs-uct240-1000its,855,870,2202.375357221,2196.915490843,-15
carcassonne-uct450-vs-uct255-1000its,855,870,2151.016974672,2080.550126543,-15
carcassonne-boltzmann260-vs-boltzmann90-1000its,856,871,2189.033687134,2152.336158184,-15
carcassonne-boltzmann115-vs-boltzmann435-1000its,862,877,2210.151259572,2169.25244158,-15
carcassonne-ucttuned35-vs-ucttuned390-1000its,863,878,2323.98882984,2260.022406127,-15
carcassonne-ucttuned250-vs-ucttuned255-1000its,867,882,2203.43456181,2161.862085632,-15
carcassonne-boltzmann105-vs-boltzmann45-1000its,868,883,2179.934908921,2111.438477934,-15
carcassonne-uct265-vs-uct205-1000its,869,884,2198.659196436,2151.856422867,-15
carcassonne-uct310-vs-uct115-1000its,872,887,2258.051554063,2196.212876531,-15
carcassonne-ucttuned220-vs-ucttuned255-1000its,872,887,2214.143652928,2175.150901196,-15
carcassonne-ucttuned315-vs-ucttuned40-1000its,882,897,2146.121239024,2085.598865849,-15
carcassonne-ucttuned30-vs-ucttuned215-1000its,907,922,2138.47255729,2097.481881968,-15
carcassonne-ucttuned50-vs-ucttuned440-1000its,916,931,2231.1086924,2181.578767761,-15
carcassonne-uct110-vs-uct155-1000its,934,949,2205.635967297,2153.718873641,-15
carcassonne-boltzmann455-vs-boltzmann190-1000its,688,702,1838.625949978,1803.596998983,-14
carcassonne-boltzmann55-vs-boltzmann255-1000its,696,710,2197.348866397,2149.182707841,-14
carcassonne-ucttuned375-vs-ucttuned300-1000its,712,726,2208.26265292,2192.764876431,-14
carcassonne-uct305-vs-uct325-1000its,721,735,2146.26386268,2070.786277331,-14
carcassonne-boltzmann410-vs-boltzmann430-1000its,725,739,2146.074589861,2131.050925628,-14
carcassonne-ucttuned400-vs-ucttuned495-1000its,725,739,2150.063194415,2135.423920633,-14
carcassonne-boltzmann95-vs-boltzmann495-1000its,729,743,2182.043061182,2138.040822734,-14
carcassonne-uct330-vs-uct140-1000its,732,746,2226.203191821,2156.111949678,-14
carcassonne-boltzmann310-vs-boltzmann40-1000its,733,747,2144.877187846,2107.89361893,-14
carcassonne-boltzmann110-vs-boltzmann85-1000its,734,748,2264.729052999,2238.885284638,-14
carcassonne-boltzmann185-vs-boltzmann380-1000its,734,748,2272.853997827,2264.113439071,-14
carcassonne-ucttuned275-vs-ucttuned15-1000its,736,750,2160.869169497,2108.80958789,-14
carcassonne-ucttuned335-vs-ucttuned75-1000its,736,750,2192.725879217,2134.645922421,-14
carcassonne-boltzmann190-vs-boltzmann290-1000its,737,751,2179.995300959,2067.393124254,-14
carcassonne-uct455-vs-uct350-1000its,741,755,2174.032777566,2115.891994917,-14
carcassonne-ucttuned260-vs-ucttuned175-1000its,747,761,2192.760340628,2182.159129817,-14
carcassonne-boltzmann225-vs-boltzmann395-1000its,748,762,2198.518869435,2124.215054645,-14
carcassonne-boltzmann125-vs-boltzmann150-1000its,751,765,2209.500553609,2181.049365778,-14
carcassonne-uct295-vs-uct375-1000its,751,765,2266.381273543,2199.66089307,-14
carcassonne-boltzmann65-vs-boltzmann195-1000its,753,767,2201.440931123,2192.60146211,-14
carcassonne-boltzmann215-vs-boltzmann475-1000its,755,769,2206.120243879,2171.2842924,-14
carcassonne-boltzmann235-vs-boltzmann435-1000its,756,770,2148.153253278,2137.334071326,-14
carcassonne-ucttuned65-vs-ucttuned220-1000its,756,770,2150.691104773,2108.888263736,-14
carcassonne-boltzmann105-vs-boltzmann60-1000its,757,771,2133.338175354,2136.293497877,-14
carcassonne-uct85-vs-uct60-1000its,757,771,2216.989639957,2131.841107479,-14
carcassonne-uct445-vs-uct495-1000its,758,772,2212.145315503,2192.433520047,-14
carcassonne-uct460-vs-uct70-1000its,761,775,2178.214448268,2104.190276093,-14
carcassonne-ucttuned55-vs-ucttuned30-1000its,761,775,2175.989149966,2156.964385811,-14
carcassonne-uct205-vs-uct410-1000its,762,776,2200.202962588,2175.387151079,-14
carcassonne-ucttuned370-vs-ucttuned185-1000its,762,776,2180.875291477,2137.804660408,-14
carcassonne-ucttuned30-vs-ucttuned460-1000its,763,777,2157.87289538,2082.534055101,-14
carcassonne-boltzmann65-vs-boltzmann60-1000its,764,778,2199.388740687,2162.912009877,-14
carcassonne-ucttuned55-vs-ucttuned450-1000its,764,778,2214.651064086,2159.490448352,-14
carcassonne-uct50-vs-uct110-1000its,765,779,2210.540878732,2133.140981254,-14
carcassonne-boltzmann60-vs-boltzmann425-1000its,766,780,2186.490718761,2129.755973812,-14
carcassonne-boltzmann195-vs-boltzmann340-1000its,767,781,2318.372713811,2232.562142506,-14
carcassonne-boltzmann295-vs-boltzmann420-1000its,767,781,2183.766068017,2106.799391604,-14
carcassonne-uct305-vs-uct430-1000its,767,781,2248.888032151,2224.085650892,-14
carcassonne-ucttuned245-vs-ucttuned275-1000its,767,781,2184.071060451,2110.673467647,-14
carcassonne-boltzmann485-vs-boltzmann345-1000its,770,784,2224.985427684,2171.70168896,-14
carcassonne-uct355-vs-uct400-1000its,771,785,2206.226341471,2148.071586383,-14
carcassonne-ucttuned145-vs-ucttuned435-1000its,771,785,2257.975211554,2220.404034836,-14
carcassonne-ucttuned160-vs-ucttuned155-1000its,772,786,2317.39466854,2249.69772833,-14
carcassonne-boltzmann460-vs-boltzmann410-1000its,773,787,2180.265000112,2190.730925632,-14
carcassonne-ucttuned250-vs-ucttuned270-1000its,773,787,2185.353967755,2165.30789816,-14
carcassonne-uct215-vs-uct420-1000its,774,788,2221.11710094,2171.181562335,-14
carcassonne-uct25-vs-uct85-1000its,775,789,2164.459047645,2109.81423494,-14
carcassonne-boltzmann270-vs-boltzmann250-1000its,776,790,2164.931998567,2142.606887625,-14
carcassonne-boltzmann415-vs-boltzmann145-1000its,776,790,2275.356589481,2238.515159376,-14
carcassonne-ucttuned100-vs-ucttuned70-1000its,776,790,2144.325659831,2121.625405134,-14
carcassonne-uct125-vs-uct160-1000its,777,791,2155.019445543,2065.900420317,-14
carcassonne-uct160-vs-uct340-1000its,777,791,2217.167126208,2123.974054579,-14
carcassonne-ucttuned220-vs-ucttuned300-1000its,777,791,2208.650182945,2110.909750236,-14
carcassonne-ucttuned325-vs-ucttuned185-1000its,777,791,2200.383025814,2186.490227613,-14
carcassonne-boltzmann15-vs-boltzmann80-1000its,778,792,2129.882115292,2090.106535571,-14
carcassonne-boltzmann460-vs-boltzmann200-1000its,779,793,2160.847299914,2116.180183512,-14
carcassonne-uct215-vs-uct195-1000its,779,793,2176.897804093,2119.173461865,-14
carcassonne-boltzmann95-vs-boltzmann410-1000its,780,794,2122.024359687,2059.008527634,-14
carcassonne-uct140-vs-uct420-1000its,780,794,2178.292470409,2131.853729915,-14
carcassonne-uct110-vs-uct470-1000its,781,795,2120.596327337,2084.709214771,-14
carcassonne-ucttuned340-vs-ucttuned410-1000its,781,795,2209.690187456,2172.122122839,-14
carcassonne-boltzmann440-vs-boltzmann345-1000its,782,796,2169.340916096,2187.12334886,-14
carcassonne-ucttuned25-vs-ucttuned220-1000its,782,796,2202.589066793,2163.20433132,-14
carcassonne-boltzmann50-vs-boltzmann305-1000its,783,797,2230.494135883,2126.872289328,-14
carcassonne-uct70-vs-uct215-1000its,783,797,2199.196069215,2129.249732856,-14
carcassonne-ucttuned390-vs-ucttuned340-1000its,783,797,2128.15858748,2103.298073334,-14
carcassonne-ucttuned480-vs-ucttuned205-1000its,783,797,2162.252711483,2120.844012767,-14
carcassonne-uct235-vs-uct255-1000its,784,798,2193.827555847,2151.827851383,-14
carcassonne-uct380-vs-uct80-1000its,784,798,2195.626958212,2165.798132924,-14
carcassonne-boltzmann270-vs-boltzmann45-1000its,785,799,2128.564472829,2100.873151161,-14
carcassonne-uct275-vs-uct255-1000its,785,799,2226.013034858,2157.318100305,-14
carcassonne-uct455-vs-uct165-1000its,785,799,2175.422204377,2135.078454272,-14
carcassonne-boltzmann455-vs-boltzmann165-1000its,786,800,2109.596554774,2072.83774316,-14
carcassonne-boltzmann290-vs-boltzmann270-1000its,788,802,2172.477009477,2119.945175786,-14
carcassonne-boltzmann85-vs-boltzmann320-1000its,789,803,2190.335735923,2131.259968388,-14
carcassonne-ucttuned95-vs-ucttuned20-1000its,790,804,2194.233059785,2154.625060689,-14
carcassonne-ucttuned140-vs-ucttuned160-1000its,791,805,2179.354571265,2083.696895576,-14
carcassonne-ucttuned225-vs-ucttuned100-1000its,791,805,2235.85219796,2210.397824082,-14
carcassonne-boltzmann295-vs-boltzmann90-1000its,792,806,2179.662496096,2111.908286895,-14
carcassonne-uct385-vs-uct80-1000its,793,807,2162.273346155,2133.326198348,-14
carcassonne-ucttuned415-vs-ucttuned300-1000its,793,807,2207.238791484,2161.490208245,-14
carcassonne-boltzmann480-vs-boltzmann5-1000its,794,808,2115.951588991,2115.855611441,-14
carcassonne-uct100-vs-uct165-1000its,795,809,2169.969970251,2152.3538961,-14
carcassonne-ucttuned275-vs-ucttuned35-1000its,796,810,2164.256272245,2130.077442729,-14
carcassonne-uct255-vs-uct125-1000its,797,811,2213.990929559,2157.765381628,-14
carcassonne-boltzmann320-vs-boltzmann260-1000its,801,815,2241.696287707,2260.776692192,-14
carcassonne-uct455-vs-uct385-1000its,801,815,2202.377300616,2176.848300337,-14
carcassonne-ucttuned65-vs-ucttuned240-1000its,801,815,2264.941436632,2222.167318704,-14
carcassonne-uct415-vs-uct55-1000its,802,816,2166.340653227,2110.209196541,-14
carcassonne-ucttuned460-vs-ucttuned375-1000its,802,816,2320.748811212,2259.816434387,-14
carcassonne-boltzmann410-vs-boltzmann465-1000its,804,818,2204.610253252,2210.988727666,-14
carcassonne-uct155-vs-uct185-1000its,804,818,2193.113158769,2144.207842028,-14
carcassonne-uct440-vs-uct35-1000its,804,818,2196.389422407,2198.133923147,-14
carcassonne-boltzmann315-vs-boltzmann330-1000its,805,819,2252.48199992,2221.200372857,-14
carcassonne-uct40-vs-uct295-1000its,805,819,2171.842142303,2072.621168731,-14
carcassonne-boltzmann485-vs-boltzmann10-1000its,807,821,2132.393501612,2094.117940565,-14
carcassonne-ucttuned200-vs-ucttuned250-1000its,807,821,2196.69521569,2177.426803843,-14
carcassonne-boltzmann325-vs-boltzmann60-1000its,809,823,2279.102884158,2248.845806763,-14
carcassonne-boltzmann455-vs-boltzmann340-1000its,809,823,2240.902455309,2163.308030323,-14
carcassonne-uct10-vs-uct495-1000its,809,823,2108.445554096,2046.340218713,-14
carcassonne-ucttuned25-vs-ucttuned390-1000its,809,823,2205.091157446,2168.891089806,-14
carcassonne-ucttuned225-vs-ucttuned215-1000its,810,824,2216.508339704,2181.649226419,-14
carcassonne-uct410-vs-uct225-1000its,811,825,2197.130740963,2146.758127991,-14
carcassonne-uct55-vs-uct405-1000its,812,826,2219.966798421,2170.023075276,-14
carcassonne-boltzmann385-vs-boltzmann375-1000its,814,828,2179.255750335,2136.391541355,-14
carcassonne-ucttuned395-vs-ucttuned370-1000its,814,828,2147.266520626,2122.103737581,-14
carcassonne-uct225-vs-uct300-1000its,815,829,2197.395316225,2155.754724267,-14
carcassonne-uct365-vs-uct165-1000its,815,829,2192.227327147,2118.741452876,-14
carcassonne-boltzmann470-vs-boltzmann15-1000its,817,831,2136.254603601,2140.002742558,-14
carcassonne-ucttuned80-vs-ucttuned175-1000its,818,832,2169.570670871,2122.758646321,-14
carcassonne-ucttuned265-vs-ucttuned420-1000its,819,833,2250.739004496,2175.346138859,-14
carcassonne-boltzmann265-vs-boltzmann155-1000its,820,834,2186.24867625,2124.91656015,-14
carcassonne-ucttuned65-vs-ucttuned165-1000its,820,834,2203.504669636,2187.904086476,-14
carcassonne-ucttuned75-vs-ucttuned395-1000its,820,834,2214.594868465,2177.820137325,-14
carcassonne-boltzmann385-vs-boltzmann65-1000its,821,835,2238.773027002,2195.374391817,-14
carcassonne-uct250-vs-uct450-1000its,821,835,2198.210043852,2142.248318513,-14
carcassonne-ucttuned340-vs-ucttuned415-1000its,821,835,2219.987158933,2131.011439565,-14
carcassonne-uct20-vs-uct155-1000its,822,836,2214.717788635,2149.992462497,-14
carcassonne-uct310-vs-uct370-1000its,824,838,2187.596130164,2175.45049975,-14
carcassonne-boltzmann115-vs-boltzmann335-1000its,825,839,2301.453676812,2231.929879268,-14
carcassonne-ucttuned455-vs-ucttuned20-1000its,825,839,2175.043256093,2141.940909623,-14
carcassonne-uct330-vs-uct235-1000its,828,842,2195.284251161,2147.950421723,-14
carcassonne-uct190-vs-uct265-1000its,831,845,2169.820269263,2069.575609098,-14
carcassonne-ucttuned100-vs-ucttuned350-1000its,832,846,2121.934709979,2110.296853275,-14
carcassonne-ucttuned70-vs-ucttuned425-1000its,832,846,2231.129248065,2180.465972286,-14
carcassonne-ucttuned445-vs-ucttuned490-1000its,834,848,2136.316149894,2117.186804361,-14
carcassonne-boltzmann425-vs-boltzmann125-1000its,835,849,2164.262791188,2141.259960432,-14
carcassonne-ucttuned295-vs-ucttuned55-1000its,835,849,2215.926740389,2168.051040242,-14
carcassonne-uct440-vs-uct265-1000its,836,850,2176.194078261,2147.731823542,-14
carcassonne-uct95-vs-uct90-1000its,836,850,2139.350884891,2137.695053951,-14
carcassonne-ucttuned150-vs-ucttuned185-1000its,836,850,2224.213066142,2181.779004432,-14
carcassonne-ucttuned390-vs-ucttuned345-1000its,836,850,2201.816711004,2164.094350647,-14
carcassonne-ucttuned20-vs-ucttuned490-1000its,837,851,2242.977319391,2158.521396914,-14
carcassonne-uct460-vs-uct290-1000its,839,853,2158.563633118,2138.725493873,-14
carcassonne-ucttuned395-vs-ucttuned175-1000its,842,856,2141.664205438,2079.317656608,-14
carcassonne-boltzmann340-vs-boltzmann30-1000its,843,857,2217.250259969,2159.17396168,-14
carcassonne-uct15-vs-uct400-1000its,843,857,2228.104918528,2211.651994508,-14
carcassonne-ucttuned285-vs-ucttuned20-1000its,843,857,2185.766193401,2156.090300332,-14
carcassonne-boltzmann345-vs-boltzmann205-1000its,844,858,2292.597709513,2260.166871909,-14
carcassonne-uct250-vs-uct490-1000its,844,858,2222.566354363,2182.196199997,-14
carcassonne-boltzmann130-vs-boltzmann55-1000its,845,859,2166.391628731,2166.487426827,-14
carcassonne-boltzmann290-vs-boltzmann440-1000its,846,860,2293.527189507,2270.724527126,-14
carcassonne-ucttuned300-vs-ucttuned355-1000its,847,861,2193.781850683,2156.005164201,-14
carcassonne-boltzmann175-vs-boltzmann245-1000its,851,865,2258.744772924,2203.17067496,-14
carcassonne-uct445-vs-uct115-1000its,852,866,2202.192808405,2141.737531104,-14
carcassonne-ucttuned125-vs-ucttuned240-1000its,852,866,2274.89799202,2214.435685655,-14
carcassonne-uct300-vs-uct95-1000its,855,869,2210.422367547,2170.584764522,-14
carcassonne-uct435-vs-uct375-1000its,856,870,2311.970486357,2275.31660886,-14
carcassonne-uct360-vs-uct50-1000its,857,871,2227.59464073,2166.236630712,-14
carcassonne-uct35-vs-uct320-1000its,860,874,2215.49472704,2179.345652373,-14
carcassonne-ucttuned485-vs-ucttuned155-1000its,861,875,2193.180949778,2146.131749048,-14
carcassonne-ucttuned190-vs-ucttuned385-1000its,865,879,2136.626250864,2092.551182491,-14
carcassonne-uct200-vs-uct60-1000its,867,881,2165.616702898,2111.563311836,-14
carcassonne-uct25-vs-uct450-1000its,870,884,2188.607779311,2147.634223925,-14
carcassonne-boltzmann345-vs-boltzmann440-1000its,873,887,2196.478024829,2155.767769795,-14
carcassonne-ucttuned225-vs-ucttuned395-1000its,881,895,2189.677294098,2140.934919027,-14
carcassonne-boltzmann255-vs-boltzmann150-1000its,891,905,2140.268389647,2072.541050527,-14
carcassonne-ucttuned455-vs-ucttuned185-1000its,891,905,2123.282934253,2086.606255739,-14
carcassonne-uct15-vs-uct280-1000its,909,923,2143.360561812,2159.180647564,-14
carcassonne-ucttuned295-vs-ucttuned315-1000its,914,928,2173.337909011,2130.268205221,-14
carcassonne-ucttuned185-vs-ucttuned145-1000its,703,716,2140.871973019,2129.365918528,-13
carcassonne-ucttuned440-vs-ucttuned165-1000its,703,716,2199.033329202,2126.600268439,-13
carcassonne-ucttuned65-vs-ucttuned145-1000its,724,737,2174.246401974,2081.447026804,-13
carcassonne-boltzmann285-vs-boltzmann210-1000its,729,742,2191.134020562,2168.781324855,-13
carcassonne-uct50-vs-uct40-1000its,733,746,2229.712760313,2172.335752742,-13
carcassonne-ucttuned65-vs-ucttuned370-1000its,741,754,2197.249494697,2143.886338613,-13
carcassonne-ucttuned335-vs-ucttuned360-1000its,750,763,2171.217279463,2118.149440785,-13
carcassonne-boltzmann340-vs-boltzmann135-1000its,751,764,2136.193349359,2142.515070477,-13
carcassonne-uct155-vs-uct455-1000its,751,764,2220.088603318,2128.046071966,-13
carcassonne-boltzmann465-vs-boltzmann160-1000its,755,768,2218.278722769,2211.755644479,-13
carcassonne-uct60-vs-uct490-1000its,755,768,2155.580581201,2105.955050384,-13
carcassonne-ucttuned200-vs-ucttuned480-1000its,755,768,2150.354777887,2125.689141023,-13
carcassonne-ucttuned245-vs-ucttuned240-1000its,755,768,2187.423634963,2157.596413562,-13
carcassonne-ucttuned420-vs-ucttuned450-1000its,755,768,2145.509260647,2142.665012837,-13
carcassonne-ucttuned75-vs-ucttuned270-1000its,755,768,2158.971861311,2108.421111908,-13
carcassonne-boltzmann260-vs-boltzmann265-1000its,756,769,2238.021567179,2166.555971932,-13
carcassonne-boltzmann275-vs-boltzmann390-1000its,758,771,2211.702782796,2190.015813702,-13
carcassonne-uct340-vs-uct400-1000its,761,774,2191.250010152,2144.634103419,-13
carcassonne-uct75-vs-uct295-1000its,761,774,2246.273227534,2149.665103083,-13
carcassonne-boltzmann85-vs-boltzmann100-1000its,762,775,2161.597893854,2135.250023605,-13
carcassonne-boltzmann395-vs-boltzmann350-1000its,763,776,2167.020062653,2137.873580789,-13
carcassonne-ucttuned405-vs-ucttuned245-1000its,763,776,2205.657956604,2181.587520843,-13
carcassonne-boltzmann160-vs-boltzmann85-1000its,766,779,2156.927896161,2106.571592964,-13
carcassonne-uct270-vs-uct175-1000its,767,780,2183.158371072,2148.089081313,-13
carcassonne-uct320-vs-uct475-1000its,767,780,2111.176714565,2091.375904427,-13
carcassonne-boltzmann350-vs-boltzmann15-1000its,768,781,2185.535552734,2201.549507695,-13
carcassonne-uct235-vs-uct210-1000its,768,781,2260.385958292,2222.078753036,-13
carcassonne-boltzmann270-vs-boltzmann220-1000its,770,783,2205.599642294,2196.891553909,-13
carcassonne-boltzmann490-vs-boltzmann170-1000its,771,784,2220.32842762,2172.989069265,-13
carcassonne-uct50-vs-uct205-1000its,771,784,2155.236563977,2096.875130968,-13
carcassonne-ucttuned245-vs-ucttuned450-1000its,772,785,2225.2162498,2156.001564189,-13
carcassonne-ucttuned450-vs-ucttuned100-1000its,773,786,2231.278293877,2224.629697928,-13
carcassonne-boltzmann265-vs-boltzmann365-1000its,774,787,2175.821312798,2119.825816326,-13
carcassonne-uct270-vs-uct285-1000its,776,789,2160.023801739,2149.699125942,-13
carcassonne-ucttuned145-vs-ucttuned320-1000its,776,789,2205.461255757,2152.739955666,-13
carcassonne-boltzmann240-vs-boltzmann265-1000its,777,790,2284.626257889,2234.073894023,-13
carcassonne-uct175-vs-uct335-1000its,777,790,2153.952056645,2124.456812851,-13
carcassonne-ucttuned445-vs-ucttuned275-1000its,778,791,2196.936590915,2134.914390827,-13
carcassonne-uct245-vs-uct310-1000its,779,792,2145.465196255,2072.341504111,-13
carcassonne-boltzmann135-vs-boltzmann270-1000its,781,794,2239.49053794,2182.497246122,-13
carcassonne-uct5-vs-uct300-1000its,782,795,2209.002513592,2132.49925176,-13
carcassonne-ucttuned440-vs-ucttuned415-1000its,783,796,2231.86514255,2236.780250282,-13
carcassonne-uct415-vs-uct460-1000its,784,797,2173.904704866,2154.445770766,-13
carcassonne-boltzmann495-vs-boltzmann245-1000its,785,798,2223.96990509,2190.514703141,-13
carcassonne-uct225-vs-uct495-1000its,786,799,2241.548582154,2231.455930466,-13
carcassonne-ucttuned290-vs-ucttuned465-1000its,787,800,2169.396452208,2132.789919858,-13
carcassonne-ucttuned360-vs-ucttuned280-1000its,789,802,2198.552432237,2162.989925262,-13
carcassonne-boltzmann485-vs-boltzmann145-1000its,790,803,2216.675396836,2168.203678536,-13
carcassonne-uct145-vs-uct390-1000its,790,803,2214.545137012,2178.496395709,-13
carcassonne-ucttuned425-vs-ucttuned315-1000its,791,804,2206.200445495,2139.774574695,-13
carcassonne-uct485-vs-uct210-1000its,792,805,2140.535165807,2088.717256774,-13
carcassonne-ucttuned425-vs-ucttuned130-1000its,792,805,2147.415468494,2089.802206927,-13
carcassonne-boltzmann245-vs-boltzmann60-1000its,793,806,2182.522425148,2132.216686301,-13
carcassonne-uct290-vs-uct280-1000its,793,806,2157.394768303,2133.763679991,-13
carcassonne-boltzmann145-vs-boltzmann470-1000its,794,807,2189.373921771,2143.542890011,-13
carcassonne-uct230-vs-uct495-1000its,795,808,2185.511523794,2159.450262434,-13
carcassonne-uct465-vs-uct160-1000its,795,808,2222.533240701,2168.687450795,-13
carcassonne-ucttuned425-vs-ucttuned65-1000its,795,808,2231.699498933,2197.869512169,-13
carcassonne-ucttuned85-vs-ucttuned335-1000its,795,808,2247.28163644,2155.283277622,-13
carcassonne-ucttuned190-vs-ucttuned150-1000its,796,809,2163.479111166,2120.150942687,-13
carcassonne-ucttuned480-vs-ucttuned290-1000its,797,810,2221.26623196,2163.029755464,-13
carcassonne-uct115-vs-uct20-1000its,799,812,2160.177122199,2148.273911627,-13
carcassonne-uct20-vs-uct350-1000its,799,812,2186.892848715,2132.862890286,-13
carcassonne-ucttuned430-vs-ucttuned120-1000its,799,812,2196.472420453,2158.057502865,-13
carcassonne-boltzmann340-vs-boltzmann120-1000its,801,814,2251.421523892,2192.354545574,-13
carcassonne-uct120-vs-uct240-1000its,801,814,2248.281841828,2192.763019864,-13
carcassonne-ucttuned355-vs-ucttuned410-1000its,801,814,2207.539998611,2154.239838207,-13
carcassonne-ucttuned420-vs-ucttuned335-1000its,801,814,2176.929590747,2133.560399282,-13
carcassonne-ucttuned490-vs-ucttuned55-1000its,801,814,2157.06638785,2168.9911645,-13
carcassonne-ucttuned140-vs-ucttuned170-1000its,803,816,2190.107112208,2118.537686482,-13
carcassonne-ucttuned150-vs-ucttuned55-1000its,804,817,2158.580569573,2150.431275873,-13
carcassonne-uct355-vs-uct455-1000its,805,818,2242.947843895,2183.435130419,-13
carcassonne-boltzmann430-vs-boltzmann60-1000its,806,819,2164.0693645,2126.059992917,-13
carcassonne-ucttuned280-vs-ucttuned490-1000its,808,821,2107.058452463,2121.201413766,-13
carcassonne-ucttuned5-vs-ucttuned485-1000its,808,821,2146.606630099,2089.61800765,-13
carcassonne-boltzmann165-vs-boltzmann235-1000its,810,823,2213.244030464,2123.587511453,-13
carcassonne-uct170-vs-uct455-1000its,812,825,2217.801717612,2162.221149081,-13
carcassonne-uct315-vs-uct160-1000its,812,825,2281.366470663,2210.922876537,-13
carcassonne-ucttuned130-vs-ucttuned125-1000its,814,827,2224.156203169,2164.236529556,-13
carcassonne-ucttuned320-vs-ucttuned280-1000its,814,827,2196.665901176,2172.301693523,-13
carcassonne-ucttuned180-vs-ucttuned35-1000its,815,828,2199.514154756,2176.567445065,-13
carcassonne-uct100-vs-uct330-1000its,816,829,2209.453704891,2182.168421498,-13
carcassonne-uct460-vs-uct155-1000its,817,830,2165.294326347,2114.331214453,-13
carcassonne-boltzmann195-vs-boltzmann210-1000its,819,832,2153.986916799,2141.741478633,-13
carcassonne-uct75-vs-uct40-1000its,819,832,2123.787965308,2130.001698174,-13
carcassonne-ucttuned120-vs-ucttuned45-1000its,819,832,2182.523088177,2193.592642338,-13
carcassonne-uct30-vs-uct365-1000its,820,833,2163.045902017,2127.515695357,-13
carcassonne-ucttuned455-vs-ucttuned215-1000its,820,833,2226.749474866,2137.855864453,-13
carcassonne-boltzmann315-vs-boltzmann190-1000its,821,834,2204.644597851,2178.625803677,-13
carcassonne-uct55-vs-uct230-1000its,821,834,2188.236540047,2166.35703584,-13
carcassonne-uct270-vs-uct215-1000its,822,835,2199.648281211,2177.882698922,-13
carcassonne-uct445-vs-uct125-1000its,823,836,2186.315616272,2102.396711308,-13
carcassonne-ucttuned35-vs-ucttuned415-1000its,823,836,2189.712213448,2149.098033081,-13
carcassonne-ucttuned355-vs-ucttuned425-1000its,824,837,2148.024071744,2112.329411641,-13
carcassonne-ucttuned85-vs-ucttuned485-1000its,825,838,2114.236285048,2126.178427374,-13
carcassonne-boltzmann445-vs-boltzmann375-1000its,826,839,2221.412959709,2161.696526448,-13
carcassonne-uct10-vs-uct350-1000its,826,839,2230.64108226,2182.181078282,-13
carcassonne-uct385-vs-uct90-1000its,826,839,2211.103754111,2196.07783978,-13
carcassonne-ucttuned325-vs-ucttuned330-1000its,826,839,2204.259992229,2127.961438635,-13
carcassonne-ucttuned35-vs-ucttuned360-1000its,826,839,2223.919721761,2120.131247362,-13
carcassonne-ucttuned405-vs-ucttuned365-1000its,827,840,2114.325281708,2092.095692331,-13
carcassonne-ucttuned115-vs-ucttuned300-1000its,828,841,2266.916891873,2192.49724295,-13
carcassonne-boltzmann45-vs-boltzmann365-1000its,829,842,2156.810447625,2149.331233601,-13
carcassonne-ucttuned490-vs-ucttuned395-1000its,829,842,2256.281244228,2187.621051006,-13
carcassonne-boltzmann115-vs-boltzmann470-1000its,831,844,2193.265631239,2175.381422573,-13
carcassonne-uct30-vs-uct110-1000its,831,844,2248.471931271,2221.324099034,-13
carcassonne-ucttuned425-vs-ucttuned240-1000its,831,844,2174.935216384,2157.798092375,-13
carcassonne-boltzmann495-vs-boltzmann235-1000its,832,845,2164.93176284,2135.684626392,-13
carcassonne-boltzmann495-vs-boltzmann315-1000its,832,845,2195.500396075,2165.143215078,-13
carcassonne-ucttuned355-vs-ucttuned375-1000its,832,845,2156.741140209,2131.708316652,-13
carcassonne-boltzmann35-vs-boltzmann265-1000its,833,846,2219.158263955,2145.707121547,-13
carcassonne-uct360-vs-uct480-1000its,833,846,2200.734685441,2158.18503746,-13
carcassonne-uct115-vs-uct485-1000its,834,847,2156.51161597,2112.011721175,-13
carcassonne-uct155-vs-uct215-1000its,834,847,2221.987456486,2171.334349004,-13
carcassonne-uct70-vs-uct245-1000its,835,848,2202.793253801,2190.300374292,-13
carcassonne-ucttuned170-vs-ucttuned25-1000its,835,848,2193.784696914,2180.051300037,-13
carcassonne-ucttuned420-vs-ucttuned25-1000its,835,848,2209.412944831,2160.129094538,-13
carcassonne-uct120-vs-uct485-1000its,837,850,2138.173627328,2132.65747771,-13
carcassonne-boltzmann395-vs-boltzmann235-1000its,838,851,2196.627731443,2124.741138631,-13
carcassonne-boltzmann250-vs-boltzmann210-1000its,839,852,2245.894121029,2206.815692816,-13
carcassonne-boltzmann395-vs-boltzmann50-1000its,840,853,2231.92352393,2188.335907627,-13
carcassonne-ucttuned335-vs-ucttuned250-1000its,840,853,2242.427553458,2227.136066954,-13
carcassonne-ucttuned70-vs-ucttuned285-1000its,840,853,2253.070843373,2125.046853115,-13
carcassonne-uct50-vs-uct240-1000its,841,854,2178.117963675,2114.081544486,-13
carcassonne-ucttuned200-vs-ucttuned75-1000its,841,854,2165.10597361,2130.664784074,-13
carcassonne-ucttuned375-vs-ucttuned410-1000its,841,854,2217.245268588,2177.049572037,-13
carcassonne-ucttuned90-vs-ucttuned70-1000its,843,856,2161.345328978,2141.020195861,-13
carcassonne-boltzmann265-vs-boltzmann335-1000its,844,857,2164.90587062,2161.090803192,-13
carcassonne-uct395-vs-uct480-1000its,844,857,2233.744714794,2225.674837589,-13
carcassonne-ucttuned10-vs-ucttuned235-1000its,844,857,2242.765163257,2190.067681046,-13
carcassonne-ucttuned105-vs-ucttuned125-1000its,844,857,2220.38848467,2168.188213998,-13
carcassonne-ucttuned250-vs-ucttuned120-1000its,844,857,2188.948155263,2147.045557286,-13
carcassonne-uct435-vs-uct120-1000its,845,858,2169.946089716,2108.0536921,-13
carcassonne-uct260-vs-uct430-1000its,846,859,2124.732507496,2110.427983011,-13
carcassonne-uct45-vs-uct470-1000its,846,859,2211.464106756,2121.077476987,-13
carcassonne-ucttuned415-vs-ucttuned45-1000its,847,860,2264.482089339,2285.91849884,-13
carcassonne-boltzmann20-vs-boltzmann75-1000its,848,861,2251.988566728,2189.087702855,-13
carcassonne-boltzmann165-vs-boltzmann400-1000its,850,863,2163.69356964,2147.198239587,-13
carcassonne-uct70-vs-uct25-1000its,850,863,2171.759276995,2140.367238344,-13
carcassonne-ucttuned180-vs-ucttuned400-1000its,850,863,2198.926191572,2168.726618639,-13
carcassonne-boltzmann135-vs-boltzmann410-1000its,851,864,2196.646365013,2136.698512866,-13
carcassonne-boltzmann85-vs-boltzmann280-1000its,853,866,2235.54684445,2218.601556035,-13
carcassonne-boltzmann65-vs-boltzmann450-1000its,855,868,2200.153188191,2163.715411241,-13
carcassonne-boltzmann375-vs-boltzmann255-1000its,859,872,2113.422737504,2098.897036534,-13
carcassonne-ucttuned325-vs-ucttuned315-1000its,863,876,2270.24877143,2226.462053236,-13
carcassonne-ucttuned275-vs-ucttuned480-1000its,865,878,2143.216115658,2093.451139386,-13
carcassonne-boltzmann445-vs-boltzmann390-1000its,866,879,2279.133671061,2227.918842284,-13
carcassonne-ucttuned55-vs-ucttuned315-1000its,867,880,2182.858033298,2138.230824525,-13
carcassonne-ucttuned95-vs-ucttuned180-1000its,867,880,2230.079184149,2178.56667441,-13
carcassonne-ucttuned305-vs-ucttuned310-1000its,869,882,2151.116272492,2132.781635438,-13
carcassonne-ucttuned435-vs-ucttuned5-1000its,874,887,2213.35459161,2193.014225009,-13
carcassonne-ucttuned385-vs-ucttuned180-1000its,875,888,2165.802468813,2154.050380735,-13
carcassonne-boltzmann150-vs-boltzmann40-1000its,878,891,2166.592579114,2123.055849234,-13
carcassonne-uct395-vs-uct465-1000its,878,891,2167.252722982,2126.630811952,-13
carcassonne-uct10-vs-uct5-1000its,888,901,2176.585601533,2134.429933397,-13
carcassonne-uct420-vs-uct30-1000its,892,905,2181.361714261,2160.200923292,-13
carcassonne-uct445-vs-uct50-1000its,892,905,2224.929092697,2171.507067208,-13
carcassonne-uct135-vs-uct170-1000its,893,906,2289.17221871,2230.026774993,-13
carcassonne-ucttuned170-vs-ucttuned50-1000its,897,910,2171.026020336,2134.441950826,-13
carcassonne-uct375-vs-uct425-1000its,898,911,2281.926341531,2224.755532115,-13
carcassonne-boltzmann55-vs-boltzmann350-1000its,720,732,2182.803454901,2113.722207543,-12
carcassonne-boltzmann50-vs-boltzmann15-1000its,723,735,2137.446951327,2135.975193862,-12
carcassonne-boltzmann480-vs-boltzmann80-1000its,724,736,2222.582466844,2171.055631197,-12
carcassonne-boltzmann265-vs-boltzmann135-1000its,730,742,2231.034911106,2188.694296795,-12
carcassonne-uct480-vs-uct485-1000its,732,744,2181.086361729,2132.13992106,-12
carcassonne-ucttuned120-vs-ucttuned455-1000its,734,746,2199.812131909,2157.174940198,-12
carcassonne-boltzmann95-vs-boltzmann280-1000its,735,747,2212.767240264,2181.258303117,-12
carcassonne-uct485-vs-uct90-1000its,737,749,2157.167362268,2124.815570584,-12
carcassonne-ucttuned435-vs-ucttuned120-1000its,740,752,2249.066263555,2204.591801425,-12
carcassonne-boltzmann440-vs-boltzmann65-1000its,742,754,2203.745111207,2146.593566222,-12
carcassonne-boltzmann50-vs-boltzmann170-1000its,743,755,2191.789220469,2105.191847413,-12
carcassonne-boltzmann165-vs-boltzmann180-1000its,745,757,2225.680640487,2197.291120322,-12
carcassonne-boltzmann260-vs-boltzmann225-1000its,751,763,2256.60215058,2204.115953634,-12
carcassonne-boltzmann290-vs-boltzmann375-1000its,757,769,2186.859744214,2113.546008474,-12
carcassonne-boltzmann350-vs-boltzmann230-1000its,759,771,2173.652851867,2153.175939527,-12
carcassonne-ucttuned190-vs-ucttuned305-1000its,759,771,2083.65998898,2047.604967679,-12
carcassonne-ucttuned445-vs-ucttuned420-1000its,760,772,2247.11288641,2211.44265031,-12
carcassonne-boltzmann105-vs-boltzmann485-1000its,761,773,2196.477697233,2162.497113842,-12
carcassonne-boltzmann110-vs-boltzmann410-1000its,761,773,2203.264606398,2130.856196786,-12
carcassonne-boltzmann265-vs-boltzmann90-1000its,761,773,2226.273025775,2173.304719008,-12
carcassonne-boltzmann70-vs-boltzmann250-1000its,762,774,2205.402319554,2149.440905911,-12
carcassonne-uct85-vs-uct150-1000its,762,774,2241.802499421,2179.676944352,-12
carcassonne-uct175-vs-uct235-1000its,764,776,2219.052683888,2132.575963234,-12
carcassonne-uct475-vs-uct30-1000its,764,776,2207.463384423,2190.559249278,-12
carcassonne-uct480-vs-uct375-1000its,764,776,2208.067451463,2148.165476334,-12
carcassonne-boltzmann490-vs-boltzmann260-1000its,765,777,2198.731731471,2128.05176551,-12
carcassonne-ucttuned150-vs-ucttuned385-1000its,766,778,2167.660345325,2146.007593592,-12
carcassonne-uct480-vs-uct345-1000its,767,779,2156.502505946,2120.241038725,-12
carcassonne-ucttuned125-vs-ucttuned485-1000its,767,779,2132.503990194,2092.922484929,-12
carcassonne-boltzmann210-vs-boltzmann115-1000its,772,784,2168.739949237,2143.23310937,-12
carcassonne-boltzmann170-vs-boltzmann430-1000its,773,785,2163.039813708,2143.854787825,-12
carcassonne-boltzmann50-vs-boltzmann95-1000its,775,787,2288.882791568,2202.91002267,-12
carcassonne-ucttuned315-vs-ucttuned305-1000its,775,787,2239.296258389,2177.098448951,-12
carcassonne-boltzmann335-vs-boltzmann90-1000its,777,789,2180.585229721,2081.033743344,-12
carcassonne-uct415-vs-uct330-1000its,777,789,2159.262231912,2153.161582294,-12
carcassonne-uct295-vs-uct225-1000its,780,792,2184.658181184,2154.620173851,-12
carcassonne-ucttuned280-vs-ucttuned5-1000its,781,793,2170.590781907,2148.73779597,-12
carcassonne-boltzmann420-vs-boltzmann75-1000its,782,794,2205.409044971,2176.494705098,-12
carcassonne-boltzmann45-vs-boltzmann245-1000its,782,794,2223.843747105,2216.619555987,-12
carcassonne-ucttuned410-vs-ucttuned355-1000its,782,794,2198.252375535,2151.530199323,-12
carcassonne-uct40-vs-uct225-1000its,783,795,2186.051801863,2136.437622956,-12
carcassonne-ucttuned360-vs-ucttuned80-1000its,783,795,2233.888240166,2192.403894581,-12
carcassonne-boltzmann135-vs-boltzmann380-1000its,785,797,2210.500747728,2162.625395927,-12
carcassonne-ucttuned245-vs-ucttuned205-1000its,785,797,2178.235295947,2119.190441903,-12
carcassonne-uct425-vs-uct435-1000its,787,799,2249.723078009,2198.684020901,-12
carcassonne-ucttuned120-vs-ucttuned75-1000its,787,799,2237.766646564,2192.936789883,-12
carcassonne-boltzmann345-vs-boltzmann225-1000its,788,800,2174.851756435,2078.004418428,-12
carcassonne-uct280-vs-uct245-1000its,789,801,2224.461966916,2138.167183591,-12
carcassonne-uct190-vs-uct95-1000its,790,802,2183.97513988,2148.2190813,-12
carcassonne-uct215-vs-uct180-1000its,791,803,2141.275036659,2121.661108138,-12
carcassonne-uct310-vs-uct485-1000its,791,803,2248.758480304,2194.577846429,-12
carcassonne-ucttuned95-vs-ucttuned380-1000its,792,804,2155.331287217,2114.101175926,-12
carcassonne-boltzmann160-vs-boltzmann285-1000its,794,806,2150.744366635,2160.239983737,-12
carcassonne-boltzmann40-vs-boltzmann280-1000its,794,806,2185.989119185,2121.975615324,-12
carcassonne-uct330-vs-uct210-1000its,795,807,2246.992278534,2120.391815996,-12
carcassonne-ucttuned35-vs-ucttuned355-1000its,795,807,2206.777986594,2094.264181985,-12
carcassonne-boltzmann15-vs-boltzmann290-1000its,796,808,2169.666501443,2167.433499494,-12
carcassonne-boltzmann320-vs-boltzmann280-1000its,796,808,2155.83561622,2145.452644904,-12
carcassonne-uct365-vs-uct215-1000its,796,808,2196.231967908,2160.723216313,-12
carcassonne-ucttuned175-vs-ucttuned130-1000its,796,808,2161.677074288,2081.751134201,-12
carcassonne-uct20-vs-uct455-1000its,797,809,2213.636629802,2199.621891371,-12
carcassonne-boltzmann320-vs-boltzmann75-1000its,799,811,2298.158411911,2280.623238878,-12
carcassonne-boltzmann425-vs-boltzmann330-1000its,799,811,2232.865366183,2141.646413775,-12
carcassonne-uct180-vs-uct100-1000its,799,811,2302.792923014,2251.470660895,-12
carcassonne-ucttuned90-vs-ucttuned330-1000its,799,811,2201.346334351,2173.569932579,-12
carcassonne-uct85-vs-uct20-1000its,800,812,2184.108939907,2160.64917844,-12
carcassonne-boltzmann330-vs-boltzmann70-1000its,801,813,2236.719405531,2188.088003026,-12
carcassonne-uct240-vs-uct95-1000its,801,813,2152.707886663,2165.520079938,-12
carcassonne-uct485-vs-uct305-1000its,801,813,2104.67130134,2088.408645679,-12
carcassonne-ucttuned55-vs-ucttuned210-1000its,801,813,2194.580263994,2131.142809045,-12
carcassonne-boltzmann20-vs-boltzmann490-1000its,802,814,2181.144168893,2120.384986067,-12
carcassonne-uct295-vs-uct420-1000its,802,814,2181.121939576,2130.42047143,-12
carcassonne-boltzmann375-vs-boltzmann250-1000its,803,815,2234.64328314,2217.488422022,-12
carcassonne-boltzmann55-vs-boltzmann475-1000its,803,815,2180.868897195,2140.662855631,-12
carcassonne-uct455-vs-uct75-1000its,803,815,2274.709442118,2193.284485026,-12
carcassonne-boltzmann390-vs-boltzmann445-1000its,804,816,2197.05655897,2100.888392031,-12
carcassonne-boltzmann430-vs-boltzmann110-1000its,804,816,2213.701070765,2173.012499402,-12
carcassonne-uct420-vs-uct250-1000its,804,816,2202.078235036,2191.170148813,-12
carcassonne-boltzmann465-vs-boltzmann375-1000its,805,817,2189.173508899,2139.528231478,-12
carcassonne-uct175-vs-uct440-1000its,805,817,2189.446542582,2112.175033721,-12
carcassonne-uct230-vs-uct115-1000its,805,817,2192.308290864,2120.414577805,-12
carcassonne-uct405-vs-uct35-1000its,805,817,2194.434193456,2151.290982477,-12
carcassonne-boltzmann470-vs-boltzmann265-1000its,806,818,2211.039541129,2163.659934612,-12
carcassonne-uct165-vs-uct355-1000its,808,820,2202.046970362,2200.963563076,-12
carcassonne-uct170-vs-uct175-1000its,808,820,2197.996705573,2170.677294637,-12
carcassonne-uct205-vs-uct25-1000its,809,821,2232.917274562,2178.999458922,-12
carcassonne-uct260-vs-uct375-1000its,809,821,2163.501648022,2105.237963955,-12
carcassonne-ucttuned160-vs-ucttuned80-1000its,810,822,2301.090368504,2210.721675649,-12
carcassonne-boltzmann455-vs-boltzmann75-1000its,813,825,2232.93783358,2160.431536667,-12
carcassonne-boltzmann85-vs-boltzmann60-1000its,813,825,2207.21586453,2149.53540034,-12
carcassonne-boltzmann30-vs-boltzmann425-1000its,814,826,2192.112021109,2133.792086621,-12
carcassonne-uct275-vs-uct210-1000its,814,826,2187.686299681,2142.42519458,-12
carcassonne-ucttuned460-vs-ucttuned195-1000its,814,826,2182.708610941,2111.248870158,-12
carcassonne-uct195-vs-uct200-1000its,815,827,2119.100712274,2095.724357336,-12
carcassonne-ucttuned275-vs-ucttuned215-1000its,815,827,2139.535991598,2122.369859369,-12
carcassonne-boltzmann45-vs-boltzmann115-1000its,816,828,2219.713461692,2155.942574369,-12
carcassonne-uct370-vs-uct295-1000its,816,828,2248.381532402,2184.559367393,-12
carcassonne-ucttuned365-vs-ucttuned305-1000its,816,828,2236.586420697,2146.804794715,-12
carcassonne-boltzmann285-vs-boltzmann275-1000its,817,829,2174.910795345,2116.474804121,-12
carcassonne-uct400-vs-uct175-1000its,817,829,2137.532207877,2132.632474147,-12
carcassonne-uct60-vs-uct190-1000its,818,830,2191.619584066,2178.964724073,-12
carcassonne-ucttuned310-vs-ucttuned420-1000its,818,830,2189.833284389,2153.845350719,-12
carcassonne-uct195-vs-uct230-1000its,820,832,2119.037191072,2062.485302045,-12
carcassonne-ucttuned465-vs-ucttuned245-1000its,821,833,2194.309935752,2174.581308684,-12
carcassonne-uct45-vs-uct70-1000its,822,834,2210.761269423,2192.312653564,-12
carcassonne-boltzmann315-vs-boltzmann220-1000its,823,835,2116.159662852,2137.280272643,-12
carcassonne-uct105-vs-uct170-1000its,824,836,2249.155417994,2210.527550967,-12
carcassonne-ucttuned150-vs-ucttuned440-1000its,824,836,2273.586168708,2218.915539476,-12
carcassonne-ucttuned465-vs-ucttuned155-1000its,824,836,2193.416305118,2127.292052528,-12
carcassonne-boltzmann100-vs-boltzmann240-1000its,825,837,2200.255858892,2209.271815767,-12
carcassonne-boltzmann130-vs-boltzmann360-1000its,825,837,2194.039325494,2165.985095501,-12
carcassonne-boltzmann15-vs-boltzmann55-1000its,825,837,2227.11924212,2159.187777682,-12
carcassonne-uct130-vs-uct370-1000its,826,838,2165.192809395,2130.394814515,-12
carcassonne-uct275-vs-uct80-1000its,828,840,2286.153561325,2231.217103024,-12
carcassonne-ucttuned325-vs-ucttuned90-1000its,829,841,2146.2513156,2105.878721399,-12
carcassonne-ucttuned345-vs-ucttuned390-1000its,829,841,2209.158876755,2148.696497395,-12
carcassonne-boltzmann295-vs-boltzmann195-1000its,830,842,2184.866744869,2117.700647426,-12
carcassonne-boltzmann220-vs-boltzmann445-1000its,831,843,2207.455036845,2138.159010581,-12
carcassonne-ucttuned20-vs-ucttuned395-1000its,831,843,2166.12809144,2085.048692653,-12
carcassonne-boltzmann395-vs-boltzmann470-1000its,832,844,2212.726513836,2189.914738806,-12
carcassonne-boltzmann115-vs-boltzmann300-1000its,834,846,2173.038958321,2136.571618458,-12
carcassonne-boltzmann485-vs-boltzmann150-1000its,834,846,2219.646855756,2175.391438766,-12
carcassonne-uct445-vs-uct355-1000its,834,846,2241.591318173,2214.899412388,-12
carcassonne-boltzmann380-vs-boltzmann205-1000its,839,851,2247.118300171,2180.02972434,-12
carcassonne-boltzmann25-vs-boltzmann95-1000its,843,855,2202.603928023,2191.881832819,-12
carcassonne-ucttuned255-vs-ucttuned420-1000its,844,856,2228.913612264,2152.498186692,-12
carcassonne-ucttuned375-vs-ucttuned350-1000its,845,857,2171.323219073,2128.233809879,-12
carcassonne-ucttuned230-vs-ucttuned255-1000its,846,858,2276.309352569,2229.557413367,-12
carcassonne-boltzmann340-vs-boltzmann365-1000its,847,859,2218.734369177,2180.79979752,-12
carcassonne-boltzmann325-vs-boltzmann410-1000its,848,860,2204.622458403,2185.640693434,-12
carcassonne-uct280-vs-uct405-1000its,848,860,2262.984500709,2208.438590848,-12
carcassonne-boltzmann30-vs-boltzmann470-1000its,849,861,2208.178829454,2163.43462549,-12
carcassonne-boltzmann145-vs-boltzmann10-1000its,852,864,2229.085911957,2195.435674671,-12
carcassonne-boltzmann260-vs-boltzmann480-1000its,852,864,2224.23609522,2157.99627623,-12
carcassonne-ucttuned265-vs-ucttuned50-1000its,853,865,2126.153631165,2074.289188101,-12
carcassonne-uct270-vs-uct290-1000its,854,866,2172.924442549,2168.582992642,-12
carcassonne-uct90-vs-uct30-1000its,854,866,2322.338688672,2284.99898303,-12
carcassonne-ucttuned360-vs-ucttuned155-1000its,858,870,2196.157551754,2179.742317221,-12
carcassonne-uct25-vs-uct280-1000its,862,874,2228.880649406,2185.772569294,-12
carcassonne-uct440-vs-uct430-1000its,863,875,2189.48848387,2101.06557346,-12
carcassonne-boltzmann195-vs-boltzmann225-1000its,864,876,2206.117700173,2155.85444871,-12
carcassonne-uct400-vs-uct235-1000its,865,877,2175.638353573,2132.636005129,-12
carcassonne-uct190-vs-uct295-1000its,867,879,2206.687989201,2171.707214342,-12
carcassonne-boltzmann465-vs-boltzmann365-1000its,868,880,2221.148947449,2177.587996809,-12
carcassonne-boltzmann5-vs-boltzmann345-1000its,869,881,2258.534135526,2236.788322586,-12
carcassonne-uct25-vs-uct370-1000its,869,881,2221.273387424,2196.334974549,-12
carcassonne-uct55-vs-uct320-1000its,870,882,2182.503615912,2102.860405153,-12
carcassonne-ucttuned135-vs-ucttuned70-1000its,876,888,2199.733427571,2144.19243633,-12
carcassonne-ucttuned385-vs-ucttuned410-1000its,879,891,2151.462766113,2130.539510509,-12
carcassonne-ucttuned435-vs-ucttuned20-1000its,879,891,2119.008265933,2089.148634172,-12
carcassonne-ucttuned160-vs-ucttuned380-1000its,880,892,2165.196121034,2134.254229441,-12
carcassonne-ucttuned25-vs-ucttuned450-1000its,883,895,2164.321226502,2127.508213789,-12
carcassonne-ucttuned65-vs-ucttuned335-1000its,884,896,2139.722121339,2103.662035751,-12
carcassonne-ucttuned185-vs-ucttuned330-1000its,890,902,2212.032460283,2154.449777789,-12
carcassonne-ucttuned90-vs-ucttuned125-1000its,914,926,2269.081842298,2210.235256685,-12
carcassonne-ucttuned340-vs-ucttuned305-1000its,917,929,2254.089045805,2156.73001999,-12
carcassonne-ucttuned170-vs-ucttuned210-1000its,640,651,1753.099636477,1769.857638552,-11
carcassonne-ucttuned185-vs-ucttuned370-1000its,678,689,2211.071188312,2176.114001857,-11
carcassonne-uct105-vs-uct200-1000its,685,696,1737.117256009,1713.595593457,-11
carcassonne-uct145-vs-uct125-1000its,701,712,2176.872600997,2148.866425076,-11
carcassonne-uct480-vs-uct475-1000its,703,714,2167.323506234,2136.186739656,-11
carcassonne-boltzmann95-vs-boltzmann160-1000its,715,726,2101.895600976,2082.603211671,-11
carcassonne-boltzmann220-vs-boltzmann245-1000its,723,734,2206.688343782,2191.943038853,-11
carcassonne-boltzmann195-vs-boltzmann120-1000its,729,740,2193.543450233,2118.417348414,-11
carcassonne-boltzmann55-vs-boltzmann15-1000its,733,744,2205.852092645,2135.23026818,-11
carcassonne-boltzmann460-vs-boltzmann270-1000its,742,753,2223.895296298,2189.488236163,-11
carcassonne-ucttuned300-vs-ucttuned160-1000its,742,753,2135.028540536,2099.166013365,-11
carcassonne-uct115-vs-uct75-1000its,744,755,2202.862203443,2159.896087861,-11
carcassonne-uct480-vs-uct380-1000its,745,756,2155.852522727,2111.664857408,-11
carcassonne-ucttuned380-vs-ucttuned135-1000its,745,756,2163.621989759,2179.145917223,-11
carcassonne-uct330-vs-uct320-1000its,747,758,2246.803876245,2167.662901164,-11
carcassonne-boltzmann360-vs-boltzmann200-1000its,748,759,2200.692111819,2117.066435942,-11
carcassonne-boltzmann110-vs-boltzmann375-1000its,749,760,2211.048976998,2159.396626852,-11
carcassonne-boltzmann150-vs-boltzmann310-1000its,749,760,2223.056761673,2127.998916946,-11
carcassonne-boltzmann50-vs-boltzmann400-1000its,749,760,2142.23793483,2102.070308899,-11
carcassonne-uct445-vs-uct95-1000its,752,763,2134.357738512,2113.22827857,-11
carcassonne-uct310-vs-uct205-1000its,754,765,2155.025502474,2134.175788261,-11
carcassonne-ucttuned360-vs-ucttuned180-1000its,756,767,2230.750442574,2204.916106064,-11
carcassonne-ucttuned225-vs-ucttuned20-1000its,758,769,2157.261464009,2164.547408878,-11
carcassonne-ucttuned340-vs-ucttuned485-1000its,758,769,2144.869754003,2117.875990287,-11
carcassonne-ucttuned25-vs-ucttuned55-1000its,760,771,2263.361030341,2208.007537758,-11
carcassonne-ucttuned30-vs-ucttuned350-1000its,762,773,2245.73733657,2204.238108761,-11
carcassonne-ucttuned380-vs-ucttuned315-1000its,762,773,2197.622244671,2167.339907933,-11
carcassonne-boltzmann100-vs-boltzmann275-1000its,763,774,2212.997538753,2180.482554546,-11
carcassonne-boltzmann445-vs-boltzmann345-1000its,767,778,2200.182005988,2135.228455852,-11
carcassonne-ucttuned475-vs-ucttuned175-1000its,767,778,2245.360120566,2187.679976052,-11
carcassonne-boltzmann345-vs-boltzmann5-1000its,768,779,2210.632450864,2202.568844923,-11
carcassonne-boltzmann400-vs-boltzmann255-1000its,768,779,2205.332380703,2106.554608295,-11
carcassonne-ucttuned100-vs-ucttuned230-1000its,768,779,2141.500472256,2136.703940138,-11
carcassonne-ucttuned495-vs-ucttuned315-1000its,768,779,2124.255685864,2099.145405061,-11
carcassonne-uct95-vs-uct455-1000its,769,780,2225.298158074,2187.355820871,-11
carcassonne-boltzmann210-vs-boltzmann250-1000its,770,781,2171.861439523,2120.978110054,-11
carcassonne-uct395-vs-uct190-1000its,773,784,2168.383761054,2117.177997649,-11
carcassonne-ucttuned225-vs-ucttuned265-1000its,773,784,2200.977308548,2185.12722546,-11
carcassonne-ucttuned205-vs-ucttuned270-1000its,774,785,2174.043247131,2165.232566878,-11
carcassonne-ucttuned195-vs-ucttuned125-1000its,775,786,2215.794348007,2141.368082047,-11
carcassonne-uct390-vs-uct225-1000its,776,787,2221.763476625,2168.986804437,-11
carcassonne-uct350-vs-uct345-1000its,778,789,2179.781700527,2122.507047693,-11
carcassonne-boltzmann20-vs-boltzmann295-1000its,779,790,2218.694330145,2184.998701655,-11
carcassonne-uct90-vs-uct270-1000its,779,790,2166.907606796,2115.182316247,-11
carcassonne-uct85-vs-uct185-1000its,780,791,2194.144561802,2146.115406491,-11
carcassonne-boltzmann425-vs-boltzmann165-1000its,781,792,2291.521730693,2260.07005747,-11
carcassonne-uct85-vs-uct235-1000its,781,792,2183.496730407,2133.169561922,-11
carcassonne-ucttuned110-vs-ucttuned260-1000its,781,792,2188.314164546,2087.048647106,-11
carcassonne-boltzmann395-vs-boltzmann230-1000its,782,793,2248.095156065,2162.257345799,-11
carcassonne-ucttuned360-vs-ucttuned370-1000its,783,794,2212.59863151,2139.142679494,-11
carcassonne-uct110-vs-uct295-1000its,785,796,2197.317495704,2115.52441211,-11
carcassonne-uct170-vs-uct315-1000its,786,797,2109.956334007,2152.416262171,-11
carcassonne-ucttuned275-vs-ucttuned285-1000its,786,797,2218.782810642,2159.260762444,-11
carcassonne-ucttuned320-vs-ucttuned130-1000its,786,797,2199.049127281,2175.636407298,-11
carcassonne-boltzmann285-vs-boltzmann370-1000its,787,798,2207.335490147,2154.269939243,-11
carcassonne-uct130-vs-uct180-1000its,788,799,2186.955920585,2152.695729998,-11
carcassonne-uct135-vs-uct470-1000its,788,799,2257.802887443,2186.683158812,-11
carcassonne-ucttuned110-vs-ucttuned185-1000its,789,800,2189.521547187,2147.034686539,-11
carcassonne-boltzmann125-vs-boltzmann335-1000its,791,802,2175.40114371,2110.732791609,-11
carcassonne-uct405-vs-uct450-1000its,791,802,2186.092902068,2166.416036134,-11
carcassonne-boltzmann180-vs-boltzmann130-1000its,792,803,2156.463058631,2122.850530403,-11
carcassonne-boltzmann290-vs-boltzmann180-1000its,792,803,2246.061823446,2161.048301852,-11
carcassonne-uct325-vs-uct190-1000its,792,803,2166.669871745,2099.299286147,-11
carcassonne-uct310-vs-uct340-1000its,793,804,2177.362837649,2117.581082693,-11
carcassonne-ucttuned235-vs-ucttuned470-1000its,793,804,2126.460817782,2081.048107359,-11
carcassonne-ucttuned475-vs-ucttuned285-1000its,793,804,2214.945923421,2142.651506798,-11
carcassonne-boltzmann200-vs-boltzmann110-1000its,794,805,2158.308520133,2108.593521025,-11
carcassonne-uct275-vs-uct455-1000its,795,806,2192.032023157,2155.654306263,-11
carcassonne-ucttuned355-vs-ucttuned445-1000its,795,806,2154.238636579,2119.518847265,-11
carcassonne-boltzmann280-vs-boltzmann415-1000its,796,807,2318.925240356,2283.604129244,-11
carcassonne-ucttuned330-vs-ucttuned340-1000its,796,807,2207.170335548,2163.074955061,-11
carcassonne-boltzmann345-vs-boltzmann245-1000its,797,808,2276.14122723,2214.329105915,-11
carcassonne-uct25-vs-uct20-1000its,797,808,2253.989148452,2203.689944313,-11
carcassonne-uct270-vs-uct260-1000its,797,808,2170.131541864,2137.82263075,-11
carcassonne-ucttuned100-vs-ucttuned405-1000its,797,808,2288.460734318,2262.072533258,-11
carcassonne-uct205-vs-uct65-1000its,798,809,2147.451772816,2150.679374707,-11
carcassonne-uct265-vs-uct485-1000its,798,809,2179.202207011,2134.063774508,-11
carcassonne-uct190-vs-uct320-1000its,799,810,2140.825532175,2077.03050628,-11
carcassonne-ucttuned405-vs-ucttuned315-1000its,799,810,2174.010633578,2167.631901282,-11
carcassonne-boltzmann380-vs-boltzmann340-1000its,800,811,2137.020795444,2088.195386335,-11
carcassonne-uct335-vs-uct190-1000its,800,811,2176.690955558,2119.080624592,-11
carcassonne-uct335-vs-uct90-1000its,800,811,2196.97549039,2183.895516645,-11
carcassonne-ucttuned80-vs-ucttuned150-1000its,800,811,2213.936427988,2190.784174293,-11
carcassonne-uct200-vs-uct385-1000its,801,812,2238.937950391,2195.845318364,-11
carcassonne-ucttuned135-vs-ucttuned175-1000its,801,812,2163.773083597,2118.612820696,-11
carcassonne-ucttuned280-vs-ucttuned465-1000its,801,812,2239.63043234,2192.495135181,-11
carcassonne-boltzmann160-vs-boltzmann430-1000its,802,813,2223.332644571,2157.684113652,-11
carcassonne-boltzmann475-vs-boltzmann385-1000its,802,813,2216.237578192,2162.512811022,-11
carcassonne-uct250-vs-uct90-1000its,802,813,2245.369526285,2195.958565752,-11
carcassonne-boltzmann330-vs-boltzmann285-1000its,803,814,2242.189645506,2203.911563889,-11
carcassonne-boltzmann350-vs-boltzmann490-1000its,803,814,2236.599568676,2161.124306303,-11
carcassonne-uct260-vs-uct320-1000its,803,814,2202.989588943,2132.924054612,-11
carcassonne-uct380-vs-uct495-1000its,803,814,2186.44875332,2142.129702258,-11
carcassonne-uct305-vs-uct150-1000its,804,815,2159.335924215,2151.10961305,-11
carcassonne-ucttuned155-vs-ucttuned445-1000its,804,815,2285.906440122,2215.558173481,-11
carcassonne-boltzmann235-vs-boltzmann25-1000its,805,816,2196.162412246,2161.075612376,-11
carcassonne-uct5-vs-uct485-1000its,805,816,2242.521340208,2172.844354448,-11
carcassonne-ucttuned175-vs-ucttuned380-1000its,805,816,2204.793783993,2170.803529397,-11
carcassonne-boltzmann90-vs-boltzmann140-1000its,806,817,2262.009514279,2256.019170724,-11
carcassonne-uct235-vs-uct90-1000its,806,817,2238.587200066,2219.151058916,-11
carcassonne-uct260-vs-uct335-1000its,806,817,2199.090115913,2149.639534518,-11
carcassonne-uct440-vs-uct415-1000its,806,817,2287.861861456,2210.676297945,-11
carcassonne-ucttuned190-vs-ucttuned450-1000its,807,818,2226.123491593,2161.677393983,-11
carcassonne-ucttuned320-vs-ucttuned100-1000its,807,818,2193.308040009,2168.196118926,-11
carcassonne-boltzmann475-vs-boltzmann125-1000its,809,820,2149.434570787,2114.543911254,-11
carcassonne-uct290-vs-uct325-1000its,809,820,2143.170860741,2093.915032502,-11
carcassonne-ucttuned425-vs-ucttuned475-1000its,809,820,2258.228214708,2192.877456046,-11
carcassonne-ucttuned250-vs-ucttuned40-1000its,811,822,2147.39069429,2134.433601134,-11
carcassonne-ucttuned95-vs-ucttuned60-1000its,811,822,2166.764856306,2140.016437726,-11
carcassonne-ucttuned40-vs-ucttuned435-1000its,813,824,2244.50270812,2199.583889539,-11
carcassonne-uct205-vs-uct260-1000its,815,826,2187.00016134,2094.877692399,-11
carcassonne-uct390-vs-uct100-1000its,815,826,2214.542642222,2169.366019356,-11
carcassonne-uct50-vs-uct85-1000its,815,826,2162.097631313,2136.771599169,-11
carcassonne-uct150-vs-uct20-1000its,816,827,2163.154233566,2112.463162395,-11
carcassonne-uct395-vs-uct275-1000its,817,828,2148.470130901,2163.274898816,-11
carcassonne-ucttuned80-vs-ucttuned280-1000its,817,828,2250.239130457,2172.442813909,-11
carcassonne-boltzmann135-vs-boltzmann35-1000its,818,829,2233.04952042,2144.340425115,-11
carcassonne-uct160-vs-uct190-1000its,819,830,2162.172766907,2142.107254123,-11
carcassonne-uct275-vs-uct400-1000its,819,830,2159.418010283,2134.420627013,-11
carcassonne-ucttuned165-vs-ucttuned5-1000its,819,830,2172.57607215,2140.48667141,-11
carcassonne-ucttuned455-vs-ucttuned115-1000its,819,830,2178.43105767,2119.383248946,-11
carcassonne-uct145-vs-uct275-1000its,820,831,2213.238433103,2181.678234672,-11
carcassonne-uct260-vs-uct25-1000its,821,832,2268.570258971,2185.726543534,-11
carcassonne-ucttuned265-vs-ucttuned315-1000its,821,832,2175.803576213,2143.756425024,-11
carcassonne-ucttuned485-vs-ucttuned110-1000its,821,832,2180.316439552,2115.893110217,-11
carcassonne-uct120-vs-uct180-1000its,822,833,2200.342351969,2105.835376948,-11
carcassonne-ucttuned125-vs-ucttuned370-1000its,824,835,2261.812124709,2204.509739865,-11
carcassonne-ucttuned205-vs-ucttuned195-1000its,826,837,2226.094201029,2171.384133956,-11
carcassonne-ucttuned370-vs-ucttuned180-1000its,826,837,2156.738602584,2109.865442352,-11
carcassonne-ucttuned170-vs-ucttuned110-1000its,828,839,2120.69844848,2090.181858893,-11
carcassonne-ucttuned290-vs-ucttuned110-1000its,830,841,2217.584697981,2190.051076369,-11
carcassonne-ucttuned435-vs-ucttuned110-1000its,830,841,2212.403326531,2158.800146497,-11
carcassonne-uct340-vs-uct20-1000its,832,843,2201.855544831,2113.765368544,-11
carcassonne-boltzmann215-vs-boltzmann490-1000its,833,844,2175.431891686,2161.947823649,-11
carcassonne-ucttuned345-vs-ucttuned240-1000its,834,845,2190.757769052,2170.577475206,-11
carcassonne-ucttuned415-vs-ucttuned105-1000its,834,845,2148.028018018,2124.544235001,-11
carcassonne-ucttuned450-vs-ucttuned105-1000its,835,846,2247.85763585,2220.93683333,-11
carcassonne-ucttuned490-vs-ucttuned100-1000its,835,846,2232.63443529,2203.928107546,-11
carcassonne-boltzmann340-vs-boltzmann410-1000its,838,849,2195.432302378,2136.008681268,-11
carcassonne-ucttuned265-vs-ucttuned45-1000its,838,849,2187.842582359,2170.646025255,-11
carcassonne-boltzmann275-vs-boltzmann65-1000its,839,850,2130.231287312,2083.709713761,-11
carcassonne-uct315-vs-uct180-1000its,839,850,2153.847023648,2094.803844332,-11
carcassonne-ucttuned265-vs-ucttuned130-1000its,839,850,2152.297420141,2101.648982263,-11
carcassonne-boltzmann340-vs-boltzmann60-1000its,841,852,2136.980223679,2125.790492898,-11
carcassonne-ucttuned235-vs-ucttuned385-1000its,842,853,2143.06514775,2108.95587106,-11
carcassonne-ucttuned145-vs-ucttuned20-1000its,844,855,2154.535684299,2104.614716265,-11
carcassonne-ucttuned150-vs-ucttuned285-1000its,845,856,2222.644026014,2201.255620199,-11
carcassonne-boltzmann120-vs-boltzmann195-1000its,846,857,2166.832497383,2115.786271351,-11
carcassonne-uct160-vs-uct25-1000its,846,857,2193.570718308,2112.512819962,-11
carcassonne-uct90-vs-uct320-1000its,846,857,2240.145260544,2220.21360732,-11
carcassonne-ucttuned165-vs-ucttuned45-1000its,846,857,2217.088825824,2155.51973788,-11
carcassonne-boltzmann320-vs-boltzmann390-1000its,848,859,2224.072412576,2165.101408915,-11
carcassonne-boltzmann95-vs-boltzmann295-1000its,848,859,2190.214100546,2156.577988536,-11
carcassonne-uct275-vs-uct30-1000its,850,861,2172.739908623,2183.246363707,-11
carcassonne-boltzmann75-vs-boltzmann430-1000its,852,863,2228.69852762,2200.985772369,-11
carcassonne-ucttuned155-vs-ucttuned455-1000its,852,863,2212.283556846,2155.822872338,-11
carcassonne-uct390-vs-uct195-1000its,853,864,2194.503555334,2151.261619691,-11
carcassonne-ucttuned380-vs-ucttuned410-1000its,853,864,2252.265916001,2184.334006911,-11
carcassonne-uct135-vs-uct10-1000its,854,865,2240.815992676,2197.465923,-11
carcassonne-uct390-vs-uct220-1000its,854,865,2147.588833316,2108.410352565,-11
carcassonne-boltzmann260-vs-boltzmann125-1000its,855,866,2185.509480811,2176.325736107,-11
carcassonne-boltzmann30-vs-boltzmann255-1000its,856,867,2187.827103677,2112.037004853,-11
carcassonne-boltzmann55-vs-boltzmann60-1000its,856,867,2195.543776985,2157.763590954,-11
carcassonne-uct260-vs-uct420-1000its,856,867,2202.408009464,2164.290386241,-11
carcassonne-uct115-vs-uct465-1000its,857,868,2163.661038591,2109.603313108,-11
carcassonne-ucttuned125-vs-ucttuned75-1000its,862,873,2269.723584933,2230.658110918,-11
carcassonne-boltzmann315-vs-boltzmann150-1000its,863,874,2219.311774035,2159.264394239,-11
carcassonne-ucttuned215-vs-ucttuned405-1000its,866,877,2120.540781727,2065.319182362,-11
carcassonne-uct80-vs-uct280-1000its,871,882,2211.090362179,2198.141017595,-11
carcassonne-uct170-vs-uct390-1000its,874,885,2224.558686493,2145.773899397,-11
carcassonne-ucttuned440-vs-ucttuned385-1000its,874,885,2163.100987315,2125.200355949,-11
carcassonne-ucttuned300-vs-ucttuned20-1000its,881,892,2218.49597455,2181.401078078,-11
carcassonne-ucttuned255-vs-ucttuned160-1000its,883,894,2186.528843984,2110.543198688,-11
carcassonne-uct215-vs-uct5-1000its,890,901,2161.104808333,2174.239389857,-11
carcassonne-ucttuned250-vs-ucttuned330-1000its,900,911,2225.613400719,2237.59995445,-11
carcassonne-uct350-vs-uct5-1000its,930,941,2219.221551402,2198.765524466,-11
carcassonne-ucttuned315-vs-ucttuned150-1000its,699,709,2122.307808514,2078.998131232,-10
carcassonne-uct175-vs-uct100-1000its,720,730,2193.167362584,2139.600483144,-10
carcassonne-boltzmann330-vs-boltzmann200-1000its,727,737,2152.926830203,2112.586741035,-10
carcassonne-uct155-vs-uct300-1000its,728,738,2218.918384075,2171.681076175,-10
carcassonne-boltzmann35-vs-boltzmann310-1000its,735,745,2240.015259252,2204.170553674,-10
carcassonne-uct190-vs-uct210-1000its,735,745,2208.541195974,2162.424430523,-10
carcassonne-ucttuned295-vs-ucttuned220-1000its,737,747,2197.721780908,2150.391814386,-10
carcassonne-ucttuned455-vs-ucttuned470-1000its,741,751,2214.956453988,2199.16660248,-10
carcassonne-ucttuned465-vs-ucttuned310-1000its,743,753,2279.432210462,2243.344448952,-10
carcassonne-ucttuned380-vs-ucttuned345-1000its,744,754,2239.436463232,2177.818106599,-10
carcassonne-boltzmann310-vs-boltzmann80-1000its,747,757,2202.108780143,2129.488261087,-10
carcassonne-boltzmann465-vs-boltzmann45-1000its,747,757,2247.559408095,2198.568053179,-10
carcassonne-uct380-vs-uct445-1000its,747,757,2197.794449197,2160.919796977,-10
carcassonne-ucttuned290-vs-ucttuned185-1000its,747,757,2185.58110342,2132.049717844,-10
carcassonne-boltzmann325-vs-boltzmann115-1000its,749,759,2200.612883801,2179.80191433,-10
carcassonne-ucttuned130-vs-ucttuned20-1000its,749,759,2165.224079081,2146.633394214,-10
carcassonne-boltzmann165-vs-boltzmann195-1000its,751,761,2175.604411535,2154.337680591,-10
carcassonne-uct210-vs-uct360-1000its,752,762,2174.486221163,2137.204149046,-10
carcassonne-ucttuned255-vs-ucttuned355-1000its,753,763,2262.228576167,2171.747665968,-10
carcassonne-boltzmann60-vs-boltzmann70-1000its,754,764,2218.448074648,2164.496738138,-10
carcassonne-uct355-vs-uct290-1000its,755,765,2128.083583928,2103.92725916,-10
carcassonne-boltzmann20-vs-boltzmann80-1000its,756,766,2156.648698251,2113.669827637,-10
carcassonne-ucttuned245-vs-ucttuned20-1000its,757,767,2177.059323355,2164.375451919,-10
carcassonne-ucttuned95-vs-ucttuned30-1000its,757,767,2211.974921366,2185.644996627,-10
carcassonne-ucttuned50-vs-ucttuned20-1000its,758,768,2259.029814952,2206.697532297,-10
carcassonne-boltzmann495-vs-boltzmann350-1000its,761,771,2228.123620265,2180.650411097,-10
carcassonne-boltzmann230-vs-boltzmann60-1000its,762,772,2162.086330081,2154.680604244,-10
carcassonne-ucttuned340-vs-ucttuned25-1000its,764,774,2274.493905831,2213.731559325,-10
carcassonne-ucttuned245-vs-ucttuned475-1000its,765,775,2144.804334945,2124.235419589,-10
carcassonne-boltzmann395-vs-boltzmann185-1000its,766,776,2146.284746023,2085.849248628,-10
carcassonne-ucttuned65-vs-ucttuned320-1000its,767,777,2243.513241469,2237.218938846,-10
carcassonne-uct185-vs-uct300-1000its,768,778,2202.771202209,2151.10222534,-10
carcassonne-ucttuned410-vs-ucttuned340-1000its,769,779,2199.363364491,2174.712625014,-10
carcassonne-boltzmann360-vs-boltzmann10-1000its,771,781,2252.24815064,2196.156585013,-10
carcassonne-uct145-vs-uct140-1000its,774,784,2232.539535727,2180.067369068,-10
carcassonne-ucttuned365-vs-ucttuned335-1000its,774,784,2244.852219013,2174.330071706,-10
carcassonne-ucttuned390-vs-ucttuned470-1000its,774,784,2180.771038031,2138.093515361,-10
carcassonne-boltzmann340-vs-boltzmann35-1000its,775,785,2178.968628744,2114.37526551,-10
carcassonne-uct445-vs-uct295-1000its,775,785,2255.650548759,2168.914253693,-10
carcassonne-boltzmann275-vs-boltzmann105-1000its,776,786,2148.731250795,2128.709712899,-10
carcassonne-boltzmann425-vs-boltzmann375-1000its,776,786,2187.111477039,2134.16140157,-10
carcassonne-uct235-vs-uct50-1000its,776,786,2212.527302272,2184.184188146,-10
carcassonne-boltzmann360-vs-boltzmann450-1000its,777,787,2259.726854049,2194.353917861,-10
carcassonne-uct100-vs-uct120-1000its,777,787,2184.386966036,2146.044464665,-10
carcassonne-ucttuned415-vs-ucttuned130-1000its,779,789,2222.37251169,2131.210032067,-10
carcassonne-uct260-vs-uct465-1000its,782,792,2262.748293438,2208.688754887,-10
carcassonne-ucttuned30-vs-ucttuned95-1000its,782,792,2232.526945587,2224.195200042,-10
carcassonne-uct315-vs-uct460-1000its,783,793,2210.103713837,2164.874548802,-10
carcassonne-boltzmann290-vs-boltzmann430-1000its,784,794,2178.722115687,2071.275700451,-10
carcassonne-boltzmann60-vs-boltzmann325-1000its,785,795,2216.696792293,2144.787767409,-10
carcassonne-boltzmann135-vs-boltzmann15-1000its,786,796,2138.950119694,2103.532132514,-10
carcassonne-boltzmann390-vs-boltzmann215-1000its,786,796,2161.453494262,2093.278590183,-10
carcassonne-uct345-vs-uct35-1000its,787,797,2220.715319915,2150.791045708,-10
carcassonne-uct450-vs-uct285-1000its,787,797,2241.434464231,2205.179023858,-10
carcassonne-ucttuned370-vs-ucttuned360-1000its,788,798,2237.228219971,2185.711592441,-10
carcassonne-boltzmann420-vs-boltzmann295-1000its,789,799,2158.592691363,2102.60296471,-10
carcassonne-boltzmann60-vs-boltzmann215-1000its,789,799,2260.629308976,2183.6270799,-10
carcassonne-ucttuned180-vs-ucttuned390-1000its,789,799,2178.60584443,2133.929306748,-10
carcassonne-boltzmann225-vs-boltzmann340-1000its,791,801,2252.294058897,2188.126387691,-10
carcassonne-ucttuned285-vs-ucttuned65-1000its,791,801,2197.612506897,2162.856695862,-10
carcassonne-boltzmann60-vs-boltzmann100-1000its,793,803,2130.306118146,2096.117883025,-10
carcassonne-ucttuned375-vs-ucttuned340-1000its,793,803,2180.858577334,2120.768515751,-10
carcassonne-boltzmann490-vs-boltzmann380-1000its,795,805,2229.588569458,2180.785806839,-10
carcassonne-uct80-vs-uct460-1000its,795,805,2145.165500118,2100.664928665,-10
carcassonne-ucttuned290-vs-ucttuned70-1000its,795,805,2170.362094451,2160.467670947,-10
carcassonne-boltzmann115-vs-boltzmann295-1000its,796,806,2172.055394004,2089.818159902,-10
carcassonne-boltzmann205-vs-boltzmann150-1000its,796,806,2194.840071384,2134.047553026,-10
carcassonne-boltzmann210-vs-boltzmann40-1000its,796,806,2145.975402719,2097.563743717,-10
carcassonne-uct455-vs-uct445-1000its,797,807,2281.226474675,2190.344896305,-10
carcassonne-boltzmann385-vs-boltzmann420-1000its,799,809,2160.141366289,2112.822378823,-10
carcassonne-uct175-vs-uct205-1000its,799,809,2165.219808475,2096.37583112,-10
carcassonne-uct300-vs-uct480-1000its,799,809,2252.721412876,2150.533006359,-10
carcassonne-uct460-vs-uct90-1000its,800,810,2160.278538709,2113.468784397,-10
carcassonne-uct365-vs-uct145-1000its,801,811,2165.91616006,2118.787091426,-10
carcassonne-uct365-vs-uct185-1000its,802,812,2198.453701674,2133.083481492,-10
carcassonne-uct395-vs-uct250-1000its,803,813,2198.415280498,2145.501132648,-10
carcassonne-boltzmann160-vs-boltzmann370-1000its,804,814,2230.387322179,2164.566857175,-10
carcassonne-boltzmann220-vs-boltzmann190-1000its,804,814,2127.856382978,2070.832889873,-10
carcassonne-boltzmann170-vs-boltzmann470-1000its,807,817,2139.386411667,2153.806623743,-10
carcassonne-ucttuned395-vs-ucttuned155-1000its,807,817,2177.14148584,2094.578780638,-10
carcassonne-boltzmann230-vs-boltzmann335-1000its,808,818,2278.686947674,2223.23791635,-10
carcassonne-uct15-vs-uct90-1000its,808,818,2184.619646657,2153.747409448,-10
carcassonne-ucttuned150-vs-ucttuned475-1000its,808,818,2192.105621334,2166.097307751,-10
carcassonne-ucttuned70-vs-ucttuned385-1000its,808,818,2176.53766946,2134.903398329,-10
carcassonne-ucttuned90-vs-ucttuned205-1000its,808,818,2172.265931436,2137.8771406,-10
carcassonne-uct445-vs-uct10-1000its,809,819,2171.816978328,2164.418890873,-10
carcassonne-ucttuned75-vs-ucttuned445-1000its,809,819,2174.620569584,2169.081818001,-10
carcassonne-boltzmann435-vs-boltzmann290-1000its,810,820,2173.26355941,2150.241454217,-10
carcassonne-boltzmann465-vs-boltzmann255-1000its,810,820,2228.486401423,2188.640659369,-10
carcassonne-ucttuned420-vs-ucttuned130-1000its,811,821,2192.323740105,2119.617744707,-10
carcassonne-boltzmann385-vs-boltzmann120-1000its,812,822,2193.510044378,2133.05089605,-10
carcassonne-uct150-vs-uct130-1000its,812,822,2190.024379087,2152.361937636,-10
carcassonne-uct395-vs-uct15-1000its,812,822,2159.539463139,2161.597711481,-10
carcassonne-uct40-vs-uct285-1000its,812,822,2213.380934309,2159.617123659,-10
carcassonne-uct415-vs-uct5-1000its,813,823,2190.354420026,2168.775054058,-10
carcassonne-ucttuned180-vs-ucttuned230-1000its,813,823,2151.915550717,2111.457400597,-10
carcassonne-boltzmann245-vs-boltzmann215-1000its,814,824,2288.435296009,2222.886342673,-10
carcassonne-boltzmann240-vs-boltzmann390-1000its,815,825,2146.430588286,2089.218707349,-10
carcassonne-ucttuned245-vs-ucttuned280-1000its,815,825,2199.635047939,2117.796148348,-10
carcassonne-ucttuned375-vs-ucttuned210-1000its,815,825,2214.315310633,2170.061564671,-10
carcassonne-uct30-vs-uct95-1000its,817,827,2278.115523702,2178.263148177,-10
carcassonne-uct420-vs-uct435-1000its,817,827,2224.217420306,2176.092991058,-10
carcassonne-ucttuned305-vs-ucttuned165-1000its,817,827,2210.583584981,2154.894056943,-10
carcassonne-boltzmann120-vs-boltzmann475-1000its,818,828,2199.141159241,2142.803566229,-10
carcassonne-boltzmann455-vs-boltzmann65-1000its,818,828,2200.273847415,2168.472666558,-10
carcassonne-uct10-vs-uct255-1000its,818,828,2278.196027881,2193.160740508,-10
carcassonne-uct275-vs-uct310-1000its,818,828,2134.439779824,2091.852241297,-10
carcassonne-uct390-vs-uct170-1000its,818,828,2206.175253996,2137.425657562,-10
carcassonne-ucttuned125-vs-ucttuned135-1000its,819,829,2221.265907396,2200.600319208,-10
carcassonne-ucttuned450-vs-ucttuned35-1000its,819,829,2255.476777749,2250.82617501,-10
carcassonne-ucttuned315-vs-ucttuned325-1000its,820,830,2184.673166425,2187.808170175,-10
carcassonne-ucttuned380-vs-ucttuned265-1000its,820,830,2238.287495497,2182.406098452,-10
carcassonne-ucttuned490-vs-ucttuned480-1000its,821,831,2137.092889233,2109.908502545,-10
carcassonne-boltzmann445-vs-boltzmann230-1000its,822,832,2177.339653801,2144.210466387,-10
carcassonne-uct35-vs-uct390-1000its,823,833,2193.139482928,2183.585591447,-10
carcassonne-ucttuned160-vs-ucttuned240-1000its,823,833,2253.792401779,2209.576255187,-10
carcassonne-ucttuned340-vs-ucttuned10-1000its,823,833,2109.972324282,2116.770404585,-10
carcassonne-ucttuned155-vs-ucttuned35-1000its,824,834,2143.255902996,2099.963721919,-10
carcassonne-ucttuned200-vs-ucttuned60-1000its,825,835,2162.256307017,2138.656132986,-10
carcassonne-ucttuned495-vs-ucttuned330-1000its,825,835,2226.21166804,2159.296473342,-10
carcassonne-uct70-vs-uct470-1000its,828,838,2141.016788207,2125.57509683,-10
carcassonne-ucttuned270-vs-ucttuned235-1000its,828,838,2198.03060802,2153.021719551,-10
carcassonne-ucttuned335-vs-ucttuned345-1000its,828,838,2193.782153671,2143.778442353,-10
carcassonne-ucttuned70-vs-ucttuned180-1000its,830,840,2205.426350994,2158.842590481,-10
carcassonne-uct245-vs-uct175-1000its,831,841,2282.023297113,2253.795203062,-10
carcassonne-ucttuned460-vs-ucttuned50-1000its,831,841,2122.48866758,2099.515075593,-10
carcassonne-uct115-vs-uct245-1000its,832,842,2135.98324173,2133.347501337,-10
carcassonne-uct155-vs-uct430-1000its,832,842,2232.044671925,2204.398753791,-10
carcassonne-ucttuned135-vs-ucttuned65-1000its,832,842,2210.7953645,2168.169603753,-10
carcassonne-ucttuned90-vs-ucttuned40-1000its,834,844,2238.689836759,2183.598468067,-10
carcassonne-boltzmann10-vs-boltzmann190-1000its,835,845,2197.635685824,2159.267365643,-10
carcassonne-uct75-vs-uct305-1000its,835,845,2221.099308381,2183.035706708,-10
carcassonne-boltzmann490-vs-boltzmann395-1000its,836,846,2171.498441533,2138.179007437,-10
carcassonne-uct140-vs-uct325-1000its,836,846,2278.592377711,2209.587494425,-10
carcassonne-boltzmann425-vs-boltzmann370-1000its,837,847,2259.33821687,2212.183917697,-10
carcassonne-boltzmann315-vs-boltzmann125-1000its,839,849,2236.10503734,2202.461498339,-10
carcassonne-boltzmann335-vs-boltzmann245-1000its,839,849,2186.52551805,2148.60430481,-10
carcassonne-boltzmann65-vs-boltzmann30-1000its,842,852,2222.210740545,2165.936334251,-10
carcassonne-boltzmann355-vs-boltzmann105-1000its,843,853,2181.556295151,2137.811778063,-10
carcassonne-boltzmann470-vs-boltzmann200-1000its,844,854,2202.543177859,2137.171802031,-10
carcassonne-ucttuned105-vs-ucttuned30-1000its,846,856,2214.851807665,2184.27010923,-10
carcassonne-uct170-vs-uct25-1000its,847,857,2196.760944221,2127.20369162,-10
carcassonne-ucttuned180-vs-ucttuned120-1000its,847,857,2189.35621498,2155.376258637,-10
carcassonne-boltzmann195-vs-boltzmann110-1000its,848,858,2227.960995389,2191.468189416,-10
carcassonne-boltzmann295-vs-boltzmann65-1000its,849,859,2174.458975112,2126.393132169,-10
carcassonne-uct380-vs-uct435-1000its,850,860,2200.439466976,2206.893231072,-10
carcassonne-uct310-vs-uct90-1000its,852,862,2246.032086876,2226.683114251,-10
carcassonne-uct295-vs-uct105-1000its,854,864,2210.922175965,2143.922824804,-10
carcassonne-ucttuned125-vs-ucttuned95-1000its,857,867,2125.969197314,2078.651944605,-10
carcassonne-uct335-vs-uct410-1000its,859,869,2216.771524182,2138.789454804,-10
carcassonne-ucttuned475-vs-ucttuned110-1000its,859,869,2185.098936869,2148.949427626,-10
carcassonne-ucttuned80-vs-ucttuned465-1000its,862,872,2194.582622484,2140.526457181,-10
carcassonne-uct460-vs-uct375-1000its,865,875,2238.425377312,2173.557842821,-10
carcassonne-boltzmann325-vs-boltzmann205-1000its,866,876,2235.955061166,2172.951752512,-10
carcassonne-uct45-vs-uct425-1000its,866,876,2252.984137228,2169.730449774,-10
carcassonne-uct165-vs-uct60-1000its,872,882,2122.783660765,2044.019970765,-10
carcassonne-ucttuned315-vs-ucttuned135-1000its,873,883,2153.399123313,2110.629456661,-10
carcassonne-boltzmann385-vs-boltzmann360-1000its,876,886,2233.001217969,2182.627284754,-10
carcassonne-boltzmann210-vs-boltzmann165-1000its,877,887,2167.173402346,2142.296047559,-10
carcassonne-ucttuned110-vs-ucttuned455-1000its,883,893,2262.97821846,2194.803572898,-10
carcassonne-ucttuned365-vs-ucttuned100-1000its,913,923,2172.923572022,2146.117146396,-10
carcassonne-ucttuned375-vs-ucttuned265-1000its,711,720,2174.029548345,2091.585965485,-9
carcassonne-boltzmann480-vs-boltzmann420-1000its,718,727,2236.435744238,2196.320127368,-9
carcassonne-boltzmann410-vs-boltzmann70-1000its,728,737,2258.762376537,2241.836531093,-9
carcassonne-boltzmann190-vs-boltzmann395-1000its,731,740,2216.012456886,2182.091870428,-9
carcassonne-boltzmann115-vs-boltzmann230-1000its,734,743,2202.78066431,2164.680981862,-9
carcassonne-boltzmann40-vs-boltzmann340-1000its,736,745,2232.044915848,2206.172445147,-9
carcassonne-uct365-vs-uct45-1000its,736,745,2218.573962709,2176.123217534,-9
carcassonne-boltzmann130-vs-boltzmann305-1000its,737,746,2220.718458899,2158.42412762,-9
carcassonne-boltzmann220-vs-boltzmann100-1000its,739,748,2191.879761947,2166.806502228,-9
carcassonne-uct140-vs-uct135-1000its,740,749,2171.229178707,2109.728053591,-9
carcassonne-uct250-vs-uct430-1000its,741,750,2147.134640636,2124.679747976,-9
carcassonne-boltzmann70-vs-boltzmann350-1000its,742,751,2230.189685733,2198.262843541,-9
carcassonne-ucttuned230-vs-ucttuned245-1000its,742,751,2163.749928118,2152.234208617,-9
carcassonne-ucttuned275-vs-ucttuned155-1000its,747,756,2165.400712021,2125.404796015,-9
carcassonne-boltzmann290-vs-boltzmann65-1000its,749,758,2237.292719818,2205.576677555,-9
carcassonne-ucttuned285-vs-ucttuned300-1000its,751,760,2254.074295438,2232.76244169,-9
carcassonne-boltzmann345-vs-boltzmann425-1000its,755,764,2225.325939347,2178.342615903,-9
carcassonne-ucttuned130-vs-ucttuned90-1000its,758,767,2245.315654313,2204.980629182,-9
carcassonne-ucttuned355-vs-ucttuned225-1000its,760,769,2219.330300312,2160.436971618,-9
carcassonne-uct275-vs-uct375-1000its,762,771,2152.677448206,2132.864366666,-9
carcassonne-ucttuned495-vs-ucttuned310-1000its,762,771,2140.136410416,2088.250602824,-9
carcassonne-boltzmann460-vs-boltzmann315-1000its,765,774,2230.166776618,2164.213525203,-9
carcassonne-uct85-vs-uct415-1000its,768,777,2215.983587945,2195.380834784,-9
carcassonne-boltzmann480-vs-boltzmann215-1000its,770,779,2179.883199809,2180.767381865,-9
carcassonne-uct470-vs-uct20-1000its,771,780,2139.375950692,2123.883499333,-9
carcassonne-boltzmann390-vs-boltzmann95-1000its,774,783,2206.844999911,2125.186634489,-9
carcassonne-boltzmann200-vs-boltzmann60-1000its,775,784,2213.324586435,2170.991656093,-9
carcassonne-ucttuned295-vs-ucttuned85-1000its,775,784,2155.033432976,2125.222065689,-9
carcassonne-boltzmann300-vs-boltzmann5-1000its,776,785,2134.729921786,2132.15875366,-9
carcassonne-boltzmann210-vs-boltzmann235-1000its,777,786,2204.78379978,2159.559268633,-9
carcassonne-boltzmann270-vs-boltzmann15-1000its,779,788,2219.766274923,2169.325608841,-9
carcassonne-boltzmann295-vs-boltzmann320-1000its,779,788,2162.452476167,2100.955582963,-9
carcassonne-uct75-vs-uct380-1000its,781,790,2196.481532257,2179.271731858,-9
carcassonne-ucttuned35-vs-ucttuned95-1000its,782,791,2151.873547878,2081.26995342,-9
carcassonne-boltzmann225-vs-boltzmann250-1000its,783,792,2133.401530988,2070.598677432,-9
carcassonne-ucttuned250-vs-ucttuned390-1000its,784,793,2179.134687723,2157.940517147,-9
carcassonne-ucttuned415-vs-ucttuned210-1000its,784,793,2181.009844722,2155.032253995,-9
carcassonne-uct320-vs-uct75-1000its,786,795,2250.275444694,2164.624489295,-9
carcassonne-uct330-vs-uct475-1000its,786,795,2252.818912092,2223.162845209,-9
carcassonne-boltzmann155-vs-boltzmann115-1000its,787,796,2198.558041966,2198.58521817,-9
carcassonne-boltzmann55-vs-boltzmann470-1000its,788,797,2189.252291133,2139.285239972,-9
carcassonne-uct135-vs-uct460-1000its,790,799,2234.364517953,2213.488962471,-9
carcassonne-uct355-vs-uct385-1000its,792,801,2235.444146974,2181.722899711,-9
carcassonne-ucttuned120-vs-ucttuned415-1000its,792,801,2200.391790935,2175.47803063,-9
carcassonne-boltzmann390-vs-boltzmann150-1000its,794,803,2145.321756997,2098.985364739,-9
carcassonne-uct315-vs-uct85-1000its,795,804,2258.884821987,2180.974097946,-9
carcassonne-uct115-vs-uct175-1000its,797,806,2213.801024998,2183.469244715,-9
carcassonne-boltzmann100-vs-boltzmann255-1000its,798,807,2202.591006137,2141.486152194,-9
carcassonne-ucttuned260-vs-ucttuned240-1000its,798,807,2223.751046299,2172.356470848,-9
carcassonne-uct190-vs-uct310-1000its,799,808,2268.54454539,2216.00554937,-9
carcassonne-uct245-vs-uct440-1000its,799,808,2148.647669395,2161.499677934,-9
carcassonne-uct445-vs-uct475-1000its,799,808,2129.148685493,2096.608071688,-9
carcassonne-uct240-vs-uct35-1000its,800,809,2167.080412616,2117.096267258,-9
carcassonne-boltzmann200-vs-boltzmann285-1000its,801,810,2171.231504041,2121.658874918,-9
carcassonne-boltzmann220-vs-boltzmann215-1000its,801,810,2207.148640564,2182.367433613,-9
carcassonne-ucttuned175-vs-ucttuned450-1000its,805,814,2259.372935015,2135.056433002,-9
carcassonne-boltzmann140-vs-boltzmann340-1000its,806,815,2268.537869044,2192.228180028,-9
carcassonne-boltzmann15-vs-boltzmann390-1000its,806,815,2193.411459405,2169.927260507,-9
carcassonne-boltzmann30-vs-boltzmann475-1000its,806,815,2198.49825233,2098.190524556,-9
carcassonne-boltzmann40-vs-boltzmann425-1000its,807,816,2113.648025215,2117.266545814,-9
carcassonne-uct45-vs-uct235-1000its,807,816,2246.36810602,2203.326237872,-9
carcassonne-uct50-vs-uct335-1000its,807,816,2201.766857729,2154.257667106,-9
carcassonne-ucttuned365-vs-ucttuned185-1000its,807,816,2214.275841009,2154.06803995,-9
carcassonne-boltzmann365-vs-boltzmann90-1000its,809,818,2169.836431815,2153.342974507,-9
carcassonne-boltzmann470-vs-boltzmann305-1000its,810,819,2146.418786413,2144.566709789,-9
carcassonne-uct355-vs-uct440-1000its,810,819,2271.279335004,2210.39964385,-9
carcassonne-ucttuned390-vs-ucttuned365-1000its,810,819,2169.848464311,2146.599240422,-9
carcassonne-boltzmann420-vs-boltzmann285-1000its,811,820,2181.166942263,2166.994979149,-9
carcassonne-uct150-vs-uct345-1000its,811,820,2212.138975786,2151.365177384,-9
carcassonne-uct240-vs-uct375-1000its,812,821,2212.627393294,2159.985265554,-9
carcassonne-uct295-vs-uct390-1000its,812,821,2195.780402744,2141.42393714,-9
carcassonne-ucttuned215-vs-ucttuned135-1000its,812,821,2150.052958352,2127.617559313,-9
carcassonne-ucttuned220-vs-ucttuned250-1000its,812,821,2234.104630416,2193.858657219,-9
carcassonne-boltzmann185-vs-boltzmann305-1000its,816,825,2249.163913715,2203.742242912,-9
carcassonne-boltzmann260-vs-boltzmann105-1000its,816,825,2210.749115086,2150.814558185,-9
carcassonne-uct35-vs-uct75-1000its,816,825,2203.178666991,2173.770818718,-9
carcassonne-uct405-vs-uct105-1000its,817,826,2172.672020195,2156.602141232,-9
carcassonne-ucttuned240-vs-ucttuned280-1000its,819,828,2213.268433098,2153.933466054,-9
carcassonne-ucttuned170-vs-ucttuned270-1000its,820,829,2228.420045449,2236.736743243,-9
carcassonne-uct45-vs-uct65-1000its,821,830,2268.210905887,2196.625592224,-9
carcassonne-ucttuned420-vs-ucttuned175-1000its,821,830,2185.173934081,2139.271518079,-9
carcassonne-boltzmann195-vs-boltzmann420-1000its,822,831,2205.07278148,2156.705502475,-9
carcassonne-boltzmann455-vs-boltzmann250-1000its,822,831,2142.426671362,2125.209037218,-9
carcassonne-boltzmann5-vs-boltzmann180-1000its,822,831,2177.517895302,2150.847550637,-9
carcassonne-uct170-vs-uct335-1000its,824,833,2115.753432028,2140.292506585,-9
carcassonne-ucttuned275-vs-ucttuned390-1000its,824,833,2171.313801507,2106.977162068,-9
carcassonne-boltzmann20-vs-boltzmann320-1000its,826,835,2267.159489501,2192.840466915,-9
carcassonne-boltzmann460-vs-boltzmann495-1000its,826,835,2157.096092749,2119.342716859,-9
carcassonne-uct220-vs-uct135-1000its,826,835,2248.001048444,2178.324756328,-9
carcassonne-uct235-vs-uct135-1000its,826,835,2204.430752047,2202.14652541,-9
carcassonne-boltzmann10-vs-boltzmann175-1000its,828,837,2187.972834316,2123.989731505,-9
carcassonne-uct215-vs-uct315-1000its,829,838,2220.48780084,2151.035935171,-9
carcassonne-uct305-vs-uct400-1000its,829,838,2236.693047434,2197.453805059,-9
carcassonne-uct425-vs-uct175-1000its,830,839,2263.522736012,2178.503228595,-9
carcassonne-boltzmann10-vs-boltzmann380-1000its,831,840,2166.78564859,2109.323003726,-9
carcassonne-uct495-vs-uct125-1000its,831,840,2249.930713982,2234.727816985,-9
carcassonne-ucttuned205-vs-ucttuned155-1000its,831,840,2248.175365637,2195.331912547,-9
carcassonne-ucttuned205-vs-ucttuned5-1000its,834,843,2272.666808658,2231.195075133,-9
carcassonne-uct285-vs-uct260-1000its,835,844,2254.596241913,2224.626999177,-9
carcassonne-ucttuned135-vs-ucttuned120-1000its,836,845,2160.677814975,2163.530137564,-9
carcassonne-uct225-vs-uct55-1000its,837,846,2277.863289861,2211.818900658,-9
carcassonne-uct280-vs-uct355-1000its,837,846,2186.196532792,2151.391760671,-9
carcassonne-ucttuned455-vs-ucttuned5-1000its,838,847,2211.536140826,2148.526426239,-9
carcassonne-boltzmann255-vs-boltzmann470-1000its,839,848,2229.231730063,2160.522982681,-9
carcassonne-uct390-vs-uct40-1000its,839,848,2199.760842365,2131.682342098,-9
carcassonne-boltzmann295-vs-boltzmann170-1000its,842,851,2172.648870771,2140.512362438,-9
carcassonne-boltzmann30-vs-boltzmann170-1000its,844,853,2173.885106573,2160.441313269,-9
carcassonne-ucttuned205-vs-ucttuned185-1000its,844,853,2186.961408182,2174.454504046,-9
carcassonne-boltzmann290-vs-boltzmann470-1000its,845,854,2185.944229828,2145.888472233,-9
carcassonne-uct35-vs-uct490-1000its,846,855,2169.012916744,2128.474555923,-9
carcassonne-ucttuned20-vs-ucttuned315-1000its,846,855,2154.924651886,2128.503587651,-9
carcassonne-ucttuned315-vs-ucttuned485-1000its,847,856,2219.60234483,2147.55263865,-9
carcassonne-boltzmann160-vs-boltzmann435-1000its,848,857,2144.99508552,2128.618702673,-9
carcassonne-ucttuned340-vs-ucttuned130-1000its,848,857,2270.279276273,2184.337479614,-9
carcassonne-boltzmann215-vs-boltzmann255-1000its,850,859,2169.562243889,2132.950208538,-9
carcassonne-ucttuned210-vs-ucttuned55-1000its,850,859,2266.85989882,2242.760341803,-9
carcassonne-ucttuned380-vs-ucttuned60-1000its,850,859,2132.548848272,2101.351633904,-9
carcassonne-ucttuned410-vs-ucttuned300-1000its,850,859,2143.885368447,2087.467361677,-9
carcassonne-ucttuned285-vs-ucttuned175-1000its,856,865,2215.095062244,2166.59979632,-9
carcassonne-ucttuned360-vs-ucttuned100-1000its,860,869,2262.253600565,2194.378514556,-9
carcassonne-boltzmann185-vs-boltzmann260-1000its,864,873,2195.147797063,2135.990585506,-9
carcassonne-ucttuned75-vs-ucttuned5-1000its,864,873,2200.748988504,2133.226727499,-9
carcassonne-uct65-vs-uct445-1000its,865,874,2126.617674798,2101.528992319,-9
carcassonne-boltzmann375-vs-boltzmann215-1000its,867,876,2267.264950223,2221.838315442,-9
carcassonne-ucttuned345-vs-ucttuned15-1000its,867,876,2194.376851325,2111.314485222,-9
carcassonne-boltzmann385-vs-boltzmann15-1000its,868,877,2175.8703496,2159.2665321,-9
carcassonne-ucttuned225-vs-ucttuned365-1000its,876,885,2188.704589605,2129.380723026,-9
carcassonne-boltzmann450-vs-boltzmann400-1000its,881,890,2141.416968983,2086.647896994,-9
carcassonne-ucttuned155-vs-ucttuned5-1000its,889,898,2206.097576923,2193.36215948,-9
carcassonne-ucttuned340-vs-ucttuned140-1000its,890,899,2213.220627051,2140.754441966,-9
carcassonne-ucttuned460-vs-ucttuned15-1000its,892,901,2194.185142832,2138.802644329,-9
carcassonne-uct195-vs-uct5-1000its,906,915,2159.240008494,2148.829127058,-9
carcassonne-boltzmann30-vs-boltzmann390-1000its,942,951,2185.144349204,2146.667852466,-9
carcassonne-ucttuned420-vs-ucttuned280-1000its,942,951,2263.27409884,2251.878029495,-9
carcassonne-boltzmann175-vs-boltzmann280-1000its,698,706,2178.684712819,2159.949545803,-8
carcassonne-uct85-vs-uct380-1000its,720,728,2186.082575385,2139.95332996,-8
carcassonne-boltzmann190-vs-boltzmann170-1000its,722,730,2185.883226989,2196.464817754,-8
carcassonne-ucttuned220-vs-ucttuned205-1000its,732,740,2215.616668133,2150.357219295,-8
carcassonne-ucttuned170-vs-ucttuned145-1000its,736,744,2152.217082856,2124.709596031,-8
carcassonne-uct10-vs-uct360-1000its,738,746,2168.682575201,2125.336749721,-8
carcassonne-boltzmann165-vs-boltzmann240-1000its,740,748,2181.781356262,2158.194379813,-8
carcassonne-boltzmann130-vs-boltzmann100-1000its,741,749,2094.493975182,2119.161329251,-8
carcassonne-uct350-vs-uct30-1000its,743,751,2274.560844034,2255.574030648,-8
carcassonne-boltzmann275-vs-boltzmann100-1000its,745,753,2138.649079331,2085.086562651,-8
carcassonne-uct70-vs-uct455-1000its,745,753,2240.613604369,2185.599030892,-8
carcassonne-ucttuned165-vs-ucttuned75-1000its,746,754,2152.287055694,2101.467813098,-8
carcassonne-ucttuned485-vs-ucttuned315-1000its,747,755,2185.584314852,2155.308939265,-8
carcassonne-boltzmann420-vs-boltzmann290-1000its,748,756,2221.737506029,2154.945786903,-8
carcassonne-uct45-vs-uct415-1000its,748,756,2225.681351569,2207.264923975,-8
carcassonne-boltzmann230-vs-boltzmann355-1000its,750,758,2241.90365353,2173.232957304,-8
carcassonne-uct280-vs-uct130-1000its,751,759,2174.56683658,2114.285684372,-8
carcassonne-boltzmann150-vs-boltzmann110-1000its,753,761,2184.27306488,2091.240596222,-8
carcassonne-boltzmann75-vs-boltzmann90-1000its,754,762,2189.80819993,2124.984793107,-8
carcassonne-ucttuned135-vs-ucttuned430-1000its,754,762,2218.02812594,2193.225845126,-8
carcassonne-boltzmann310-vs-boltzmann260-1000its,755,763,2197.184805529,2174.139585669,-8
carcassonne-boltzmann365-vs-boltzmann185-1000its,755,763,2227.688793509,2163.494479579,-8
carcassonne-ucttuned305-vs-ucttuned275-1000its,755,763,2217.941155716,2184.972688836,-8
carcassonne-ucttuned120-vs-ucttuned425-1000its,760,768,2277.591627687,2193.003311394,-8
carcassonne-uct125-vs-uct185-1000its,763,771,2228.85597778,2171.986984851,-8
carcassonne-ucttuned405-vs-ucttuned305-1000its,763,771,2241.135143522,2143.805608316,-8
carcassonne-boltzmann20-vs-boltzmann375-1000its,766,774,2280.737434384,2207.544395201,-8
carcassonne-boltzmann480-vs-boltzmann65-1000its,766,774,2151.989390771,2103.100347171,-8
carcassonne-boltzmann70-vs-boltzmann155-1000its,766,774,2152.742240972,2104.737091106,-8
carcassonne-uct185-vs-uct360-1000its,766,774,2347.189490507,2298.258230363,-8
carcassonne-boltzmann265-vs-boltzmann175-1000its,767,775,2226.939061212,2138.765516985,-8
carcassonne-boltzmann355-vs-boltzmann395-1000its,767,775,2187.125188534,2140.77457483,-8
carcassonne-uct75-vs-uct230-1000its,767,775,2225.26750733,2216.405444542,-8
carcassonne-boltzmann130-vs-boltzmann10-1000its,768,776,2168.656602034,2142.110298889,-8
carcassonne-boltzmann350-vs-boltzmann280-1000its,768,776,2155.736218725,2118.556340236,-8
carcassonne-uct260-vs-uct300-1000its,769,777,2245.557437915,2207.302127397,-8
carcassonne-ucttuned35-vs-ucttuned485-1000its,769,777,2187.298198332,2097.864895941,-8
carcassonne-ucttuned290-vs-ucttuned425-1000its,771,779,2198.452903799,2169.707364606,-8
carcassonne-boltzmann405-vs-boltzmann235-1000its,773,781,2119.400154886,2081.005772245,-8
carcassonne-uct190-vs-uct260-1000its,773,781,2263.477484305,2246.643213189,-8
carcassonne-uct235-vs-uct100-1000its,773,781,2202.449409521,2168.838467849,-8
carcassonne-uct260-vs-uct275-1000its,774,782,2128.008359319,2095.823142502,-8
carcassonne-boltzmann255-vs-boltzmann330-1000its,775,783,2166.493166571,2105.991383502,-8
carcassonne-uct375-vs-uct395-1000its,775,783,2243.969582088,2147.063292381,-8
carcassonne-uct320-vs-uct260-1000its,777,785,2230.689186203,2159.77339921,-8
carcassonne-uct465-vs-uct190-1000its,777,785,2259.083758646,2167.553324344,-8
carcassonne-ucttuned210-vs-ucttuned105-1000its,778,786,2256.237241963,2203.405514125,-8
carcassonne-ucttuned280-vs-ucttuned300-1000its,778,786,2163.046977434,2087.774150608,-8
carcassonne-ucttuned85-vs-ucttuned40-1000its,778,786,2213.03419079,2160.808534833,-8
carcassonne-boltzmann405-vs-boltzmann90-1000its,780,788,2192.863826588,2185.023787011,-8
carcassonne-ucttuned380-vs-ucttuned465-1000its,780,788,2195.893917054,2182.993255837,-8
carcassonne-ucttuned445-vs-ucttuned470-1000its,780,788,2302.422367243,2236.96160186,-8
carcassonne-uct170-vs-uct495-1000its,781,789,2212.166628612,2232.569095839,-8
carcassonne-ucttuned75-vs-ucttuned425-1000its,781,789,2184.053437369,2124.414044383,-8
carcassonne-uct35-vs-uct160-1000its,783,791,2342.239238867,2294.232771993,-8
carcassonne-uct485-vs-uct165-1000its,783,791,2181.136523944,2107.038783485,-8
carcassonne-ucttuned230-vs-ucttuned450-1000its,783,791,2272.134352958,2253.715866896,-8
carcassonne-ucttuned380-vs-ucttuned350-1000its,784,792,2195.101768193,2171.737215998,-8
carcassonne-boltzmann340-vs-boltzmann165-1000its,785,793,2180.483345506,2096.78848105,-8
carcassonne-boltzmann55-vs-boltzmann10-1000its,785,793,2265.102843515,2196.745447825,-8
carcassonne-uct280-vs-uct145-1000its,785,793,2135.313030117,2154.99284515,-8
carcassonne-uct455-vs-uct290-1000its,787,795,2220.054622678,2162.870113581,-8
carcassonne-uct60-vs-uct395-1000its,787,795,2162.334969752,2121.901921102,-8
carcassonne-ucttuned80-vs-ucttuned15-1000its,787,795,2191.61427519,2177.437068929,-8
carcassonne-boltzmann470-vs-boltzmann280-1000its,788,796,2185.982205088,2189.351934608,-8
carcassonne-boltzmann215-vs-boltzmann180-1000its,789,797,2121.72089626,2047.877236039,-8
carcassonne-uct145-vs-uct30-1000its,789,797,2212.591309442,2211.569635412,-8
carcassonne-boltzmann150-vs-boltzmann285-1000its,791,799,2197.277319742,2179.194562204,-8
carcassonne-boltzmann195-vs-boltzmann315-1000its,792,800,2148.842699197,2085.54258728,-8
carcassonne-boltzmann270-vs-boltzmann285-1000its,792,800,2201.11076294,2164.38595785,-8
carcassonne-boltzmann365-vs-boltzmann100-1000its,792,800,2241.470016567,2230.428915357,-8
carcassonne-ucttuned270-vs-ucttuned275-1000its,792,800,2173.052659962,2134.559406725,-8
carcassonne-boltzmann70-vs-boltzmann180-1000its,793,801,2222.956068863,2128.136004402,-8
carcassonne-uct390-vs-uct275-1000its,793,801,2206.693592863,2091.593592606,-8
carcassonne-uct485-vs-uct325-1000its,793,801,2287.223438235,2239.307143085,-8
carcassonne-uct60-vs-uct465-1000its,793,801,2174.374636091,2104.380528864,-8
carcassonne-boltzmann200-vs-boltzmann305-1000its,794,802,2159.486838879,2124.401339739,-8
carcassonne-boltzmann320-vs-boltzmann105-1000its,794,802,2258.69786144,2202.896820785,-8
carcassonne-ucttuned280-vs-ucttuned150-1000its,794,802,2205.469568043,2129.470438934,-8
carcassonne-ucttuned215-vs-ucttuned95-1000its,796,804,2118.070606373,2092.303708923,-8
carcassonne-ucttuned455-vs-ucttuned320-1000its,797,805,2186.245813358,2104.404185481,-8
carcassonne-boltzmann255-vs-boltzmann45-1000its,798,806,2293.71990525,2234.129154478,-8
carcassonne-boltzmann150-vs-boltzmann90-1000its,799,807,2138.893656427,2129.385936681,-8
carcassonne-boltzmann355-vs-boltzmann65-1000its,800,808,2206.794826309,2141.732704802,-8
carcassonne-uct110-vs-uct360-1000its,801,809,2221.882435509,2224.709327944,-8
carcassonne-uct35-vs-uct430-1000its,801,809,2174.418226205,2130.783159088,-8
carcassonne-uct95-vs-uct180-1000its,801,809,2235.908488173,2185.774670803,-8
carcassonne-ucttuned120-vs-ucttuned430-1000its,801,809,2164.198540863,2071.958594448,-8
carcassonne-ucttuned125-vs-ucttuned360-1000its,801,809,2181.711208482,2130.02352295,-8
carcassonne-ucttuned140-vs-ucttuned120-1000its,801,809,2187.649592984,2129.607458234,-8
carcassonne-uct360-vs-uct265-1000its,803,811,2172.253344062,2120.170139015,-8
carcassonne-uct465-vs-uct10-1000its,803,811,2193.592822021,2162.446351213,-8
carcassonne-uct485-vs-uct180-1000its,803,811,2155.931852901,2084.79159374,-8
carcassonne-uct125-vs-uct20-1000its,805,813,2228.503673435,2211.084248792,-8
carcassonne-uct225-vs-uct445-1000its,805,813,2213.450160288,2173.321635803,-8
carcassonne-ucttuned285-vs-ucttuned380-1000its,805,813,2150.475324529,2082.58026071,-8
carcassonne-ucttuned415-vs-ucttuned205-1000its,806,814,2279.468294408,2224.393229914,-8
carcassonne-ucttuned235-vs-ucttuned380-1000its,807,815,2202.478147747,2235.542003292,-8
carcassonne-ucttuned140-vs-ucttuned365-1000its,809,817,2136.641655109,2109.138491352,-8
carcassonne-ucttuned375-vs-ucttuned115-1000its,810,818,2232.684037031,2174.128423268,-8
carcassonne-boltzmann35-vs-boltzmann270-1000its,811,819,2136.377810789,2111.734589229,-8
carcassonne-uct385-vs-uct145-1000its,812,820,2212.695658235,2161.204444067,-8
carcassonne-uct205-vs-uct250-1000its,813,821,2206.564616527,2146.626761076,-8
carcassonne-uct220-vs-uct360-1000its,813,821,2144.55370048,2074.616720267,-8
carcassonne-boltzmann40-vs-boltzmann220-1000its,814,822,2126.662922439,2140.12141225,-8
carcassonne-boltzmann440-vs-boltzmann335-1000its,814,822,2209.108300751,2173.554944039,-8
carcassonne-boltzmann45-vs-boltzmann280-1000its,814,822,2163.919121163,2094.037133869,-8
carcassonne-ucttuned275-vs-ucttuned410-1000its,816,824,2199.356629386,2148.726621049,-8
carcassonne-ucttuned50-vs-ucttuned495-1000its,816,824,2121.841500275,2108.499602954,-8
carcassonne-boltzmann220-vs-boltzmann465-1000its,817,825,2140.872926444,2149.163687849,-8
carcassonne-boltzmann185-vs-boltzmann125-1000its,818,826,2235.071175717,2192.75817633,-8
carcassonne-uct415-vs-uct205-1000its,818,826,2259.53313597,2166.073866617,-8
carcassonne-ucttuned405-vs-ucttuned195-1000its,818,826,2207.726103261,2152.149481732,-8
carcassonne-ucttuned440-vs-ucttuned380-1000its,818,826,2163.193701315,2107.636108149,-8
carcassonne-boltzmann80-vs-boltzmann90-1000its,819,827,2222.437942197,2158.40995056,-8
carcassonne-ucttuned410-vs-ucttuned55-1000its,820,828,2147.23228303,2126.506895023,-8
carcassonne-boltzmann200-vs-boltzmann435-1000its,821,829,2175.672174216,2108.541993907,-8
carcassonne-ucttuned465-vs-ucttuned120-1000its,821,829,2199.832676354,2169.102911902,-8
carcassonne-uct165-vs-uct70-1000its,822,830,2192.654865923,2158.066686858,-8
carcassonne-ucttuned100-vs-ucttuned275-1000its,822,830,2237.746142214,2203.817651288,-8
carcassonne-ucttuned125-vs-ucttuned180-1000its,824,832,2217.287084718,2194.081679489,-8
carcassonne-uct465-vs-uct245-1000its,825,833,2161.723911936,2126.657736087,-8
carcassonne-ucttuned40-vs-ucttuned120-1000its,825,833,2191.613512949,2152.48237312,-8
carcassonne-ucttuned40-vs-ucttuned195-1000its,825,833,2313.85228014,2276.268405096,-8
carcassonne-uct300-vs-uct435-1000its,827,835,2163.496935306,2134.984651024,-8
carcassonne-ucttuned15-vs-ucttuned85-1000its,827,835,2244.712629127,2193.795942614,-8
carcassonne-ucttuned190-vs-ucttuned405-1000its,827,835,2211.281147102,2195.153029259,-8
carcassonne-boltzmann110-vs-boltzmann385-1000its,828,836,2122.858199567,2077.761240155,-8
carcassonne-boltzmann190-vs-boltzmann195-1000its,828,836,2194.649392093,2091.808763386,-8
carcassonne-boltzmann195-vs-boltzmann495-1000its,829,837,2210.173194513,2167.188881005,-8
carcassonne-uct15-vs-uct345-1000its,829,837,2201.243361999,2189.461405044,-8
carcassonne-uct280-vs-uct250-1000its,829,837,2260.188716984,2230.283452843,-8
carcassonne-boltzmann90-vs-boltzmann215-1000its,831,839,2194.324946282,2181.087745418,-8
carcassonne-uct325-vs-uct165-1000its,831,839,2186.461593509,2169.508446649,-8
carcassonne-ucttuned305-vs-ucttuned255-1000its,831,839,2193.061733246,2169.918446598,-8
carcassonne-uct300-vs-uct185-1000its,832,840,2231.82041128,2165.126292771,-8
carcassonne-ucttuned40-vs-ucttuned70-1000its,832,840,2168.526236805,2112.452732084,-8
carcassonne-ucttuned230-vs-ucttuned490-1000its,833,841,2143.660359865,2145.586481758,-8
carcassonne-uct440-vs-uct495-1000its,834,842,2239.124113929,2186.830550484,-8
carcassonne-ucttuned280-vs-ucttuned285-1000its,834,842,2238.742097902,2199.171194494,-8
carcassonne-boltzmann125-vs-boltzmann400-1000its,835,843,2213.933124909,2171.443395339,-8
carcassonne-uct230-vs-uct300-1000its,836,844,2199.140370728,2162.700956194,-8
carcassonne-uct485-vs-uct240-1000its,836,844,2222.075663284,2149.726583432,-8
carcassonne-ucttuned140-vs-ucttuned95-1000its,836,844,2159.038766749,2125.48363004,-8
carcassonne-ucttuned100-vs-ucttuned375-1000its,837,845,2156.179291515,2151.299759917,-8
carcassonne-boltzmann395-vs-boltzmann410-1000its,838,846,2200.414197622,2172.905924643,-8
carcassonne-uct145-vs-uct75-1000its,839,847,2212.235551942,2153.284975971,-8
carcassonne-uct150-vs-uct35-1000its,840,848,2192.56605638,2141.208853154,-8
carcassonne-ucttuned400-vs-ucttuned265-1000its,840,848,2234.211215685,2193.177072459,-8
carcassonne-ucttuned440-vs-ucttuned320-1000its,840,848,2205.792142468,2171.847625395,-8
carcassonne-boltzmann335-vs-boltzmann485-1000its,843,851,2198.313890104,2116.011384292,-8
carcassonne-uct140-vs-uct390-1000its,843,851,2212.70032276,2147.278328725,-8
carcassonne-uct285-vs-uct425-1000its,843,851,2207.318628812,2158.237971499,-8
carcassonne-uct410-vs-uct465-1000its,848,856,2257.931841716,2206.714523055,-8
carcassonne-boltzmann150-vs-boltzmann65-1000its,849,857,2147.518174411,2147.936527808,-8
carcassonne-uct400-vs-uct95-1000its,849,857,2205.34476527,2145.4286053,-8
carcassonne-boltzmann230-vs-boltzmann490-1000its,853,861,2252.239876835,2150.940251147,-8
carcassonne-boltzmann150-vs-boltzmann485-1000its,854,862,2236.920441474,2160.047271662,-8
carcassonne-ucttuned325-vs-ucttuned110-1000its,854,862,2288.313906747,2236.508358837,-8
carcassonne-boltzmann70-vs-boltzmann360-1000its,855,863,2163.09741334,2110.375434616,-8
carcassonne-uct465-vs-uct155-1000its,857,865,2261.838987446,2216.327179345,-8
carcassonne-ucttuned120-vs-ucttuned470-1000its,858,866,2155.229725505,2122.607854324,-8
carcassonne-ucttuned315-vs-ucttuned95-1000its,860,868,2163.579594251,2086.844033414,-8
carcassonne-uct165-vs-uct375-1000its,862,870,2200.970480002,2189.198173712,-8
carcassonne-ucttuned305-vs-ucttuned430-1000its,862,870,2233.455271399,2225.204202826,-8
carcassonne-uct160-vs-uct310-1000its,865,873,2256.980327692,2177.309561618,-8
carcassonne-boltzmann25-vs-boltzmann240-1000its,866,874,2235.847194476,2149.559913003,-8
carcassonne-uct315-vs-uct5-1000its,866,874,2160.300695619,2104.250562213,-8
carcassonne-uct275-vs-uct270-1000its,881,889,2181.603904545,2163.126066196,-8
carcassonne-boltzmann270-vs-boltzmann120-1000its,882,890,2225.755277847,2193.454240951,-8
carcassonne-ucttuned235-vs-ucttuned15-1000its,887,895,2159.042280739,2126.070457142,-8
carcassonne-uct125-vs-uct10-1000its,888,896,2212.810726838,2165.576678722,-8
carcassonne-uct395-vs-uct470-1000its,889,897,2195.91672314,2147.107241222,-8
carcassonne-uct60-vs-uct250-1000its,894,902,2132.276081797,2075.66943435,-8
carcassonne-boltzmann190-vs-boltzmann275-1000its,896,904,2180.105345293,2149.630700278,-8
carcassonne-ucttuned275-vs-ucttuned125-1000its,911,919,2223.730176659,2197.097054029,-8
carcassonne-boltzmann30-vs-boltzmann265-1000its,914,922,2165.406637292,2147.785791156,-8
carcassonne-ucttuned310-vs-ucttuned260-1000its,725,732,2193.126300492,2130.164524222,-7
carcassonne-boltzmann345-vs-boltzmann455-1000its,736,743,2147.301654414,2118.302660118,-7
carcassonne-ucttuned245-vs-ucttuned100-1000its,736,743,2245.180918034,2217.386337067,-7
carcassonne-ucttuned80-vs-ucttuned385-1000its,737,744,2162.637332958,2160.383859626,-7
carcassonne-boltzmann280-vs-boltzmann495-1000its,740,747,2192.27026377,2152.344509126,-7
carcassonne-ucttuned230-vs-ucttuned460-1000its,740,747,2173.822028919,2170.269562202,-7
carcassonne-boltzmann10-vs-boltzmann135-1000its,744,751,2223.28914996,2160.22277115,-7
carcassonne-boltzmann55-vs-boltzmann380-1000its,746,753,2114.256976083,2114.667954976,-7
carcassonne-ucttuned490-vs-ucttuned340-1000its,746,753,2228.701195858,2168.67805449,-7
carcassonne-boltzmann145-vs-boltzmann450-1000its,747,754,2214.135900648,2183.009453598,-7
carcassonne-boltzmann225-vs-boltzmann130-1000its,749,756,2243.487087061,2237.66737524,-7
carcassonne-boltzmann200-vs-boltzmann25-1000its,754,761,2212.743353658,2180.312014841,-7
carcassonne-boltzmann315-vs-boltzmann445-1000its,754,761,2162.488349742,2114.9940176,-7
carcassonne-boltzmann95-vs-boltzmann345-1000its,756,763,2196.945544445,2108.640239691,-7
carcassonne-uct265-vs-uct135-1000its,757,764,2218.156241842,2176.583140179,-7
carcassonne-boltzmann475-vs-boltzmann430-1000its,759,766,2175.21386431,2134.967879395,-7
carcassonne-boltzmann290-vs-boltzmann225-1000its,761,768,2207.043200216,2174.461314405,-7
carcassonne-ucttuned415-vs-ucttuned465-1000its,763,770,2256.629791742,2173.761060773,-7
carcassonne-ucttuned435-vs-ucttuned335-1000its,763,770,2244.387807569,2218.0691257,-7
carcassonne-uct370-vs-uct185-1000its,767,774,2141.834216453,2106.771123171,-7
carcassonne-uct110-vs-uct255-1000its,769,776,2179.478482557,2191.163884347,-7
carcassonne-boltzmann385-vs-boltzmann225-1000its,771,778,2282.13715825,2187.343305276,-7
carcassonne-boltzmann300-vs-boltzmann250-1000its,772,779,2267.345577731,2220.323865967,-7
carcassonne-uct200-vs-uct380-1000its,772,779,2212.950217762,2196.784736636,-7
carcassonne-uct420-vs-uct240-1000its,773,780,2180.771304874,2125.261930029,-7
carcassonne-boltzmann220-vs-boltzmann450-1000its,774,781,2293.408356401,2207.996624461,-7
carcassonne-uct130-vs-uct215-1000its,774,781,2194.421420128,2127.527318423,-7
carcassonne-uct470-vs-uct275-1000its,774,781,2181.039257334,2161.293806157,-7
carcassonne-boltzmann105-vs-boltzmann90-1000its,775,782,2212.743234036,2157.917490403,-7
carcassonne-boltzmann180-vs-boltzmann395-1000its,775,782,2216.220996004,2194.630845069,-7
carcassonne-uct215-vs-uct120-1000its,776,783,2201.64850363,2165.786406353,-7
carcassonne-boltzmann230-vs-boltzmann280-1000its,777,784,2210.062342055,2152.165941934,-7
carcassonne-boltzmann260-vs-boltzmann235-1000its,777,784,2142.251473356,2139.693274104,-7
carcassonne-boltzmann450-vs-boltzmann410-1000its,780,787,2207.005100623,2181.368623772,-7
carcassonne-ucttuned55-vs-ucttuned135-1000its,780,787,2144.273911836,2068.415276881,-7
carcassonne-boltzmann160-vs-boltzmann145-1000its,781,788,2236.92783934,2144.641422847,-7
carcassonne-uct310-vs-uct325-1000its,781,788,2206.25495047,2151.741261359,-7
carcassonne-ucttuned105-vs-ucttuned185-1000its,781,788,2272.777088862,2193.859414222,-7
carcassonne-uct130-vs-uct305-1000its,783,790,2205.11547143,2170.272682422,-7
carcassonne-ucttuned450-vs-ucttuned205-1000its,783,790,2190.561137921,2186.5409347,-7
carcassonne-uct320-vs-uct310-1000its,784,791,2145.892917382,2105.370460352,-7
carcassonne-ucttuned5-vs-ucttuned250-1000its,784,791,2216.929671553,2177.501577632,-7
carcassonne-uct470-vs-uct190-1000its,785,792,2214.778219838,2167.800353853,-7
carcassonne-uct30-vs-uct220-1000its,787,794,2169.843973472,2123.485550655,-7
carcassonne-uct355-vs-uct255-1000its,787,794,2241.307677908,2195.786739449,-7
carcassonne-uct360-vs-uct270-1000its,787,794,2135.344209196,2080.157636148,-7
carcassonne-uct175-vs-uct25-1000its,788,795,2210.516729103,2178.810827688,-7
carcassonne-uct345-vs-uct120-1000its,788,795,2198.625923281,2165.477782887,-7
carcassonne-boltzmann460-vs-boltzmann35-1000its,789,796,2224.149832494,2166.532593864,-7
carcassonne-ucttuned300-vs-ucttuned185-1000its,789,796,2186.712786668,2174.835854467,-7
carcassonne-uct330-vs-uct280-1000its,791,798,2232.102756319,2164.245897967,-7
carcassonne-ucttuned275-vs-ucttuned10-1000its,791,798,2173.449500201,2196.776807745,-7
carcassonne-boltzmann295-vs-boltzmann255-1000its,792,799,2203.144970594,2174.39324291,-7
carcassonne-uct265-vs-uct345-1000its,792,799,2274.702325878,2209.823592639,-7
carcassonne-ucttuned120-vs-ucttuned305-1000its,792,799,2140.921337662,2139.382688263,-7
carcassonne-uct250-vs-uct340-1000its,793,800,2215.209790706,2185.928186223,-7
carcassonne-uct470-vs-uct285-1000its,794,801,2226.830784802,2187.507580563,-7
carcassonne-ucttuned135-vs-ucttuned340-1000its,794,801,2138.580551421,2126.376842417,-7
carcassonne-boltzmann180-vs-boltzmann250-1000its,796,803,2204.762580427,2183.07119665,-7
carcassonne-uct110-vs-uct275-1000its,796,803,2216.643878054,2165.55194487,-7
carcassonne-ucttuned140-vs-ucttuned255-1000its,796,803,2200.069456219,2147.819941168,-7
carcassonne-boltzmann425-vs-boltzmann390-1000its,797,804,2286.496898282,2195.826232899,-7
carcassonne-ucttuned385-vs-ucttuned50-1000its,797,804,2161.633733816,2109.389365309,-7
carcassonne-ucttuned415-vs-ucttuned310-1000its,797,804,2200.352001063,2181.760907897,-7
carcassonne-boltzmann160-vs-boltzmann80-1000its,799,806,2174.160808007,2185.323936654,-7
carcassonne-boltzmann35-vs-boltzmann480-1000its,799,806,2176.149454509,2131.214829904,-7
carcassonne-uct15-vs-uct425-1000its,799,806,2218.758479252,2189.466706154,-7
carcassonne-ucttuned170-vs-ucttuned30-1000its,799,806,2182.090175714,2129.871916699,-7
carcassonne-ucttuned320-vs-ucttuned200-1000its,800,807,2155.24331125,2150.235786799,-7
carcassonne-boltzmann360-vs-boltzmann55-1000its,801,808,2193.636233822,2162.041006222,-7
carcassonne-ucttuned490-vs-ucttuned220-1000its,801,808,2207.735915752,2112.681162353,-7
carcassonne-uct205-vs-uct335-1000its,804,811,2239.653951426,2152.88105857,-7
carcassonne-ucttuned110-vs-ucttuned145-1000its,804,811,2235.53232572,2208.693471414,-7
carcassonne-ucttuned355-vs-ucttuned80-1000its,804,811,2191.765911256,2190.625952631,-7
carcassonne-ucttuned385-vs-ucttuned125-1000its,804,811,2185.980660701,2167.564744058,-7
carcassonne-ucttuned5-vs-ucttuned80-1000its,805,812,2096.540140694,2084.795291068,-7
carcassonne-uct25-vs-uct185-1000its,806,813,2169.198297644,2140.750052105,-7
carcassonne-ucttuned155-vs-ucttuned60-1000its,806,813,2177.456684929,2195.062492782,-7
carcassonne-ucttuned240-vs-ucttuned475-1000its,806,813,2181.263127977,2165.697659541,-7
carcassonne-boltzmann400-vs-boltzmann155-1000its,807,814,2161.133618353,2114.654986183,-7
carcassonne-uct430-vs-uct150-1000its,807,814,2226.140749579,2180.071276603,-7
carcassonne-uct460-vs-uct485-1000its,807,814,2163.234797985,2145.167351381,-7
carcassonne-boltzmann125-vs-boltzmann205-1000its,809,816,2187.086118076,2157.97109321,-7
carcassonne-ucttuned110-vs-ucttuned15-1000its,809,816,2200.207579969,2205.08469914,-7
carcassonne-boltzmann260-vs-boltzmann110-1000its,810,817,2230.6856987,2180.05517998,-7
carcassonne-uct250-vs-uct275-1000its,810,817,2263.856848523,2216.484641572,-7
carcassonne-ucttuned90-vs-ucttuned270-1000its,810,817,2208.945127402,2160.421953229,-7
carcassonne-uct180-vs-uct160-1000its,811,818,2209.801327689,2152.672591579,-7
carcassonne-ucttuned185-vs-ucttuned180-1000its,812,819,2175.923819208,2193.692799739,-7
carcassonne-ucttuned450-vs-ucttuned320-1000its,812,819,2293.473779105,2255.291193455,-7
carcassonne-ucttuned450-vs-ucttuned370-1000its,812,819,2154.053730866,2112.469565548,-7
carcassonne-uct295-vs-uct305-1000its,814,821,2181.648151414,2177.351636134,-7
carcassonne-ucttuned190-vs-ucttuned165-1000its,814,821,2196.583130046,2115.484584725,-7
carcassonne-ucttuned215-vs-ucttuned420-1000its,814,821,2173.28090298,2131.354021028,-7
carcassonne-boltzmann465-vs-boltzmann150-1000its,815,822,2146.686719955,2126.597046689,-7
carcassonne-ucttuned445-vs-ucttuned450-1000its,815,822,2193.14860491,2143.072138063,-7
carcassonne-uct265-vs-uct420-1000its,816,823,2166.664611691,2137.605874727,-7
carcassonne-ucttuned50-vs-ucttuned150-1000its,816,823,2119.03128696,2068.689752412,-7
carcassonne-boltzmann245-vs-boltzmann80-1000its,817,824,2143.930426784,2107.780091086,-7
carcassonne-boltzmann135-vs-boltzmann40-1000its,818,825,2200.633145404,2126.056365339,-7
carcassonne-ucttuned255-vs-ucttuned395-1000its,818,825,2125.505986565,2086.478477741,-7
carcassonne-ucttuned185-vs-ucttuned355-1000its,820,827,2200.220608485,2152.324211169,-7
carcassonne-boltzmann290-vs-boltzmann50-1000its,822,829,2227.387665897,2204.977320417,-7
carcassonne-ucttuned250-vs-ucttuned205-1000its,822,829,2210.436275319,2163.343997135,-7
carcassonne-ucttuned495-vs-ucttuned150-1000its,822,829,2209.220268432,2150.760833958,-7
carcassonne-boltzmann360-vs-boltzmann330-1000its,823,830,2175.915436881,2131.524005701,-7
carcassonne-ucttuned20-vs-ucttuned145-1000its,823,830,2205.457176068,2153.880252839,-7
carcassonne-uct230-vs-uct150-1000its,824,831,2249.776095685,2206.301847415,-7
carcassonne-uct340-vs-uct180-1000its,824,831,2167.495661714,2074.861969646,-7
carcassonne-ucttuned135-vs-ucttuned285-1000its,826,833,2230.550961989,2180.147140783,-7
carcassonne-ucttuned205-vs-ucttuned345-1000its,827,834,2143.941092981,2137.43949105,-7
carcassonne-boltzmann150-vs-boltzmann365-1000its,829,836,2228.943609083,2157.77701961,-7
carcassonne-uct410-vs-uct25-1000its,829,836,2277.13574063,2233.278077006,-7
carcassonne-ucttuned350-vs-ucttuned210-1000its,830,837,2231.703427616,2188.716597901,-7
carcassonne-boltzmann95-vs-boltzmann305-1000its,832,839,2187.275975841,2173.871492057,-7
carcassonne-uct50-vs-uct290-1000its,832,839,2204.860690237,2134.845085925,-7
carcassonne-boltzmann35-vs-boltzmann445-1000its,833,840,2121.935895119,2056.271166468,-7
carcassonne-uct150-vs-uct435-1000its,833,840,2176.229495864,2142.324595227,-7
carcassonne-boltzmann405-vs-boltzmann460-1000its,835,842,2202.987302645,2201.684247561,-7
carcassonne-uct70-vs-uct100-1000its,835,842,2217.806694583,2168.099070571,-7
carcassonne-ucttuned150-vs-ucttuned495-1000its,835,842,2238.883790403,2175.57187563,-7
carcassonne-ucttuned365-vs-ucttuned155-1000its,836,843,2230.234572536,2158.307484227,-7
carcassonne-ucttuned320-vs-ucttuned205-1000its,837,844,2150.180065203,2143.557956927,-7
carcassonne-boltzmann420-vs-boltzmann250-1000its,841,848,2156.60991474,2102.38665307,-7
carcassonne-ucttuned255-vs-ucttuned60-1000its,841,848,2159.908569243,2113.337388853,-7
carcassonne-ucttuned70-vs-ucttuned135-1000its,841,848,2199.30475193,2167.64793685,-7
carcassonne-ucttuned155-vs-ucttuned375-1000its,843,850,2220.965033182,2189.495793832,-7
carcassonne-ucttuned5-vs-ucttuned165-1000its,843,850,2138.311799646,2076.23734834,-7
carcassonne-boltzmann15-vs-boltzmann185-1000its,846,853,2199.861006194,2162.935941141,-7
carcassonne-boltzmann40-vs-boltzmann345-1000its,846,853,2189.295398033,2182.235775238,-7
carcassonne-boltzmann70-vs-boltzmann25-1000its,847,854,2159.979389997,2166.025784719,-7
carcassonne-ucttuned315-vs-ucttuned295-1000its,847,854,2239.545597408,2166.368944887,-7
carcassonne-uct200-vs-uct390-1000its,848,855,2293.419188023,2226.009909466,-7
carcassonne-uct220-vs-uct100-1000its,851,858,2185.217402662,2142.958886998,-7
carcassonne-ucttuned20-vs-ucttuned110-1000its,851,858,2246.705382803,2202.032967832,-7
carcassonne-uct240-vs-uct430-1000its,852,859,2267.053341316,2227.504439871,-7
carcassonne-uct35-vs-uct150-1000its,853,860,2224.031034269,2155.96529173,-7
carcassonne-ucttuned170-vs-ucttuned70-1000its,854,861,2172.61355572,2116.532474386,-7
carcassonne-ucttuned120-vs-ucttuned250-1000its,855,862,2256.467610998,2167.906790369,-7
carcassonne-uct80-vs-uct305-1000its,856,863,2216.590664482,2186.887397067,-7
carcassonne-boltzmann320-vs-boltzmann450-1000its,857,864,2304.539240936,2275.189652589,-7
carcassonne-uct5-vs-uct210-1000its,857,864,2194.706684886,2157.770359328,-7
carcassonne-boltzmann330-vs-boltzmann275-1000its,860,867,2202.520537185,2147.606059786,-7
carcassonne-ucttuned230-vs-ucttuned240-1000its,860,867,2169.171141656,2125.903641616,-7
carcassonne-ucttuned70-vs-ucttuned190-1000its,862,869,2225.98061454,2155.233528499,-7
carcassonne-boltzmann160-vs-boltzmann330-1000its,866,873,2225.832253071,2253.410246424,-7
carcassonne-ucttuned195-vs-ucttuned25-1000its,867,874,2202.709444575,2169.774630289,-7
carcassonne-ucttuned45-vs-ucttuned120-1000its,868,875,2197.104119195,2152.457116697,-7
carcassonne-ucttuned470-vs-ucttuned450-1000its,872,879,2243.470648204,2215.255605383,-7
carcassonne-boltzmann210-vs-boltzmann480-1000its,875,882,2212.64151294,2182.2018469,-7
carcassonne-boltzmann135-vs-boltzmann295-1000its,876,883,2178.30645881,2148.149284959,-7
carcassonne-ucttuned275-vs-ucttuned210-1000its,877,884,2208.582057871,2150.439753807,-7
carcassonne-ucttuned200-vs-ucttuned45-1000its,878,885,2160.269289437,2149.471892008,-7
carcassonne-uct220-vs-uct85-1000its,879,886,2135.26567757,2113.893934606,-7
carcassonne-ucttuned425-vs-ucttuned470-1000its,881,888,2228.613950595,2178.190700029,-7
carcassonne-ucttuned10-vs-ucttuned55-1000its,883,890,2184.350700221,2163.936758655,-7
carcassonne-boltzmann85-vs-boltzmann20-1000its,884,891,2185.409775454,2138.259527862,-7
carcassonne-ucttuned190-vs-ucttuned75-1000its,886,893,2171.699506416,2150.647759634,-7
carcassonne-boltzmann170-vs-boltzmann230-1000its,887,894,2252.793999049,2186.283620943,-7
carcassonne-boltzmann5-vs-boltzmann15-1000its,889,896,2115.682630703,2091.377195514,-7
carcassonne-ucttuned320-vs-ucttuned35-1000its,889,896,2160.31481265,2143.149507619,-7
carcassonne-uct65-vs-uct305-1000its,902,909,2180.215795086,2122.866526061,-7
carcassonne-uct240-vs-uct60-1000its,905,912,2183.661908378,2102.967033466,-7
carcassonne-boltzmann445-vs-boltzmann100-1000its,688,694,2159.603490324,2128.05996798,-6
carcassonne-ucttuned95-vs-ucttuned80-1000its,691,697,1681.7357762,1661.677567442,-6
carcassonne-boltzmann95-vs-boltzmann490-1000its,719,725,2245.035705418,2247.024827083,-6
carcassonne-ucttuned445-vs-ucttuned430-1000its,719,725,2211.381843752,2170.566505164,-6
carcassonne-ucttuned470-vs-ucttuned340-1000its,735,741,2141.917547103,2125.81807118,-6
carcassonne-ucttuned140-vs-ucttuned300-1000its,740,746,2245.328267117,2209.940084467,-6
carcassonne-boltzmann440-vs-boltzmann350-1000its,749,755,2203.208706855,2103.07442172,-6
carcassonne-ucttuned160-vs-ucttuned145-1000its,751,757,2174.349855212,2139.148877158,-6
carcassonne-ucttuned215-vs-ucttuned265-1000its,751,757,2217.256488008,2202.843782093,-6
carcassonne-ucttuned355-vs-ucttuned300-1000its,754,760,2181.683709776,2170.448720161,-6
carcassonne-uct340-vs-uct155-1000its,755,761,2156.4673214,2106.346140118,-6
carcassonne-uct205-vs-uct265-1000its,758,764,2165.931499536,2124.765198227,-6
carcassonne-boltzmann270-vs-boltzmann185-1000its,759,765,2199.451342208,2138.199697391,-6
carcassonne-boltzmann150-vs-boltzmann160-1000its,760,766,2142.138286784,2089.661522632,-6
carcassonne-ucttuned150-vs-ucttuned75-1000its,760,766,2173.761093867,2135.662274999,-6
carcassonne-ucttuned190-vs-ucttuned425-1000its,760,766,2191.623120678,2149.656175093,-6
carcassonne-ucttuned475-vs-ucttuned150-1000its,760,766,2169.533349098,2141.59661635,-6
carcassonne-boltzmann20-vs-boltzmann110-1000its,762,768,2240.102715475,2177.136391704,-6
carcassonne-uct300-vs-uct375-1000its,762,768,2219.107991379,2129.893235753,-6
carcassonne-ucttuned190-vs-ucttuned330-1000its,763,769,2125.995148801,2070.046638086,-6
carcassonne-boltzmann135-vs-boltzmann285-1000its,765,771,2197.342198481,2190.254278456,-6
carcassonne-boltzmann155-vs-boltzmann375-1000its,765,771,2176.65263083,2148.413105579,-6
carcassonne-boltzmann480-vs-boltzmann185-1000its,765,771,2211.852081412,2116.669483877,-6
carcassonne-boltzmann235-vs-boltzmann390-1000its,766,772,2164.224001759,2118.17040472,-6
carcassonne-boltzmann420-vs-boltzmann265-1000its,766,772,2131.894725307,2131.176929276,-6
carcassonne-uct110-vs-uct385-1000its,766,772,2151.88442566,2128.892440559,-6
carcassonne-ucttuned250-vs-ucttuned165-1000its,766,772,2196.395178528,2191.526584471,-6
carcassonne-boltzmann165-vs-boltzmann470-1000its,767,773,2173.257145162,2102.265856524,-6
carcassonne-uct435-vs-uct150-1000its,772,778,2227.65184895,2165.411872247,-6
carcassonne-boltzmann420-vs-boltzmann495-1000its,774,780,2194.793801832,2145.871139491,-6
carcassonne-ucttuned220-vs-ucttuned265-1000its,776,782,2196.235079043,2135.392022792,-6
carcassonne-ucttuned265-vs-ucttuned135-1000its,777,783,2149.799821072,2092.218374263,-6
carcassonne-boltzmann325-vs-boltzmann480-1000its,778,784,2173.588444526,2111.339372246,-6
carcassonne-boltzmann425-vs-boltzmann180-1000its,779,785,2284.627351831,2175.235286691,-6
carcassonne-uct405-vs-uct355-1000its,780,786,2206.052042287,2142.295248658,-6
carcassonne-ucttuned175-vs-ucttuned480-1000its,780,786,2163.580780048,2116.756360267,-6
carcassonne-uct450-vs-uct490-1000its,783,789,2215.598484469,2155.555247801,-6
carcassonne-boltzmann275-vs-boltzmann400-1000its,787,793,2209.313114031,2134.354205704,-6
carcassonne-ucttuned50-vs-ucttuned55-1000its,787,793,2244.221572238,2195.103807182,-6
carcassonne-boltzmann240-vs-boltzmann430-1000its,788,794,2231.620814967,2161.042717862,-6
carcassonne-ucttuned10-vs-ucttuned25-1000its,788,794,2209.155528612,2156.50312115,-6
carcassonne-uct400-vs-uct130-1000its,789,795,2158.888666368,2144.895575123,-6
carcassonne-ucttuned55-vs-ucttuned335-1000its,789,795,2253.558770357,2198.244503054,-6
carcassonne-ucttuned455-vs-ucttuned425-1000its,790,796,2185.273424024,2123.800228328,-6
carcassonne-boltzmann375-vs-boltzmann345-1000its,791,797,2222.606669673,2182.82705871,-6
carcassonne-uct100-vs-uct405-1000its,791,797,2194.023553909,2168.418678548,-6
carcassonne-ucttuned160-vs-ucttuned405-1000its,792,798,2187.600635364,2161.949661121,-6
carcassonne-uct330-vs-uct5-1000its,793,799,2210.586542988,2143.476118395,-6
carcassonne-ucttuned325-vs-ucttuned25-1000its,793,799,2215.18193498,2186.072194044,-6
carcassonne-boltzmann390-vs-boltzmann300-1000its,794,800,2214.365466315,2182.010787426,-6
carcassonne-uct260-vs-uct345-1000its,795,801,2213.865164703,2172.246661136,-6
carcassonne-boltzmann130-vs-boltzmann35-1000its,796,802,2221.406343137,2181.690168063,-6
carcassonne-boltzmann485-vs-boltzmann240-1000its,796,802,2137.968631464,2096.059073866,-6
carcassonne-boltzmann90-vs-boltzmann205-1000its,796,802,2145.034116616,2085.794096933,-6
carcassonne-uct80-vs-uct235-1000its,796,802,2177.778434143,2166.536844821,-6
carcassonne-boltzmann315-vs-boltzmann325-1000its,798,804,2251.723251653,2161.909678825,-6
carcassonne-boltzmann440-vs-boltzmann85-1000its,799,805,2204.320373226,2134.675309977,-6
carcassonne-uct235-vs-uct185-1000its,799,805,2264.9087807,2231.1053438,-6
carcassonne-ucttuned425-vs-ucttuned340-1000its,799,805,2194.579683334,2141.626849527,-6
carcassonne-uct180-vs-uct115-1000its,800,806,2195.427746486,2135.129779395,-6
carcassonne-uct60-vs-uct450-1000its,800,806,2165.219668777,2167.061571397,-6
carcassonne-ucttuned140-vs-ucttuned130-1000its,801,807,2148.801320204,2116.883448647,-6
carcassonne-ucttuned385-vs-ucttuned475-1000its,801,807,2134.622029495,2099.812812874,-6
carcassonne-ucttuned395-vs-ucttuned20-1000its,801,807,2214.002770805,2132.327619935,-6
carcassonne-boltzmann60-vs-boltzmann470-1000its,802,808,2257.876137601,2226.107128185,-6
carcassonne-ucttuned495-vs-ucttuned210-1000its,802,808,2212.142058574,2197.985394253,-6
carcassonne-uct335-vs-uct440-1000its,803,809,2209.004226614,2179.239849592,-6
carcassonne-ucttuned345-vs-ucttuned250-1000its,804,810,2224.151576002,2155.876955689,-6
carcassonne-boltzmann20-vs-boltzmann180-1000its,805,811,2247.138423494,2191.697939066,-6
carcassonne-uct180-vs-uct485-1000its,805,811,2217.112113186,2155.190752181,-6
carcassonne-ucttuned335-vs-ucttuned405-1000its,805,811,2127.746341996,2123.210457316,-6
carcassonne-boltzmann315-vs-boltzmann275-1000its,806,812,2255.974213289,2181.927087578,-6
carcassonne-uct475-vs-uct125-1000its,806,812,2119.834788314,2064.681423112,-6
carcassonne-ucttuned380-vs-ucttuned470-1000its,807,813,2153.633582043,2117.362292469,-6
carcassonne-boltzmann10-vs-boltzmann295-1000its,808,814,2160.37224337,2123.379359071,-6
carcassonne-uct80-vs-uct395-1000its,808,814,2199.090196868,2168.521655704,-6
carcassonne-ucttuned170-vs-ucttuned360-1000its,808,814,2197.205315565,2146.271719406,-6
carcassonne-ucttuned90-vs-ucttuned335-1000its,810,816,2153.742970436,2103.939625436,-6
carcassonne-boltzmann125-vs-boltzmann290-1000its,811,817,2172.903960075,2165.396740286,-6
carcassonne-ucttuned35-vs-ucttuned120-1000its,811,817,2161.417995634,2132.277033379,-6
carcassonne-ucttuned30-vs-ucttuned400-1000its,813,819,2232.368539715,2180.093345382,-6
carcassonne-ucttuned425-vs-ucttuned300-1000its,813,819,2162.228010447,2090.654095608,-6
carcassonne-boltzmann290-vs-boltzmann95-1000its,814,820,2148.975942499,2087.844937835,-6
carcassonne-boltzmann370-vs-boltzmann230-1000its,814,820,2225.160514927,2171.630417743,-6
carcassonne-uct145-vs-uct470-1000its,814,820,2224.440893171,2158.750227352,-6
carcassonne-boltzmann365-vs-boltzmann215-1000its,816,822,2132.597224811,2093.247362854,-6
carcassonne-ucttuned365-vs-ucttuned255-1000its,816,822,2282.350532921,2218.408639889,-6
carcassonne-boltzmann395-vs-boltzmann95-1000its,817,823,2233.564219998,2135.101296071,-6
carcassonne-uct145-vs-uct35-1000its,817,823,2209.985857679,2098.391601838,-6
carcassonne-uct265-vs-uct10-1000its,818,824,2203.058103433,2205.112688582,-6
carcassonne-ucttuned185-vs-ucttuned345-1000its,819,825,2198.954983974,2111.478624089,-6
carcassonne-boltzmann110-vs-boltzmann260-1000its,821,827,2197.572797861,2167.502842831,-6
carcassonne-boltzmann265-vs-boltzmann440-1000its,821,827,2218.229889695,2132.26135474,-6
carcassonne-uct65-vs-uct480-1000its,823,829,2167.632231248,2138.535807575,-6
carcassonne-boltzmann485-vs-boltzmann290-1000its,824,830,2197.479742364,2143.830836551,-6
carcassonne-uct55-vs-uct455-1000its,824,830,2197.415989907,2147.11384667,-6
carcassonne-ucttuned115-vs-ucttuned5-1000its,824,830,2160.729515632,2114.369159037,-6
carcassonne-ucttuned250-vs-ucttuned230-1000its,824,830,2234.281318709,2155.665705901,-6
carcassonne-ucttuned180-vs-ucttuned65-1000its,825,831,2286.857263543,2224.533159103,-6
carcassonne-uct45-vs-uct285-1000its,826,832,2193.83043487,2144.045034315,-6
carcassonne-uct430-vs-uct60-1000its,827,833,2154.272069406,2146.939544761,-6
carcassonne-boltzmann125-vs-boltzmann365-1000its,828,834,2183.411571834,2131.277920845,-6
carcassonne-uct295-vs-uct260-1000its,828,834,2166.801951523,2131.583179446,-6
carcassonne-ucttuned95-vs-ucttuned185-1000its,828,834,2196.140654975,2126.603538362,-6
carcassonne-boltzmann285-vs-boltzmann145-1000its,829,835,2170.027338449,2100.646533438,-6
carcassonne-uct205-vs-uct455-1000its,829,835,2232.808485589,2152.756620648,-6
carcassonne-uct385-vs-uct200-1000its,829,835,2233.346105861,2126.426249725,-6
carcassonne-uct475-vs-uct410-1000its,829,835,2229.678875296,2210.009791708,-6
carcassonne-ucttuned290-vs-ucttuned220-1000its,829,835,2141.500811345,2071.571953996,-6
carcassonne-boltzmann290-vs-boltzmann20-1000its,830,836,2297.363675959,2239.536467881,-6
carcassonne-uct270-vs-uct345-1000its,831,837,2207.818029827,2131.063317256,-6
carcassonne-uct360-vs-uct325-1000its,831,837,2176.100640496,2156.716882443,-6
carcassonne-ucttuned110-vs-ucttuned415-1000its,832,838,2116.456014035,2064.36485424,-6
carcassonne-ucttuned20-vs-ucttuned95-1000its,832,838,2198.447161776,2157.847335573,-6
carcassonne-boltzmann70-vs-boltzmann470-1000its,833,839,2243.096841807,2148.441555785,-6
carcassonne-ucttuned390-vs-ucttuned240-1000its,833,839,2226.742507013,2176.51089279,-6
carcassonne-ucttuned55-vs-ucttuned40-1000its,834,840,2256.176509547,2207.10188492,-6
carcassonne-uct125-vs-uct70-1000its,835,841,2188.977897191,2145.985829398,-6
carcassonne-ucttuned340-vs-ucttuned475-1000its,836,842,2219.448272476,2150.470352338,-6
carcassonne-ucttuned495-vs-ucttuned230-1000its,836,842,2146.787159161,2102.806864399,-6
carcassonne-boltzmann280-vs-boltzmann275-1000its,837,843,2228.840801947,2138.085039099,-6
carcassonne-ucttuned425-vs-ucttuned280-1000its,837,843,2137.673981651,2119.889364138,-6
carcassonne-boltzmann195-vs-boltzmann145-1000its,838,844,2135.915306458,2088.921985905,-6
carcassonne-ucttuned140-vs-ucttuned220-1000its,838,844,2195.146132462,2153.04944898,-6
carcassonne-ucttuned165-vs-ucttuned220-1000its,839,845,2110.210985314,2098.565702308,-6
carcassonne-ucttuned420-vs-ucttuned400-1000its,839,845,2217.126244218,2183.172618545,-6
carcassonne-boltzmann315-vs-boltzmann310-1000its,840,846,2239.459449849,2135.522892411,-6
carcassonne-uct70-vs-uct200-1000its,842,848,2176.562540123,2128.820134705,-6
carcassonne-ucttuned190-vs-ucttuned200-1000its,842,848,2222.869702061,2199.407756696,-6
carcassonne-uct10-vs-uct230-1000its,844,850,2171.17620437,2108.01963023,-6
carcassonne-uct380-vs-uct150-1000its,844,850,2181.13281676,2138.140519713,-6
carcassonne-ucttuned145-vs-ucttuned355-1000its,845,851,2157.525480789,2130.482197481,-6
carcassonne-ucttuned165-vs-ucttuned330-1000its,845,851,2175.883442978,2118.26775143,-6
carcassonne-uct35-vs-uct480-1000its,847,853,2216.146642063,2156.687752992,-6
carcassonne-ucttuned380-vs-ucttuned180-1000its,848,854,2143.401312,2088.535120658,-6
carcassonne-uct55-vs-uct380-1000its,850,856,2152.558446141,2134.663136319,-6
carcassonne-ucttuned190-vs-ucttuned295-1000its,850,856,2211.487036884,2147.507019709,-6
carcassonne-boltzmann45-vs-boltzmann455-1000its,854,860,2222.925910573,2150.142047501,-6
carcassonne-uct265-vs-uct90-1000its,855,861,2170.776139865,2110.644099259,-6
carcassonne-uct260-vs-uct220-1000its,859,865,2123.259942471,2112.010167885,-6
carcassonne-ucttuned295-vs-ucttuned455-1000its,859,865,2243.323651813,2188.343134518,-6
carcassonne-boltzmann295-vs-boltzmann285-1000its,863,869,2251.409131028,2262.14892621,-6
carcassonne-uct395-vs-uct110-1000its,865,871,2199.069600465,2194.931553177,-6
carcassonne-ucttuned195-vs-ucttuned250-1000its,865,871,2232.32427492,2159.532160647,-6
carcassonne-uct185-vs-uct100-1000its,866,872,2204.047966287,2166.861284523,-6
carcassonne-uct5-vs-uct350-1000its,869,875,2131.774777593,2106.228913979,-6
carcassonne-ucttuned30-vs-ucttuned495-1000its,871,877,2246.808660813,2227.498378263,-6
carcassonne-boltzmann330-vs-boltzmann310-1000its,874,880,2174.480721157,2142.227416333,-6
carcassonne-uct310-vs-uct255-1000its,875,881,2259.124426519,2216.656803671,-6
carcassonne-uct145-vs-uct25-1000its,876,882,2233.570198048,2206.885106799,-6
carcassonne-uct20-vs-uct375-1000its,878,884,2161.718922456,2126.681918046,-6
carcassonne-uct425-vs-uct410-1000its,879,885,2170.821176818,2177.897598178,-6
carcassonne-uct400-vs-uct365-1000its,890,896,2126.283068609,2073.409506109,-6
carcassonne-uct275-vs-uct85-1000its,897,903,2173.523954681,2127.670696165,-6
carcassonne-ucttuned150-vs-ucttuned40-1000its,898,904,2260.498330288,2232.024177552,-6
carcassonne-boltzmann105-vs-boltzmann170-1000its,699,704,2180.798741042,2157.450705328,-5
carcassonne-uct100-vs-uct290-1000its,716,721,2193.621666856,2143.728539606,-5
carcassonne-ucttuned240-vs-ucttuned420-1000its,734,739,2190.485338116,2139.029266099,-5
carcassonne-ucttuned235-vs-ucttuned225-1000its,735,740,2166.767315858,2127.351582114,-5
carcassonne-boltzmann145-vs-boltzmann100-1000its,736,741,2248.583843546,2173.352647138,-5
carcassonne-boltzmann450-vs-boltzmann215-1000its,742,747,2225.544357832,2156.742477822,-5
carcassonne-boltzmann275-vs-boltzmann160-1000its,744,749,2221.068362034,2198.211028759,-5
carcassonne-boltzmann265-vs-boltzmann420-1000its,748,753,2140.833186459,2083.562745344,-5
carcassonne-ucttuned180-vs-ucttuned370-1000its,750,755,2173.807029496,2146.596362276,-5
carcassonne-boltzmann270-vs-boltzmann60-1000its,753,758,2135.59808312,2084.28651487,-5
carcassonne-uct25-vs-uct90-1000its,754,759,2210.324211557,2156.653255384,-5
carcassonne-ucttuned60-vs-ucttuned270-1000its,758,763,2187.026237158,2165.58256764,-5
carcassonne-boltzmann210-vs-boltzmann490-1000its,759,764,2197.583974587,2114.142388261,-5
carcassonne-boltzmann80-vs-boltzmann450-1000its,762,767,2157.362046056,2108.416833761,-5
carcassonne-ucttuned480-vs-ucttuned30-1000its,763,768,2196.330487775,2166.131496099,-5
carcassonne-boltzmann215-vs-boltzmann185-1000its,764,769,2198.992410983,2118.472085485,-5
carcassonne-boltzmann490-vs-boltzmann465-1000its,765,770,2176.686785737,2160.953563876,-5
carcassonne-ucttuned95-vs-ucttuned140-1000its,766,771,2108.160217474,2063.005602509,-5
carcassonne-boltzmann335-vs-boltzmann275-1000its,767,772,2132.308611556,2091.580912559,-5
carcassonne-ucttuned300-vs-ucttuned435-1000its,767,772,2155.18889557,2163.127775696,-5
carcassonne-ucttuned355-vs-ucttuned305-1000its,768,773,2207.609812571,2117.78599366,-5
carcassonne-boltzmann360-vs-boltzmann215-1000its,769,774,2167.936688449,2153.376653024,-5
carcassonne-boltzmann375-vs-boltzmann385-1000its,769,774,2203.533192777,2135.101824682,-5
carcassonne-ucttuned55-vs-ucttuned200-1000its,772,777,2228.790755314,2134.652093013,-5
carcassonne-boltzmann260-vs-boltzmann240-1000its,776,781,2244.538492803,2214.22563992,-5
carcassonne-ucttuned45-vs-ucttuned405-1000its,776,781,2162.9247591,2144.790011583,-5
carcassonne-uct395-vs-uct295-1000its,778,783,2101.108091046,2063.101844417,-5
carcassonne-ucttuned305-vs-ucttuned175-1000its,780,785,2165.270571098,2123.320464228,-5
carcassonne-ucttuned110-vs-ucttuned175-1000its,781,786,2172.426009061,2176.380958504,-5
carcassonne-ucttuned275-vs-ucttuned255-1000its,781,786,2114.249251357,2114.011760624,-5
carcassonne-boltzmann370-vs-boltzmann200-1000its,782,787,2134.789148733,2114.928017273,-5
carcassonne-ucttuned300-vs-ucttuned75-1000its,782,787,2179.079380401,2172.610279685,-5
carcassonne-uct25-vs-uct435-1000its,784,789,2187.675121669,2143.34200882,-5
carcassonne-ucttuned100-vs-ucttuned470-1000its,785,790,2235.000137266,2163.747466459,-5
carcassonne-ucttuned80-vs-ucttuned240-1000its,785,790,2312.553196981,2226.418234799,-5
carcassonne-boltzmann205-vs-boltzmann475-1000its,786,791,2201.757940581,2151.472294691,-5
carcassonne-ucttuned490-vs-ucttuned260-1000its,786,791,2105.830516343,2072.291181322,-5
carcassonne-boltzmann220-vs-boltzmann180-1000its,787,792,2160.139976425,2098.071642329,-5
carcassonne-uct435-vs-uct75-1000its,787,792,2217.679526661,2169.146617091,-5
carcassonne-uct80-vs-uct130-1000its,788,793,2170.325510493,2123.605697932,-5
carcassonne-ucttuned210-vs-ucttuned395-1000its,789,794,2174.490012236,2140.265285564,-5
carcassonne-uct120-vs-uct205-1000its,790,795,2224.145013347,2159.585156564,-5
carcassonne-uct130-vs-uct45-1000its,790,795,2157.238491165,2131.028594728,-5
carcassonne-boltzmann145-vs-boltzmann225-1000its,792,797,2161.063415332,2152.57195623,-5
carcassonne-uct315-vs-uct480-1000its,792,797,2208.186617507,2183.042507597,-5
carcassonne-uct70-vs-uct480-1000its,793,798,2190.696761401,2182.203486479,-5
carcassonne-boltzmann230-vs-boltzmann240-1000its,794,799,2106.534695644,2127.658756231,-5
carcassonne-boltzmann115-vs-boltzmann265-1000its,795,800,2184.905960497,2145.549315569,-5
carcassonne-uct245-vs-uct320-1000its,795,800,2257.796919089,2195.232387104,-5
carcassonne-ucttuned390-vs-ucttuned460-1000its,795,800,2242.426337354,2180.02753433,-5
carcassonne-ucttuned420-vs-ucttuned340-1000its,796,801,2140.158411434,2105.992149509,-5
carcassonne-boltzmann205-vs-boltzmann135-1000its,797,802,2193.757469267,2199.262819457,-5
carcassonne-uct220-vs-uct125-1000its,797,802,2203.017512832,2163.894375096,-5
carcassonne-uct45-vs-uct305-1000its,797,802,2212.299076299,2137.731637273,-5
carcassonne-boltzmann150-vs-boltzmann190-1000its,798,803,2239.310459808,2201.499091113,-5
carcassonne-boltzmann255-vs-boltzmann305-1000its,798,803,2242.438015898,2163.816347256,-5
carcassonne-uct125-vs-uct310-1000its,799,804,2156.693082427,2117.963515312,-5
carcassonne-uct90-vs-uct110-1000its,800,805,2132.681196114,2106.516671231,-5
carcassonne-uct360-vs-uct160-1000its,801,806,2274.858876827,2246.936090622,-5
carcassonne-uct50-vs-uct490-1000its,801,806,2239.950381083,2201.34405765,-5
carcassonne-ucttuned395-vs-ucttuned450-1000its,801,806,2192.027858398,2163.735391234,-5
carcassonne-ucttuned445-vs-ucttuned110-1000its,802,807,2197.980518165,2169.96803362,-5
carcassonne-ucttuned460-vs-ucttuned110-1000its,802,807,2113.964652476,2071.059623061,-5
carcassonne-uct65-vs-uct280-1000its,803,808,2207.203154641,2187.316558887,-5
carcassonne-boltzmann25-vs-boltzmann275-1000its,804,809,2230.661151258,2167.804854228,-5
carcassonne-boltzmann350-vs-boltzmann175-1000its,804,809,2205.500078435,2151.305273203,-5
carcassonne-ucttuned320-vs-ucttuned310-1000its,804,809,2184.773520889,2102.675349166,-5
carcassonne-uct190-vs-uct115-1000its,805,810,2156.87024848,2143.113238594,-5
carcassonne-uct380-vs-uct300-1000its,806,811,2163.37466689,2121.446578982,-5
carcassonne-ucttuned145-vs-ucttuned470-1000its,806,811,2129.501828285,2114.331267017,-5
carcassonne-ucttuned460-vs-ucttuned125-1000its,806,811,2326.367963967,2270.577395559,-5
carcassonne-boltzmann235-vs-boltzmann80-1000its,807,812,2219.8173412,2194.520339949,-5
carcassonne-uct470-vs-uct165-1000its,807,812,2184.336677101,2138.530610802,-5
carcassonne-boltzmann235-vs-boltzmann95-1000its,808,813,2211.560584528,2149.049136939,-5
carcassonne-uct330-vs-uct75-1000its,809,814,2221.23429529,2206.404261218,-5
carcassonne-uct115-vs-uct30-1000its,810,815,2220.235205802,2169.025357297,-5
carcassonne-uct440-vs-uct180-1000its,810,815,2264.768455663,2222.052706072,-5
carcassonne-uct365-vs-uct425-1000its,813,818,2236.614961338,2166.936513613,-5
carcassonne-boltzmann145-vs-boltzmann350-1000its,814,819,2180.60443322,2161.74122447,-5
carcassonne-boltzmann230-vs-boltzmann185-1000its,814,819,2192.737450025,2085.583627239,-5
carcassonne-boltzmann340-vs-boltzmann235-1000its,814,819,2197.773806391,2168.117358434,-5
carcassonne-ucttuned75-vs-ucttuned255-1000its,814,819,2206.464358315,2150.019889373,-5
carcassonne-boltzmann225-vs-boltzmann100-1000its,815,820,2207.685398136,2166.463823467,-5
carcassonne-boltzmann90-vs-boltzmann115-1000its,815,820,2220.175240711,2196.862417543,-5
carcassonne-uct365-vs-uct350-1000its,815,820,2204.167238182,2166.752164945,-5
carcassonne-boltzmann170-vs-boltzmann395-1000its,816,821,2232.593249836,2158.490662176,-5
carcassonne-ucttuned235-vs-ucttuned410-1000its,817,822,2197.267878796,2159.887047012,-5
carcassonne-ucttuned415-vs-ucttuned345-1000its,817,822,2192.165872371,2178.284356988,-5
carcassonne-uct355-vs-uct250-1000its,818,823,2158.147368408,2138.90848706,-5
carcassonne-ucttuned85-vs-ucttuned305-1000its,818,823,2138.611372065,2084.768000741,-5
carcassonne-boltzmann70-vs-boltzmann355-1000its,819,824,2176.623863133,2115.861789391,-5
carcassonne-ucttuned240-vs-ucttuned45-1000its,821,826,2170.248125202,2162.192310255,-5
carcassonne-boltzmann35-vs-boltzmann465-1000its,822,827,2199.992859371,2172.418300091,-5
carcassonne-ucttuned345-vs-ucttuned395-1000its,822,827,2235.716249426,2183.461995543,-5
carcassonne-ucttuned410-vs-ucttuned25-1000its,822,827,2205.805091017,2174.538078816,-5
carcassonne-boltzmann155-vs-boltzmann60-1000its,823,828,2202.364926802,2148.635733642,-5
carcassonne-boltzmann415-vs-boltzmann440-1000its,823,828,2185.661392985,2116.261183625,-5
carcassonne-uct315-vs-uct145-1000its,823,828,2216.093579721,2188.562212757,-5
carcassonne-ucttuned235-vs-ucttuned325-1000its,823,828,2145.242734116,2102.76136796,-5
carcassonne-boltzmann300-vs-boltzmann10-1000its,824,829,2277.932743202,2215.333437088,-5
carcassonne-boltzmann140-vs-boltzmann125-1000its,825,830,2244.302190247,2228.940047629,-5
carcassonne-uct190-vs-uct450-1000its,826,831,2146.582849631,2106.159507649,-5
carcassonne-boltzmann120-vs-boltzmann175-1000its,829,834,2229.008995545,2222.788534891,-5
carcassonne-uct195-vs-uct325-1000its,829,834,2265.159598003,2197.31151212,-5
carcassonne-uct480-vs-uct45-1000its,830,835,2272.124243902,2210.081168176,-5
carcassonne-uct485-vs-uct5-1000its,830,835,2184.600071917,2140.655920716,-5
carcassonne-boltzmann220-vs-boltzmann125-1000its,831,836,2218.549715336,2188.570597285,-5
carcassonne-uct140-vs-uct380-1000its,832,837,2163.18291996,2122.884334872,-5
carcassonne-uct150-vs-uct85-1000its,832,837,2150.009362664,2124.022393184,-5
carcassonne-uct165-vs-uct395-1000its,832,837,2208.079280548,2164.967294645,-5
carcassonne-ucttuned25-vs-ucttuned165-1000its,832,837,2186.551490623,2119.8144297,-5
carcassonne-boltzmann310-vs-boltzmann75-1000its,833,838,2207.911976394,2078.138898634,-5
carcassonne-uct330-vs-uct290-1000its,833,838,2222.039578231,2167.898827743,-5
carcassonne-uct50-vs-uct420-1000its,833,838,2164.012362884,2106.593600001,-5
carcassonne-ucttuned305-vs-ucttuned415-1000its,834,839,2250.132415611,2231.612931361,-5
carcassonne-uct220-vs-uct340-1000its,836,841,2196.660072476,2156.826782438,-5
carcassonne-uct260-vs-uct355-1000its,836,841,2231.201203738,2195.431602045,-5
carcassonne-uct385-vs-uct355-1000its,837,842,2170.466099072,2146.999939998,-5
carcassonne-ucttuned260-vs-ucttuned280-1000its,837,842,2237.287662108,2207.666928747,-5
carcassonne-uct50-vs-uct395-1000its,840,845,2162.35776147,2158.406224266,-5
carcassonne-ucttuned395-vs-ucttuned245-1000its,840,845,2237.233752688,2182.14115648,-5
carcassonne-ucttuned440-vs-ucttuned30-1000its,840,845,2147.997263699,2094.319752691,-5
carcassonne-uct265-vs-uct495-1000its,843,848,2168.639116718,2113.509343082,-5
carcassonne-ucttuned235-vs-ucttuned165-1000its,843,848,2214.712413905,2181.565805036,-5
carcassonne-boltzmann260-vs-boltzmann410-1000its,844,849,2212.011283996,2138.561999196,-5
carcassonne-ucttuned35-vs-ucttuned435-1000its,845,850,2183.012517166,2145.666847828,-5
carcassonne-uct465-vs-uct80-1000its,846,851,2233.129694478,2166.842492364,-5
carcassonne-uct100-vs-uct275-1000its,847,852,2199.659860467,2151.136429266,-5
carcassonne-boltzmann420-vs-boltzmann280-1000its,848,853,2201.506405865,2169.883593588,-5
carcassonne-uct315-vs-uct60-1000its,848,853,2165.478448004,2166.57771059,-5
carcassonne-ucttuned385-vs-ucttuned200-1000its,848,853,2177.693544866,2093.321682827,-5
carcassonne-boltzmann60-vs-boltzmann200-1000its,850,855,2134.456359183,2100.617351408,-5
carcassonne-ucttuned65-vs-ucttuned490-1000its,850,855,2182.388912151,2115.995867994,-5
carcassonne-ucttuned170-vs-ucttuned20-1000its,855,860,2125.503950086,2106.081375307,-5
carcassonne-ucttuned360-vs-ucttuned290-1000its,857,862,2218.320569701,2194.817542686,-5
carcassonne-boltzmann75-vs-boltzmann55-1000its,859,864,2211.957804704,2164.203373785,-5
carcassonne-ucttuned15-vs-ucttuned480-1000its,859,864,2139.874205151,2083.304776499,-5
carcassonne-ucttuned160-vs-ucttuned30-1000its,861,866,2202.668824183,2178.26592929,-5
carcassonne-ucttuned340-vs-ucttuned325-1000its,862,867,2221.01919323,2141.968212053,-5
carcassonne-boltzmann160-vs-boltzmann480-1000its,864,869,2267.680497955,2183.611448687,-5
carcassonne-uct370-vs-uct200-1000its,867,872,2158.816239562,2161.048613955,-5
carcassonne-ucttuned140-vs-ucttuned115-1000its,868,873,2191.199996127,2171.596460935,-5
carcassonne-ucttuned455-vs-ucttuned395-1000its,868,873,2207.204884368,2152.446927286,-5
carcassonne-uct460-vs-uct205-1000its,871,876,2204.902093148,2152.289338829,-5
carcassonne-uct210-vs-uct100-1000its,878,883,2133.555837229,2101.901577815,-5
carcassonne-uct200-vs-uct330-1000its,891,896,2232.135040842,2151.027304748,-5
carcassonne-uct60-vs-uct470-1000its,891,896,2194.92302388,2158.173192227,-5
carcassonne-uct150-vs-uct280-1000its,897,902,2291.194944092,2195.355465435,-5
carcassonne-boltzmann175-vs-boltzmann60-1000its,900,905,2178.413633529,2166.118027421,-5
carcassonne-ucttuned190-vs-ucttuned25-1000its,938,943,2224.338913046,2157.567458442,-5
carcassonne-ucttuned325-vs-ucttuned460-1000its,593,597,1825.933291065,1813.326745684,-4
carcassonne-ucttuned110-vs-ucttuned125-1000its,683,687,2137.895103471,2104.310785114,-4
carcassonne-boltzmann475-vs-boltzmann410-1000its,707,711,2176.364269794,2116.07728298,-4
carcassonne-boltzmann80-vs-boltzmann275-1000its,712,716,2233.171197793,2132.553066344,-4
carcassonne-boltzmann75-vs-boltzmann115-1000its,715,719,2197.004369582,2197.836747179,-4
carcassonne-ucttuned25-vs-ucttuned320-1000its,726,730,2165.755888752,2125.24403942,-4
carcassonne-boltzmann145-vs-boltzmann265-1000its,727,731,2212.720628861,2175.367213643,-4
carcassonne-ucttuned420-vs-ucttuned105-1000its,727,731,2228.803861359,2203.151736938,-4
carcassonne-boltzmann330-vs-boltzmann215-1000its,732,736,2197.88715242,2149.011792451,-4
carcassonne-uct220-vs-uct480-1000its,737,741,2196.130392278,2133.703211296,-4
carcassonne-uct440-vs-uct205-1000its,737,741,2164.154994747,2143.62846779,-4
carcassonne-uct350-vs-uct220-1000its,739,743,2214.90948976,2184.283042572,-4
carcassonne-boltzmann310-vs-boltzmann70-1000its,741,745,2156.0687971,2153.362864875,-4
carcassonne-boltzmann235-vs-boltzmann30-1000its,742,746,2247.431450258,2240.814681194,-4
carcassonne-boltzmann495-vs-boltzmann285-1000its,742,746,2300.427686226,2236.065415931,-4
carcassonne-ucttuned325-vs-ucttuned475-1000its,746,750,2224.098098254,2194.271882424,-4
carcassonne-ucttuned90-vs-ucttuned380-1000its,750,754,2101.581344466,2048.930918982,-4
carcassonne-boltzmann180-vs-boltzmann255-1000its,756,760,2230.665893636,2190.087072735,-4
carcassonne-ucttuned135-vs-ucttuned495-1000its,757,761,2079.615694496,2080.511130399,-4
carcassonne-uct30-vs-uct415-1000its,758,762,2193.581253028,2121.649472179,-4
carcassonne-boltzmann270-vs-boltzmann230-1000its,759,763,2171.667539547,2147.463133429,-4
carcassonne-uct90-vs-uct220-1000its,759,763,2190.847458129,2120.514364397,-4
carcassonne-ucttuned110-vs-ucttuned165-1000its,762,766,2238.320569762,2207.068508429,-4
carcassonne-boltzmann390-vs-boltzmann200-1000its,763,767,2280.6881506,2185.310844351,-4
carcassonne-boltzmann185-vs-boltzmann475-1000its,764,768,2105.475902914,2131.065818204,-4
carcassonne-ucttuned255-vs-ucttuned190-1000its,765,769,2192.846830434,2157.051849862,-4
carcassonne-boltzmann215-vs-boltzmann240-1000its,766,770,2148.224214445,2110.145292947,-4
carcassonne-uct155-vs-uct85-1000its,767,771,2282.40951089,2223.315309612,-4
carcassonne-boltzmann445-vs-boltzmann185-1000its,768,772,2262.790003338,2225.84773416,-4
carcassonne-boltzmann135-vs-boltzmann10-1000its,770,774,2216.073540623,2220.282891815,-4
carcassonne-uct430-vs-uct115-1000its,770,774,2148.243310055,2134.026163388,-4
carcassonne-ucttuned145-vs-ucttuned290-1000its,770,774,2197.850210355,2145.376115584,-4
carcassonne-ucttuned205-vs-ucttuned305-1000its,770,774,2183.140220238,2158.64938434,-4
carcassonne-boltzmann330-vs-boltzmann260-1000its,772,776,2224.577093145,2217.454983961,-4
carcassonne-boltzmann335-vs-boltzmann130-1000its,772,776,2240.85730757,2138.481765143,-4
carcassonne-uct260-vs-uct190-1000its,774,778,2230.562582867,2157.065808923,-4
carcassonne-boltzmann335-vs-boltzmann475-1000its,775,779,2221.858242122,2147.301534733,-4
carcassonne-uct480-vs-uct270-1000its,776,780,2172.678693425,2154.528634771,-4
carcassonne-ucttuned230-vs-ucttuned360-1000its,780,784,2264.470452059,2175.40428599,-4
carcassonne-uct455-vs-uct45-1000its,781,785,2270.922577952,2264.194386032,-4
carcassonne-boltzmann230-vs-boltzmann250-1000its,783,787,2161.096537386,2123.73614692,-4
carcassonne-boltzmann495-vs-boltzmann195-1000its,785,789,2119.58780876,2076.578435768,-4
carcassonne-uct125-vs-uct330-1000its,785,789,2241.704276375,2211.952601991,-4
carcassonne-uct270-vs-uct225-1000its,785,789,2230.867812842,2197.257556506,-4
carcassonne-uct330-vs-uct480-1000its,785,789,2189.935440994,2134.172692714,-4
carcassonne-ucttuned245-vs-ucttuned170-1000its,785,789,2198.569750137,2140.104832831,-4
carcassonne-boltzmann185-vs-boltzmann415-1000its,786,790,2230.82964489,2138.747829377,-4
carcassonne-uct470-vs-uct420-1000its,786,790,2189.500391236,2178.581700273,-4
carcassonne-ucttuned175-vs-ucttuned135-1000its,786,790,2229.921959046,2160.683995101,-4
carcassonne-ucttuned290-vs-ucttuned55-1000its,786,790,2210.827958109,2201.733227036,-4
carcassonne-ucttuned345-vs-ucttuned380-1000its,786,790,2240.907731245,2174.493650369,-4
carcassonne-boltzmann345-vs-boltzmann175-1000its,787,791,2234.645295547,2192.511338747,-4
carcassonne-uct10-vs-uct415-1000its,787,791,2286.55666578,2263.346169287,-4
carcassonne-boltzmann310-vs-boltzmann115-1000its,788,792,2166.52806719,2116.635317373,-4
carcassonne-boltzmann105-vs-boltzmann355-1000its,790,794,2224.847518005,2112.959919683,-4
carcassonne-uct125-vs-uct30-1000its,791,795,2157.602432252,2139.316554637,-4
carcassonne-uct140-vs-uct30-1000its,792,796,2186.101544078,2096.875438617,-4
carcassonne-uct295-vs-uct485-1000its,793,797,2230.762694339,2194.290055128,-4
carcassonne-boltzmann400-vs-boltzmann320-1000its,794,798,2227.174382622,2231.505945403,-4
carcassonne-uct20-vs-uct60-1000its,795,799,2257.284569298,2146.895241622,-4
carcassonne-boltzmann80-vs-boltzmann385-1000its,796,800,2280.684863797,2178.830009047,-4
carcassonne-uct395-vs-uct135-1000its,796,800,2225.772300373,2216.960772579,-4
carcassonne-uct75-vs-uct95-1000its,796,800,2144.051833343,2079.950221746,-4
carcassonne-boltzmann195-vs-boltzmann45-1000its,797,801,2158.668212151,2138.472537097,-4
carcassonne-uct475-vs-uct395-1000its,797,801,2213.21483743,2192.061727007,-4
carcassonne-ucttuned415-vs-ucttuned375-1000its,797,801,2230.930796072,2173.177990009,-4
carcassonne-ucttuned65-vs-ucttuned280-1000its,797,801,2284.532231294,2186.031340874,-4
carcassonne-boltzmann445-vs-boltzmann115-1000its,798,802,2211.736824915,2124.038265978,-4
carcassonne-boltzmann380-vs-boltzmann130-1000its,799,803,2207.22598247,2170.407697669,-4
carcassonne-boltzmann485-vs-boltzmann225-1000its,799,803,2199.403951887,2129.784870386,-4
carcassonne-uct135-vs-uct445-1000its,799,803,2131.151196889,2090.795419591,-4
carcassonne-uct180-vs-uct85-1000its,799,803,2145.518655028,2078.013078449,-4
carcassonne-boltzmann180-vs-boltzmann200-1000its,800,804,2098.567907679,2089.037926343,-4
carcassonne-ucttuned370-vs-ucttuned495-1000its,800,804,2187.227679379,2196.62795806,-4
carcassonne-ucttuned325-vs-ucttuned240-1000its,801,805,2146.918638881,2117.159761818,-4
carcassonne-ucttuned410-vs-ucttuned15-1000its,801,805,2177.222400831,2121.497389432,-4
carcassonne-ucttuned420-vs-ucttuned165-1000its,801,805,2155.441454264,2120.044069198,-4
carcassonne-boltzmann95-vs-boltzmann180-1000its,802,806,2152.778275109,2121.093481307,-4
carcassonne-uct45-vs-uct265-1000its,803,807,2191.410641508,2198.569799437,-4
carcassonne-boltzmann95-vs-boltzmann320-1000its,805,809,2253.541598486,2181.533374528,-4
carcassonne-uct240-vs-uct390-1000its,805,809,2184.63429361,2116.852689952,-4
carcassonne-boltzmann190-vs-boltzmann160-1000its,806,810,2203.885189649,2149.551864819,-4
carcassonne-ucttuned180-vs-ucttuned445-1000its,807,811,2197.723894493,2179.816028,-4
carcassonne-uct465-vs-uct175-1000its,808,812,2207.571381575,2164.20253138,-4
carcassonne-boltzmann35-vs-boltzmann350-1000its,809,813,2141.477086392,2066.099951422,-4
carcassonne-ucttuned330-vs-ucttuned455-1000its,810,814,2189.545944652,2059.499297628,-4
carcassonne-uct55-vs-uct95-1000its,811,815,2206.290955018,2184.690071271,-4
carcassonne-ucttuned425-vs-ucttuned25-1000its,812,816,2110.636805388,2132.284128229,-4
carcassonne-boltzmann245-vs-boltzmann5-1000its,814,818,2186.76704456,2146.655105685,-4
carcassonne-ucttuned480-vs-ucttuned55-1000its,815,819,2213.62258147,2184.314568404,-4
carcassonne-boltzmann330-vs-boltzmann85-1000its,816,820,2190.187241715,2153.659729053,-4
carcassonne-boltzmann75-vs-boltzmann305-1000its,817,821,2153.35273752,2116.262337866,-4
carcassonne-boltzmann315-vs-boltzmann240-1000its,818,822,2216.725002309,2167.669980157,-4
carcassonne-boltzmann60-vs-boltzmann450-1000its,818,822,2185.006022222,2150.903015662,-4
carcassonne-uct415-vs-uct40-1000its,819,823,2273.349742683,2228.473440039,-4
carcassonne-uct465-vs-uct140-1000its,819,823,2155.720594128,2145.223322525,-4
carcassonne-uct485-vs-uct285-1000its,819,823,2248.105866065,2210.891372547,-4
carcassonne-ucttuned250-vs-ucttuned350-1000its,819,823,2203.273789715,2130.110940381,-4
carcassonne-ucttuned265-vs-ucttuned220-1000its,819,823,2159.837208896,2160.200031884,-4
carcassonne-boltzmann120-vs-boltzmann40-1000its,820,824,2210.581334565,2156.354818723,-4
carcassonne-uct135-vs-uct145-1000its,821,825,2237.430219683,2188.925832907,-4
carcassonne-boltzmann150-vs-boltzmann60-1000its,823,827,2207.754724751,2145.523236507,-4
carcassonne-ucttuned160-vs-ucttuned250-1000its,823,827,2203.371795394,2132.424294226,-4
carcassonne-uct390-vs-uct440-1000its,825,829,2185.545151523,2155.265008527,-4
carcassonne-ucttuned420-vs-ucttuned120-1000its,825,829,2159.420005114,2113.753167314,-4
carcassonne-ucttuned65-vs-ucttuned20-1000its,825,829,2220.308930384,2178.967604549,-4
carcassonne-boltzmann275-vs-boltzmann230-1000its,826,830,2162.22868028,2131.132946081,-4
carcassonne-uct65-vs-uct160-1000its,826,830,2199.695686826,2129.241333961,-4
carcassonne-ucttuned295-vs-ucttuned170-1000its,826,830,2241.134602605,2195.384407052,-4
carcassonne-boltzmann365-vs-boltzmann60-1000its,827,831,2196.850486776,2135.988509765,-4
carcassonne-boltzmann435-vs-boltzmann200-1000its,827,831,2194.042115767,2167.327927689,-4
carcassonne-ucttuned475-vs-ucttuned275-1000its,827,831,2121.223869238,2084.965401251,-4
carcassonne-uct200-vs-uct130-1000its,828,832,2219.595034871,2142.387802831,-4
carcassonne-uct475-vs-uct40-1000its,828,832,2225.167226387,2188.758194567,-4
carcassonne-ucttuned170-vs-ucttuned245-1000its,828,832,2193.134855921,2175.597354776,-4
carcassonne-uct365-vs-uct30-1000its,830,834,2195.666937799,2131.072093025,-4
carcassonne-boltzmann100-vs-boltzmann150-1000its,831,835,2241.695251619,2167.566290914,-4
carcassonne-ucttuned75-vs-ucttuned240-1000its,831,835,2284.392681701,2228.768366227,-4
carcassonne-ucttuned465-vs-ucttuned280-1000its,832,836,2178.449387171,2123.172326632,-4
carcassonne-uct135-vs-uct70-1000its,833,837,2141.426318671,2112.169674598,-4
carcassonne-ucttuned310-vs-ucttuned350-1000its,835,839,2204.699826637,2197.593925497,-4
carcassonne-ucttuned25-vs-ucttuned235-1000its,836,840,2287.179516366,2194.769985244,-4
carcassonne-ucttuned445-vs-ucttuned410-1000its,836,840,2196.344373016,2165.054855749,-4
carcassonne-boltzmann465-vs-boltzmann120-1000its,837,841,2238.069092196,2161.035087364,-4
carcassonne-uct380-vs-uct310-1000its,837,841,2242.27314356,2159.731510498,-4
carcassonne-boltzmann390-vs-boltzmann450-1000its,840,844,2108.730974876,2043.393769845,-4
carcassonne-boltzmann105-vs-boltzmann255-1000its,841,845,2219.247843833,2199.299637079,-4
carcassonne-boltzmann375-vs-boltzmann60-1000its,841,845,2216.938339982,2165.568076698,-4
carcassonne-ucttuned405-vs-ucttuned265-1000its,841,845,2176.695692782,2106.071998353,-4
carcassonne-ucttuned415-vs-ucttuned55-1000its,841,845,2202.618377301,2162.201090752,-4
carcassonne-boltzmann150-vs-boltzmann330-1000its,843,847,2201.687143447,2141.416290912,-4
carcassonne-uct130-vs-uct425-1000its,843,847,2131.767910077,2126.064940846,-4
carcassonne-uct285-vs-uct235-1000its,843,847,2170.804181852,2115.754166057,-4
carcassonne-ucttuned460-vs-ucttuned370-1000its,843,847,2225.770535772,2161.55515971,-4
carcassonne-boltzmann430-vs-boltzmann485-1000its,844,848,2234.750069624,2170.754731418,-4
carcassonne-boltzmann345-vs-boltzmann475-1000its,846,850,2199.610899081,2163.523261971,-4
carcassonne-uct360-vs-uct195-1000its,846,850,2218.384115408,2187.853890252,-4
carcassonne-ucttuned160-vs-ucttuned315-1000its,847,851,2162.038384238,2119.509630396,-4
carcassonne-uct380-vs-uct235-1000its,848,852,2209.3981419,2182.014382475,-4
carcassonne-ucttuned385-vs-ucttuned280-1000its,849,853,2140.530608055,2101.7252208,-4
carcassonne-uct420-vs-uct220-1000its,851,855,2169.248076727,2131.835745183,-4
carcassonne-ucttuned305-vs-ucttuned315-1000its,851,855,2148.403696848,2101.040026913,-4
carcassonne-uct140-vs-uct490-1000its,852,856,2146.887603669,2083.291735307,-4
carcassonne-uct5-vs-uct340-1000its,853,857,2195.579031999,2149.838645302,-4
carcassonne-ucttuned280-vs-ucttuned255-1000its,853,857,2207.631875978,2159.330229598,-4
carcassonne-uct15-vs-uct275-1000its,857,861,2195.574092482,2172.554874812,-4
carcassonne-ucttuned285-vs-ucttuned335-1000its,865,869,2229.688034448,2178.41330936,-4
carcassonne-uct85-vs-uct210-1000its,867,871,2173.647534315,2164.606586118,-4
carcassonne-ucttuned490-vs-ucttuned265-1000its,870,874,2237.756735427,2148.04977353,-4
carcassonne-boltzmann320-vs-boltzmann140-1000its,872,876,2202.426997752,2123.381886707,-4
carcassonne-ucttuned195-vs-ucttuned160-1000its,874,878,2167.45513091,2107.627013354,-4
carcassonne-boltzmann415-vs-boltzmann460-1000its,878,882,2200.205595449,2117.153784665,-4
carcassonne-boltzmann15-vs-boltzmann360-1000its,879,883,2258.519033566,2185.903027159,-4
carcassonne-uct345-vs-uct315-1000its,886,890,2232.538478841,2227.194579742,-4
carcassonne-ucttuned105-vs-ucttuned360-1000its,886,890,2078.69138699,2088.651796528,-4
carcassonne-uct35-vs-uct270-1000its,887,891,2154.374960268,2093.775867313,-4
carcassonne-boltzmann305-vs-boltzmann465-1000its,890,894,2205.787055699,2149.29854849,-4
carcassonne-uct105-vs-uct110-1000its,893,897,2182.644785186,2164.880931189,-4
carcassonne-ucttuned150-vs-ucttuned330-1000its,902,906,2194.762440388,2146.160711425,-4
carcassonne-boltzmann450-vs-boltzmann360-1000its,660,663,1722.72422701,1699.216552817,-3
carcassonne-boltzmann180-vs-boltzmann320-1000its,730,733,2224.157355883,2187.654646191,-3
carcassonne-boltzmann215-vs-boltzmann210-1000its,731,734,2287.171132375,2223.182497965,-3
carcassonne-uct335-vs-uct365-1000its,742,745,2197.084295522,2126.983404091,-3
carcassonne-boltzmann200-vs-boltzmann475-1000its,746,749,2159.382946898,2098.933915448,-3
carcassonne-ucttuned435-vs-ucttuned265-1000its,746,749,2250.55506321,2229.477613477,-3
carcassonne-boltzmann260-vs-boltzmann390-1000its,752,755,2256.312878224,2197.458046909,-3
carcassonne-boltzmann435-vs-boltzmann355-1000its,754,757,2143.06740093,2073.164440892,-3
carcassonne-boltzmann235-vs-boltzmann285-1000its,755,758,2148.570135657,2078.025224604,-3
carcassonne-ucttuned390-vs-ucttuned265-1000its,759,762,2181.269759049,2166.710692363,-3
carcassonne-ucttuned40-vs-ucttuned400-1000its,761,764,2204.905291526,2146.732818771,-3
carcassonne-ucttuned175-vs-ucttuned295-1000its,765,768,2190.989574945,2148.688492192,-3
carcassonne-boltzmann25-vs-boltzmann410-1000its,766,769,2260.308214442,2217.23564583,-3
carcassonne-boltzmann380-vs-boltzmann180-1000its,767,770,2200.060341331,2136.711312312,-3
carcassonne-uct65-vs-uct115-1000its,768,771,2212.988754578,2201.208331617,-3
carcassonne-boltzmann155-vs-boltzmann485-1000its,770,773,2192.319651936,2135.614147072,-3
carcassonne-uct490-vs-uct275-1000its,772,775,2177.757158019,2159.792385693,-3
carcassonne-ucttuned350-vs-ucttuned470-1000its,772,775,2240.582142429,2184.746861823,-3
carcassonne-boltzmann50-vs-boltzmann395-1000its,773,776,2181.639347198,2124.131661757,-3
carcassonne-uct15-vs-uct270-1000its,773,776,2195.419178988,2212.82514928,-3
carcassonne-boltzmann160-vs-boltzmann120-1000its,774,777,2249.990200315,2198.874960778,-3
carcassonne-boltzmann225-vs-boltzmann255-1000its,774,777,2146.258120653,2119.778945972,-3
carcassonne-ucttuned430-vs-ucttuned290-1000its,774,777,2281.303723885,2214.096829433,-3
carcassonne-ucttuned145-vs-ucttuned100-1000its,775,778,2203.155625815,2148.909816938,-3
carcassonne-ucttuned230-vs-ucttuned205-1000its,775,778,2226.202966089,2155.962076492,-3
carcassonne-boltzmann100-vs-boltzmann250-1000its,777,780,2209.621565961,2166.60765002,-3
carcassonne-boltzmann400-vs-boltzmann485-1000its,777,780,2196.024452774,2142.285050458,-3
carcassonne-uct335-vs-uct180-1000its,777,780,2293.055104693,2283.88358611,-3
carcassonne-uct95-vs-uct480-1000its,778,781,2211.876561975,2169.089541867,-3
carcassonne-boltzmann295-vs-boltzmann115-1000its,779,782,2203.397999352,2122.502116854,-3
carcassonne-boltzmann390-vs-boltzmann75-1000its,779,782,2232.046701112,2181.961673431,-3
carcassonne-boltzmann410-vs-boltzmann490-1000its,784,787,2222.487779195,2149.876027462,-3
carcassonne-boltzmann85-vs-boltzmann220-1000its,784,787,2208.524470839,2207.820770977,-3
carcassonne-ucttuned325-vs-ucttuned60-1000its,785,788,2256.911237478,2210.629477533,-3
carcassonne-ucttuned225-vs-ucttuned245-1000its,786,789,2158.203779696,2114.984806084,-3
carcassonne-uct405-vs-uct330-1000its,787,790,2193.009095695,2191.691228585,-3
carcassonne-ucttuned265-vs-ucttuned20-1000its,790,793,2158.822294776,2137.686776511,-3
carcassonne-ucttuned270-vs-ucttuned5-1000its,790,793,2217.389211673,2147.458991783,-3
carcassonne-uct155-vs-uct90-1000its,791,794,2145.706904297,2066.788641949,-3
carcassonne-ucttuned465-vs-ucttuned390-1000its,791,794,2236.300020098,2210.881807379,-3
carcassonne-boltzmann185-vs-boltzmann405-1000its,792,795,2168.370405419,2113.812993432,-3
carcassonne-uct430-vs-uct70-1000its,792,795,2205.155241307,2132.376559694,-3
carcassonne-boltzmann360-vs-boltzmann95-1000its,793,796,2181.459824189,2162.151052898,-3
carcassonne-uct440-vs-uct470-1000its,793,796,2318.212621251,2256.507231786,-3
carcassonne-ucttuned380-vs-ucttuned280-1000its,794,797,2183.302216085,2160.662050291,-3
carcassonne-boltzmann380-vs-boltzmann285-1000its,795,798,2258.339629484,2234.31123187,-3
carcassonne-uct170-vs-uct195-1000its,795,798,2182.323538453,2168.165664476,-3
carcassonne-uct240-vs-uct250-1000its,795,798,2252.757498054,2222.173488012,-3
carcassonne-uct45-vs-uct15-1000its,796,799,2279.864127052,2205.737797605,-3
carcassonne-uct45-vs-uct360-1000its,796,799,2212.873363342,2196.092904239,-3
carcassonne-uct135-vs-uct450-1000its,797,800,2237.462960262,2176.599633426,-3
carcassonne-uct40-vs-uct175-1000its,797,800,2191.289321939,2194.323151339,-3
carcassonne-uct425-vs-uct20-1000its,797,800,2151.220358352,2117.006143868,-3
carcassonne-boltzmann355-vs-boltzmann195-1000its,798,801,2246.625569098,2242.093206392,-3
carcassonne-ucttuned170-vs-ucttuned120-1000its,798,801,2243.990572506,2187.94157975,-3
carcassonne-boltzmann50-vs-boltzmann140-1000its,799,802,2169.19751002,2101.319077516,-3
carcassonne-uct75-vs-uct360-1000its,801,804,2217.012710396,2122.407468738,-3
carcassonne-ucttuned85-vs-ucttuned115-1000its,801,804,2228.274438474,2138.848076779,-3
carcassonne-uct470-vs-uct330-1000its,802,805,2207.294179985,2191.585945866,-3
carcassonne-boltzmann140-vs-boltzmann210-1000its,804,807,2210.648070941,2189.356492897,-3
carcassonne-boltzmann200-vs-boltzmann290-1000its,804,807,2181.367770413,2138.905177841,-3
carcassonne-uct230-vs-uct325-1000its,804,807,2239.605926111,2181.972545971,-3
carcassonne-uct390-vs-uct480-1000its,806,809,2136.266716763,2142.944686784,-3
carcassonne-uct55-vs-uct105-1000its,808,811,2178.070072375,2159.845989557,-3
carcassonne-ucttuned15-vs-ucttuned90-1000its,808,811,2175.911964579,2112.475814275,-3
carcassonne-ucttuned305-vs-ucttuned295-1000its,808,811,2172.289543844,2132.633057575,-3
carcassonne-ucttuned310-vs-ucttuned475-1000its,808,811,2168.821914426,2085.610463988,-3
carcassonne-uct210-vs-uct305-1000its,809,812,2106.53457428,2068.873141979,-3
carcassonne-boltzmann310-vs-boltzmann235-1000its,811,814,2215.334317986,2169.871297683,-3
carcassonne-uct220-vs-uct430-1000its,811,814,2181.454126154,2134.38602193,-3
carcassonne-uct490-vs-uct365-1000its,811,814,2243.656004997,2211.71820277,-3
carcassonne-ucttuned210-vs-ucttuned150-1000its,812,815,2146.749430799,2096.431701385,-3
carcassonne-ucttuned315-vs-ucttuned320-1000its,812,815,2251.045534408,2159.181635191,-3
carcassonne-ucttuned400-vs-ucttuned425-1000its,814,817,2195.266669151,2173.073152738,-3
carcassonne-boltzmann350-vs-boltzmann50-1000its,816,819,2202.575693195,2166.011836022,-3
carcassonne-ucttuned115-vs-ucttuned440-1000its,816,819,2227.053497783,2179.669573819,-3
carcassonne-ucttuned465-vs-ucttuned45-1000its,816,819,2233.426477716,2226.035268178,-3
carcassonne-ucttuned295-vs-ucttuned410-1000its,817,820,2151.20826451,2118.214437956,-3
carcassonne-uct365-vs-uct105-1000its,818,821,2206.623039226,2178.783235478,-3
carcassonne-uct425-vs-uct385-1000its,820,823,2222.58486451,2171.854884865,-3
carcassonne-ucttuned150-vs-ucttuned160-1000its,820,823,2154.075426433,2110.276951456,-3
carcassonne-ucttuned375-vs-ucttuned65-1000its,822,825,2197.640947886,2152.374415928,-3
carcassonne-boltzmann435-vs-boltzmann10-1000its,823,826,2190.104357817,2117.665318623,-3
carcassonne-ucttuned150-vs-ucttuned115-1000its,824,827,2204.170099518,2156.621372853,-3
carcassonne-boltzmann205-vs-boltzmann280-1000its,825,828,2188.625022766,2108.197155479,-3
carcassonne-boltzmann290-vs-boltzmann70-1000its,825,828,2166.16651291,2105.598929392,-3
carcassonne-boltzmann75-vs-boltzmann160-1000its,825,828,2189.683529247,2136.974838285,-3
carcassonne-ucttuned425-vs-ucttuned35-1000its,825,828,2211.861540359,2180.632266793,-3
carcassonne-uct20-vs-uct105-1000its,826,829,2187.878310141,2128.193230602,-3
carcassonne-ucttuned215-vs-ucttuned365-1000its,827,830,2215.583520762,2166.508587059,-3
carcassonne-uct160-vs-uct75-1000its,830,833,2138.141687693,2116.962816154,-3
carcassonne-uct445-vs-uct325-1000its,830,833,2192.953503503,2134.845439321,-3
carcassonne-uct475-vs-uct365-1000its,831,834,2186.615988789,2138.251359242,-3
carcassonne-boltzmann130-vs-boltzmann475-1000its,832,835,2183.416380613,2154.766346016,-3
carcassonne-boltzmann85-vs-boltzmann400-1000its,832,835,2140.501160207,2095.319563222,-3
carcassonne-ucttuned70-vs-ucttuned65-1000its,833,836,2208.125728854,2178.41641825,-3
carcassonne-uct40-vs-uct390-1000its,834,837,2239.11467067,2236.097239972,-3
carcassonne-uct440-vs-uct465-1000its,836,839,2239.105908311,2196.014765733,-3
carcassonne-ucttuned140-vs-ucttuned425-1000its,837,840,2206.397253053,2150.940193309,-3
carcassonne-uct170-vs-uct480-1000its,839,842,2232.813508509,2149.904749136,-3
carcassonne-ucttuned20-vs-ucttuned135-1000its,840,843,2172.601071216,2101.637552871,-3
carcassonne-uct235-vs-uct160-1000its,841,844,2143.509818271,2084.472586451,-3
carcassonne-uct465-vs-uct460-1000its,842,845,2153.138761422,2111.685289551,-3
carcassonne-ucttuned485-vs-ucttuned490-1000its,842,845,2193.794901797,2165.916876994,-3
carcassonne-ucttuned75-vs-ucttuned455-1000its,846,849,2203.290841939,2177.069095173,-3
carcassonne-boltzmann255-vs-boltzmann155-1000its,847,850,2236.251687617,2142.116322399,-3
carcassonne-boltzmann95-vs-boltzmann245-1000its,849,852,2165.301263955,2131.799838474,-3
carcassonne-ucttuned485-vs-ucttuned115-1000its,850,853,2196.79794537,2140.296490587,-3
carcassonne-uct300-vs-uct260-1000its,851,854,2213.171819895,2170.178335738,-3
carcassonne-boltzmann65-vs-boltzmann105-1000its,853,856,2163.609383627,2127.640055194,-3
carcassonne-uct320-vs-uct270-1000its,853,856,2231.207914051,2171.224511231,-3
carcassonne-boltzmann375-vs-boltzmann15-1000its,855,858,2218.847425514,2216.47477477,-3
carcassonne-ucttuned100-vs-ucttuned130-1000its,862,865,2244.275097744,2207.262482245,-3
carcassonne-uct230-vs-uct355-1000its,863,866,2155.022221715,2133.578246708,-3
carcassonne-ucttuned415-vs-ucttuned215-1000its,863,866,2168.197150779,2154.107830185,-3
carcassonne-boltzmann325-vs-boltzmann10-1000its,864,867,2217.344964471,2192.746251162,-3
carcassonne-boltzmann130-vs-boltzmann435-1000its,866,869,2233.105184035,2195.976301907,-3
carcassonne-ucttuned160-vs-ucttuned110-1000its,866,869,2208.69308901,2177.004582825,-3
carcassonne-uct35-vs-uct380-1000its,867,870,2297.166459331,2230.735555005,-3
carcassonne-ucttuned40-vs-ucttuned460-1000its,869,872,2227.143376338,2172.769460987,-3
carcassonne-boltzmann35-vs-boltzmann85-1000its,870,873,2185.666788683,2090.096562436,-3
carcassonne-boltzmann420-vs-boltzmann490-1000its,874,877,2197.361738509,2175.637846853,-3
carcassonne-uct125-vs-uct165-1000its,874,877,2207.496699303,2176.339111171,-3
carcassonne-ucttuned70-vs-ucttuned250-1000its,885,888,2193.899343755,2148.073220235,-3
carcassonne-ucttuned200-vs-ucttuned5-1000its,886,889,2167.732126852,2163.215018639,-3
carcassonne-uct235-vs-uct335-1000its,890,893,2232.152511598,2122.811775117,-3
carcassonne-uct20-vs-uct470-1000its,899,902,2239.706974628,2184.228399649,-3
carcassonne-ucttuned195-vs-ucttuned55-1000its,908,911,2239.829406582,2211.774031793,-3
carcassonne-uct285-vs-uct5-1000its,921,924,2209.364713038,2159.369200249,-3
carcassonne-boltzmann110-vs-boltzmann255-1000its,963,966,2175.963822771,2172.027641138,-3
carcassonne-uct335-vs-uct285-1000its,696,698,2172.359515365,2150.585442012,-2
carcassonne-boltzmann305-vs-boltzmann190-1000its,711,713,2191.844945815,2177.093723666,-2
carcassonne-ucttuned75-vs-ucttuned85-1000its,729,731,2173.224719831,2146.096740955,-2
carcassonne-uct350-vs-uct50-1000its,731,733,2081.93361383,2105.320127055,-2
carcassonne-boltzmann170-vs-boltzmann340-1000its,741,743,2323.018635378,2264.525204048,-2
carcassonne-uct335-vs-uct405-1000its,742,744,2176.227497366,2100.471527256,-2
carcassonne-boltzmann285-vs-boltzmann410-1000its,744,746,2257.29546248,2184.510417439,-2
carcassonne-uct290-vs-uct340-1000its,744,746,2221.371045872,2188.157175592,-2
carcassonne-uct95-vs-uct410-1000its,744,746,2137.216581342,2101.30443466,-2
carcassonne-uct175-vs-uct70-1000its,745,747,2164.999894948,2130.92663799,-2
carcassonne-uct190-vs-uct270-1000its,745,747,2189.716634299,2165.535427005,-2
carcassonne-boltzmann305-vs-boltzmann20-1000its,748,750,2237.653710241,2150.610764485,-2
carcassonne-boltzmann275-vs-boltzmann60-1000its,749,751,2179.188156648,2150.46542915,-2
carcassonne-boltzmann160-vs-boltzmann310-1000its,750,752,2173.660138414,2126.29436553,-2
carcassonne-ucttuned125-vs-ucttuned220-1000its,752,754,2224.965934128,2191.891760091,-2
carcassonne-ucttuned370-vs-ucttuned55-1000its,752,754,2226.652948723,2210.269955353,-2
carcassonne-uct440-vs-uct55-1000its,754,756,2157.026600389,2140.586180569,-2
carcassonne-boltzmann195-vs-boltzmann270-1000its,755,757,2204.460173388,2145.48898947,-2
carcassonne-boltzmann440-vs-boltzmann120-1000its,755,757,2148.984749193,2156.983808615,-2
carcassonne-boltzmann25-vs-boltzmann320-1000its,756,758,2260.084068431,2212.858958511,-2
carcassonne-boltzmann115-vs-boltzmann210-1000its,757,759,2165.780355163,2096.985403888,-2
carcassonne-boltzmann135-vs-boltzmann30-1000its,757,759,2203.05695961,2174.971763705,-2
carcassonne-boltzmann230-vs-boltzmann475-1000its,757,759,2363.676921812,2290.665805538,-2
carcassonne-uct475-vs-uct75-1000its,758,760,2143.899966571,2093.352837342,-2
carcassonne-uct305-vs-uct490-1000its,759,761,2153.142471238,2099.690190827,-2
carcassonne-uct305-vs-uct30-1000its,760,762,2155.67448523,2092.36507828,-2
carcassonne-uct25-vs-uct250-1000its,761,763,2166.999642618,2126.348137118,-2
carcassonne-boltzmann180-vs-boltzmann295-1000its,762,764,2278.223444047,2197.877168678,-2
carcassonne-boltzmann250-vs-boltzmann90-1000its,762,764,2196.477832403,2160.347177766,-2
carcassonne-uct445-vs-uct405-1000its,764,766,2178.003892731,2133.113070949,-2
carcassonne-uct245-vs-uct280-1000its,766,768,2218.983938664,2193.989438062,-2
carcassonne-ucttuned20-vs-ucttuned485-1000its,769,771,2165.131981367,2133.003234234,-2
carcassonne-uct225-vs-uct490-1000its,770,772,2273.043854359,2208.125642641,-2
carcassonne-boltzmann260-vs-boltzmann450-1000its,772,774,2149.894882491,2125.008007572,-2
carcassonne-ucttuned465-vs-ucttuned475-1000its,775,777,2150.008540167,2134.477984629,-2
carcassonne-boltzmann490-vs-boltzmann50-1000its,776,778,2193.141712315,2144.172728001,-2
carcassonne-uct255-vs-uct160-1000its,776,778,2161.688720974,2122.200557596,-2
carcassonne-boltzmann460-vs-boltzmann300-1000its,777,779,2161.851468487,2072.076924534,-2
carcassonne-ucttuned65-vs-ucttuned225-1000its,777,779,2232.293599898,2215.547670169,-2
carcassonne-ucttuned285-vs-ucttuned160-1000its,778,780,2133.062735424,2080.26475512,-2
carcassonne-ucttuned95-vs-ucttuned310-1000its,778,780,2205.98042303,2169.563280505,-2
carcassonne-boltzmann350-vs-boltzmann115-1000its,779,781,2157.70956954,2110.536342476,-2
carcassonne-uct30-vs-uct240-1000its,779,781,2149.744803862,2041.198125873,-2
carcassonne-ucttuned125-vs-ucttuned395-1000its,779,781,2194.126361287,2123.432635154,-2
carcassonne-boltzmann50-vs-boltzmann425-1000its,781,783,2166.121520254,2141.637723345,-2
carcassonne-uct35-vs-uct340-1000its,781,783,2231.612019545,2169.349178255,-2
carcassonne-ucttuned275-vs-ucttuned475-1000its,781,783,2249.322178376,2167.717214289,-2
carcassonne-uct380-vs-uct360-1000its,783,785,2251.904890613,2232.544866758,-2
carcassonne-ucttuned210-vs-ucttuned235-1000its,783,785,2175.895300753,2143.004436406,-2
carcassonne-ucttuned390-vs-ucttuned30-1000its,783,785,2143.793799727,2088.11705712,-2
carcassonne-boltzmann195-vs-boltzmann440-1000its,784,786,2231.296375943,2181.570031506,-2
carcassonne-ucttuned390-vs-ucttuned385-1000its,784,786,2153.474813715,2056.748892563,-2
carcassonne-ucttuned40-vs-ucttuned230-1000its,784,786,2115.701662727,2049.229042027,-2
carcassonne-boltzmann440-vs-boltzmann15-1000its,785,787,2187.706903859,2160.780765834,-2
carcassonne-uct265-vs-uct380-1000its,785,787,2157.294902564,2154.996661479,-2
carcassonne-ucttuned185-vs-ucttuned115-1000its,785,787,2178.772836341,2115.015000529,-2
carcassonne-ucttuned155-vs-ucttuned145-1000its,786,788,2146.356324391,2147.521628295,-2
carcassonne-ucttuned380-vs-ucttuned55-1000its,788,790,2142.816766368,2122.346701992,-2
carcassonne-ucttuned200-vs-ucttuned280-1000its,789,791,2222.295325942,2140.520595001,-2
carcassonne-ucttuned400-vs-ucttuned180-1000its,789,791,2235.461221135,2215.044866811,-2
carcassonne-boltzmann390-vs-boltzmann110-1000its,790,792,2150.515194441,2129.756080485,-2
carcassonne-boltzmann405-vs-boltzmann430-1000its,791,793,2198.644091911,2157.810333524,-2
carcassonne-uct30-vs-uct130-1000its,791,793,2212.085118011,2152.392135618,-2
carcassonne-ucttuned320-vs-ucttuned170-1000its,792,794,2188.295252772,2136.610906489,-2
carcassonne-ucttuned295-vs-ucttuned425-1000its,793,795,2229.421794338,2151.898217726,-2
carcassonne-ucttuned95-vs-ucttuned495-1000its,793,795,2187.21423431,2134.496605151,-2
carcassonne-boltzmann55-vs-boltzmann125-1000its,794,796,2137.99872662,2090.350145905,-2
carcassonne-ucttuned50-vs-ucttuned10-1000its,795,797,2193.321553732,2163.210244679,-2
carcassonne-boltzmann295-vs-boltzmann135-1000its,796,798,2196.855276087,2143.116701291,-2
carcassonne-ucttuned255-vs-ucttuned345-1000its,796,798,2193.912296214,2139.525761173,-2
carcassonne-boltzmann245-vs-boltzmann345-1000its,800,802,2215.795111746,2137.259055783,-2
carcassonne-uct55-vs-uct120-1000its,801,803,2226.23017288,2155.787839052,-2
carcassonne-uct85-vs-uct345-1000its,801,803,2158.486297209,2083.165158015,-2
carcassonne-ucttuned340-vs-ucttuned45-1000its,802,804,2097.396973758,2082.131812588,-2
carcassonne-ucttuned50-vs-ucttuned30-1000its,802,804,2164.805508535,2121.222055636,-2
carcassonne-boltzmann275-vs-boltzmann380-1000its,803,805,2210.868031264,2141.373648685,-2
carcassonne-boltzmann80-vs-boltzmann320-1000its,804,806,2224.84200732,2206.624522649,-2
carcassonne-uct450-vs-uct290-1000its,804,806,2232.055225872,2188.897916497,-2
carcassonne-ucttuned285-vs-ucttuned330-1000its,804,806,2252.321457245,2233.162921473,-2
carcassonne-boltzmann140-vs-boltzmann215-1000its,805,807,2217.669665949,2154.889436558,-2
carcassonne-uct400-vs-uct495-1000its,805,807,2164.79025634,2139.359221509,-2
carcassonne-uct55-vs-uct475-1000its,805,807,2227.662491389,2197.690227656,-2
carcassonne-boltzmann175-vs-boltzmann295-1000its,806,808,2178.577271299,2128.225316664,-2
carcassonne-uct345-vs-uct485-1000its,806,808,2126.015942698,2073.022882968,-2
carcassonne-ucttuned5-vs-ucttuned315-1000its,806,808,2185.198477465,2114.877248187,-2
carcassonne-uct330-vs-uct150-1000its,810,812,2214.513949171,2166.299821545,-2
carcassonne-ucttuned180-vs-ucttuned10-1000its,810,812,2218.197399993,2202.343416877,-2
carcassonne-ucttuned345-vs-ucttuned260-1000its,810,812,2271.122041342,2247.73622061,-2
carcassonne-boltzmann30-vs-boltzmann395-1000its,811,813,2130.571718256,2088.752652378,-2
carcassonne-uct330-vs-uct215-1000its,811,813,2200.431354261,2138.956681132,-2
carcassonne-ucttuned270-vs-ucttuned100-1000its,812,814,2237.420138252,2200.487433096,-2
carcassonne-ucttuned455-vs-ucttuned340-1000its,812,814,2187.053039365,2145.206161725,-2
carcassonne-boltzmann260-vs-boltzmann145-1000its,813,815,2179.465281685,2159.575877603,-2
carcassonne-boltzmann490-vs-boltzmann320-1000its,813,815,2213.213493679,2138.314240122,-2
carcassonne-boltzmann50-vs-boltzmann195-1000its,813,815,2236.153093569,2204.095956081,-2
carcassonne-uct45-vs-uct300-1000its,813,815,2221.263449592,2211.414978169,-2
carcassonne-ucttuned60-vs-ucttuned35-1000its,815,817,2209.131384933,2179.647134046,-2
carcassonne-uct65-vs-uct265-1000its,817,819,2206.244385915,2190.321376953,-2
carcassonne-boltzmann105-vs-boltzmann100-1000its,818,820,2242.735557556,2157.21675524,-2
carcassonne-ucttuned385-vs-ucttuned340-1000its,818,820,2208.721103698,2159.198798696,-2
carcassonne-uct250-vs-uct170-1000its,819,821,2136.711837284,2093.948831964,-2
carcassonne-uct65-vs-uct15-1000its,823,825,2212.605933898,2193.724078915,-2
carcassonne-ucttuned130-vs-ucttuned410-1000its,823,825,2172.369746561,2083.007348201,-2
carcassonne-ucttuned480-vs-ucttuned15-1000its,826,828,2228.694929464,2218.157376361,-2
carcassonne-boltzmann245-vs-boltzmann195-1000its,828,830,2221.653866312,2156.551530033,-2
carcassonne-ucttuned195-vs-ucttuned100-1000its,828,830,2154.229509356,2115.586232285,-2
carcassonne-uct315-vs-uct410-1000its,829,831,2237.051201491,2209.37782141,-2
carcassonne-boltzmann15-vs-boltzmann60-1000its,830,832,2210.297219582,2146.977093643,-2
carcassonne-ucttuned235-vs-ucttuned205-1000its,830,832,2226.911764965,2193.049885722,-2
carcassonne-uct65-vs-uct55-1000its,831,833,2164.600683991,2144.853676014,-2
carcassonne-uct165-vs-uct330-1000its,832,834,2181.814604489,2142.555358087,-2
carcassonne-uct25-vs-uct45-1000its,832,834,2179.094227661,2132.370253965,-2
carcassonne-ucttuned85-vs-ucttuned105-1000its,832,834,2208.154701006,2147.704223432,-2
carcassonne-boltzmann105-vs-boltzmann365-1000its,834,836,2216.397031212,2135.677381176,-2
carcassonne-ucttuned270-vs-ucttuned45-1000its,834,836,2241.76237876,2210.262289308,-2
carcassonne-ucttuned370-vs-ucttuned430-1000its,834,836,2216.969973222,2172.744208461,-2
carcassonne-boltzmann190-vs-boltzmann475-1000its,835,837,2222.710357375,2160.754304249,-2
carcassonne-ucttuned200-vs-ucttuned325-1000its,836,838,2176.333196127,2161.103197443,-2
carcassonne-uct405-vs-uct260-1000its,837,839,2151.158106047,2142.044602311,-2
carcassonne-boltzmann435-vs-boltzmann340-1000its,838,840,2170.025045176,2129.013215765,-2
carcassonne-boltzmann330-vs-boltzmann250-1000its,840,842,2261.118719349,2189.437024588,-2
carcassonne-uct395-vs-uct10-1000its,841,843,2123.135433399,2130.838436917,-2
carcassonne-uct50-vs-uct280-1000its,842,844,2260.012943173,2179.533596911,-2
carcassonne-boltzmann425-vs-boltzmann485-1000its,843,845,2251.985959333,2186.504418755,-2
carcassonne-uct120-vs-uct455-1000its,844,846,2214.189239046,2179.744508951,-2
carcassonne-boltzmann270-vs-boltzmann475-1000its,845,847,2205.309924699,2169.246044845,-2
carcassonne-boltzmann330-vs-boltzmann325-1000its,845,847,2183.438434481,2167.224090308,-2
carcassonne-ucttuned25-vs-ucttuned375-1000its,845,847,2183.99732528,2130.757729839,-2
carcassonne-ucttuned75-vs-ucttuned250-1000its,845,847,2240.933578946,2188.425010586,-2
carcassonne-boltzmann160-vs-boltzmann210-1000its,848,850,2113.513717051,2093.001607353,-2
carcassonne-ucttuned480-vs-ucttuned235-1000its,852,854,2212.45476027,2193.910127809,-2
carcassonne-ucttuned315-vs-ucttuned330-1000its,853,855,2182.803144962,2141.661962304,-2
carcassonne-ucttuned55-vs-ucttuned85-1000its,853,855,2123.559192713,2113.410780027,-2
carcassonne-ucttuned75-vs-ucttuned475-1000its,855,857,2236.785391388,2171.763887587,-2
carcassonne-ucttuned210-vs-ucttuned495-1000its,856,858,2234.855761918,2218.714006005,-2
carcassonne-uct450-vs-uct460-1000its,860,862,2147.425526771,2119.230123299,-2
carcassonne-ucttuned415-vs-ucttuned330-1000its,860,862,2197.144596394,2195.456840468,-2
carcassonne-uct20-vs-uct10-1000its,861,863,2149.770340577,2118.438511094,-2
carcassonne-boltzmann365-vs-boltzmann480-1000its,862,864,2193.81657457,2138.218394034,-2
carcassonne-ucttuned405-vs-ucttuned160-1000its,862,864,2234.94884751,2222.982402591,-2
carcassonne-boltzmann150-vs-boltzmann200-1000its,863,865,2151.094197755,2067.994725098,-2
carcassonne-boltzmann165-vs-boltzmann225-1000its,863,865,2149.088105212,2148.459388575,-2
carcassonne-boltzmann30-vs-boltzmann435-1000its,863,865,2241.688523239,2155.142688827,-2
carcassonne-ucttuned105-vs-ucttuned390-1000its,866,868,2215.52936445,2174.535576248,-2
carcassonne-uct480-vs-uct300-1000its,867,869,2177.232884064,2104.959903382,-2
carcassonne-ucttuned125-vs-ucttuned390-1000its,868,870,2226.707822278,2147.374938565,-2
carcassonne-boltzmann120-vs-boltzmann125-1000its,870,872,2194.593826175,2137.485722003,-2
carcassonne-uct85-vs-uct445-1000its,871,873,2230.882046643,2198.517362206,-2
carcassonne-boltzmann395-vs-boltzmann495-1000its,875,877,2256.471999968,2194.114950231,-2
carcassonne-uct340-vs-uct475-1000its,875,877,2242.263219865,2147.041171288,-2
carcassonne-uct450-vs-uct150-1000its,877,879,2219.459049862,2162.811950428,-2
carcassonne-ucttuned460-vs-ucttuned235-1000its,882,884,2223.212076388,2196.340109215,-2
carcassonne-boltzmann215-vs-boltzmann290-1000its,888,890,2131.20452743,2140.949796306,-2
carcassonne-ucttuned390-vs-ucttuned100-1000its,891,893,2178.128057125,2119.670501969,-2
carcassonne-uct5-vs-uct330-1000its,904,906,2245.696997577,2186.38873399,-2
carcassonne-boltzmann255-vs-boltzmann400-1000its,916,918,2261.047297398,2164.803602624,-2
carcassonne-uct15-vs-uct230-1000its,926,928,2275.151509205,2235.35672997,-2
carcassonne-boltzmann5-vs-boltzmann40-1000its,667,668,1749.427545142,1670.398037424,-1
carcassonne-boltzmann400-vs-boltzmann25-1000its,729,730,2132.745711625,2107.867938877,-1
carcassonne-uct180-vs-uct220-1000its,741,742,2175.904562903,2160.295607453,-1
carcassonne-ucttuned230-vs-ucttuned300-1000its,741,742,2205.973763252,2184.806286498,-1
carcassonne-ucttuned35-vs-ucttuned490-1000its,741,742,2134.225363671,2098.274338859,-1
carcassonne-uct15-vs-uct195-1000its,746,747,2094.879016577,2046.810804054,-1
carcassonne-ucttuned280-vs-ucttuned365-1000its,746,747,2218.15687876,2121.769476797,-1
carcassonne-boltzmann270-vs-boltzmann65-1000its,749,750,2196.797675806,2122.82823747,-1
carcassonne-boltzmann350-vs-boltzmann300-1000its,749,750,2329.993966217,2271.275704636,-1
carcassonne-ucttuned245-vs-ucttuned370-1000its,750,751,2204.938912224,2177.058040152,-1
carcassonne-uct430-vs-uct495-1000its,753,754,2200.281099097,2143.711853875,-1
carcassonne-uct210-vs-uct150-1000its,754,755,2207.694969561,2174.548794128,-1
carcassonne-boltzmann275-vs-boltzmann450-1000its,756,757,2230.088421093,2182.272586215,-1
carcassonne-boltzmann350-vs-boltzmann210-1000its,756,757,2211.196326533,2199.557666902,-1
carcassonne-uct210-vs-uct275-1000its,756,757,2203.124632181,2141.756298644,-1
carcassonne-boltzmann130-vs-boltzmann375-1000its,760,761,2298.764247875,2202.214325859,-1
carcassonne-boltzmann55-vs-boltzmann295-1000its,760,761,2298.573018381,2226.669660649,-1
carcassonne-uct285-vs-uct75-1000its,760,761,2145.809166643,2063.461605353,-1
carcassonne-boltzmann405-vs-boltzmann425-1000its,762,763,2227.500999127,2151.97070963,-1
carcassonne-ucttuned470-vs-ucttuned165-1000its,764,765,2284.136294628,2240.162960113,-1
carcassonne-uct450-vs-uct240-1000its,765,766,2147.82917223,2111.845028464,-1
carcassonne-ucttuned275-vs-ucttuned235-1000its,767,768,2152.354344265,2127.516371581,-1
carcassonne-uct135-vs-uct25-1000its,768,769,2180.634844221,2127.396804133,-1
carcassonne-uct345-vs-uct55-1000its,768,769,2135.764709697,2069.805236186,-1
carcassonne-ucttuned435-vs-ucttuned60-1000its,769,770,2200.736036529,2182.910717541,-1
carcassonne-ucttuned480-vs-ucttuned325-1000its,770,771,2173.668220918,2132.991323019,-1
carcassonne-uct470-vs-uct250-1000its,771,772,2196.083285914,2143.732243466,-1
carcassonne-ucttuned110-vs-ucttuned115-1000its,772,773,2194.95593486,2159.966685882,-1
carcassonne-uct495-vs-uct270-1000its,773,774,2191.201607641,2196.755731299,-1
carcassonne-boltzmann35-vs-boltzmann395-1000its,774,775,2228.401685739,2160.602785256,-1
carcassonne-boltzmann430-vs-boltzmann20-1000its,774,775,2205.521482677,2147.9463175,-1
carcassonne-uct295-vs-uct210-1000its,774,775,2140.282278605,2105.2811092,-1
carcassonne-ucttuned240-vs-ucttuned485-1000its,775,776,2157.3443701,2139.423318319,-1
carcassonne-uct50-vs-uct345-1000its,776,777,2202.879470576,2187.178699187,-1
carcassonne-boltzmann120-vs-boltzmann145-1000its,777,778,2131.271452226,2153.174255932,-1
carcassonne-uct135-vs-uct375-1000its,777,778,2192.121578255,2198.175164194,-1
carcassonne-ucttuned135-vs-ucttuned195-1000its,777,778,2223.908950333,2171.677206815,-1
carcassonne-uct85-vs-uct10-1000its,778,779,2121.828708436,2086.045849063,-1
carcassonne-ucttuned105-vs-ucttuned215-1000its,778,779,2168.428220192,2138.463614741,-1
carcassonne-uct315-vs-uct95-1000its,779,780,2206.96253942,2176.998787031,-1
carcassonne-boltzmann170-vs-boltzmann345-1000its,780,781,2220.516488043,2217.614531555,-1
carcassonne-uct325-vs-uct370-1000its,781,782,2159.538050668,2112.751792924,-1
carcassonne-boltzmann125-vs-boltzmann435-1000its,782,783,2162.248842574,2087.098270643,-1
carcassonne-uct35-vs-uct115-1000its,783,784,2188.775814504,2166.929910087,-1
carcassonne-ucttuned95-vs-ucttuned290-1000its,784,785,2159.153408032,2107.75857266,-1
carcassonne-uct475-vs-uct345-1000its,786,787,2177.001414937,2103.819185419,-1
carcassonne-uct65-vs-uct210-1000its,786,787,2230.730847186,2163.068304204,-1
carcassonne-ucttuned490-vs-ucttuned455-1000its,786,787,2165.091732781,2142.599900112,-1
carcassonne-boltzmann150-vs-boltzmann30-1000its,787,788,2215.394247117,2166.995010575,-1
carcassonne-uct155-vs-uct195-1000its,787,788,2139.378611071,2088.93348556,-1
carcassonne-uct190-vs-uct485-1000its,787,788,2268.718218396,2193.130821786,-1
carcassonne-uct315-vs-uct415-1000its,787,788,2229.775665613,2184.441551823,-1
carcassonne-uct85-vs-uct480-1000its,787,788,2204.654299889,2176.561548036,-1
carcassonne-ucttuned400-vs-ucttuned165-1000its,789,790,2214.003786051,2186.07947891,-1
carcassonne-ucttuned365-vs-ucttuned490-1000its,792,793,2249.215152482,2208.322685997,-1
carcassonne-uct280-vs-uct215-1000its,793,794,2140.559599227,2134.026894249,-1
carcassonne-boltzmann90-vs-boltzmann15-1000its,795,796,2115.256198524,2097.289575435,-1
carcassonne-uct375-vs-uct60-1000its,795,796,2165.943336661,2129.836385229,-1
carcassonne-ucttuned165-vs-ucttuned115-1000its,795,796,2152.445180856,2108.354539337,-1
carcassonne-boltzmann305-vs-boltzmann295-1000its,798,799,2152.645736475,2179.64131208,-1
carcassonne-uct475-vs-uct300-1000its,798,799,2185.925018584,2126.340908916,-1
carcassonne-boltzmann290-vs-boltzmann240-1000its,799,800,2155.656899345,2134.013834158,-1
carcassonne-ucttuned320-vs-ucttuned410-1000its,799,800,2206.829771235,2203.948000293,-1
carcassonne-uct450-vs-uct485-1000its,800,801,2238.399982403,2145.036327482,-1
carcassonne-uct455-vs-uct325-1000its,800,801,2162.301362235,2135.106445395,-1
carcassonne-uct280-vs-uct465-1000its,802,803,2208.73877187,2215.431355041,-1
carcassonne-ucttuned345-vs-ucttuned360-1000its,802,803,2213.24996648,2184.532157489,-1
carcassonne-uct200-vs-uct425-1000its,803,804,2224.805747625,2206.694264646,-1
carcassonne-uct240-vs-uct365-1000its,804,805,2165.193902353,2139.246152256,-1
carcassonne-uct300-vs-uct90-1000its,804,805,2243.783557465,2150.783518774,-1
carcassonne-boltzmann240-vs-boltzmann445-1000its,805,806,2184.23398585,2148.516884515,-1
carcassonne-boltzmann75-vs-boltzmann480-1000its,806,807,2193.980971934,2149.571720097,-1
carcassonne-boltzmann475-vs-boltzmann160-1000its,807,808,2204.065993438,2166.518328071,-1
carcassonne-boltzmann465-vs-boltzmann20-1000its,808,809,2180.338656596,2110.526940268,-1
carcassonne-boltzmann100-vs-boltzmann70-1000its,809,810,2237.135482203,2176.816345709,-1
carcassonne-uct445-vs-uct305-1000its,810,811,2182.070216318,2155.717345746,-1
carcassonne-ucttuned115-vs-ucttuned435-1000its,810,811,2142.832553069,2127.196612938,-1
carcassonne-ucttuned130-vs-ucttuned140-1000its,810,811,2177.397814829,2147.170741879,-1
carcassonne-ucttuned475-vs-ucttuned430-1000its,810,811,2259.750027082,2205.776938145,-1
carcassonne-ucttuned485-vs-ucttuned420-1000its,811,812,2161.104189453,2163.831896978,-1
carcassonne-ucttuned65-vs-ucttuned200-1000its,811,812,2181.618396475,2131.925796157,-1
carcassonne-ucttuned70-vs-ucttuned170-1000its,811,812,2208.331100559,2157.081609834,-1
carcassonne-ucttuned235-vs-ucttuned415-1000its,813,814,2242.281720614,2148.804667897,-1
carcassonne-ucttuned305-vs-ucttuned65-1000its,813,814,2231.933520724,2229.354548965,-1
carcassonne-boltzmann340-vs-boltzmann265-1000its,814,815,2192.662502253,2166.657671194,-1
carcassonne-ucttuned455-vs-ucttuned235-1000its,815,816,2163.648614318,2143.043225256,-1
carcassonne-boltzmann60-vs-boltzmann445-1000its,816,817,2178.029907492,2143.605933409,-1
carcassonne-boltzmann355-vs-boltzmann390-1000its,817,818,2194.164061996,2152.404904686,-1
carcassonne-uct290-vs-uct185-1000its,817,818,2165.037557975,2123.109008603,-1
carcassonne-boltzmann25-vs-boltzmann120-1000its,818,819,2229.679632873,2169.87770814,-1
carcassonne-uct205-vs-uct10-1000its,818,819,2162.263897978,2130.70555239,-1
carcassonne-boltzmann190-vs-boltzmann105-1000its,820,821,2155.861857384,2108.028934372,-1
carcassonne-uct390-vs-uct165-1000its,821,822,2173.235353932,2202.082806,-1
carcassonne-uct5-vs-uct20-1000its,821,822,2184.924296261,2145.583751364,-1
carcassonne-ucttuned220-vs-ucttuned185-1000its,821,822,2225.371208816,2189.801145184,-1
carcassonne-boltzmann50-vs-boltzmann450-1000its,822,823,2259.879983921,2199.730122987,-1
carcassonne-ucttuned330-vs-ucttuned85-1000its,822,823,2249.41951025,2255.571485044,-1
carcassonne-uct485-vs-uct495-1000its,823,824,2182.126406792,2142.144573202,-1
carcassonne-ucttuned365-vs-ucttuned65-1000its,823,824,2171.525663654,2129.280797811,-1
carcassonne-boltzmann490-vs-boltzmann295-1000its,824,825,2152.386782956,2115.075407171,-1
carcassonne-uct145-vs-uct110-1000its,824,825,2193.026192702,2101.549926079,-1
carcassonne-ucttuned145-vs-ucttuned185-1000its,824,825,2195.286490852,2155.611348988,-1
carcassonne-uct285-vs-uct275-1000its,825,826,2187.684077716,2138.506593787,-1
carcassonne-boltzmann80-vs-boltzmann310-1000its,826,827,2293.204786823,2267.913524073,-1
carcassonne-uct80-vs-uct440-1000its,826,827,2248.225706114,2170.417889448,-1
carcassonne-uct75-vs-uct190-1000its,827,828,2288.724305096,2217.223349473,-1
carcassonne-boltzmann25-vs-boltzmann360-1000its,828,829,2249.637695241,2176.426171459,-1
carcassonne-uct465-vs-uct5-1000its,828,829,2200.984601964,2146.584329294,-1
carcassonne-boltzmann250-vs-boltzmann330-1000its,830,831,2198.05774528,2147.031492169,-1
carcassonne-uct400-vs-uct330-1000its,831,832,2164.61918634,2086.850289043,-1
carcassonne-uct195-vs-uct25-1000its,832,833,2249.035238944,2202.665945469,-1
carcassonne-uct145-vs-uct305-1000its,835,836,2119.648585321,2135.612404208,-1
carcassonne-ucttuned120-vs-ucttuned215-1000its,836,837,2199.428654083,2162.315052515,-1
carcassonne-ucttuned180-vs-ucttuned300-1000its,836,837,2167.143356168,2116.946574619,-1
carcassonne-ucttuned405-vs-ucttuned50-1000its,836,837,2188.457950186,2131.777604067,-1
carcassonne-uct75-vs-uct110-1000its,840,841,2247.131873322,2198.825590272,-1
carcassonne-ucttuned335-vs-ucttuned70-1000its,840,841,2192.948415939,2168.525541517,-1
carcassonne-uct70-vs-uct15-1000its,841,842,2250.098858429,2192.576234269,-1
carcassonne-boltzmann435-vs-boltzmann180-1000its,842,843,2190.94973306,2142.775489389,-1
carcassonne-boltzmann265-vs-boltzmann55-1000its,843,844,2118.637280079,2085.116953554,-1
carcassonne-uct65-vs-uct485-1000its,843,844,2273.775250213,2193.742123551,-1
carcassonne-ucttuned260-vs-ucttuned235-1000its,844,845,2216.42977635,2173.031904534,-1
carcassonne-ucttuned445-vs-ucttuned370-1000its,844,845,2170.089833317,2154.388650085,-1
carcassonne-boltzmann395-vs-boltzmann145-1000its,846,847,2213.106309886,2152.331934313,-1
carcassonne-boltzmann300-vs-boltzmann200-1000its,849,850,2173.662397929,2212.274342751,-1
carcassonne-ucttuned370-vs-ucttuned415-1000its,849,850,2256.363207626,2220.21460162,-1
carcassonne-uct55-vs-uct450-1000its,850,851,2220.033061528,2167.308825756,-1
carcassonne-boltzmann330-vs-boltzmann380-1000its,851,852,2227.953102999,2160.408037756,-1
carcassonne-ucttuned195-vs-ucttuned270-1000its,854,855,2179.345881033,2125.405635387,-1
carcassonne-ucttuned485-vs-ucttuned275-1000its,854,855,2163.124518152,2134.839644669,-1
carcassonne-boltzmann340-vs-boltzmann20-1000its,855,856,2208.702874502,2145.533650867,-1
carcassonne-uct380-vs-uct85-1000its,856,857,2247.934633482,2204.944767147,-1
carcassonne-ucttuned225-vs-ucttuned420-1000its,858,859,2217.273106566,2224.905858552,-1
carcassonne-uct135-vs-uct20-1000its,859,860,2221.214598089,2187.610594221,-1
carcassonne-ucttuned95-vs-ucttuned25-1000its,860,861,2158.433689258,2150.074726992,-1
carcassonne-ucttuned60-vs-ucttuned50-1000its,861,862,2182.664131337,2101.392221593,-1
carcassonne-ucttuned485-vs-ucttuned75-1000its,867,868,2132.625017649,2077.279262797,-1
carcassonne-boltzmann265-vs-boltzmann255-1000its,868,869,2253.58840806,2203.986727085,-1
carcassonne-ucttuned435-vs-ucttuned230-1000its,870,871,2195.949971287,2185.793092946,-1
carcassonne-uct330-vs-uct245-1000its,871,872,2194.419211761,2174.69684373,-1
carcassonne-ucttuned420-vs-ucttuned430-1000its,880,881,2258.961142472,2185.798584708,-1
carcassonne-uct345-vs-uct5-1000its,912,913,2208.21004307,2136.377497937,-1
carcassonne-ucttuned30-vs-ucttuned160-1000its,925,926,2227.659328118,2182.078441067,-1
carcassonne-ucttuned40-vs-ucttuned140-1000its,942,943,2216.791477493,2191.77269779,-1
carcassonne-uct280-vs-uct345-1000its,723,723,2188.938699736,2136.311105206,0
carcassonne-uct395-vs-uct400-1000its,731,731,2176.255216289,2129.208609979,0
carcassonne-boltzmann240-vs-boltzmann475-1000its,734,734,2210.101288305,2161.382613393,0
carcassonne-uct130-vs-uct230-1000its,741,741,2154.71842075,2126.71227091,0
carcassonne-boltzmann460-vs-boltzmann215-1000its,742,742,2281.095559392,2202.362298912,0
carcassonne-ucttuned210-vs-ucttuned145-1000its,756,756,2228.160213321,2147.578753269,0
carcassonne-uct350-vs-uct480-1000its,757,757,2223.033676486,2188.132070467,0
carcassonne-boltzmann5-vs-boltzmann170-1000its,758,758,2294.658006567,2276.795368329,0
carcassonne-ucttuned150-vs-ucttuned90-1000its,758,758,2172.135340555,2141.059056912,0
carcassonne-boltzmann205-vs-boltzmann380-1000its,760,760,2161.471050981,2095.743160871,0
carcassonne-boltzmann70-vs-boltzmann290-1000its,764,764,2234.747182678,2189.89261805,0
carcassonne-uct225-vs-uct255-1000its,764,764,2204.373365959,2180.897674041,0
carcassonne-uct60-vs-uct15-1000its,764,764,2265.690372393,2188.540101868,0
carcassonne-boltzmann190-vs-boltzmann70-1000its,765,765,2198.3577571,2174.897796662,0
carcassonne-uct145-vs-uct135-1000its,765,765,2226.804946509,2189.51922007,0
carcassonne-boltzmann345-vs-boltzmann260-1000its,767,767,2221.57934603,2128.914355325,0
carcassonne-boltzmann50-vs-boltzmann220-1000its,768,768,2218.334419422,2172.926280169,0
carcassonne-uct125-vs-uct455-1000its,768,768,2223.851001329,2175.547078944,0
carcassonne-uct345-vs-uct10-1000its,770,770,2188.969701614,2122.091294622,0
carcassonne-uct385-vs-uct45-1000its,770,770,2252.367197328,2162.756673664,0
carcassonne-boltzmann395-vs-boltzmann485-1000its,771,771,2170.196027961,2121.108428371,0
carcassonne-boltzmann435-vs-boltzmann35-1000its,771,771,2187.388856639,2156.929441586,0
carcassonne-boltzmann35-vs-boltzmann285-1000its,772,772,2155.498433863,2097.420668605,0
carcassonne-boltzmann350-vs-boltzmann395-1000its,772,772,2214.101962211,2191.746815621,0
carcassonne-ucttuned290-vs-ucttuned280-1000its,772,772,2236.397794731,2198.863336738,0
carcassonne-boltzmann320-vs-boltzmann120-1000its,773,773,2199.476824777,2184.244795897,0
carcassonne-boltzmann355-vs-boltzmann490-1000its,776,776,2137.387774963,2088.151889109,0
carcassonne-boltzmann375-vs-boltzmann430-1000its,776,776,2271.625315024,2238.493286257,0
carcassonne-uct40-vs-uct100-1000its,777,777,2170.182628856,2142.308158695,0
carcassonne-uct270-vs-uct200-1000its,778,778,2191.10066356,2148.081965247,0
carcassonne-ucttuned405-vs-ucttuned320-1000its,779,779,2194.942617515,2153.675841278,0
carcassonne-boltzmann485-vs-boltzmann45-1000its,783,783,2155.650367648,2091.885034167,0
carcassonne-uct340-vs-uct50-1000its,784,784,2095.041508288,2064.707796197,0
carcassonne-ucttuned480-vs-ucttuned470-1000its,784,784,2301.023205863,2227.126761728,0
carcassonne-uct175-vs-uct105-1000its,787,787,2180.07818102,2158.427340641,0
carcassonne-uct470-vs-uct70-1000its,788,788,2150.811086108,2103.00010975,0
carcassonne-uct355-vs-uct445-1000its,790,790,2227.161142001,2158.82071408,0
carcassonne-boltzmann110-vs-boltzmann490-1000its,791,791,2239.461770245,2196.558077673,0
carcassonne-uct70-vs-uct380-1000its,791,791,2255.624088832,2209.720568617,0
carcassonne-ucttuned90-vs-ucttuned195-1000its,792,792,2132.356157654,2083.41783084,0
carcassonne-ucttuned60-vs-ucttuned355-1000its,793,793,2158.999847638,2101.471497268,0
carcassonne-boltzmann365-vs-boltzmann495-1000its,794,794,2161.000427076,2089.13714855,0
carcassonne-ucttuned150-vs-ucttuned350-1000its,794,794,2139.715851538,2089.956667435,0
carcassonne-ucttuned65-vs-ucttuned125-1000its,794,794,2191.112410488,2098.90852535,0
carcassonne-boltzmann300-vs-boltzmann135-1000its,795,795,2216.193299066,2172.793748295,0
carcassonne-uct455-vs-uct50-1000its,795,795,2135.123796791,2106.918680871,0
carcassonne-boltzmann290-vs-boltzmann475-1000its,796,796,2136.727835554,2121.926584186,0
carcassonne-ucttuned285-vs-ucttuned105-1000its,796,796,2171.942386623,2136.708917599,0
carcassonne-ucttuned60-vs-ucttuned460-1000its,797,797,2105.865862479,2088.596989749,0
carcassonne-boltzmann485-vs-boltzmann425-1000its,798,798,2190.768406036,2130.020854227,0
carcassonne-uct395-vs-uct70-1000its,798,798,2142.265256572,2143.850497351,0
carcassonne-ucttuned215-vs-ucttuned30-1000its,798,798,2208.679553542,2083.71817,0
carcassonne-uct135-vs-uct295-1000its,799,799,2196.223536247,2107.991309799,0
carcassonne-uct220-vs-uct365-1000its,800,800,2194.928983129,2126.490197703,0
carcassonne-uct30-vs-uct90-1000its,800,800,2230.943360734,2189.813595443,0
carcassonne-boltzmann230-vs-boltzmann300-1000its,801,801,2208.038291174,2161.639876634,0
carcassonne-uct320-vs-uct35-1000its,801,801,2188.466010711,2144.43505397,0
carcassonne-boltzmann425-vs-boltzmann255-1000its,802,802,2187.291163198,2163.125815011,0
carcassonne-uct190-vs-uct435-1000its,802,802,2151.012153935,2127.146380685,0
carcassonne-uct155-vs-uct410-1000its,804,804,2203.08278627,2150.042395676,0
carcassonne-ucttuned270-vs-ucttuned55-1000its,804,804,2201.495399196,2148.043153691,0
carcassonne-ucttuned215-vs-ucttuned185-1000its,805,805,2226.480146011,2150.739953529,0
carcassonne-ucttuned275-vs-ucttuned350-1000its,805,805,2238.97530934,2185.023997744,0
carcassonne-ucttuned405-vs-ucttuned480-1000its,805,805,2167.603704548,2175.155503863,0
carcassonne-boltzmann335-vs-boltzmann60-1000its,806,806,2233.94692182,2160.125991458,0
carcassonne-boltzmann235-vs-boltzmann40-1000its,808,808,2206.876327832,2141.960403856,0
carcassonne-boltzmann350-vs-boltzmann360-1000its,808,808,2193.235522641,2149.400890935,0
carcassonne-boltzmann65-vs-boltzmann255-1000its,808,808,2126.386816987,2106.667355069,0
carcassonne-uct420-vs-uct470-1000its,808,808,2187.082473557,2162.003868695,0
carcassonne-ucttuned320-vs-ucttuned135-1000its,808,808,2215.120783421,2138.152467768,0
carcassonne-boltzmann140-vs-boltzmann30-1000its,809,809,2174.046625568,2141.763620605,0
carcassonne-uct455-vs-uct195-1000its,809,809,2150.773093149,2136.669846158,0
carcassonne-ucttuned370-vs-ucttuned235-1000its,809,809,2244.369590428,2172.71971654,0
carcassonne-uct30-vs-uct325-1000its,810,810,2273.560884852,2200.832767149,0
carcassonne-ucttuned155-vs-ucttuned355-1000its,810,810,2182.344472491,2144.6504738,0
carcassonne-boltzmann465-vs-boltzmann115-1000its,811,811,2121.987985606,2119.946973279,0
carcassonne-uct440-vs-uct145-1000its,811,811,2183.195039778,2165.580890114,0
carcassonne-ucttuned175-vs-ucttuned325-1000its,811,811,2159.905477187,2119.664263219,0
carcassonne-boltzmann385-vs-boltzmann435-1000its,812,812,2271.038676657,2154.101885001,0
carcassonne-boltzmann155-vs-boltzmann395-1000its,813,813,2173.033408937,2089.552877434,0
carcassonne-ucttuned65-vs-ucttuned455-1000its,813,813,2260.500779583,2147.292413546,0
carcassonne-ucttuned25-vs-ucttuned125-1000its,814,814,2250.950947172,2204.375303666,0
carcassonne-ucttuned330-vs-ucttuned175-1000its,816,816,2157.701223139,2125.618166769,0
carcassonne-boltzmann155-vs-boltzmann150-1000its,817,817,2229.726558366,2172.992679817,0
carcassonne-uct30-vs-uct70-1000its,817,817,2219.656506449,2187.752026142,0
carcassonne-uct360-vs-uct460-1000its,817,817,2221.747902742,2229.267098631,0
carcassonne-uct275-vs-uct330-1000its,818,818,2242.154737098,2180.566997737,0
carcassonne-ucttuned285-vs-ucttuned355-1000its,818,818,2215.371928517,2195.987061123,0
carcassonne-boltzmann260-vs-boltzmann45-1000its,819,819,2204.80583352,2171.929119622,0
carcassonne-boltzmann455-vs-boltzmann60-1000its,820,820,2202.621808363,2133.69832621,0
carcassonne-uct410-vs-uct180-1000its,820,820,2255.300827966,2190.266638413,0
carcassonne-ucttuned250-vs-ucttuned485-1000its,821,821,2176.78150669,2164.799955146,0
carcassonne-boltzmann225-vs-boltzmann120-1000its,822,822,2208.497261281,2177.211529506,0
carcassonne-boltzmann445-vs-boltzmann250-1000its,822,822,2205.378547768,2189.147327642,0
carcassonne-uct95-vs-uct175-1000its,822,822,2172.390102339,2154.541564643,0
carcassonne-uct95-vs-uct290-1000its,822,822,2180.575487343,2103.896677318,0
carcassonne-boltzmann240-vs-boltzmann425-1000its,824,824,2186.077667692,2193.149905324,0
carcassonne-boltzmann210-vs-boltzmann225-1000its,825,825,2222.448063069,2156.432443208,0
carcassonne-uct305-vs-uct25-1000its,825,825,2181.45210919,2171.881635316,0
carcassonne-uct25-vs-uct230-1000its,826,826,2210.164425025,2153.725176183,0
carcassonne-boltzmann470-vs-boltzmann400-1000its,828,828,2168.787838364,2137.976786657,0
carcassonne-ucttuned30-vs-ucttuned325-1000its,828,828,2227.051857199,2177.633370278,0
carcassonne-boltzmann355-vs-boltzmann15-1000its,829,829,2205.991560132,2178.809168305,0
carcassonne-ucttuned190-vs-ucttuned215-1000its,830,830,2082.663099416,2032.384713003,0
carcassonne-boltzmann250-vs-boltzmann255-1000its,831,831,2234.856728957,2209.126706726,0
carcassonne-uct145-vs-uct415-1000its,831,831,2205.53941172,2169.31514583,0
carcassonne-boltzmann200-vs-boltzmann140-1000its,833,833,2224.462773965,2103.842420434,0
carcassonne-uct370-vs-uct490-1000its,833,833,2197.540121727,2137.320129184,0
carcassonne-ucttuned130-vs-ucttuned425-1000its,833,833,2168.352043955,2158.156811307,0
carcassonne-uct95-vs-uct75-1000its,836,836,2238.303301637,2228.789688424,0
carcassonne-boltzmann450-vs-boltzmann160-1000its,837,837,2231.215894469,2175.83026913,0
carcassonne-uct165-vs-uct445-1000its,838,838,2184.140490327,2159.033187684,0
carcassonne-uct395-vs-uct85-1000its,838,838,2224.641383084,2153.586756608,0
carcassonne-uct40-vs-uct240-1000its,839,839,2268.286561649,2170.631298332,0
carcassonne-uct280-vs-uct375-1000its,841,841,2175.422187251,2139.019561051,0
carcassonne-ucttuned360-vs-ucttuned35-1000its,841,841,2214.175366928,2138.697058424,0
carcassonne-ucttuned85-vs-ucttuned55-1000its,841,841,2215.321087471,2130.342547554,0
carcassonne-uct275-vs-uct115-1000its,844,844,2176.780035148,2152.258322054,0
carcassonne-uct320-vs-uct125-1000its,844,844,2184.400755862,2137.146928148,0
carcassonne-ucttuned160-vs-ucttuned55-1000its,845,845,2228.866859901,2163.471475342,0
carcassonne-uct200-vs-uct135-1000its,846,846,2206.242113673,2177.247735386,0
carcassonne-uct265-vs-uct200-1000its,846,846,2159.658170635,2067.236742481,0
carcassonne-uct250-vs-uct325-1000its,849,849,2296.301876933,2223.195629565,0
carcassonne-boltzmann340-vs-boltzmann95-1000its,850,850,2159.691114664,2127.44231676,0
carcassonne-boltzmann35-vs-boltzmann5-1000its,850,850,2202.601284856,2209.280765619,0
carcassonne-uct135-vs-uct30-1000its,850,850,2169.645446713,2130.752049504,0
carcassonne-uct165-vs-uct90-1000its,852,852,2215.974060645,2194.739066628,0
carcassonne-ucttuned65-vs-ucttuned390-1000its,855,855,2223.165832523,2216.504948065,0
carcassonne-boltzmann250-vs-boltzmann10-1000its,856,856,2235.626065668,2176.852292089,0
carcassonne-boltzmann310-vs-boltzmann405-1000its,857,857,2171.749636538,2152.622207414,0
carcassonne-ucttuned70-vs-ucttuned115-1000its,857,857,2187.851521217,2143.732158491,0
carcassonne-uct10-vs-uct85-1000its,861,861,2245.250451696,2193.379036963,0
carcassonne-boltzmann485-vs-boltzmann270-1000its,862,862,2141.142517136,2116.02809087,0
carcassonne-uct135-vs-uct275-1000its,864,864,2239.717097398,2157.990136946,0
carcassonne-boltzmann410-vs-boltzmann485-1000its,867,867,2197.027375499,2136.644987699,0
carcassonne-boltzmann445-vs-boltzmann205-1000its,873,873,2222.301563013,2211.358106817,0
carcassonne-ucttuned55-vs-ucttuned125-1000its,873,873,2271.098620398,2192.363556364,0
carcassonne-uct255-vs-uct10-1000its,874,874,2208.404774488,2133.165587669,0
carcassonne-uct110-vs-uct320-1000its,876,876,2192.690955924,2141.655352104,0
carcassonne-ucttuned170-vs-ucttuned190-1000its,880,880,2258.174628301,2210.907654465,0
carcassonne-ucttuned445-vs-ucttuned160-1000its,880,880,2183.591740252,2140.625829548,0
carcassonne-ucttuned15-vs-ucttuned235-1000its,892,892,2217.898723796,2226.51535253,0
carcassonne-ucttuned475-vs-ucttuned40-1000its,903,903,2200.397086904,2119.520298428,0
carcassonne-boltzmann385-vs-boltzmann280-1000its,908,908,2187.580993685,2123.871047658,0
carcassonne-ucttuned190-vs-ucttuned5-1000its,921,921,2149.434552013,2097.427119404,0
carcassonne-ucttuned275-vs-ucttuned30-1000its,924,924,2177.163186544,2171.803456123,0
carcassonne-boltzmann370-vs-boltzmann450-1000its,710,709,2229.587770449,2183.014709728,1
carcassonne-uct300-vs-uct230-1000its,714,713,2192.438772828,2111.250350375,1
carcassonne-boltzmann400-vs-boltzmann450-1000its,722,721,2160.689332905,2045.154393392,1
carcassonne-uct315-vs-uct120-1000its,724,723,2232.447246728,2185.352964819,1
carcassonne-uct330-vs-uct50-1000its,754,753,2153.091651693,2151.574513989,1
carcassonne-boltzmann260-vs-boltzmann150-1000its,755,754,2211.437017867,2201.523913254,1
carcassonne-uct435-vs-uct425-1000its,755,754,2200.329842671,2121.097666663,1
carcassonne-boltzmann370-vs-boltzmann205-1000its,756,755,2167.322478624,2128.089147855,1
carcassonne-uct270-vs-uct390-1000its,758,757,2213.284311011,2173.757687725,1
carcassonne-boltzmann160-vs-boltzmann235-1000its,759,758,2146.796919981,2127.910137403,1
carcassonne-boltzmann195-vs-boltzmann280-1000its,759,758,2185.325125099,2134.459362794,1
carcassonne-boltzmann240-vs-boltzmann330-1000its,759,758,2180.915049416,2173.630824562,1
carcassonne-boltzmann350-vs-boltzmann75-1000its,760,759,2196.022353311,2168.028787499,1
carcassonne-boltzmann260-vs-boltzmann485-1000its,762,761,2151.514556784,2106.948756322,1
carcassonne-boltzmann440-vs-boltzmann55-1000its,765,764,2174.778047712,2145.61508269,1
carcassonne-ucttuned165-vs-ucttuned325-1000its,766,765,2157.485437741,2142.78897682,1
carcassonne-boltzmann300-vs-boltzmann310-1000its,767,766,2130.765468819,2109.411925912,1
carcassonne-uct130-vs-uct495-1000its,768,767,2198.111815372,2157.794527129,1
carcassonne-ucttuned205-vs-ucttuned495-1000its,768,767,2241.409567437,2172.720668094,1
carcassonne-ucttuned155-vs-ucttuned240-1000its,770,769,2197.929219717,2159.895215184,1
carcassonne-boltzmann275-vs-boltzmann440-1000its,771,770,2172.302591284,2123.912430535,1
carcassonne-boltzmann305-vs-boltzmann15-1000its,772,771,2118.615982637,2098.339050253,1
carcassonne-boltzmann210-vs-boltzmann155-1000its,774,773,2188.47481245,2165.531578806,1
carcassonne-boltzmann475-vs-boltzmann315-1000its,774,773,2146.67512974,2125.316184199,1
carcassonne-ucttuned350-vs-ucttuned285-1000its,774,773,2186.669612383,2174.601360011,1
carcassonne-ucttuned25-vs-ucttuned130-1000its,775,774,2122.289002523,2072.851858058,1
carcassonne-ucttuned55-vs-ucttuned415-1000its,776,775,2197.125206796,2151.311264401,1
carcassonne-uct105-vs-uct210-1000its,777,776,2240.721475994,2184.847553829,1
carcassonne-uct445-vs-uct120-1000its,778,777,2189.253349897,2125.412598333,1
carcassonne-ucttuned330-vs-ucttuned365-1000its,778,777,2183.18425684,2157.006366038,1
carcassonne-ucttuned420-vs-ucttuned275-1000its,779,778,2275.984990351,2204.759996058,1
carcassonne-ucttuned90-vs-ucttuned400-1000its,779,778,2308.572960025,2231.167584634,1
carcassonne-ucttuned435-vs-ucttuned310-1000its,781,780,2342.485950786,2265.798274598,1
carcassonne-boltzmann355-vs-boltzmann250-1000its,782,781,2210.292792875,2141.107441442,1
carcassonne-boltzmann405-vs-boltzmann255-1000its,782,781,2185.182484372,2117.192447512,1
carcassonne-boltzmann65-vs-boltzmann40-1000its,782,781,2176.590217266,2142.424821305,1
carcassonne-uct30-vs-uct275-1000its,783,782,2226.77374293,2166.75726832,1
carcassonne-ucttuned400-vs-ucttuned15-1000its,783,782,2204.090217586,2135.862845628,1
carcassonne-uct150-vs-uct250-1000its,784,783,2121.798719836,2057.933011652,1
carcassonne-ucttuned255-vs-ucttuned275-1000its,784,783,2193.511377304,2175.876626711,1
carcassonne-boltzmann80-vs-boltzmann360-1000its,787,786,2171.304777846,2108.903230897,1
carcassonne-uct445-vs-uct345-1000its,787,786,2260.856635271,2242.032511027,1
carcassonne-ucttuned490-vs-ucttuned470-1000its,787,786,2162.503570844,2077.978196478,1
carcassonne-uct220-vs-uct5-1000its,788,787,2249.736361076,2252.008529825,1
carcassonne-uct265-vs-uct120-1000its,789,788,2164.819742131,2156.869326065,1
carcassonne-ucttuned350-vs-ucttuned445-1000its,789,788,2222.593130992,2158.147792932,1
carcassonne-uct160-vs-uct380-1000its,792,791,2141.04360091,2129.623995981,1
carcassonne-uct465-vs-uct340-1000its,792,791,2178.208316043,2105.53350901,1
carcassonne-uct65-vs-uct470-1000its,792,791,2266.880858287,2194.477506212,1
carcassonne-ucttuned75-vs-ucttuned480-1000its,792,791,2207.45181493,2131.846921954,1
carcassonne-uct235-vs-uct355-1000its,793,792,2202.553945801,2148.262035498,1
carcassonne-ucttuned405-vs-ucttuned10-1000its,793,792,2171.569443925,2159.838173265,1
carcassonne-ucttuned470-vs-ucttuned365-1000its,793,792,2168.155261627,2104.949603283,1
carcassonne-uct105-vs-uct225-1000its,794,793,2154.631305616,2114.495434475,1
carcassonne-uct425-vs-uct125-1000its,794,793,2180.632595596,2162.988507038,1
carcassonne-uct440-vs-uct405-1000its,794,793,2208.409061371,2161.492855045,1
carcassonne-ucttuned295-vs-ucttuned245-1000its,795,794,2155.174977118,2149.393561444,1
carcassonne-ucttuned440-vs-ucttuned130-1000its,795,794,2241.352673459,2191.631545998,1
carcassonne-boltzmann100-vs-boltzmann475-1000its,796,795,2268.404572942,2230.678999342,1
carcassonne-uct350-vs-uct185-1000its,796,795,2138.852403393,2105.072833856,1
carcassonne-ucttuned290-vs-ucttuned330-1000its,796,795,2205.402805004,2168.068125732,1
carcassonne-boltzmann225-vs-boltzmann265-1000its,797,796,2283.598178252,2202.947006608,1
carcassonne-ucttuned170-vs-ucttuned235-1000its,797,796,2257.460553025,2208.495971304,1
carcassonne-boltzmann370-vs-boltzmann40-1000its,798,797,2209.729781839,2177.772764532,1
carcassonne-ucttuned140-vs-ucttuned75-1000its,798,797,2173.829139882,2140.813363574,1
carcassonne-ucttuned25-vs-ucttuned145-1000its,799,798,2241.653602171,2159.172323511,1
carcassonne-boltzmann415-vs-boltzmann140-1000its,800,799,2152.325744582,2087.821600219,1
carcassonne-uct260-vs-uct235-1000its,800,799,2251.569378423,2193.457935546,1
carcassonne-uct355-vs-uct20-1000its,800,799,2212.868248297,2158.825361191,1
carcassonne-ucttuned315-vs-ucttuned140-1000its,800,799,2148.711888838,2148.123814372,1
carcassonne-boltzmann145-vs-boltzmann310-1000its,801,800,2234.828702685,2190.573058635,1
carcassonne-boltzmann310-vs-boltzmann35-1000its,801,800,2157.439004082,2106.072004394,1
carcassonne-uct150-vs-uct330-1000its,801,800,2224.689235295,2168.195772349,1
carcassonne-ucttuned405-vs-ucttuned445-1000its,801,800,2250.570361165,2201.121549035,1
carcassonne-boltzmann100-vs-boltzmann170-1000its,802,801,2234.549364465,2183.866051118,1
carcassonne-uct100-vs-uct55-1000its,802,801,2172.66183344,2136.823880452,1
carcassonne-uct40-vs-uct375-1000its,802,801,2182.197989403,2144.776808323,1
carcassonne-uct415-vs-uct35-1000its,802,801,2168.283960239,2134.883222962,1
carcassonne-boltzmann405-vs-boltzmann210-1000its,803,802,2164.738606039,2081.357708108,1
carcassonne-uct450-vs-uct280-1000its,804,803,2187.093062583,2159.643113707,1
carcassonne-ucttuned250-vs-ucttuned360-1000its,805,804,2225.429660529,2164.742788704,1
carcassonne-uct415-vs-uct120-1000its,806,805,2191.44306407,2174.495304855,1
carcassonne-uct180-vs-uct95-1000its,808,807,2253.018402707,2202.435958512,1
carcassonne-uct225-vs-uct180-1000its,809,808,2152.607546321,2085.545180154,1
carcassonne-boltzmann170-vs-boltzmann285-1000its,810,809,2144.493442605,2097.230729,1
carcassonne-boltzmann240-vs-boltzmann460-1000its,810,809,2262.076057514,2200.685132437,1
carcassonne-uct230-vs-uct210-1000its,810,809,2170.372923193,2101.019330419,1
carcassonne-ucttuned205-vs-ucttuned465-1000its,810,809,2147.263906806,2118.954365033,1
carcassonne-ucttuned305-vs-ucttuned260-1000its,810,809,2205.926285033,2174.330455793,1
carcassonne-uct135-vs-uct440-1000its,812,811,2135.446157669,2043.006645113,1
carcassonne-uct250-vs-uct300-1000its,812,811,2194.330363216,2108.793360414,1
carcassonne-uct155-vs-uct360-1000its,813,812,2105.775177651,2061.689154223,1
carcassonne-uct495-vs-uct435-1000its,813,812,2213.656126319,2164.374103912,1
carcassonne-uct310-vs-uct95-1000its,814,813,2244.218180358,2210.584547651,1
carcassonne-uct115-vs-uct410-1000its,815,814,2171.610195222,2085.693565779,1
carcassonne-uct30-vs-uct360-1000its,815,814,2242.696139422,2162.374076382,1
carcassonne-boltzmann290-vs-boltzmann295-1000its,816,815,2222.46815541,2185.049827639,1
carcassonne-uct130-vs-uct160-1000its,816,815,2199.029145464,2149.005651814,1
carcassonne-uct255-vs-uct195-1000its,816,815,2192.65896658,2203.613580934,1
carcassonne-uct230-vs-uct195-1000its,817,816,2169.650223885,2121.954952078,1
carcassonne-boltzmann105-vs-boltzmann245-1000its,818,817,2126.459571792,2111.374398048,1
carcassonne-ucttuned380-vs-ucttuned420-1000its,818,817,2180.588174475,2168.809049172,1
carcassonne-boltzmann110-vs-boltzmann95-1000its,819,818,2175.601033503,2140.543797214,1
carcassonne-boltzmann210-vs-boltzmann290-1000its,819,818,2250.108362356,2195.973536125,1
carcassonne-boltzmann220-vs-boltzmann140-1000its,819,818,2258.13813735,2185.70443588,1
carcassonne-uct410-vs-uct320-1000its,819,818,2205.592636768,2138.79616377,1
carcassonne-ucttuned160-vs-ucttuned400-1000its,819,818,2185.186382272,2140.243998748,1
carcassonne-uct120-vs-uct125-1000its,820,819,2169.062329421,2131.261992171,1
carcassonne-boltzmann210-vs-boltzmann475-1000its,821,820,2181.715663557,2134.324273188,1
carcassonne-boltzmann25-vs-boltzmann70-1000its,821,820,2271.333024236,2190.638603423,1
carcassonne-boltzmann315-vs-boltzmann210-1000its,821,820,2257.514318281,2205.79609955,1
carcassonne-boltzmann5-vs-boltzmann410-1000its,822,821,2282.326444718,2196.639251786,1
carcassonne-boltzmann20-vs-boltzmann50-1000its,823,822,2234.942249648,2186.252475851,1
carcassonne-uct40-vs-uct315-1000its,825,824,2193.514144397,2167.803996185,1
carcassonne-uct330-vs-uct405-1000its,826,825,2140.684060653,2110.300702632,1
carcassonne-boltzmann460-vs-boltzmann70-1000its,829,828,2180.867310736,2124.674480338,1
carcassonne-uct115-vs-uct440-1000its,830,829,2189.249006182,2120.951809206,1
carcassonne-uct145-vs-uct95-1000its,830,829,2283.774949,2233.438557014,1
carcassonne-uct235-vs-uct190-1000its,830,829,2228.986683656,2152.725535599,1
carcassonne-uct45-vs-uct85-1000its,832,831,2211.863629257,2202.257680388,1
carcassonne-boltzmann375-vs-boltzmann20-1000its,833,832,2245.338623534,2179.79650678,1
carcassonne-uct250-vs-uct270-1000its,833,832,2174.157085487,2120.596228014,1
carcassonne-uct55-vs-uct220-1000its,833,832,2250.537352065,2178.491255721,1
carcassonne-uct290-vs-uct480-1000its,834,833,2206.485504659,2103.301803514,1
carcassonne-uct35-vs-uct25-1000its,834,833,2258.879734655,2193.576607301,1
carcassonne-ucttuned385-vs-ucttuned380-1000its,835,834,2157.33909909,2143.426540517,1
carcassonne-ucttuned470-vs-ucttuned480-1000its,835,834,2208.916227132,2183.298210172,1
carcassonne-uct295-vs-uct275-1000its,836,835,2200.277034034,2154.590105054,1
carcassonne-uct310-vs-uct175-1000its,836,835,2180.197078795,2097.388907664,1
carcassonne-uct380-vs-uct430-1000its,836,835,2238.525307637,2209.404822755,1
carcassonne-uct245-vs-uct170-1000its,838,837,2236.609644791,2215.43146861,1
carcassonne-ucttuned335-vs-ucttuned460-1000its,839,838,2186.17566671,2093.192224296,1
carcassonne-ucttuned240-vs-ucttuned225-1000its,840,839,2199.111552847,2178.678706623,1
carcassonne-ucttuned310-vs-ucttuned135-1000its,840,839,2203.444105139,2109.625950329,1
carcassonne-uct35-vs-uct190-1000its,843,842,2192.607972035,2151.326968699,1
carcassonne-uct375-vs-uct90-1000its,843,842,2223.072019403,2177.402232242,1
carcassonne-uct405-vs-uct200-1000its,844,843,2211.083360437,2139.077478562,1
carcassonne-ucttuned40-vs-ucttuned55-1000its,844,843,2293.523157572,2244.223723541,1
carcassonne-boltzmann220-vs-boltzmann90-1000its,845,844,2268.79261775,2226.123926126,1
carcassonne-boltzmann95-vs-boltzmann110-1000its,845,844,2204.915226809,2156.432503902,1
carcassonne-ucttuned275-vs-ucttuned230-1000its,845,844,2176.817475963,2139.907716058,1
carcassonne-ucttuned25-vs-ucttuned65-1000its,847,846,2257.446142099,2229.2856228,1
carcassonne-ucttuned405-vs-ucttuned340-1000its,847,846,2275.738827169,2208.084175365,1
carcassonne-boltzmann240-vs-boltzmann165-1000its,849,848,2225.18933131,2192.160162896,1
carcassonne-uct455-vs-uct160-1000its,849,848,2243.495293888,2214.294879783,1
carcassonne-ucttuned480-vs-ucttuned280-1000its,849,848,2190.853882034,2133.10104011,1
carcassonne-uct75-vs-uct405-1000its,850,849,2134.331512756,2120.549006948,1
carcassonne-ucttuned310-vs-ucttuned155-1000its,850,849,2174.577199707,2179.049889436,1
carcassonne-uct60-vs-uct145-1000its,852,851,2245.560059507,2222.056793782,1
carcassonne-uct80-vs-uct375-1000its,852,851,2178.805792741,2144.145952328,1
carcassonne-uct115-vs-uct355-1000its,853,852,2138.69501661,2119.282030388,1
carcassonne-uct235-vs-uct155-1000its,857,856,2170.133762652,2114.091506674,1
carcassonne-uct280-vs-uct5-1000its,858,857,2191.097501939,2190.684431702,1
carcassonne-uct80-vs-uct265-1000its,859,858,2304.533535105,2202.373185959,1
carcassonne-boltzmann385-vs-boltzmann140-1000its,860,859,2190.936487612,2097.006267353,1
carcassonne-ucttuned130-vs-ucttuned470-1000its,861,860,2258.568518457,2238.624632936,1
carcassonne-boltzmann305-vs-boltzmann90-1000its,862,861,2181.862773275,2161.005446773,1
carcassonne-uct150-vs-uct385-1000its,862,861,2191.595653434,2151.07334277,1
carcassonne-uct80-vs-uct140-1000its,862,861,2245.435891408,2205.832599474,1
carcassonne-ucttuned390-vs-ucttuned270-1000its,863,862,2168.349815406,2151.310467527,1
carcassonne-uct470-vs-uct135-1000its,864,863,2175.536689878,2191.918194885,1
carcassonne-uct435-vs-uct110-1000its,869,868,2162.165966428,2145.421383005,1
carcassonne-ucttuned295-vs-ucttuned300-1000its,869,868,2266.010117416,2232.448162449,1
carcassonne-ucttuned380-vs-ucttuned255-1000its,870,869,2198.699117378,2156.436570187,1
carcassonne-ucttuned345-vs-ucttuned280-1000its,872,871,2249.412826239,2195.511675519,1
carcassonne-uct455-vs-uct20-1000its,874,873,2214.866272912,2182.191092328,1
carcassonne-uct180-vs-uct310-1000its,875,874,2182.093799846,2126.317575759,1
carcassonne-uct90-vs-uct115-1000its,879,878,2243.70423242,2183.017039681,1
carcassonne-ucttuned205-vs-ucttuned260-1000its,879,878,2207.965160278,2169.376515758,1
carcassonne-ucttuned255-vs-ucttuned425-1000its,879,878,2211.235405303,2164.475587588,1
carcassonne-boltzmann405-vs-boltzmann15-1000its,880,879,2236.843583757,2200.164685138,1
carcassonne-ucttuned370-vs-ucttuned20-1000its,880,879,2197.931345411,2143.214759862,1
carcassonne-ucttuned465-vs-ucttuned295-1000its,881,880,2220.508828396,2166.080186651,1
carcassonne-uct290-vs-uct395-1000its,883,882,2156.340041828,2147.963174636,1
carcassonne-ucttuned140-vs-ucttuned150-1000its,883,882,2311.1463985,2264.860816883,1
carcassonne-uct320-vs-uct55-1000its,885,884,2216.800606924,2152.787397851,1
carcassonne-uct220-vs-uct35-1000its,887,886,2275.587427839,2238.987621805,1
carcassonne-ucttuned115-vs-ucttuned20-1000its,909,908,2201.507668444,2135.472194892,1
carcassonne-uct290-vs-uct495-1000its,923,922,2164.39906218,2125.057395858,1
carcassonne-ucttuned340-vs-ucttuned60-1000its,929,928,2169.373578643,2143.571472938,1
carcassonne-boltzmann335-vs-boltzmann415-1000its,735,733,2193.708498404,2162.469561784,2
carcassonne-uct400-vs-uct435-1000its,737,735,2180.490894328,2148.273888842,2
carcassonne-uct40-vs-uct200-1000its,738,736,2181.279564773,2130.379199018,2
carcassonne-uct215-vs-uct390-1000its,741,739,2187.539259082,2162.239520506,2
carcassonne-uct375-vs-uct460-1000its,746,744,2230.031411323,2203.62143049,2
carcassonne-ucttuned415-vs-ucttuned390-1000its,747,745,2239.347635016,2170.012235143,2
carcassonne-boltzmann265-vs-boltzmann290-1000its,749,747,2174.945634324,2093.212882997,2
carcassonne-uct215-vs-uct305-1000its,750,748,2273.919096401,2197.66261457,2
carcassonne-boltzmann80-vs-boltzmann175-1000its,751,749,2131.751518773,2086.954230368,2
carcassonne-uct190-vs-uct285-1000its,755,753,2254.136714358,2186.417277951,2
carcassonne-ucttuned155-vs-ucttuned460-1000its,756,754,2166.21833051,2112.830362769,2
carcassonne-ucttuned495-vs-ucttuned205-1000its,756,754,2186.075258149,2148.374495792,2
carcassonne-ucttuned275-vs-ucttuned120-1000its,759,757,2158.925642384,2102.380044903,2
carcassonne-ucttuned355-vs-ucttuned230-1000its,759,757,2295.644068466,2208.166988142,2
carcassonne-boltzmann345-vs-boltzmann405-1000its,762,760,2106.293849018,2050.15791318,2
carcassonne-ucttuned55-vs-ucttuned80-1000its,764,762,2326.069468091,2223.35938519,2
carcassonne-boltzmann215-vs-boltzmann320-1000its,765,763,2121.022055984,2056.588006515,2
carcassonne-ucttuned195-vs-ucttuned240-1000its,766,764,2208.525508055,2199.065844944,2
carcassonne-ucttuned390-vs-ucttuned145-1000its,767,765,2235.261346109,2191.443114458,2
carcassonne-ucttuned480-vs-ucttuned450-1000its,768,766,2221.928502837,2203.776819892,2
carcassonne-uct380-vs-uct480-1000its,769,767,2214.605728705,2198.923161043,2
carcassonne-ucttuned425-vs-ucttuned335-1000its,770,768,2178.320255349,2139.810322424,2
carcassonne-boltzmann365-vs-boltzmann235-1000its,772,770,2249.560351014,2227.829380945,2
carcassonne-uct170-vs-uct435-1000its,772,770,2203.655853143,2196.05908676,2
carcassonne-uct80-vs-uct495-1000its,772,770,2199.02908701,2201.388963664,2
carcassonne-boltzmann260-vs-boltzmann15-1000its,773,771,2269.656146696,2227.395005714,2
carcassonne-boltzmann340-vs-boltzmann240-1000its,773,771,2135.334495955,2086.480679153,2
carcassonne-ucttuned340-vs-ucttuned195-1000its,773,771,2203.312083229,2210.363387752,2
carcassonne-boltzmann445-vs-boltzmann70-1000its,774,772,2222.575710569,2168.117454679,2
carcassonne-boltzmann360-vs-boltzmann140-1000its,775,773,2247.982602421,2209.603561372,2
carcassonne-uct365-vs-uct480-1000its,778,776,2156.937980857,2106.277616848,2
carcassonne-ucttuned120-vs-ucttuned35-1000its,779,777,2167.134170276,2114.610532749,2
carcassonne-boltzmann145-vs-boltzmann95-1000its,780,778,2101.078259001,2068.544239793,2
carcassonne-ucttuned350-vs-ucttuned60-1000its,781,779,2249.06252088,2193.576390139,2
carcassonne-ucttuned420-vs-ucttuned475-1000its,783,781,2163.350613081,2135.241179088,2
carcassonne-uct210-vs-uct195-1000its,784,782,2191.167741595,2120.600397506,2
carcassonne-uct300-vs-uct70-1000its,784,782,2189.825866461,2133.946074025,2
carcassonne-boltzmann235-vs-boltzmann425-1000its,787,785,2247.016926809,2180.046936602,2
carcassonne-boltzmann35-vs-boltzmann330-1000its,787,785,2254.288222905,2176.624613994,2
carcassonne-uct270-vs-uct60-1000its,788,786,2184.545950908,2164.148461251,2
carcassonne-ucttuned165-vs-ucttuned385-1000its,788,786,2187.154095528,2146.746189907,2
carcassonne-boltzmann395-vs-boltzmann200-1000its,789,787,2161.118937942,2110.44250227,2
carcassonne-ucttuned175-vs-ucttuned490-1000its,789,787,2180.536942786,2163.488020804,2
carcassonne-ucttuned50-vs-ucttuned300-1000its,789,787,2248.597329447,2196.828587843,2
carcassonne-boltzmann345-vs-boltzmann370-1000its,790,788,2202.45685327,2144.527544199,2
carcassonne-uct220-vs-uct75-1000its,790,788,2151.067182308,2082.875493471,2
carcassonne-ucttuned255-vs-ucttuned110-1000its,791,789,2115.223785694,2066.196685691,2
carcassonne-ucttuned335-vs-ucttuned295-1000its,791,789,2161.535540802,2145.90702595,2
carcassonne-ucttuned45-vs-ucttuned50-1000its,791,789,2273.935524425,2221.867795745,2
carcassonne-uct90-vs-uct280-1000its,793,791,2242.063472654,2196.84970028,2
carcassonne-ucttuned45-vs-ucttuned155-1000its,793,791,2204.915345228,2125.19092526,2
carcassonne-boltzmann260-vs-boltzmann305-1000its,794,792,2149.714549549,2115.385962038,2
carcassonne-ucttuned125-vs-ucttuned25-1000its,795,793,2313.627540481,2248.832126442,2
carcassonne-boltzmann355-vs-boltzmann140-1000its,797,795,2212.311993601,2194.004249808,2
carcassonne-boltzmann415-vs-boltzmann105-1000its,797,795,2184.08866607,2148.412548681,2
carcassonne-uct85-vs-uct115-1000its,797,795,2109.376337546,2096.090592185,2
carcassonne-ucttuned400-vs-ucttuned285-1000its,797,795,2130.208923984,2133.906734008,2
carcassonne-boltzmann50-vs-boltzmann300-1000its,799,797,2279.830618918,2205.465304812,2
carcassonne-uct230-vs-uct225-1000its,799,797,2232.062964309,2200.511997998,2
carcassonne-uct125-vs-uct105-1000its,800,798,2150.674362885,2125.494760661,2
carcassonne-uct155-vs-uct275-1000its,800,798,2126.104264403,2074.723074274,2
carcassonne-uct200-vs-uct215-1000its,800,798,2243.427780708,2219.453042608,2
carcassonne-boltzmann55-vs-boltzmann310-1000its,801,799,2144.699372418,2124.850438631,2
carcassonne-ucttuned490-vs-ucttuned360-1000its,801,799,2150.592383971,2126.83139842,2
carcassonne-boltzmann280-vs-boltzmann310-1000its,802,800,2219.130401771,2278.786516775,2
carcassonne-ucttuned430-vs-ucttuned10-1000its,802,800,2147.52635297,2120.634958396,2
carcassonne-uct150-vs-uct105-1000its,803,801,2265.196667201,2196.19358628,2
carcassonne-uct35-vs-uct470-1000its,804,802,2196.378061125,2155.555106617,2
carcassonne-uct355-vs-uct365-1000its,805,803,2169.575198724,2142.969014559,2
carcassonne-boltzmann225-vs-boltzmann370-1000its,806,804,2189.763351325,2161.086649536,2
carcassonne-boltzmann90-vs-boltzmann465-1000its,806,804,2216.443222388,2136.911759763,2
carcassonne-uct15-vs-uct320-1000its,806,804,2168.694131889,2129.261943143,2
carcassonne-ucttuned90-vs-ucttuned480-1000its,806,804,2179.87793164,2168.507000616,2
carcassonne-boltzmann70-vs-boltzmann415-1000its,807,805,2245.888102788,2225.229644857,2
carcassonne-uct225-vs-uct390-1000its,807,805,2273.161450549,2195.358473885,2
carcassonne-uct495-vs-uct145-1000its,807,805,2270.214951575,2198.752733831,2
carcassonne-boltzmann180-vs-boltzmann355-1000its,808,806,2177.599110443,2156.732942471,2
carcassonne-boltzmann20-vs-boltzmann70-1000its,808,806,2185.457158333,2143.593039016,2
carcassonne-uct330-vs-uct165-1000its,808,806,2209.773339121,2166.653160174,2
carcassonne-uct395-vs-uct115-1000its,808,806,2141.71077505,2123.498296679,2
carcassonne-ucttuned155-vs-ucttuned55-1000its,808,806,2158.419026581,2109.458007118,2
carcassonne-ucttuned215-vs-ucttuned130-1000its,808,806,2247.523412339,2199.337490194,2
carcassonne-ucttuned70-vs-ucttuned320-1000its,808,806,2182.392250111,2170.906252998,2
carcassonne-boltzmann240-vs-boltzmann315-1000its,809,807,2184.568434807,2169.841943466,2
carcassonne-boltzmann180-vs-boltzmann450-1000its,812,810,2207.356071718,2132.23861449,2
carcassonne-ucttuned460-vs-ucttuned5-1000its,812,810,2095.5236505,2080.279363918,2
carcassonne-uct150-vs-uct90-1000its,813,811,2257.085379651,2201.456616183,2
carcassonne-uct230-vs-uct470-1000its,813,811,2168.824486394,2129.06027829,2
carcassonne-uct315-vs-uct30-1000its,813,811,2172.073765167,2085.139293216,2
carcassonne-boltzmann170-vs-boltzmann415-1000its,814,812,2230.027728473,2144.009964006,2
carcassonne-uct20-vs-uct215-1000its,814,812,2265.913481215,2148.959703012,2
carcassonne-boltzmann360-vs-boltzmann380-1000its,815,813,2181.122459417,2111.261663942,2
carcassonne-uct265-vs-uct175-1000its,815,813,2245.080402582,2182.197653918,2
carcassonne-uct420-vs-uct325-1000its,816,814,2200.79279065,2142.993490418,2
carcassonne-uct400-vs-uct210-1000its,817,815,2257.781740684,2180.299464138,2
carcassonne-ucttuned290-vs-ucttuned65-1000its,817,815,2174.197248063,2170.832727735,2
carcassonne-ucttuned420-vs-ucttuned465-1000its,817,815,2269.736813723,2203.993114281,2
carcassonne-ucttuned120-vs-ucttuned210-1000its,818,816,2230.99916887,2155.900538814,2
carcassonne-ucttuned435-vs-ucttuned330-1000its,818,816,2189.348873673,2133.319504815,2
carcassonne-boltzmann100-vs-boltzmann110-1000its,819,817,2145.390080593,2138.155825962,2
carcassonne-boltzmann30-vs-boltzmann35-1000its,819,817,2184.782966253,2130.570830231,2
carcassonne-ucttuned200-vs-ucttuned40-1000its,819,817,2115.573930758,2117.569296728,2
carcassonne-boltzmann315-vs-boltzmann480-1000its,820,818,2156.427243019,2097.445383278,2
carcassonne-ucttuned360-vs-ucttuned85-1000its,820,818,2216.400108148,2183.833225776,2
carcassonne-uct130-vs-uct50-1000its,821,819,2252.475240623,2201.182036787,2
carcassonne-ucttuned470-vs-ucttuned200-1000its,821,819,2257.096878598,2202.870933352,2
carcassonne-ucttuned445-vs-ucttuned280-1000its,822,820,2246.881211787,2175.84139398,2
carcassonne-boltzmann300-vs-boltzmann345-1000its,824,822,2222.124565427,2198.466059725,2
carcassonne-uct240-vs-uct440-1000its,824,822,2185.346468739,2140.827363731,2
carcassonne-ucttuned155-vs-ucttuned190-1000its,825,823,2220.908196885,2214.312624495,2
carcassonne-boltzmann395-vs-boltzmann345-1000its,826,824,2254.45761003,2188.385598456,2
carcassonne-boltzmann470-vs-boltzmann75-1000its,826,824,2191.510412512,2142.398811707,2
carcassonne-ucttuned225-vs-ucttuned445-1000its,826,824,2185.397379788,2139.424666157,2
carcassonne-ucttuned170-vs-ucttuned60-1000its,827,825,2228.604727097,2179.335063878,2
carcassonne-uct130-vs-uct90-1000its,828,826,2156.172940042,2155.232847324,2
carcassonne-uct140-vs-uct75-1000its,830,828,2230.71671065,2227.640596595,2
carcassonne-boltzmann380-vs-boltzmann475-1000its,831,829,2123.385065633,2086.419801548,2
carcassonne-uct475-vs-uct90-1000its,831,829,2166.523049208,2142.763498974,2
carcassonne-ucttuned350-vs-ucttuned475-1000its,831,829,2150.201875988,2111.067946792,2
carcassonne-uct195-vs-uct475-1000its,834,832,2191.779011304,2195.627906705,2
carcassonne-ucttuned325-vs-ucttuned385-1000its,834,832,2143.74935488,2095.539100854,2
carcassonne-boltzmann180-vs-boltzmann40-1000its,835,833,2240.041837128,2203.798977833,2
carcassonne-uct360-vs-uct130-1000its,835,833,2171.479727084,2152.243612278,2
carcassonne-ucttuned180-vs-ucttuned145-1000its,837,835,2189.817646585,2154.606294401,2
carcassonne-ucttuned380-vs-ucttuned240-1000its,837,835,2276.890566936,2199.371897203,2
carcassonne-boltzmann205-vs-boltzmann65-1000its,838,836,2209.76176779,2122.005863246,2
carcassonne-ucttuned420-vs-ucttuned305-1000its,839,837,2200.017540905,2147.345182059,2
carcassonne-boltzmann190-vs-boltzmann440-1000its,842,840,2211.227812035,2187.92448782,2
carcassonne-uct470-vs-uct450-1000its,842,840,2177.548170967,2115.057627774,2
carcassonne-uct95-vs-uct45-1000its,843,841,2273.360419827,2238.351903104,2
carcassonne-ucttuned60-vs-ucttuned160-1000its,849,847,2177.614986619,2114.159152322,2
carcassonne-ucttuned10-vs-ucttuned355-1000its,850,848,2270.370360094,2253.404382953,2
carcassonne-uct415-vs-uct325-1000its,852,850,2237.769518226,2178.71296347,2
carcassonne-ucttuned435-vs-ucttuned350-1000its,852,850,2153.845656883,2150.301360285,2
carcassonne-uct40-vs-uct185-1000its,854,852,2171.649348032,2157.539980997,2
carcassonne-uct400-vs-uct415-1000its,855,853,2135.144538891,2072.780199623,2
carcassonne-boltzmann230-vs-boltzmann435-1000its,856,854,2209.357056895,2133.517556989,2
carcassonne-ucttuned200-vs-ucttuned235-1000its,856,854,2135.612199964,2088.802719561,2
carcassonne-ucttuned85-vs-ucttuned280-1000its,856,854,2206.36691856,2167.827987789,2
carcassonne-ucttuned300-vs-ucttuned115-1000its,858,856,2117.778059862,2088.162081618,2
carcassonne-ucttuned115-vs-ucttuned335-1000its,861,859,2253.008926814,2168.471445863,2
carcassonne-uct455-vs-uct170-1000its,865,863,2224.123784314,2156.967622584,2
carcassonne-ucttuned20-vs-ucttuned325-1000its,865,863,2134.97915684,2100.30071081,2
carcassonne-ucttuned35-vs-ucttuned470-1000its,865,863,2171.657978595,2102.744084859,2
carcassonne-ucttuned125-vs-ucttuned190-1000its,866,864,2189.463928813,2150.816865199,2
carcassonne-uct405-vs-uct345-1000its,867,865,2186.250221315,2151.946483128,2
carcassonne-ucttuned265-vs-ucttuned340-1000its,868,866,2241.194961764,2167.667189208,2
carcassonne-ucttuned115-vs-ucttuned210-1000its,870,868,2198.526638554,2142.456684386,2
carcassonne-uct105-vs-uct335-1000its,876,874,2231.256801287,2171.786734503,2
carcassonne-boltzmann485-vs-boltzmann30-1000its,881,879,2160.997696629,2137.975526415,2
carcassonne-ucttuned295-vs-ucttuned200-1000its,882,880,2175.272032,2149.173795049,2
carcassonne-ucttuned320-vs-ucttuned275-1000its,885,883,2199.681875359,2201.771027194,2
carcassonne-ucttuned455-vs-ucttuned275-1000its,887,885,2214.259242399,2169.885839585,2
carcassonne-ucttuned210-vs-ucttuned370-1000its,892,890,2196.719412698,2159.95857926,2
carcassonne-uct390-vs-uct450-1000its,894,892,2238.050174855,2195.513130444,2
carcassonne-ucttuned485-vs-ucttuned295-1000its,901,899,2214.297294897,2164.11135868,2
carcassonne-ucttuned360-vs-ucttuned75-1000its,902,900,2162.68941083,2154.811446793,2
carcassonne-uct395-vs-uct35-1000its,659,656,1747.873697052,1714.292430345,3
carcassonne-boltzmann405-vs-boltzmann230-1000its,729,726,2252.882697211,2197.070452797,3
carcassonne-boltzmann355-vs-boltzmann215-1000its,732,729,2164.125661564,2117.019538008,3
carcassonne-uct455-vs-uct180-1000its,740,737,2207.123623132,2133.880776412,3
carcassonne-boltzmann175-vs-boltzmann235-1000its,750,747,2257.799625174,2179.578572755,3
carcassonne-ucttuned300-vs-ucttuned70-1000its,751,748,2185.579294053,2183.498773106,3
carcassonne-ucttuned240-vs-ucttuned170-1000its,753,750,2142.841429598,2144.595891712,3
carcassonne-ucttuned455-vs-ucttuned155-1000its,758,755,2186.753218915,2181.555212079,3
carcassonne-boltzmann305-vs-boltzmann330-1000its,760,757,2267.782801969,2249.503649084,3
carcassonne-ucttuned55-vs-ucttuned190-1000its,760,757,2194.29593821,2173.146412226,3
carcassonne-boltzmann320-vs-boltzmann65-1000its,766,763,2200.165740305,2214.167617748,3
carcassonne-uct305-vs-uct275-1000its,769,766,2206.762059951,2191.882752204,3
carcassonne-ucttuned20-vs-ucttuned80-1000its,769,766,2179.832345376,2098.492422582,3
carcassonne-ucttuned430-vs-ucttuned265-1000its,769,766,2215.152410254,2115.340942576,3
carcassonne-boltzmann400-vs-boltzmann345-1000its,771,768,2251.258788491,2222.672807293,3
carcassonne-uct325-vs-uct85-1000its,771,768,2160.977558191,2134.504741067,3
carcassonne-ucttuned415-vs-ucttuned495-1000its,771,768,2267.722780763,2210.635383398,3
carcassonne-boltzmann320-vs-boltzmann130-1000its,774,771,2172.151881725,2115.103581796,3
carcassonne-uct445-vs-uct385-1000its,778,775,2171.038171995,2169.202548701,3
carcassonne-boltzmann425-vs-boltzmann145-1000its,780,777,2189.766945425,2155.186225662,3
carcassonne-ucttuned355-vs-ucttuned365-1000its,780,777,2152.976118841,2131.822947385,3
carcassonne-ucttuned360-vs-ucttuned345-1000its,780,777,2272.391566495,2218.297666307,3
carcassonne-ucttuned80-vs-ucttuned195-1000its,780,777,2174.962219807,2117.829082997,3
carcassonne-boltzmann255-vs-boltzmann80-1000its,781,778,2215.302247666,2190.072105078,3
carcassonne-boltzmann75-vs-boltzmann125-1000its,781,778,2235.984908613,2175.377333552,3
carcassonne-ucttuned430-vs-ucttuned260-1000its,781,778,2183.25347506,2164.532771666,3
carcassonne-ucttuned280-vs-ucttuned325-1000its,782,779,2165.887265035,2135.299235111,3
carcassonne-boltzmann125-vs-boltzmann70-1000its,783,780,2234.342649392,2191.922305174,3
carcassonne-boltzmann320-vs-boltzmann35-1000its,783,780,2157.668420014,2085.525691719,3
carcassonne-uct60-vs-uct420-1000its,783,780,2245.917143404,2182.940327319,3
carcassonne-uct400-vs-uct220-1000its,785,782,2200.410788125,2127.682508041,3
carcassonne-ucttuned380-vs-ucttuned80-1000its,785,782,2244.981971633,2152.641248093,3
carcassonne-boltzmann260-vs-boltzmann385-1000its,786,783,2225.311229998,2174.780217669,3
carcassonne-boltzmann430-vs-boltzmann190-1000its,786,783,2234.337934434,2213.942168271,3
carcassonne-uct320-vs-uct465-1000its,786,783,2196.122725381,2184.559406837,3
carcassonne-boltzmann330-vs-boltzmann165-1000its,787,784,2256.057432779,2232.708655994,3
carcassonne-uct375-vs-uct30-1000its,787,784,2261.033629087,2149.519874284,3
carcassonne-uct75-vs-uct255-1000its,788,785,2238.794130709,2211.213539919,3
carcassonne-boltzmann360-vs-boltzmann40-1000its,789,786,2238.244407,2134.310605446,3
carcassonne-ucttuned355-vs-ucttuned100-1000its,789,786,2229.153884447,2200.867565846,3
carcassonne-uct295-vs-uct65-1000its,791,788,2216.407324777,2168.023709334,3
carcassonne-boltzmann335-vs-boltzmann350-1000its,792,789,2231.080186032,2202.41850217,3
carcassonne-ucttuned145-vs-ucttuned245-1000its,792,789,2097.171247739,2089.537702705,3
carcassonne-boltzmann185-vs-boltzmann270-1000its,794,791,2246.08100627,2207.408180885,3
carcassonne-ucttuned195-vs-ucttuned140-1000its,794,791,2252.807748674,2240.272981811,3
carcassonne-boltzmann225-vs-boltzmann155-1000its,795,792,2214.910352608,2168.491042855,3
carcassonne-uct50-vs-uct15-1000its,795,792,2191.078569767,2126.957939964,3
carcassonne-uct30-vs-uct235-1000its,796,793,2192.354074631,2116.334033563,3
carcassonne-ucttuned215-vs-ucttuned345-1000its,796,793,2279.059907982,2184.614252291,3
carcassonne-boltzmann340-vs-boltzmann370-1000its,797,794,2109.657529863,2071.239830852,3
carcassonne-boltzmann245-vs-boltzmann240-1000its,798,795,2089.907478663,2061.475819041,3
carcassonne-ucttuned55-vs-ucttuned10-1000its,798,795,2179.480369646,2160.349841753,3
carcassonne-uct400-vs-uct420-1000its,799,796,2210.043459916,2179.075214251,3
carcassonne-ucttuned245-vs-ucttuned430-1000its,800,797,2229.918762359,2194.671084047,3
carcassonne-ucttuned340-vs-ucttuned445-1000its,800,797,2157.268594105,2141.737525725,3
carcassonne-boltzmann220-vs-boltzmann175-1000its,801,798,2228.371572156,2177.55476745,3
carcassonne-boltzmann435-vs-boltzmann205-1000its,802,799,2209.04181725,2161.35458545,3
carcassonne-ucttuned355-vs-ucttuned360-1000its,802,799,2201.206055644,2123.763355913,3
carcassonne-boltzmann80-vs-boltzmann130-1000its,803,800,2218.155867587,2180.777486764,3
carcassonne-boltzmann220-vs-boltzmann110-1000its,804,801,2212.623604612,2148.27493871,3
carcassonne-boltzmann350-vs-boltzmann475-1000its,806,803,2185.054724449,2136.552609911,3
carcassonne-uct395-vs-uct175-1000its,807,804,2153.969586291,2131.693335622,3
carcassonne-boltzmann140-vs-boltzmann25-1000its,808,805,2205.89902079,2131.585576466,3
carcassonne-boltzmann300-vs-boltzmann390-1000its,808,805,2219.83233913,2153.9297208,3
carcassonne-boltzmann315-vs-boltzmann460-1000its,808,805,2211.227191174,2195.508231058,3
carcassonne-ucttuned165-vs-ucttuned435-1000its,808,805,2220.176269981,2149.352229682,3
carcassonne-boltzmann290-vs-boltzmann110-1000its,809,806,2272.900446428,2245.836047173,3
carcassonne-ucttuned300-vs-ucttuned250-1000its,809,806,2186.654606131,2152.628899456,3
carcassonne-boltzmann165-vs-boltzmann480-1000its,810,807,2209.656543856,2201.544322956,3
carcassonne-boltzmann285-vs-boltzmann140-1000its,811,808,2216.802328594,2184.263869886,3
carcassonne-ucttuned135-vs-ucttuned455-1000its,811,808,2205.449590881,2156.544785649,3
carcassonne-uct200-vs-uct100-1000its,812,809,2224.386498348,2168.738083829,3
carcassonne-uct345-vs-uct40-1000its,812,809,2151.932639084,2157.407358184,3
carcassonne-uct80-vs-uct480-1000its,813,810,2166.704560761,2108.476732168,3
carcassonne-ucttuned400-vs-ucttuned460-1000its,813,810,2165.812090917,2110.070926166,3
carcassonne-uct235-vs-uct125-1000its,814,811,2170.182330607,2121.942174619,3
carcassonne-uct270-vs-uct100-1000its,814,811,2249.475155899,2191.127212544,3
carcassonne-uct35-vs-uct15-1000its,814,811,2200.100799422,2133.139253801,3
carcassonne-boltzmann225-vs-boltzmann445-1000its,815,812,2197.89675367,2184.515871283,3
carcassonne-ucttuned445-vs-ucttuned285-1000its,815,812,2169.521024444,2098.370759333,3
carcassonne-boltzmann465-vs-boltzmann155-1000its,816,813,2215.241823323,2166.118877641,3
carcassonne-boltzmann285-vs-boltzmann110-1000its,817,814,2232.191741732,2175.63074228,3
carcassonne-boltzmann470-vs-boltzmann120-1000its,818,815,2155.515252608,2105.965940779,3
carcassonne-ucttuned210-vs-ucttuned180-1000its,818,815,2219.68536338,2150.461038591,3
carcassonne-boltzmann205-vs-boltzmann450-1000its,820,817,2202.256564861,2160.799115414,3
carcassonne-boltzmann360-vs-boltzmann210-1000its,820,817,2274.846542275,2213.046480852,3
carcassonne-uct5-vs-uct245-1000its,821,818,2189.102657545,2142.782894162,3
carcassonne-uct120-vs-uct320-1000its,823,820,2142.159804964,2091.267500187,3
carcassonne-boltzmann485-vs-boltzmann220-1000its,824,821,2228.289829962,2179.589750287,3
carcassonne-ucttuned210-vs-ucttuned260-1000its,824,821,2188.038902766,2142.731304973,3
carcassonne-uct265-vs-uct415-1000its,825,822,2274.089052648,2252.592581065,3
carcassonne-boltzmann190-vs-boltzmann325-1000its,826,823,2210.397519395,2210.738226755,3
carcassonne-uct340-vs-uct160-1000its,827,824,2194.404827208,2157.946055784,3
carcassonne-ucttuned190-vs-ucttuned105-1000its,828,825,2200.681762226,2140.059612779,3
carcassonne-uct185-vs-uct210-1000its,829,826,2140.19798213,2107.497175049,3
carcassonne-uct45-vs-uct375-1000its,830,827,2066.423124603,2030.481289133,3
carcassonne-boltzmann65-vs-boltzmann70-1000its,831,828,2176.621423834,2161.527584773,3
carcassonne-uct335-vs-uct200-1000its,831,828,2176.387635384,2116.915801683,3
carcassonne-boltzmann470-vs-boltzmann140-1000its,832,829,2244.016337915,2160.119925621,3
carcassonne-uct385-vs-uct5-1000its,832,829,2210.668746194,2159.844104301,3
carcassonne-ucttuned390-vs-ucttuned410-1000its,834,831,2197.157353338,2152.071751454,3
carcassonne-boltzmann245-vs-boltzmann270-1000its,838,835,2229.639943812,2198.920261164,3
carcassonne-ucttuned245-vs-ucttuned160-1000its,838,835,2117.280802968,2127.028611609,3
carcassonne-uct230-vs-uct220-1000its,841,838,2245.55105545,2228.580695338,3
carcassonne-boltzmann325-vs-boltzmann255-1000its,842,839,2243.627436824,2182.772658417,3
carcassonne-boltzmann370-vs-boltzmann15-1000its,844,841,2176.972913351,2108.837488304,3
carcassonne-boltzmann220-vs-boltzmann135-1000its,845,842,2244.503545686,2206.895666909,3
carcassonne-ucttuned275-vs-ucttuned75-1000its,845,842,2222.425142422,2171.10521767,3
carcassonne-uct100-vs-uct360-1000its,847,844,2177.62088919,2133.738257507,3
carcassonne-ucttuned75-vs-ucttuned430-1000its,847,844,2120.352992071,2076.322146491,3
carcassonne-boltzmann265-vs-boltzmann355-1000its,848,845,2133.169137521,2124.746907738,3
carcassonne-ucttuned405-vs-ucttuned205-1000its,848,845,2181.404504136,2143.575685067,3
carcassonne-uct30-vs-uct475-1000its,849,846,2161.864239845,2171.354154924,3
carcassonne-uct75-vs-uct420-1000its,849,846,2153.906480496,2143.604574071,3
carcassonne-boltzmann100-vs-boltzmann375-1000its,852,849,2223.817173899,2168.403604142,3
carcassonne-ucttuned440-vs-ucttuned210-1000its,852,849,2192.948522529,2147.381736751,3
carcassonne-boltzmann295-vs-boltzmann495-1000its,855,852,2165.909284407,2104.352069163,3
carcassonne-ucttuned60-vs-ucttuned95-1000its,855,852,2210.769642604,2198.479554523,3
carcassonne-boltzmann365-vs-boltzmann330-1000its,856,853,2247.651950677,2225.050538906,3
carcassonne-boltzmann235-vs-boltzmann60-1000its,860,857,2125.783879241,2038.85586473,3
carcassonne-boltzmann250-vs-boltzmann60-1000its,860,857,2197.747560767,2168.553637162,3
carcassonne-ucttuned255-vs-ucttuned445-1000its,861,858,2167.839505674,2116.205033458,3
carcassonne-ucttuned60-vs-ucttuned370-1000its,861,858,2181.208269347,2158.56811415,3
carcassonne-ucttuned455-vs-ucttuned45-1000its,863,860,2141.563386444,2103.419938106,3
carcassonne-ucttuned425-vs-ucttuned380-1000its,864,861,2306.181077925,2233.090538106,3
carcassonne-uct160-vs-uct355-1000its,865,862,2190.751699823,2163.146981022,3
carcassonne-ucttuned225-vs-ucttuned260-1000its,866,863,2183.247806001,2130.58983986,3
carcassonne-uct30-vs-uct410-1000its,867,864,2261.59617585,2176.619121619,3
carcassonne-uct105-vs-uct80-1000its,870,867,2221.509907519,2185.611690786,3
carcassonne-ucttuned415-vs-ucttuned270-1000its,872,869,2255.004745822,2169.121166644,3
carcassonne-ucttuned445-vs-ucttuned30-1000its,872,869,2160.729690487,2130.179610968,3
carcassonne-boltzmann295-vs-boltzmann130-1000its,875,872,2183.566635657,2119.191928579,3
carcassonne-uct405-vs-uct445-1000its,875,872,2171.355238861,2111.85716458,3
carcassonne-uct255-vs-uct260-1000its,876,873,2258.00413666,2200.276556407,3
carcassonne-ucttuned400-vs-ucttuned10-1000its,876,873,2254.682527619,2204.291320402,3
carcassonne-ucttuned480-vs-ucttuned10-1000its,877,874,2160.223010009,2156.327672584,3
carcassonne-boltzmann80-vs-boltzmann5-1000its,878,875,2197.588415792,2153.825379901,3
carcassonne-boltzmann265-vs-boltzmann180-1000its,897,894,2234.258257941,2194.391916904,3
carcassonne-boltzmann110-vs-boltzmann160-1000its,645,641,1776.420584051,1741.124729564,4
carcassonne-uct85-vs-uct240-1000its,682,678,1739.55232057,1698.018576041,4
carcassonne-ucttuned290-vs-ucttuned350-1000its,720,716,2246.529821203,2206.482150395,4
carcassonne-ucttuned490-vs-ucttuned285-1000its,732,728,2280.534133585,2241.660078599,4
carcassonne-uct185-vs-uct410-1000its,742,738,2156.55095653,2130.767000509,4
carcassonne-boltzmann200-vs-boltzmann310-1000its,743,739,2212.0243312,2123.623094138,4
carcassonne-boltzmann280-vs-boltzmann465-1000its,744,740,2215.88792578,2156.724598595,4
carcassonne-boltzmann215-vs-boltzmann330-1000its,745,741,2272.115325817,2210.079443106,4
carcassonne-boltzmann230-vs-boltzmann325-1000its,745,741,2183.750566984,2139.775230331,4
carcassonne-uct135-vs-uct310-1000its,746,742,2133.326351108,2100.526221376,4
carcassonne-boltzmann270-vs-boltzmann125-1000its,751,747,2205.327453835,2121.575622716,4
carcassonne-uct160-vs-uct495-1000its,752,748,2229.497848124,2196.791238576,4
carcassonne-ucttuned195-vs-ucttuned200-1000its,753,749,2203.455694977,2183.747982554,4
carcassonne-ucttuned425-vs-ucttuned400-1000its,753,749,2231.458406802,2175.831202292,4
carcassonne-ucttuned355-vs-ucttuned435-1000its,762,758,2133.046201731,2106.274530037,4
carcassonne-ucttuned490-vs-ucttuned345-1000its,762,758,2188.389444622,2113.428839953,4
carcassonne-uct325-vs-uct320-1000its,765,761,2235.645716377,2204.248362983,4
carcassonne-ucttuned95-vs-ucttuned210-1000its,767,763,2173.788533246,2138.236423549,4
carcassonne-uct225-vs-uct305-1000its,768,764,2151.986979362,2113.455180867,4
carcassonne-ucttuned80-vs-ucttuned95-1000its,768,764,2141.461464319,2137.054095342,4
carcassonne-uct325-vs-uct460-1000its,771,767,2143.092068073,2078.031392929,4
carcassonne-boltzmann410-vs-boltzmann375-1000its,772,768,2164.392239262,2154.05230091,4
carcassonne-boltzmann20-vs-boltzmann275-1000its,773,769,2212.752710094,2161.09173374,4
carcassonne-boltzmann245-vs-boltzmann70-1000its,774,770,2228.857669398,2196.034350591,4
carcassonne-uct375-vs-uct280-1000its,775,771,2183.636024246,2103.501558689,4
carcassonne-boltzmann185-vs-boltzmann180-1000its,776,772,2194.518705099,2185.029222795,4
carcassonne-ucttuned365-vs-ucttuned70-1000its,777,773,2263.218214822,2148.921834858,4
carcassonne-boltzmann25-vs-boltzmann480-1000its,778,774,2193.58771133,2156.724329202,4
carcassonne-boltzmann330-vs-boltzmann170-1000its,780,776,2258.003433166,2223.686553331,4
carcassonne-boltzmann225-vs-boltzmann90-1000its,781,777,2169.204064214,2101.474641023,4
carcassonne-ucttuned230-vs-ucttuned385-1000its,781,777,2274.974222927,2228.864232722,4
carcassonne-ucttuned245-vs-ucttuned15-1000its,781,777,2219.607539721,2194.62207574,4
carcassonne-boltzmann250-vs-boltzmann125-1000its,782,778,2251.572648586,2246.746174162,4
carcassonne-boltzmann295-vs-boltzmann30-1000its,782,778,2165.707495847,2168.108091365,4
carcassonne-ucttuned215-vs-ucttuned325-1000its,783,779,2158.526249947,2144.874937991,4
carcassonne-uct165-vs-uct310-1000its,784,780,2220.309877022,2144.381803708,4
carcassonne-uct285-vs-uct355-1000its,784,780,2180.831132391,2157.186764498,4
carcassonne-ucttuned140-vs-ucttuned435-1000its,784,780,2201.828635753,2162.146335134,4
carcassonne-ucttuned160-vs-ucttuned295-1000its,784,780,2126.867218346,2073.850213211,4
carcassonne-boltzmann10-vs-boltzmann265-1000its,785,781,2198.546729462,2153.97654624,4
carcassonne-ucttuned115-vs-ucttuned125-1000its,785,781,2168.514802588,2067.065712607,4
carcassonne-boltzmann285-vs-boltzmann70-1000its,786,782,2212.515341266,2167.411462531,4
carcassonne-boltzmann450-vs-boltzmann495-1000its,786,782,2199.432371233,2094.84140304,4
carcassonne-uct450-vs-uct5-1000its,786,782,2140.773647366,2095.111582744,4
carcassonne-boltzmann90-vs-boltzmann100-1000its,787,783,2197.7429529,2176.78211733,4
carcassonne-ucttuned480-vs-ucttuned125-1000its,787,783,2179.615045892,2157.70812932,4
carcassonne-boltzmann205-vs-boltzmann260-1000its,788,784,2135.641994464,2062.349314052,4
carcassonne-boltzmann180-vs-boltzmann60-1000its,789,785,2173.688894645,2121.054844194,4
carcassonne-ucttuned190-vs-ucttuned20-1000its,789,785,2151.712831016,2157.582036125,4
carcassonne-boltzmann130-vs-boltzmann125-1000its,791,787,2138.709033714,2110.636105246,4
carcassonne-boltzmann170-vs-boltzmann180-1000its,791,787,2191.200372944,2165.031389111,4
carcassonne-uct10-vs-uct150-1000its,791,787,2214.313200363,2145.815249664,4
carcassonne-uct55-vs-uct340-1000its,791,787,2161.68985902,2145.632587206,4
carcassonne-ucttuned120-vs-ucttuned85-1000its,791,787,2172.133570428,2110.899193932,4
carcassonne-boltzmann140-vs-boltzmann105-1000its,793,789,2196.54313044,2150.341955365,4
carcassonne-uct200-vs-uct270-1000its,793,789,2156.814784588,2147.693548676,4
carcassonne-uct335-vs-uct55-1000its,793,789,2242.203335898,2212.687795822,4
carcassonne-uct495-vs-uct85-1000its,793,789,2168.481870489,2158.687273253,4
carcassonne-uct305-vs-uct250-1000its,794,790,2255.343225944,2202.951465763,4
carcassonne-boltzmann100-vs-boltzmann430-1000its,795,791,2253.179327551,2187.352055277,4
carcassonne-boltzmann400-vs-boltzmann110-1000its,796,792,2247.875811456,2212.249026893,4
carcassonne-boltzmann470-vs-boltzmann440-1000its,796,792,2212.154886321,2209.625875456,4
carcassonne-uct145-vs-uct440-1000its,797,793,2138.669200142,2135.766263437,4
carcassonne-uct40-vs-uct455-1000its,797,793,2191.357587028,2151.148718626,4
carcassonne-ucttuned270-vs-ucttuned350-1000its,797,793,2187.963887637,2089.441576396,4
carcassonne-ucttuned395-vs-ucttuned455-1000its,797,793,2350.385624671,2257.508986014,4
carcassonne-uct375-vs-uct340-1000its,798,794,2206.283208496,2172.656000745,4
carcassonne-uct40-vs-uct405-1000its,798,794,2172.28007433,2158.313606574,4
carcassonne-uct170-vs-uct420-1000its,800,796,2203.144483367,2160.286553886,4
carcassonne-uct280-vs-uct150-1000its,800,796,2209.560007945,2158.622445811,4
carcassonne-uct305-vs-uct210-1000its,801,797,2170.439598277,2177.661814129,4
carcassonne-boltzmann495-vs-boltzmann400-1000its,802,798,2243.418778772,2201.561691729,4
carcassonne-uct50-vs-uct230-1000its,803,799,2215.871904331,2197.753218053,4
carcassonne-boltzmann100-vs-boltzmann445-1000its,804,800,2219.088670582,2219.677152793,4
carcassonne-boltzmann340-vs-boltzmann450-1000its,804,800,2194.135939129,2136.964350547,4
carcassonne-ucttuned150-vs-ucttuned200-1000its,804,800,2339.312981056,2317.25272086,4
carcassonne-boltzmann150-vs-boltzmann445-1000its,806,802,2162.016184349,2180.415367099,4
carcassonne-boltzmann165-vs-boltzmann45-1000its,806,802,2184.032392334,2150.057726224,4
carcassonne-boltzmann465-vs-boltzmann395-1000its,806,802,2199.63286631,2137.214697138,4
carcassonne-uct385-vs-uct40-1000its,806,802,2151.991214684,2120.296548451,4
carcassonne-ucttuned145-vs-ucttuned425-1000its,806,802,2190.690422759,2172.099768898,4
carcassonne-boltzmann335-vs-boltzmann320-1000its,807,803,2087.332502974,2049.546780332,4
carcassonne-ucttuned345-vs-ucttuned370-1000its,807,803,2260.491335718,2208.984168161,4
carcassonne-ucttuned460-vs-ucttuned455-1000its,807,803,2298.181963673,2214.291581841,4
carcassonne-boltzmann70-vs-boltzmann185-1000its,808,804,2195.714627801,2131.950021743,4
carcassonne-ucttuned290-vs-ucttuned270-1000its,808,804,2234.354947935,2180.687719195,4
carcassonne-ucttuned385-vs-ucttuned465-1000its,811,807,2156.806143755,2135.713636128,4
carcassonne-boltzmann305-vs-boltzmann140-1000its,812,808,2238.073906448,2161.876278898,4
carcassonne-ucttuned65-vs-ucttuned95-1000its,812,808,2193.9144475,2154.343394471,4
carcassonne-boltzmann210-vs-boltzmann30-1000its,813,809,2233.500210689,2129.672615287,4
carcassonne-uct110-vs-uct45-1000its,813,809,2206.651564065,2134.511537005,4
carcassonne-uct405-vs-uct370-1000its,813,809,2176.959573374,2169.218248078,4
carcassonne-ucttuned90-vs-ucttuned10-1000its,813,809,2249.497726668,2227.606906668,4
carcassonne-boltzmann425-vs-boltzmann25-1000its,815,811,2193.442550737,2123.892125829,4
carcassonne-boltzmann150-vs-boltzmann350-1000its,816,812,2178.819509977,2141.673031273,4
carcassonne-boltzmann60-vs-boltzmann15-1000its,816,812,2203.874383866,2196.719891904,4
carcassonne-ucttuned485-vs-ucttuned455-1000its,816,812,2152.503560418,2152.116083906,4
carcassonne-boltzmann75-vs-boltzmann345-1000its,818,814,2183.444865736,2143.248511885,4
carcassonne-uct40-vs-uct85-1000its,818,814,2213.489349367,2171.011114093,4
carcassonne-uct365-vs-uct345-1000its,819,815,2218.790743221,2167.498847377,4
carcassonne-ucttuned435-vs-ucttuned200-1000its,819,815,2229.45292066,2188.179819213,4
carcassonne-boltzmann350-vs-boltzmann140-1000its,820,816,2191.83892704,2143.424484149,4
carcassonne-uct200-vs-uct165-1000its,820,816,2197.028253766,2112.086272883,4
carcassonne-boltzmann480-vs-boltzmann425-1000its,821,817,2136.797822415,2149.806204769,4
carcassonne-uct60-vs-uct485-1000its,822,818,2224.963243657,2134.715265428,4
carcassonne-boltzmann100-vs-boltzmann90-1000its,823,819,2167.843023791,2142.295609122,4
carcassonne-ucttuned135-vs-ucttuned150-1000its,823,819,2224.897500337,2192.417529156,4
carcassonne-ucttuned355-vs-ucttuned480-1000its,823,819,2168.992437159,2094.276622171,4
carcassonne-boltzmann145-vs-boltzmann340-1000its,827,823,2279.626859998,2186.499318406,4
carcassonne-boltzmann40-vs-boltzmann330-1000its,827,823,2133.258836816,2112.070302848,4
carcassonne-ucttuned110-vs-ucttuned265-1000its,827,823,2115.200923376,2097.234892763,4
carcassonne-boltzmann130-vs-boltzmann415-1000its,828,824,2286.121261034,2212.422613685,4
carcassonne-boltzmann335-vs-boltzmann490-1000its,828,824,2204.197195278,2164.755354594,4
carcassonne-boltzmann60-vs-boltzmann50-1000its,828,824,2278.778598264,2236.677825266,4
carcassonne-uct305-vs-uct300-1000its,828,824,2169.853317558,2140.923472239,4
carcassonne-ucttuned110-vs-ucttuned80-1000its,828,824,2185.417698342,2132.438365708,4
carcassonne-uct490-vs-uct170-1000its,829,825,2160.933941206,2132.07644978,4
carcassonne-ucttuned115-vs-ucttuned110-1000its,829,825,2173.229702943,2129.903813531,4
carcassonne-boltzmann475-vs-boltzmann470-1000its,830,826,2197.544804508,2158.003349326,4
carcassonne-ucttuned145-vs-ucttuned385-1000its,830,826,2236.470658286,2207.510326179,4
carcassonne-ucttuned85-vs-ucttuned385-1000its,830,826,2249.926116956,2192.084682788,4
carcassonne-uct230-vs-uct100-1000its,831,827,2224.827527305,2134.573387505,4
carcassonne-uct145-vs-uct175-1000its,832,828,2240.619278261,2171.673651561,4
carcassonne-boltzmann270-vs-boltzmann80-1000its,833,829,2181.783651236,2104.227495507,4
carcassonne-boltzmann300-vs-boltzmann460-1000its,833,829,2131.376303956,2076.396024282,4
carcassonne-boltzmann40-vs-boltzmann380-1000its,834,830,2197.939535589,2167.592275658,4
carcassonne-boltzmann125-vs-boltzmann190-1000its,835,831,2194.097088345,2113.343333819,4
carcassonne-boltzmann375-vs-boltzmann225-1000its,836,832,2207.31258059,2179.659892406,4
carcassonne-boltzmann180-vs-boltzmann235-1000its,839,835,2140.018141862,2095.288832071,4
carcassonne-boltzmann360-vs-boltzmann15-1000its,840,836,2225.179986509,2182.565797576,4
carcassonne-boltzmann435-vs-boltzmann315-1000its,840,836,2173.782678543,2094.850518958,4
carcassonne-ucttuned230-vs-ucttuned30-1000its,840,836,2151.230875841,2124.451913659,4
carcassonne-boltzmann280-vs-boltzmann235-1000its,844,840,2286.819806713,2269.213674539,4
carcassonne-uct295-vs-uct145-1000its,845,841,2267.273585135,2223.864831055,4
carcassonne-boltzmann170-vs-boltzmann165-1000its,846,842,2202.363954282,2182.593095951,4
carcassonne-boltzmann245-vs-boltzmann210-1000its,847,843,2227.186292007,2169.434253578,4
carcassonne-ucttuned140-vs-ucttuned20-1000its,847,843,2163.782824299,2162.925193643,4
carcassonne-boltzmann60-vs-boltzmann150-1000its,854,850,2188.635708355,2125.715078581,4
carcassonne-boltzmann415-vs-boltzmann220-1000its,856,852,2261.230747631,2192.503459468,4
carcassonne-uct345-vs-uct460-1000its,856,852,2177.179187116,2125.007459249,4
carcassonne-ucttuned140-vs-ucttuned105-1000its,856,852,2210.07352503,2191.851582954,4
carcassonne-uct160-vs-uct405-1000its,857,853,2246.459643185,2197.315810238,4
carcassonne-ucttuned185-vs-ucttuned15-1000its,857,853,2173.009894606,2154.616012927,4
carcassonne-uct490-vs-uct300-1000its,860,856,2127.573150165,2019.172370568,4
carcassonne-boltzmann285-vs-boltzmann90-1000its,861,857,2218.094281239,2186.845059469,4
carcassonne-uct445-vs-uct160-1000its,862,858,2152.856396407,2110.449709581,4
carcassonne-boltzmann440-vs-boltzmann460-1000its,863,859,2176.9662881,2115.419558571,4
carcassonne-uct380-vs-uct160-1000its,863,859,2191.297402077,2146.110016734,4
carcassonne-ucttuned160-vs-ucttuned20-1000its,863,859,2179.587493908,2085.508146235,4
carcassonne-ucttuned265-vs-ucttuned210-1000its,863,859,2127.939401832,2082.94703482,4
carcassonne-uct335-vs-uct370-1000its,868,864,2232.921745353,2217.239545138,4
carcassonne-boltzmann460-vs-boltzmann225-1000its,869,865,2141.515227388,2106.292622889,4
carcassonne-ucttuned85-vs-ucttuned415-1000its,871,867,2159.436517367,2130.854929632,4
carcassonne-ucttuned130-vs-ucttuned305-1000its,879,875,2173.04569413,2147.334722316,4
carcassonne-uct240-vs-uct455-1000its,882,878,2148.606718038,2121.940640308,4
carcassonne-boltzmann175-vs-boltzmann30-1000its,883,879,2234.573757841,2159.916521653,4
carcassonne-uct250-vs-uct80-1000its,885,881,2155.196357178,2122.628640351,4
carcassonne-uct470-vs-uct30-1000its,886,882,2266.649682783,2237.703863942,4
carcassonne-ucttuned60-vs-ucttuned480-1000its,891,887,2247.891695788,2165.320398104,4
carcassonne-ucttuned155-vs-ucttuned385-1000its,902,898,2180.81183816,2170.260199963,4
carcassonne-boltzmann370-vs-boltzmann350-1000its,904,900,2220.226434574,2144.372595864,4
carcassonne-ucttuned130-vs-ucttuned170-1000its,928,924,2182.596266465,2153.825784051,4
carcassonne-uct215-vs-uct300-1000its,947,943,2223.235279314,2147.312323722,4
carcassonne-uct440-vs-uct170-1000its,610,605,1793.76849446,1735.529226354,5
carcassonne-boltzmann405-vs-boltzmann225-1000its,722,717,2217.536047917,2168.983677195,5
carcassonne-ucttuned125-vs-ucttuned385-1000its,730,725,2221.306049081,2167.979050741,5
carcassonne-ucttuned145-vs-ucttuned315-1000its,733,728,2171.402394251,2118.507797134,5
carcassonne-boltzmann75-vs-boltzmann280-1000its,737,732,2272.699403077,2199.633045253,5
carcassonne-boltzmann25-vs-boltzmann170-1000its,747,742,2136.348300978,2098.27750604,5
carcassonne-boltzmann60-vs-boltzmann135-1000its,747,742,2233.878374963,2167.953229758,5
carcassonne-boltzmann210-vs-boltzmann220-1000its,748,743,2209.554210403,2128.204680235,5
carcassonne-boltzmann85-vs-boltzmann75-1000its,749,744,2202.301705849,2176.885897444,5
carcassonne-uct40-vs-uct485-1000its,750,745,2208.649582532,2181.978923168,5
carcassonne-boltzmann70-vs-boltzmann285-1000its,752,747,2210.645068141,2190.63815137,5
carcassonne-boltzmann415-vs-boltzmann55-1000its,753,748,2168.893111887,2136.313630427,5
carcassonne-ucttuned440-vs-ucttuned495-1000its,753,748,2228.56228137,2147.606165463,5
carcassonne-boltzmann230-vs-boltzmann15-1000its,754,749,2206.6700838,2159.720071309,5
carcassonne-uct240-vs-uct475-1000its,756,751,2202.950689379,2188.293443633,5
carcassonne-uct285-vs-uct200-1000its,756,751,2230.228112446,2191.657215414,5
carcassonne-ucttuned255-vs-ucttuned145-1000its,757,752,2178.812675712,2143.343949317,5
carcassonne-uct465-vs-uct185-1000its,762,757,2194.225562439,2152.170253113,5
carcassonne-boltzmann430-vs-boltzmann360-1000its,766,761,2207.61203583,2147.720749575,5
carcassonne-uct335-vs-uct255-1000its,766,761,2158.00641698,2189.464603235,5
carcassonne-boltzmann115-vs-boltzmann475-1000its,769,764,2192.965812535,2150.945354121,5
carcassonne-boltzmann350-vs-boltzmann155-1000its,769,764,2208.021065026,2160.130596667,5
carcassonne-boltzmann350-vs-boltzmann370-1000its,770,765,2257.316002705,2194.029252173,5
carcassonne-ucttuned160-vs-ucttuned150-1000its,770,765,2228.482493827,2190.89032611,5
carcassonne-boltzmann20-vs-boltzmann125-1000its,771,766,2323.857379945,2300.888992214,5
carcassonne-ucttuned485-vs-ucttuned470-1000its,771,766,2220.397255196,2156.778560481,5
carcassonne-boltzmann365-vs-boltzmann240-1000its,772,767,2193.029391983,2132.166093005,5
carcassonne-boltzmann490-vs-boltzmann280-1000its,773,768,2174.258788188,2079.87923064,5
carcassonne-boltzmann205-vs-boltzmann210-1000its,774,769,2183.011279663,2161.826546498,5
carcassonne-boltzmann495-vs-boltzmann220-1000its,774,769,2168.227988205,2105.579932232,5
carcassonne-uct35-vs-uct50-1000its,774,769,2156.705667486,2092.677636951,5
carcassonne-uct255-vs-uct475-1000its,776,771,2214.965030317,2145.449527892,5
carcassonne-ucttuned385-vs-ucttuned195-1000its,776,771,2213.782918112,2127.125989051,5
carcassonne-boltzmann45-vs-boltzmann240-1000its,777,772,2280.043739589,2207.970987296,5
carcassonne-uct200-vs-uct25-1000its,777,772,2196.825270603,2159.090155279,5
carcassonne-uct375-vs-uct205-1000its,778,773,2198.641209693,2136.480514823,5
carcassonne-ucttuned20-vs-ucttuned130-1000its,778,773,2209.614333916,2121.602710857,5
carcassonne-boltzmann270-vs-boltzmann435-1000its,779,774,2202.822962217,2166.690971174,5
carcassonne-ucttuned475-vs-ucttuned185-1000its,779,774,2245.574458073,2202.431085689,5
carcassonne-uct160-vs-uct150-1000its,783,778,2151.762736771,2130.322767436,5
carcassonne-uct480-vs-uct295-1000its,783,778,2231.388707068,2187.78470417,5
carcassonne-ucttuned115-vs-ucttuned175-1000its,784,779,2233.872353721,2170.863072033,5
carcassonne-boltzmann145-vs-boltzmann165-1000its,785,780,2218.160853004,2185.766111744,5
carcassonne-boltzmann455-vs-boltzmann70-1000its,786,781,2150.462541068,2089.370747928,5
carcassonne-ucttuned150-vs-ucttuned415-1000its,786,781,2206.94826246,2178.799496835,5
carcassonne-uct95-vs-uct275-1000its,790,785,2186.385258442,2142.351534653,5
carcassonne-ucttuned480-vs-ucttuned345-1000its,790,785,2210.531728737,2189.748386945,5
carcassonne-uct190-vs-uct180-1000its,792,787,2189.445876401,2134.735336122,5
carcassonne-boltzmann210-vs-boltzmann275-1000its,793,788,2278.146332701,2225.726077313,5
carcassonne-boltzmann310-vs-boltzmann215-1000its,794,789,2248.577834662,2215.284010389,5
carcassonne-boltzmann355-vs-boltzmann40-1000its,794,789,2162.639234011,2131.112257256,5
carcassonne-uct225-vs-uct475-1000its,794,789,2214.623755973,2172.070478084,5
carcassonne-boltzmann15-vs-boltzmann105-1000its,795,790,2208.157961655,2162.306829406,5
carcassonne-boltzmann220-vs-boltzmann105-1000its,795,790,2170.088467586,2147.359635636,5
carcassonne-boltzmann160-vs-boltzmann350-1000its,796,791,2144.641096172,2107.828574906,5
carcassonne-uct345-vs-uct130-1000its,796,791,2131.956834313,2110.782215435,5
carcassonne-ucttuned410-vs-ucttuned435-1000its,796,791,2170.860868362,2105.311285702,5
carcassonne-uct450-vs-uct350-1000its,797,792,2211.56024037,2173.729828453,5
carcassonne-boltzmann400-vs-boltzmann135-1000its,798,793,2261.100643278,2241.053325815,5
carcassonne-ucttuned290-vs-ucttuned490-1000its,800,795,2263.960917443,2208.451130464,5
carcassonne-uct80-vs-uct220-1000its,801,796,2260.796948831,2230.814270194,5
carcassonne-uct205-vs-uct275-1000its,802,797,2101.860294906,2038.147307082,5
carcassonne-uct245-vs-uct335-1000its,803,798,2235.970747551,2186.273415741,5
carcassonne-ucttuned235-vs-ucttuned265-1000its,803,798,2224.581147668,2194.529111463,5
carcassonne-ucttuned420-vs-ucttuned355-1000its,803,798,2177.372812666,2161.743874856,5
carcassonne-boltzmann115-vs-boltzmann245-1000its,804,799,2161.786214237,2116.848085253,5
carcassonne-ucttuned250-vs-ucttuned470-1000its,805,800,2202.622595334,2168.128475372,5
carcassonne-ucttuned255-vs-ucttuned495-1000its,805,800,2178.031279484,2127.968929692,5
carcassonne-boltzmann305-vs-boltzmann10-1000its,806,801,2226.019982299,2219.430322675,5
carcassonne-ucttuned275-vs-ucttuned135-1000its,806,801,2220.243273873,2190.757518979,5
carcassonne-ucttuned325-vs-ucttuned65-1000its,806,801,2295.776832689,2217.739172613,5
carcassonne-ucttuned425-vs-ucttuned205-1000its,806,801,2223.917417905,2136.873859985,5
carcassonne-uct30-vs-uct60-1000its,808,803,2147.526077827,2134.053503426,5
carcassonne-boltzmann180-vs-boltzmann5-1000its,809,804,2176.033449866,2159.966350597,5
carcassonne-uct480-vs-uct75-1000its,809,804,2227.034163055,2217.007739132,5
carcassonne-ucttuned130-vs-ucttuned295-1000its,809,804,2266.418968809,2232.568154135,5
carcassonne-boltzmann10-vs-boltzmann245-1000its,810,805,2215.038298495,2116.59585362,5
carcassonne-boltzmann230-vs-boltzmann10-1000its,810,805,2208.959690884,2170.808767342,5
carcassonne-ucttuned285-vs-ucttuned280-1000its,810,805,2181.298560526,2120.186246365,5
carcassonne-boltzmann190-vs-boltzmann145-1000its,811,806,2186.518835872,2119.52158596,5
carcassonne-boltzmann240-vs-boltzmann440-1000its,811,806,2146.260983941,2145.986174543,5
carcassonne-ucttuned255-vs-ucttuned400-1000its,811,806,2199.212998748,2131.553961158,5
carcassonne-boltzmann240-vs-boltzmann290-1000its,812,807,2273.215804754,2237.690550992,5
carcassonne-boltzmann350-vs-boltzmann80-1000its,812,807,2160.003109063,2086.959936701,5
carcassonne-boltzmann60-vs-boltzmann335-1000its,812,807,2202.925262601,2185.745403644,5
carcassonne-ucttuned130-vs-ucttuned480-1000its,812,807,2159.174578793,2124.058387625,5
carcassonne-boltzmann315-vs-boltzmann135-1000its,813,808,2209.9212702,2190.423222762,5
carcassonne-uct375-vs-uct130-1000its,813,808,2290.931929298,2183.240193957,5
carcassonne-uct315-vs-uct195-1000its,815,810,2179.799817985,2157.221002952,5
carcassonne-ucttuned40-vs-ucttuned255-1000its,816,811,2235.005021151,2141.640451778,5
carcassonne-boltzmann105-vs-boltzmann240-1000its,818,813,2225.147480312,2133.805423242,5
carcassonne-boltzmann325-vs-boltzmann140-1000its,818,813,2249.555214152,2145.177713102,5
carcassonne-uct360-vs-uct110-1000its,818,813,2235.87544973,2191.259586429,5
carcassonne-boltzmann310-vs-boltzmann275-1000its,819,814,2159.900928737,2083.599679427,5
carcassonne-uct445-vs-uct420-1000its,819,814,2206.486925413,2156.474343557,5
carcassonne-ucttuned135-vs-ucttuned235-1000its,819,814,2209.242362034,2151.101532172,5
carcassonne-boltzmann205-vs-boltzmann85-1000its,821,816,2178.534673935,2127.64289431,5
carcassonne-boltzmann215-vs-boltzmann325-1000its,821,816,2198.474707456,2163.756701819,5
carcassonne-boltzmann25-vs-boltzmann185-1000its,821,816,2215.423758343,2109.648150226,5
carcassonne-ucttuned45-vs-ucttuned385-1000its,821,816,2163.925016927,2130.181557268,5
carcassonne-boltzmann215-vs-boltzmann410-1000its,822,817,2123.809784153,2086.844086648,5
carcassonne-ucttuned315-vs-ucttuned165-1000its,823,818,2264.941510397,2201.067615733,5
carcassonne-ucttuned425-vs-ucttuned125-1000its,823,818,2212.359333833,2111.664145974,5
carcassonne-ucttuned115-vs-ucttuned10-1000its,825,820,2100.687813051,2093.554659588,5
carcassonne-ucttuned75-vs-ucttuned440-1000its,825,820,2159.555183906,2113.104196543,5
carcassonne-uct445-vs-uct400-1000its,826,821,2222.71223065,2176.411531884,5
carcassonne-uct190-vs-uct85-1000its,827,822,2257.285700088,2201.878640251,5
carcassonne-ucttuned350-vs-ucttuned15-1000its,827,822,2231.683207947,2227.617043974,5
carcassonne-ucttuned95-vs-ucttuned135-1000its,827,822,2217.054953505,2156.610242696,5
carcassonne-boltzmann230-vs-boltzmann95-1000its,829,824,2202.389409184,2158.689013401,5
carcassonne-boltzmann350-vs-boltzmann110-1000its,829,824,2193.059790178,2177.114090727,5
carcassonne-uct475-vs-uct380-1000its,830,825,2169.138588323,2109.132359363,5
carcassonne-ucttuned245-vs-ucttuned480-1000its,830,825,2217.157778187,2197.50865132,5
carcassonne-ucttuned255-vs-ucttuned115-1000its,830,825,2293.850296054,2293.943215107,5
carcassonne-ucttuned430-vs-ucttuned80-1000its,831,826,2228.508009976,2188.623082004,5
carcassonne-ucttuned45-vs-ucttuned270-1000its,831,826,2234.536382722,2165.684749464,5
carcassonne-uct50-vs-uct165-1000its,832,827,2293.738228246,2258.751419162,5
carcassonne-boltzmann300-vs-boltzmann145-1000its,833,828,2159.350749863,2165.280612051,5
carcassonne-uct170-vs-uct15-1000its,833,828,2229.765909229,2203.079599861,5
carcassonne-uct235-vs-uct205-1000its,834,829,2204.756490428,2156.480031015,5
carcassonne-ucttuned125-vs-ucttuned205-1000its,834,829,2130.113714325,2125.087450669,5
carcassonne-ucttuned155-vs-ucttuned115-1000its,834,829,2213.753362802,2194.989503543,5
carcassonne-ucttuned390-vs-ucttuned85-1000its,835,830,2211.520299205,2154.631443592,5
carcassonne-ucttuned235-vs-ucttuned310-1000its,836,831,2163.056686482,2110.428996242,5
carcassonne-ucttuned240-vs-ucttuned235-1000its,837,832,2193.393087443,2136.600215142,5
carcassonne-ucttuned495-vs-ucttuned15-1000its,837,832,2184.083793026,2121.86416342,5
carcassonne-uct370-vs-uct340-1000its,839,834,2219.945390332,2183.669037886,5
carcassonne-ucttuned475-vs-ucttuned355-1000its,841,836,2220.036473518,2172.055150774,5
carcassonne-ucttuned335-vs-ucttuned385-1000its,844,839,2229.246173074,2206.157498625,5
carcassonne-ucttuned25-vs-ucttuned80-1000its,845,840,2221.527162371,2171.465501997,5
carcassonne-ucttuned40-vs-ucttuned25-1000its,845,840,2164.78349927,2107.900173603,5
carcassonne-uct280-vs-uct445-1000its,846,841,2151.698265317,2132.570682322,5
carcassonne-uct455-vs-uct420-1000its,846,841,2207.929506559,2116.144050416,5
carcassonne-uct205-vs-uct345-1000its,848,843,2209.735879477,2181.886294476,5
carcassonne-uct195-vs-uct280-1000its,849,844,2216.752035301,2192.080546604,5
carcassonne-ucttuned420-vs-ucttuned485-1000its,849,844,2163.119858189,2163.086338192,5
carcassonne-boltzmann105-vs-boltzmann300-1000its,850,845,2175.73702763,2176.562607673,5
carcassonne-boltzmann485-vs-boltzmann265-1000its,850,845,2205.263322566,2173.364385546,5
carcassonne-boltzmann435-vs-boltzmann360-1000its,851,846,2213.370782195,2148.469380335,5
carcassonne-ucttuned490-vs-ucttuned170-1000its,851,846,2216.827278493,2166.165149855,5
carcassonne-uct270-vs-uct55-1000its,852,847,2193.038493635,2134.567591593,5
carcassonne-ucttuned390-vs-ucttuned110-1000its,853,848,2151.391814649,2112.398110292,5
carcassonne-ucttuned110-vs-ucttuned10-1000its,856,851,2166.599861306,2136.907356317,5
carcassonne-ucttuned395-vs-ucttuned240-1000its,856,851,2232.416074225,2192.758608925,5
carcassonne-boltzmann155-vs-boltzmann275-1000its,857,852,2228.985372513,2187.229732657,5
carcassonne-uct35-vs-uct55-1000its,861,856,2208.98305007,2128.015318431,5
carcassonne-boltzmann180-vs-boltzmann260-1000its,862,857,2190.619905636,2142.227623691,5
carcassonne-uct215-vs-uct335-1000its,862,857,2210.60183065,2213.858077996,5
carcassonne-ucttuned25-vs-ucttuned305-1000its,863,858,2172.67746681,2149.894999176,5
carcassonne-uct495-vs-uct305-1000its,864,859,2351.290909496,2271.08418279,5
carcassonne-ucttuned475-vs-ucttuned10-1000its,865,860,2268.636873217,2229.664645339,5
carcassonne-uct465-vs-uct320-1000its,866,861,2163.494516063,2083.017987535,5
carcassonne-ucttuned140-vs-ucttuned235-1000its,868,863,2191.848837915,2115.960962309,5
carcassonne-uct415-vs-uct50-1000its,869,864,2235.645943612,2184.082633639,5
carcassonne-ucttuned290-vs-ucttuned75-1000its,870,865,2231.51604117,2194.890612593,5
carcassonne-ucttuned15-vs-ucttuned305-1000its,886,881,2224.593270853,2133.483746902,5
carcassonne-uct495-vs-uct430-1000its,889,884,2147.640211862,2163.477537947,5
carcassonne-ucttuned60-vs-ucttuned115-1000its,896,891,2268.298014736,2210.004569384,5
carcassonne-uct415-vs-uct260-1000its,899,894,2154.223967664,2139.69762299,5
carcassonne-ucttuned290-vs-ucttuned95-1000its,911,906,2192.235236622,2125.900453969,5
carcassonne-boltzmann275-vs-boltzmann145-1000its,715,709,2317.925819123,2278.677855819,6
carcassonne-boltzmann180-vs-boltzmann290-1000its,734,728,2180.901538211,2076.740040039,6
carcassonne-uct125-vs-uct45-1000its,739,733,2192.226717587,2130.889797444,6
carcassonne-ucttuned240-vs-ucttuned445-1000its,745,739,2214.437400222,2148.604898841,6
carcassonne-ucttuned460-vs-ucttuned300-1000its,749,743,2149.027986926,2132.682472188,6
carcassonne-boltzmann245-vs-boltzmann180-1000its,750,744,2226.304857568,2172.979756643,6
carcassonne-boltzmann150-vs-boltzmann435-1000its,752,746,2242.560167296,2214.152716707,6
carcassonne-boltzmann255-vs-boltzmann35-1000its,753,747,2270.312454556,2225.873120187,6
carcassonne-boltzmann345-vs-boltzmann450-1000its,756,750,2206.603904834,2090.399379474,6
carcassonne-uct265-vs-uct275-1000its,764,758,2202.810846505,2145.004266768,6
carcassonne-ucttuned465-vs-ucttuned60-1000its,765,759,2192.609364923,2113.926854048,6
carcassonne-boltzmann400-vs-boltzmann120-1000its,766,760,2202.728677047,2147.761275102,6
carcassonne-ucttuned85-vs-ucttuned310-1000its,766,760,2168.607536384,2159.347977987,6
carcassonne-boltzmann405-vs-boltzmann45-1000its,768,762,2218.369352703,2128.287967163,6
carcassonne-boltzmann360-vs-boltzmann135-1000its,771,765,2222.124769009,2190.727750786,6
carcassonne-boltzmann440-vs-boltzmann420-1000its,771,765,2195.887520775,2142.590769771,6
carcassonne-uct80-vs-uct360-1000its,772,766,2078.638754612,2016.180567964,6
carcassonne-ucttuned375-vs-ucttuned235-1000its,772,766,2220.014322145,2180.117530785,6
carcassonne-ucttuned65-vs-ucttuned400-1000its,774,768,2120.542461258,2083.314853154,6
carcassonne-boltzmann365-vs-boltzmann70-1000its,775,769,2210.002877297,2150.323817324,6
carcassonne-boltzmann490-vs-boltzmann470-1000its,775,769,2279.358662768,2221.649013547,6
carcassonne-uct110-vs-uct265-1000its,777,771,2203.347590857,2155.207886822,6
carcassonne-uct255-vs-uct50-1000its,777,771,2189.953364137,2137.416906164,6
carcassonne-boltzmann135-vs-boltzmann120-1000its,779,773,2236.969163665,2156.828993366,6
carcassonne-boltzmann320-vs-boltzmann190-1000its,779,773,2257.560761812,2180.613943854,6
carcassonne-uct190-vs-uct20-1000its,779,773,2103.852494755,2097.774502101,6
carcassonne-ucttuned90-vs-ucttuned220-1000its,779,773,2188.301298027,2150.687172674,6
carcassonne-boltzmann25-vs-boltzmann220-1000its,780,774,2184.259122224,2135.533815465,6
carcassonne-uct10-vs-uct95-1000its,780,774,2215.992124969,2171.021895667,6
carcassonne-boltzmann85-vs-boltzmann355-1000its,781,775,2215.743859898,2152.876702919,6
carcassonne-ucttuned25-vs-ucttuned30-1000its,781,775,2237.005897724,2226.430052097,6
carcassonne-boltzmann165-vs-boltzmann10-1000its,782,776,2177.171783689,2150.211918669,6
carcassonne-ucttuned45-vs-ucttuned305-1000its,782,776,2262.869273373,2221.03358602,6
carcassonne-uct320-vs-uct230-1000its,783,777,2163.040378364,2131.349381354,6
carcassonne-boltzmann80-vs-boltzmann40-1000its,786,780,2207.382501763,2176.13220336,6
carcassonne-ucttuned305-vs-ucttuned70-1000its,786,780,2215.582493083,2177.679349122,6
carcassonne-boltzmann330-vs-boltzmann480-1000its,787,781,2172.606337375,2134.79164409,6
carcassonne-boltzmann245-vs-boltzmann165-1000its,788,782,2187.22658702,2151.296088082,6
carcassonne-boltzmann435-vs-boltzmann350-1000its,788,782,2187.295555569,2147.620215828,6
carcassonne-uct415-vs-uct155-1000its,788,782,2137.173686611,2114.875330579,6
carcassonne-uct490-vs-uct190-1000its,788,782,2222.745536313,2198.239937816,6
carcassonne-ucttuned465-vs-ucttuned360-1000its,788,782,2305.853608446,2239.228030791,6
carcassonne-boltzmann5-vs-boltzmann365-1000its,789,783,2150.780538392,2088.986388235,6
carcassonne-uct380-vs-uct220-1000its,790,784,2165.530900886,2117.54973246,6
carcassonne-uct390-vs-uct355-1000its,790,784,2184.553642801,2146.89377071,6
carcassonne-ucttuned265-vs-ucttuned350-1000its,790,784,2224.902212991,2185.378303573,6
carcassonne-uct90-vs-uct10-1000its,791,785,2228.072556018,2214.410200171,6
carcassonne-ucttuned140-vs-ucttuned290-1000its,791,785,2190.665518068,2170.985445484,6
carcassonne-ucttuned365-vs-ucttuned230-1000its,791,785,2184.574003668,2161.303730335,6
carcassonne-ucttuned210-vs-ucttuned35-1000its,792,786,2275.602451703,2229.595665798,6
carcassonne-boltzmann400-vs-boltzmann330-1000its,793,787,2143.045163469,2099.088004306,6
carcassonne-ucttuned160-vs-ucttuned190-1000its,794,788,2238.886704289,2208.76795246,6
carcassonne-uct160-vs-uct165-1000its,796,790,2225.506203366,2221.409030771,6
carcassonne-uct240-vs-uct215-1000its,796,790,2211.754848195,2155.011846323,6
carcassonne-uct450-vs-uct315-1000its,796,790,2267.054445199,2157.549442196,6
carcassonne-ucttuned165-vs-ucttuned200-1000its,796,790,2188.274417505,2131.063399137,6
carcassonne-boltzmann250-vs-boltzmann15-1000its,797,791,2148.145909609,2116.243213629,6
carcassonne-uct45-vs-uct420-1000its,797,791,2255.929630218,2176.768268107,6
carcassonne-uct450-vs-uct100-1000its,797,791,2202.235949649,2132.837361237,6
carcassonne-boltzmann355-vs-boltzmann410-1000its,798,792,2193.168294014,2177.66705138,6
carcassonne-ucttuned320-vs-ucttuned405-1000its,798,792,2252.778305454,2179.237476398,6
carcassonne-ucttuned220-vs-ucttuned350-1000its,799,793,2153.129903169,2119.130177767,6
carcassonne-boltzmann250-vs-boltzmann30-1000its,800,794,2203.736042669,2148.334348772,6
carcassonne-uct245-vs-uct410-1000its,800,794,2171.224136524,2168.906708419,6
carcassonne-ucttuned130-vs-ucttuned490-1000its,800,794,2182.002901161,2090.540436624,6
carcassonne-boltzmann295-vs-boltzmann385-1000its,801,795,2299.92009961,2217.459109688,6
carcassonne-uct175-vs-uct65-1000its,801,795,2249.540624911,2186.681497496,6
carcassonne-ucttuned130-vs-ucttuned495-1000its,801,795,2164.73490417,2161.247774441,6
carcassonne-boltzmann325-vs-boltzmann155-1000its,803,797,2117.722993849,2094.132214702,6
carcassonne-uct95-vs-uct105-1000its,803,797,2196.470936373,2170.469016779,6
carcassonne-ucttuned210-vs-ucttuned40-1000its,803,797,2148.233866623,2072.616638984,6
carcassonne-boltzmann110-vs-boltzmann480-1000its,804,798,2198.344894526,2166.589545605,6
carcassonne-boltzmann415-vs-boltzmann110-1000its,804,798,2188.217244555,2152.966725531,6
carcassonne-ucttuned10-vs-ucttuned365-1000its,804,798,2212.497129305,2154.084278722,6
carcassonne-boltzmann225-vs-boltzmann290-1000its,805,799,2185.251808666,2135.953293093,6
carcassonne-uct160-vs-uct400-1000its,805,799,2221.012478114,2168.956142726,6
carcassonne-ucttuned490-vs-ucttuned275-1000its,805,799,2163.591682405,2173.387056218,6
carcassonne-ucttuned350-vs-ucttuned460-1000its,807,801,2138.881828364,2139.496122112,6
carcassonne-ucttuned455-vs-ucttuned250-1000its,807,801,2240.252796825,2237.510775644,6
carcassonne-boltzmann295-vs-boltzmann375-1000its,808,802,2210.636796556,2190.109099285,6
carcassonne-ucttuned190-vs-ucttuned230-1000its,808,802,2135.032716232,2151.392860893,6
carcassonne-boltzmann435-vs-boltzmann15-1000its,809,803,2191.208723039,2139.775574898,6
carcassonne-boltzmann490-vs-boltzmann305-1000its,810,804,2230.514079661,2154.343055815,6
carcassonne-ucttuned300-vs-ucttuned480-1000its,810,804,2239.272411487,2191.550732385,6
carcassonne-ucttuned200-vs-ucttuned285-1000its,811,805,2224.998497439,2120.814613715,6
carcassonne-uct460-vs-uct200-1000its,813,807,2212.138470328,2150.111645209,6
carcassonne-uct405-vs-uct480-1000its,814,808,2258.026814956,2215.08569779,6
carcassonne-uct210-vs-uct25-1000its,817,811,2231.516075149,2133.242056518,6
carcassonne-ucttuned170-vs-ucttuned435-1000its,817,811,2195.884677452,2149.61688684,6
carcassonne-ucttuned445-vs-ucttuned400-1000its,817,811,2220.467604565,2173.652007338,6
carcassonne-uct480-vs-uct80-1000its,819,813,2228.813612125,2215.048355048,6
carcassonne-boltzmann300-vs-boltzmann385-1000its,820,814,2149.78182409,2093.844374053,6
carcassonne-uct300-vs-uct445-1000its,822,816,2250.252249226,2193.597897057,6
carcassonne-boltzmann175-vs-boltzmann210-1000its,824,818,2174.626065691,2142.318484271,6
carcassonne-uct310-vs-uct185-1000its,824,818,2194.681211528,2173.667728157,6
carcassonne-boltzmann145-vs-boltzmann210-1000its,825,819,2214.536526169,2215.777297947,6
carcassonne-uct160-vs-uct35-1000its,825,819,2179.714220249,2139.553094025,6
carcassonne-uct465-vs-uct455-1000its,825,819,2234.288292505,2184.518990315,6
carcassonne-ucttuned70-vs-ucttuned375-1000its,825,819,2186.878730776,2096.923170514,6
carcassonne-uct315-vs-uct55-1000its,828,822,2240.781994743,2236.681398695,6
carcassonne-uct470-vs-uct55-1000its,828,822,2152.919145,2125.542372684,6
carcassonne-uct210-vs-uct35-1000its,829,823,2137.85221081,2082.720516249,6
carcassonne-boltzmann20-vs-boltzmann355-1000its,830,824,2241.88535096,2183.374008051,6
carcassonne-boltzmann20-vs-boltzmann480-1000its,830,824,2208.039139974,2159.777135307,6
carcassonne-uct265-vs-uct130-1000its,830,824,2192.427047541,2180.719593286,6
carcassonne-uct150-vs-uct495-1000its,831,825,2168.01160619,2145.010263121,6
carcassonne-ucttuned125-vs-ucttuned480-1000its,831,825,2194.825458958,2155.449056898,6
carcassonne-boltzmann485-vs-boltzmann305-1000its,833,827,2194.477884561,2177.988162579,6
carcassonne-uct300-vs-uct105-1000its,833,827,2154.117490468,2141.240539945,6
carcassonne-uct305-vs-uct450-1000its,834,828,2175.765487571,2103.472742163,6
carcassonne-uct170-vs-uct285-1000its,837,831,2124.347925269,2044.237143964,6
carcassonne-ucttuned405-vs-ucttuned400-1000its,838,832,2227.688127589,2147.194354268,6
carcassonne-boltzmann15-vs-boltzmann310-1000its,840,834,2175.448787094,2151.818733673,6
carcassonne-boltzmann285-vs-boltzmann365-1000its,840,834,2238.848064954,2181.131031308,6
carcassonne-boltzmann390-vs-boltzmann410-1000its,840,834,2201.295797886,2103.646425682,6
carcassonne-ucttuned255-vs-ucttuned230-1000its,840,834,2238.474118651,2211.403674573,6
carcassonne-ucttuned70-vs-ucttuned450-1000its,840,834,2213.592347784,2156.098812912,6
carcassonne-boltzmann55-vs-boltzmann445-1000its,842,836,2244.390139378,2213.04101929,6
carcassonne-uct430-vs-uct425-1000its,842,836,2247.240069489,2221.801748733,6
carcassonne-ucttuned55-vs-ucttuned410-1000its,842,836,2184.568457234,2161.13381046,6
carcassonne-ucttuned75-vs-ucttuned30-1000its,843,837,2246.784002601,2155.484131393,6
carcassonne-boltzmann375-vs-boltzmann390-1000its,846,840,2218.972256731,2167.641995957,6
carcassonne-ucttuned125-vs-ucttuned60-1000its,846,840,2157.636746786,2132.411169651,6
carcassonne-ucttuned335-vs-ucttuned40-1000its,849,843,2210.338935226,2193.968767107,6
carcassonne-ucttuned435-vs-ucttuned210-1000its,849,843,2234.126377659,2155.90705812,6
carcassonne-ucttuned420-vs-ucttuned360-1000its,853,847,2197.51228605,2145.467774725,6
carcassonne-uct255-vs-uct65-1000its,854,848,2175.106235832,2112.345358598,6
carcassonne-ucttuned40-vs-ucttuned190-1000its,855,849,2214.886574534,2168.330853623,6
carcassonne-uct175-vs-uct130-1000its,856,850,2210.995511338,2171.378837912,6
carcassonne-uct255-vs-uct455-1000its,856,850,2193.553524215,2165.757925952,6
carcassonne-uct435-vs-uct330-1000its,856,850,2162.516193806,2166.48711689,6
carcassonne-ucttuned470-vs-ucttuned145-1000its,857,851,2208.658021504,2213.310657666,6
carcassonne-ucttuned420-vs-ucttuned60-1000its,858,852,2237.439880642,2199.94568726,6
carcassonne-ucttuned265-vs-ucttuned330-1000its,860,854,2166.475027149,2146.060923305,6
carcassonne-ucttuned405-vs-ucttuned260-1000its,860,854,2228.080565208,2170.123253434,6
carcassonne-ucttuned45-vs-ucttuned170-1000its,860,854,2167.226895371,2133.625819954,6
carcassonne-boltzmann205-vs-boltzmann155-1000its,862,856,2150.191683415,2094.606026222,6
carcassonne-uct240-vs-uct420-1000its,862,856,2199.675049339,2115.257278521,6
carcassonne-boltzmann100-vs-boltzmann295-1000its,863,857,2137.967564679,2106.656048266,6
carcassonne-uct205-vs-uct270-1000its,863,857,2219.512888641,2153.810620477,6
carcassonne-uct395-vs-uct225-1000its,863,857,2195.118381446,2121.934324808,6
carcassonne-ucttuned310-vs-ucttuned255-1000its,864,858,2212.52479303,2179.543184323,6
carcassonne-boltzmann340-vs-boltzmann70-1000its,867,861,2281.656310311,2262.162471584,6
carcassonne-uct305-vs-uct390-1000its,870,864,2189.726582171,2109.387245504,6
carcassonne-ucttuned170-vs-ucttuned490-1000its,870,864,2195.715247287,2141.805454998,6
carcassonne-ucttuned70-vs-ucttuned245-1000its,877,871,2223.253097207,2145.735739641,6
carcassonne-boltzmann285-vs-boltzmann395-1000its,885,879,2196.409374796,2202.930520105,6
carcassonne-uct20-vs-uct140-1000its,888,882,2150.142133678,2122.724509593,6
carcassonne-ucttuned10-vs-ucttuned325-1000its,906,900,2140.108176636,2121.239109667,6
carcassonne-ucttuned180-vs-ucttuned475-1000its,922,916,2165.840348326,2154.241029997,6
carcassonne-uct450-vs-uct425-1000its,935,929,2235.805218552,2153.130478818,6
carcassonne-uct10-vs-uct315-1000its,936,930,2265.756915858,2187.630878716,6
carcassonne-boltzmann325-vs-boltzmann430-1000its,654,647,1774.761583189,1741.981335839,7
carcassonne-uct480-vs-uct70-1000its,713,706,2190.445677455,2175.273778306,7
carcassonne-boltzmann335-vs-boltzmann80-1000its,725,718,2163.632667849,2121.948222646,7
carcassonne-boltzmann470-vs-boltzmann430-1000its,726,719,2234.532973169,2178.273672214,7
carcassonne-ucttuned245-vs-ucttuned165-1000its,730,723,2192.828296149,2120.350197807,7
carcassonne-boltzmann270-vs-boltzmann205-1000its,740,733,2135.443392949,2075.944383685,7
carcassonne-boltzmann280-vs-boltzmann435-1000its,743,736,2080.185717841,2084.511877619,7
carcassonne-boltzmann65-vs-boltzmann410-1000its,744,737,2213.248231825,2151.859365711,7
carcassonne-boltzmann195-vs-boltzmann455-1000its,746,739,2195.66389959,2188.271119557,7
carcassonne-boltzmann355-vs-boltzmann335-1000its,746,739,2153.824979309,2133.049271686,7
carcassonne-boltzmann30-vs-boltzmann480-1000its,750,743,2167.744889053,2149.119864284,7
carcassonne-uct450-vs-uct405-1000its,750,743,2290.329781764,2222.427231765,7
carcassonne-boltzmann265-vs-boltzmann495-1000its,757,750,2149.189221486,2132.727740743,7
carcassonne-ucttuned140-vs-ucttuned385-1000its,760,753,2171.469437144,2107.848177809,7
carcassonne-ucttuned365-vs-ucttuned460-1000its,762,755,2241.906133387,2164.058305402,7
carcassonne-boltzmann170-vs-boltzmann105-1000its,763,756,2221.393794164,2169.986514654,7
carcassonne-uct315-vs-uct385-1000its,765,758,2142.950564682,2131.763551693,7
carcassonne-ucttuned75-vs-ucttuned140-1000its,766,759,2157.448774789,2091.133366392,7
carcassonne-boltzmann20-vs-boltzmann360-1000its,768,761,2185.796233364,2114.44378968,7
carcassonne-boltzmann390-vs-boltzmann55-1000its,769,762,2217.875540068,2220.361713025,7
carcassonne-boltzmann95-vs-boltzmann140-1000its,770,763,2195.036705525,2157.995965155,7
carcassonne-uct295-vs-uct445-1000its,772,765,2217.946298316,2177.049106304,7
carcassonne-uct100-vs-uct295-1000its,774,767,2151.8605475,2113.440181975,7
carcassonne-boltzmann90-vs-boltzmann295-1000its,775,768,2178.44008478,2119.74587764,7
carcassonne-uct475-vs-uct355-1000its,775,768,2212.694868577,2151.091921512,7
carcassonne-boltzmann315-vs-boltzmann80-1000its,776,769,2215.584664591,2173.224575959,7
carcassonne-uct130-vs-uct320-1000its,776,769,2157.249510612,2127.585490954,7
carcassonne-ucttuned100-vs-ucttuned65-1000its,776,769,2235.748131097,2161.887837074,7
carcassonne-ucttuned220-vs-ucttuned400-1000its,776,769,2241.453170799,2233.024022256,7
carcassonne-uct115-vs-uct360-1000its,779,772,2152.271464999,2062.499098186,7
carcassonne-uct160-vs-uct410-1000its,782,775,2176.369939146,2116.107908058,7
carcassonne-boltzmann495-vs-boltzmann180-1000its,783,776,2164.229845667,2129.555176428,7
carcassonne-ucttuned305-vs-ucttuned405-1000its,783,776,2167.86031477,2138.528589232,7
carcassonne-boltzmann395-vs-boltzmann195-1000its,784,777,2235.533860276,2200.053593474,7
carcassonne-boltzmann225-vs-boltzmann435-1000its,785,778,2251.685519801,2203.326787614,7
carcassonne-boltzmann65-vs-boltzmann215-1000its,787,780,2236.05753128,2183.404685969,7
carcassonne-uct290-vs-uct465-1000its,787,780,2137.954023879,2077.672980684,7
carcassonne-boltzmann400-vs-boltzmann365-1000its,788,781,2199.270958892,2143.906408915,7
carcassonne-boltzmann65-vs-boltzmann360-1000its,789,782,2148.014527256,2098.011504567,7
carcassonne-boltzmann15-vs-boltzmann10-1000its,790,783,2181.925505848,2148.976353523,7
carcassonne-boltzmann20-vs-boltzmann470-1000its,790,783,2155.827613136,2137.05225038,7
carcassonne-boltzmann300-vs-boltzmann340-1000its,790,783,2181.18845466,2168.791588742,7
carcassonne-uct200-vs-uct485-1000its,790,783,2108.728346174,2087.274376,7
carcassonne-boltzmann115-vs-boltzmann390-1000its,791,784,2199.232182391,2155.23399182,7
carcassonne-uct140-vs-uct160-1000its,791,784,2237.217318818,2214.747654064,7
carcassonne-ucttuned140-vs-ucttuned380-1000its,791,784,2174.784273852,2158.761154093,7
carcassonne-ucttuned345-vs-ucttuned430-1000its,791,784,2162.720596866,2093.200822644,7
carcassonne-boltzmann110-vs-boltzmann175-1000its,792,785,2240.270176355,2191.627690939,7
carcassonne-uct220-vs-uct255-1000its,793,786,2209.97381968,2161.077835007,7
carcassonne-ucttuned335-vs-ucttuned10-1000its,793,786,2172.054024611,2110.869910621,7
carcassonne-uct115-vs-uct125-1000its,795,788,2298.277426647,2205.875955922,7
carcassonne-ucttuned475-vs-ucttuned420-1000its,796,789,2204.324449888,2154.455141728,7
carcassonne-ucttuned95-vs-ucttuned105-1000its,797,790,2222.672831416,2130.221440838,7
carcassonne-boltzmann180-vs-boltzmann475-1000its,798,791,2220.408758665,2141.397893291,7
carcassonne-boltzmann280-vs-boltzmann90-1000its,799,792,2247.409196447,2181.486754513,7
carcassonne-boltzmann45-vs-boltzmann295-1000its,799,792,2224.710923144,2136.389949002,7
carcassonne-ucttuned470-vs-ucttuned140-1000its,799,792,2212.642215132,2197.875755329,7
carcassonne-boltzmann190-vs-boltzmann310-1000its,801,794,2224.240359814,2188.871795764,7
carcassonne-boltzmann405-vs-boltzmann170-1000its,801,794,2271.572011862,2209.846561479,7
carcassonne-boltzmann345-vs-boltzmann65-1000its,802,795,2218.205176078,2174.088188977,7
carcassonne-uct265-vs-uct85-1000its,803,796,2149.107814815,2101.830851328,7
carcassonne-ucttuned375-vs-ucttuned130-1000its,803,796,2138.282327216,2097.176588582,7
carcassonne-boltzmann225-vs-boltzmann360-1000its,804,797,2248.86649281,2211.542671215,7
carcassonne-ucttuned75-vs-ucttuned90-1000its,804,797,2197.832341984,2190.52069841,7
carcassonne-uct375-vs-uct190-1000its,805,798,2213.397754582,2168.216124522,7
carcassonne-boltzmann15-vs-boltzmann490-1000its,807,800,2250.831245008,2124.222608307,7
carcassonne-boltzmann25-vs-boltzmann235-1000its,807,800,2175.03798189,2170.54778072,7
carcassonne-boltzmann475-vs-boltzmann450-1000its,807,800,2239.745687602,2189.853383297,7
carcassonne-uct285-vs-uct460-1000its,808,801,2199.752491449,2171.088742513,7
carcassonne-ucttuned150-vs-ucttuned425-1000its,808,801,2225.650931297,2107.808985599,7
carcassonne-boltzmann30-vs-boltzmann290-1000its,811,804,2222.788549251,2185.420669564,7
carcassonne-boltzmann115-vs-boltzmann375-1000its,812,805,2223.038406145,2141.106378389,7
carcassonne-uct205-vs-uct405-1000its,813,806,2262.552412318,2247.195009575,7
carcassonne-uct420-vs-uct300-1000its,813,806,2211.512279711,2147.471273562,7
carcassonne-boltzmann85-vs-boltzmann180-1000its,814,807,2257.169818045,2195.6921561,7
carcassonne-uct330-vs-uct120-1000its,814,807,2235.720049739,2146.641884405,7
carcassonne-ucttuned110-vs-ucttuned225-1000its,815,808,2194.711525162,2156.049476342,7
carcassonne-boltzmann390-vs-boltzmann205-1000its,817,810,2191.49136286,2138.010170573,7
carcassonne-ucttuned265-vs-ucttuned155-1000its,817,810,2180.725231233,2104.804894134,7
carcassonne-ucttuned65-vs-ucttuned215-1000its,818,811,2270.042067326,2215.558102024,7
carcassonne-uct475-vs-uct320-1000its,819,812,2276.697958574,2261.300397391,7
carcassonne-uct170-vs-uct310-1000its,820,813,2242.310548093,2173.968070254,7
carcassonne-uct280-vs-uct360-1000its,821,814,2215.085168068,2135.680500912,7
carcassonne-boltzmann335-vs-boltzmann445-1000its,823,816,2188.807321203,2150.506793199,7
carcassonne-boltzmann340-vs-boltzmann300-1000its,823,816,2266.442176607,2212.564901077,7
carcassonne-uct315-vs-uct80-1000its,823,816,2164.240290146,2132.4529974,7
carcassonne-ucttuned255-vs-ucttuned235-1000its,824,817,2208.149093265,2172.091821759,7
carcassonne-uct270-vs-uct235-1000its,826,819,2204.249201104,2121.10404091,7
carcassonne-uct285-vs-uct350-1000its,826,819,2199.012842234,2150.65113088,7
carcassonne-ucttuned390-vs-ucttuned115-1000its,826,819,2163.819922979,2102.682381904,7
carcassonne-uct185-vs-uct90-1000its,827,820,2229.311391281,2231.133642988,7
carcassonne-ucttuned160-vs-ucttuned395-1000its,827,820,2268.725779682,2206.540372507,7
carcassonne-ucttuned80-vs-ucttuned380-1000its,827,820,2241.468515156,2245.43003169,7
carcassonne-uct250-vs-uct45-1000its,828,821,2218.108332879,2203.45260041,7
carcassonne-uct390-vs-uct215-1000its,828,821,2212.290285789,2139.939250948,7
carcassonne-uct490-vs-uct50-1000its,828,821,2175.585430589,2168.665044239,7
carcassonne-ucttuned30-vs-ucttuned465-1000its,829,822,2151.654219624,2158.066511986,7
carcassonne-ucttuned435-vs-ucttuned420-1000its,829,822,2198.682770994,2123.995350935,7
carcassonne-ucttuned80-vs-ucttuned155-1000its,829,822,2215.122230649,2157.306557245,7
carcassonne-boltzmann240-vs-boltzmann90-1000its,830,823,2185.821126127,2150.953552139,7
carcassonne-uct110-vs-uct85-1000its,830,823,2166.039584268,2104.200321274,7
carcassonne-ucttuned385-vs-ucttuned105-1000its,830,823,2161.193903669,2133.36564545,7
carcassonne-ucttuned55-vs-ucttuned145-1000its,830,823,2178.791882536,2145.167050423,7
carcassonne-boltzmann230-vs-boltzmann160-1000its,831,824,2136.543110604,2090.46766734,7
carcassonne-boltzmann70-vs-boltzmann265-1000its,831,824,2200.42233278,2141.017256298,7
carcassonne-uct275-vs-uct295-1000its,831,824,2185.086379769,2137.550202509,7
carcassonne-ucttuned375-vs-ucttuned10-1000its,833,826,2179.18208156,2148.402808299,7
carcassonne-uct200-vs-uct315-1000its,834,827,2232.267646969,2182.45719112,7
carcassonne-uct255-vs-uct75-1000its,835,828,2114.626216432,2089.843592082,7
carcassonne-boltzmann290-vs-boltzmann285-1000its,836,829,2267.155981078,2183.631155723,7
carcassonne-boltzmann445-vs-boltzmann460-1000its,837,830,2183.380715855,2142.875742585,7
carcassonne-boltzmann85-vs-boltzmann175-1000its,838,831,2129.092697877,2124.339161448,7
carcassonne-uct495-vs-uct80-1000its,839,832,2210.700961492,2160.045332397,7
carcassonne-ucttuned380-vs-ucttuned245-1000its,839,832,2223.020811076,2150.306470991,7
carcassonne-ucttuned390-vs-ucttuned190-1000its,840,833,2194.701238125,2152.882935447,7
carcassonne-uct205-vs-uct300-1000its,841,834,2142.301944127,2098.736292389,7
carcassonne-uct275-vs-uct35-1000its,841,834,2167.928282933,2128.867657742,7
carcassonne-boltzmann30-vs-boltzmann5-1000its,842,835,2153.573024568,2168.845981541,7
carcassonne-ucttuned235-vs-ucttuned25-1000its,843,836,2254.935232576,2173.586399304,7
carcassonne-boltzmann180-vs-boltzmann405-1000its,844,837,2141.067651719,2127.505779084,7
carcassonne-uct30-vs-uct290-1000its,844,837,2188.596901172,2136.483729443,7
carcassonne-uct470-vs-uct205-1000its,845,838,2152.932398596,2120.110391228,7
carcassonne-boltzmann405-vs-boltzmann410-1000its,846,839,2197.430994804,2121.905115641,7
carcassonne-boltzmann60-vs-boltzmann175-1000its,847,840,2146.694598284,2087.907481012,7
carcassonne-uct75-vs-uct235-1000its,848,841,2168.130316572,2157.553961272,7
carcassonne-ucttuned260-vs-ucttuned390-1000its,848,841,2175.891821725,2104.940437558,7
carcassonne-boltzmann365-vs-boltzmann220-1000its,854,847,2194.394882055,2134.142638742,7
carcassonne-ucttuned60-vs-ucttuned470-1000its,854,847,2178.198807425,2169.127160138,7
carcassonne-uct45-vs-uct155-1000its,855,848,2230.005336118,2166.064618784,7
carcassonne-ucttuned10-vs-ucttuned220-1000its,858,851,2188.204850513,2119.160512736,7
carcassonne-ucttuned385-vs-ucttuned370-1000its,863,856,2198.720703092,2148.824106719,7
carcassonne-boltzmann475-vs-boltzmann240-1000its,866,859,2161.95882552,2146.569109851,7
carcassonne-boltzmann410-vs-boltzmann5-1000its,868,861,2139.56260552,2186.222094595,7
carcassonne-uct445-vs-uct180-1000its,868,861,2187.819504322,2189.992190259,7
carcassonne-ucttuned140-vs-ucttuned165-1000its,868,861,2149.74228034,2105.851702746,7
carcassonne-ucttuned205-vs-ucttuned445-1000its,868,861,2174.15432783,2101.483987322,7
carcassonne-boltzmann285-vs-boltzmann205-1000its,871,864,2225.707397538,2179.428444126,7
carcassonne-boltzmann40-vs-boltzmann170-1000its,872,865,2190.431491336,2116.772930913,7
carcassonne-uct140-vs-uct155-1000its,873,866,2152.171157561,2102.868603026,7
carcassonne-boltzmann425-vs-boltzmann355-1000its,874,867,2144.507296522,2109.730842918,7
carcassonne-uct455-vs-uct275-1000its,874,867,2165.629065782,2156.167215512,7
carcassonne-ucttuned260-vs-ucttuned180-1000its,877,870,2234.351941176,2181.818850455,7
carcassonne-uct405-vs-uct100-1000its,878,871,2157.318617015,2101.146080544,7
carcassonne-uct80-vs-uct455-1000its,883,876,2189.260382079,2160.403418848,7
carcassonne-ucttuned80-vs-ucttuned25-1000its,886,879,2167.765662235,2104.771371933,7
carcassonne-boltzmann305-vs-boltzmann95-1000its,888,881,2191.004549029,2154.395327284,7
carcassonne-uct225-vs-uct100-1000its,890,883,2232.026979964,2201.459589268,7
carcassonne-ucttuned5-vs-ucttuned320-1000its,892,885,2137.071272634,2095.283744725,7
carcassonne-boltzmann225-vs-boltzmann305-1000its,897,890,2167.860605294,2129.35967217,7
carcassonne-ucttuned270-vs-ucttuned230-1000its,907,900,2245.014325658,2181.59661714,7
carcassonne-ucttuned25-vs-ucttuned285-1000its,910,903,2215.366674209,2118.803618487,7
carcassonne-ucttuned40-vs-ucttuned115-1000its,920,913,2213.24921237,2164.47632468,7
carcassonne-ucttuned490-vs-ucttuned65-1000its,649,641,1715.497622228,1686.587658737,8
carcassonne-boltzmann325-vs-boltzmann425-1000its,656,648,1772.694645883,1729.212803672,8
carcassonne-ucttuned155-vs-ucttuned405-1000its,683,675,2173.155027433,2106.689747184,8
carcassonne-boltzmann285-vs-boltzmann100-1000its,734,726,2165.782432149,2127.556847027,8
carcassonne-boltzmann215-vs-boltzmann280-1000its,736,728,2312.909965695,2259.459811711,8
carcassonne-uct365-vs-uct220-1000its,737,729,2235.70124521,2201.249941975,8
carcassonne-ucttuned380-vs-ucttuned440-1000its,738,730,2192.220903399,2139.01898196,8
carcassonne-ucttuned290-vs-ucttuned485-1000its,742,734,2237.291436194,2227.301137684,8
carcassonne-boltzmann335-vs-boltzmann135-1000its,743,735,2197.820521639,2122.521204108,8
carcassonne-boltzmann460-vs-boltzmann405-1000its,744,736,2191.397840258,2179.317138009,8
carcassonne-uct10-vs-uct140-1000its,745,737,2185.106065171,2138.77111651,8
carcassonne-boltzmann185-vs-boltzmann140-1000its,750,742,2164.913796824,2120.405846993,8
carcassonne-boltzmann270-vs-boltzmann115-1000its,754,746,2165.13601435,2094.11026102,8
carcassonne-boltzmann155-vs-boltzmann205-1000its,756,748,2202.347331616,2118.090507708,8
carcassonne-boltzmann50-vs-boltzmann235-1000its,758,750,2173.237364806,2152.834602452,8
carcassonne-boltzmann115-vs-boltzmann325-1000its,759,751,2197.830089118,2176.091910019,8
carcassonne-boltzmann285-vs-boltzmann290-1000its,763,755,2230.091244951,2201.699713606,8
carcassonne-uct55-vs-uct390-1000its,763,755,2212.681710694,2176.416819024,8
carcassonne-boltzmann490-vs-boltzmann135-1000its,764,756,2187.878854908,2137.596513601,8
carcassonne-ucttuned255-vs-ucttuned240-1000its,764,756,2137.571396478,2115.548535352,8
carcassonne-boltzmann420-vs-boltzmann180-1000its,765,757,2186.545220157,2194.343644019,8
carcassonne-uct315-vs-uct215-1000its,765,757,2190.951107728,2122.323132124,8
carcassonne-boltzmann240-vs-boltzmann490-1000its,766,758,2172.353740336,2152.057289121,8
carcassonne-boltzmann200-vs-boltzmann50-1000its,768,760,2186.832098687,2191.921270155,8
carcassonne-boltzmann255-vs-boltzmann450-1000its,769,761,2161.302764537,2124.452442711,8
carcassonne-ucttuned125-vs-ucttuned495-1000its,769,761,2226.498706025,2159.995348663,8
carcassonne-uct285-vs-uct30-1000its,772,764,2226.567277546,2163.440858537,8
carcassonne-boltzmann205-vs-boltzmann145-1000its,773,765,2221.700806955,2191.52375014,8
carcassonne-uct300-vs-uct450-1000its,777,769,2191.869035323,2158.684397942,8
carcassonne-ucttuned350-vs-ucttuned190-1000its,777,769,2252.937021858,2202.983070068,8
carcassonne-ucttuned60-vs-ucttuned285-1000its,777,769,2263.680744196,2182.088166038,8
carcassonne-uct205-vs-uct325-1000its,778,770,2207.995222259,2176.747894488,8
carcassonne-uct350-vs-uct90-1000its,779,771,2099.605095543,2112.308618354,8
carcassonne-uct460-vs-uct220-1000its,780,772,2264.926260311,2197.246728473,8
carcassonne-ucttuned35-vs-ucttuned320-1000its,780,772,2227.963662156,2156.765128693,8
carcassonne-boltzmann420-vs-boltzmann225-1000its,782,774,2237.101396702,2202.887540126,8
carcassonne-boltzmann335-vs-boltzmann285-1000its,783,775,2204.310914121,2151.169330895,8
carcassonne-ucttuned230-vs-ucttuned165-1000its,783,775,2286.353377969,2250.207530354,8
carcassonne-boltzmann10-vs-boltzmann160-1000its,785,777,2211.543989233,2134.198458503,8
carcassonne-ucttuned35-vs-ucttuned295-1000its,785,777,2181.852151971,2119.701612201,8
carcassonne-boltzmann265-vs-boltzmann65-1000its,786,778,2143.442379123,2101.9738084,8
carcassonne-ucttuned495-vs-ucttuned95-1000its,786,778,2174.567245911,2095.610886118,8
carcassonne-boltzmann445-vs-boltzmann465-1000its,787,779,2136.476479254,2131.963019736,8
carcassonne-uct350-vs-uct370-1000its,787,779,2203.029754832,2109.086025628,8
carcassonne-ucttuned255-vs-ucttuned225-1000its,787,779,2192.140840558,2117.969880377,8
carcassonne-uct25-vs-uct210-1000its,788,780,2259.770718005,2201.146104427,8
carcassonne-ucttuned170-vs-ucttuned175-1000its,788,780,2228.123577156,2197.14821164,8
carcassonne-boltzmann185-vs-boltzmann90-1000its,789,781,2244.296547475,2176.540413335,8
carcassonne-uct245-vs-uct365-1000its,789,781,2228.602579954,2197.549584767,8
carcassonne-ucttuned395-vs-ucttuned315-1000its,789,781,2137.396546789,2142.828804328,8
carcassonne-uct445-vs-uct435-1000its,790,782,2189.8971498,2137.264682901,8
carcassonne-uct455-vs-uct375-1000its,790,782,2135.372646198,2114.119015659,8
carcassonne-boltzmann215-vs-boltzmann145-1000its,791,783,2244.671943264,2168.37425122,8
carcassonne-uct250-vs-uct20-1000its,791,783,2195.487039048,2179.019463078,8
carcassonne-boltzmann325-vs-boltzmann285-1000its,792,784,2181.779453536,2138.629003108,8
carcassonne-uct415-vs-uct65-1000its,792,784,2215.009618118,2145.565277306,8
carcassonne-uct490-vs-uct45-1000its,792,784,2186.049782433,2149.094747482,8
carcassonne-boltzmann155-vs-boltzmann330-1000its,793,785,2176.033550715,2163.547832904,8
carcassonne-boltzmann165-vs-boltzmann375-1000its,793,785,2203.752933213,2181.860394969,8
carcassonne-uct390-vs-uct140-1000its,793,785,2304.278583856,2247.508661516,8
carcassonne-boltzmann80-vs-boltzmann135-1000its,794,786,2271.09166546,2248.025991962,8
carcassonne-uct290-vs-uct275-1000its,794,786,2168.247309942,2108.211803941,8
carcassonne-uct370-vs-uct255-1000its,795,787,2247.660266293,2200.318771844,8
carcassonne-ucttuned420-vs-ucttuned375-1000its,795,787,2152.654750316,2158.369202368,8
carcassonne-boltzmann455-vs-boltzmann335-1000its,796,788,2230.376812391,2179.776677525,8
carcassonne-ucttuned145-vs-ucttuned280-1000its,796,788,2196.875347081,2159.785814081,8
carcassonne-ucttuned195-vs-ucttuned485-1000its,796,788,2214.609136303,2149.741493022,8
carcassonne-ucttuned375-vs-ucttuned25-1000its,797,789,2244.888053029,2210.480063788,8
carcassonne-ucttuned390-vs-ucttuned355-1000its,797,789,2167.092536105,2110.349221887,8
carcassonne-uct245-vs-uct220-1000its,798,790,2168.800752681,2115.669439161,8
carcassonne-boltzmann185-vs-boltzmann70-1000its,799,791,2161.382639041,2123.897418697,8
carcassonne-uct295-vs-uct380-1000its,799,791,2169.847460154,2124.059494113,8
carcassonne-ucttuned70-vs-ucttuned215-1000its,799,791,2173.438178684,2108.301702741,8
carcassonne-ucttuned345-vs-ucttuned180-1000its,800,792,2191.455596868,2169.666680305,8
carcassonne-boltzmann80-vs-boltzmann60-1000its,801,793,2199.801728841,2144.898099772,8
carcassonne-boltzmann90-vs-boltzmann475-1000its,801,793,2156.720973772,2101.733761808,8
carcassonne-uct360-vs-uct105-1000its,804,796,2156.145726551,2100.571106835,8
carcassonne-uct410-vs-uct200-1000its,804,796,2237.30085935,2200.067815276,8
carcassonne-ucttuned95-vs-ucttuned370-1000its,804,796,2116.746146594,2148.835670228,8
carcassonne-uct75-vs-uct425-1000its,805,797,2144.805551037,2094.63667073,8
carcassonne-ucttuned250-vs-ucttuned190-1000its,805,797,2137.182705852,2080.091715723,8
carcassonne-ucttuned390-vs-ucttuned495-1000its,806,798,2243.11320906,2181.335678046,8
carcassonne-uct295-vs-uct250-1000its,807,799,2213.557842713,2158.997769999,8
carcassonne-ucttuned165-vs-ucttuned20-1000its,807,799,2125.390328184,2081.662717613,8
carcassonne-boltzmann270-vs-boltzmann460-1000its,808,800,2258.407062422,2237.84084778,8
carcassonne-ucttuned25-vs-ucttuned365-1000its,808,800,2207.102555016,2118.502575392,8
carcassonne-boltzmann450-vs-boltzmann455-1000its,811,803,2321.056992364,2290.950476121,8
carcassonne-uct270-vs-uct205-1000its,811,803,2233.0683556,2192.820840841,8
carcassonne-ucttuned425-vs-ucttuned140-1000its,811,803,2132.31877675,2075.897854847,8
carcassonne-boltzmann20-vs-boltzmann440-1000its,816,808,2155.30402176,2148.39439867,8
carcassonne-boltzmann475-vs-boltzmann15-1000its,816,808,2216.555603343,2209.886625115,8
carcassonne-ucttuned15-vs-ucttuned310-1000its,816,808,2232.248401987,2173.165235169,8
carcassonne-boltzmann260-vs-boltzmann290-1000its,817,809,2167.512080127,2158.254066279,8
carcassonne-boltzmann160-vs-boltzmann305-1000its,818,810,2275.17755435,2230.527716339,8
carcassonne-boltzmann245-vs-boltzmann405-1000its,818,810,2196.150794075,2101.68875378,8
carcassonne-ucttuned240-vs-ucttuned165-1000its,818,810,2246.976301653,2217.603781092,8
carcassonne-boltzmann390-vs-boltzmann250-1000its,819,811,2181.859504244,2133.925909728,8
carcassonne-uct130-vs-uct325-1000its,819,811,2201.594019036,2133.649441538,8
carcassonne-boltzmann370-vs-boltzmann335-1000its,820,812,2187.9944316,2120.757517616,8
carcassonne-uct105-vs-uct435-1000its,820,812,2213.836144751,2158.599604036,8
carcassonne-uct345-vs-uct340-1000its,820,812,2136.035233607,2102.835445851,8
carcassonne-uct240-vs-uct450-1000its,821,813,2204.578148234,2128.189778904,8
carcassonne-uct295-vs-uct230-1000its,821,813,2287.565389469,2265.646294025,8
carcassonne-ucttuned330-vs-ucttuned495-1000its,821,813,2173.660886112,2192.595622214,8
carcassonne-ucttuned345-vs-ucttuned455-1000its,821,813,2125.724208283,2079.109306465,8
carcassonne-boltzmann450-vs-boltzmann185-1000its,822,814,2181.260278358,2121.275087427,8
carcassonne-uct160-vs-uct415-1000its,822,814,2182.823911859,2089.738775619,8
carcassonne-uct265-vs-uct190-1000its,822,814,2125.524943298,2057.119329555,8
carcassonne-ucttuned360-vs-ucttuned185-1000its,822,814,2233.422314886,2206.033908107,8
carcassonne-uct275-vs-uct215-1000its,823,815,2261.519320641,2223.4335454,8
carcassonne-ucttuned480-vs-ucttuned190-1000its,824,816,2248.980121998,2223.474759602,8
carcassonne-ucttuned305-vs-ucttuned25-1000its,825,817,2177.028004616,2139.707271333,8
carcassonne-ucttuned320-vs-ucttuned415-1000its,825,817,2221.543794349,2168.74503237,8
carcassonne-ucttuned150-vs-ucttuned420-1000its,826,818,2138.45812657,2128.143600267,8
carcassonne-ucttuned40-vs-ucttuned280-1000its,826,818,2231.931931222,2192.026277093,8
carcassonne-boltzmann100-vs-boltzmann400-1000its,829,821,2242.909654159,2194.96266038,8
carcassonne-boltzmann465-vs-boltzmann430-1000its,829,821,2115.505691879,2096.696263852,8
carcassonne-ucttuned255-vs-ucttuned195-1000its,829,821,2294.823682987,2269.242900867,8
carcassonne-ucttuned380-vs-ucttuned325-1000its,829,821,2268.067018932,2211.904990396,8
carcassonne-ucttuned70-vs-ucttuned395-1000its,830,822,2194.447798443,2167.817976019,8
carcassonne-boltzmann320-vs-boltzmann235-1000its,832,824,2276.04869236,2249.036802114,8
carcassonne-boltzmann450-vs-boltzmann65-1000its,835,827,2154.646136148,2169.641766116,8
carcassonne-ucttuned480-vs-ucttuned20-1000its,835,827,2244.443655726,2205.288279694,8
carcassonne-boltzmann240-vs-boltzmann335-1000its,836,828,2313.622405636,2282.85768576,8
carcassonne-uct235-vs-uct245-1000its,836,828,2106.371890904,2096.172953546,8
carcassonne-boltzmann390-vs-boltzmann425-1000its,837,829,2224.681535227,2154.260483017,8
carcassonne-uct200-vs-uct55-1000its,837,829,2197.956308726,2184.593154969,8
carcassonne-ucttuned450-vs-ucttuned240-1000its,838,830,2261.018285858,2228.738758933,8
carcassonne-ucttuned485-vs-ucttuned15-1000its,838,830,2242.280336369,2214.607397037,8
carcassonne-ucttuned90-vs-ucttuned115-1000its,838,830,2251.083171894,2167.91214434,8
carcassonne-boltzmann20-vs-boltzmann130-1000its,839,831,2210.475286669,2179.310692123,8
carcassonne-uct480-vs-uct385-1000its,839,831,2180.97149007,2160.754741482,8
carcassonne-ucttuned275-vs-ucttuned310-1000its,839,831,2171.283610441,2149.816363256,8
carcassonne-uct475-vs-uct120-1000its,840,832,2231.292312099,2179.079144592,8
carcassonne-uct70-vs-uct275-1000its,840,832,2212.412703701,2161.200529441,8
carcassonne-uct285-vs-uct315-1000its,841,833,2323.46375182,2241.721374947,8
carcassonne-ucttuned265-vs-ucttuned400-1000its,841,833,2113.073936069,2096.426026653,8
carcassonne-uct95-vs-uct165-1000its,845,837,2145.548476517,2100.768560215,8
carcassonne-ucttuned420-vs-ucttuned425-1000its,845,837,2268.094279766,2201.294666632,8
carcassonne-boltzmann55-vs-boltzmann160-1000its,846,838,2183.252431575,2147.279038214,8
carcassonne-ucttuned455-vs-ucttuned430-1000its,847,839,2229.730105595,2165.800230314,8
carcassonne-boltzmann330-vs-boltzmann40-1000its,848,840,2166.825603902,2152.557483148,8
carcassonne-boltzmann245-vs-boltzmann230-1000its,849,841,2263.246783608,2252.725678121,8
carcassonne-uct15-vs-uct240-1000its,849,841,2193.947539511,2145.87543477,8
carcassonne-ucttuned145-vs-ucttuned340-1000its,853,845,2172.669693368,2144.694130831,8
carcassonne-ucttuned165-vs-ucttuned475-1000its,853,845,2176.927715707,2145.177138274,8
carcassonne-boltzmann265-vs-boltzmann380-1000its,854,846,2235.369370305,2205.261688393,8
carcassonne-uct315-vs-uct65-1000its,854,846,2156.561355547,2140.071953173,8
carcassonne-ucttuned375-vs-ucttuned170-1000its,854,846,2236.268890888,2181.519519764,8
carcassonne-boltzmann440-vs-boltzmann465-1000its,856,848,2127.582990678,2121.848376628,8
carcassonne-boltzmann115-vs-boltzmann50-1000its,857,849,2149.475616659,2151.462551378,8
carcassonne-uct455-vs-uct60-1000its,858,850,2184.463710469,2124.943509361,8
carcassonne-ucttuned25-vs-ucttuned170-1000its,859,851,2165.420299617,2098.543086341,8
carcassonne-boltzmann265-vs-boltzmann245-1000its,861,853,2185.7646259,2125.582697802,8
carcassonne-boltzmann335-vs-boltzmann175-1000its,862,854,2271.700466307,2179.135568402,8
carcassonne-ucttuned275-vs-ucttuned455-1000its,862,854,2183.404246211,2108.543451119,8
carcassonne-uct100-vs-uct490-1000its,863,855,2180.742549878,2144.981046688,8
carcassonne-uct240-vs-uct310-1000its,864,856,2262.915035813,2211.906774447,8
carcassonne-ucttuned40-vs-ucttuned165-1000its,864,856,2259.880772752,2203.299813549,8
carcassonne-uct165-vs-uct140-1000its,865,857,2218.079700167,2173.026296059,8
carcassonne-ucttuned100-vs-ucttuned165-1000its,865,857,2176.760912326,2130.951293745,8
carcassonne-uct365-vs-uct130-1000its,866,858,2184.449448708,2136.959517773,8
carcassonne-ucttuned15-vs-ucttuned175-1000its,868,860,2203.714427518,2152.801627344,8
carcassonne-boltzmann380-vs-boltzmann30-1000its,874,866,2209.461137765,2170.518291194,8
carcassonne-uct210-vs-uct170-1000its,874,866,2222.095523619,2155.263311915,8
carcassonne-uct235-vs-uct80-1000its,876,868,2174.351297804,2141.80680837,8
carcassonne-uct20-vs-uct25-1000its,879,871,2157.264921418,2163.606251129,8
carcassonne-boltzmann450-vs-boltzmann270-1000its,880,872,2131.346281175,2105.076624249,8
carcassonne-uct10-vs-uct175-1000its,891,883,2229.28347578,2155.712362167,8
carcassonne-uct135-vs-uct65-1000its,891,883,2189.027884455,2166.91993419,8
carcassonne-boltzmann155-vs-boltzmann335-1000its,896,888,2219.930641687,2187.503150595,8
carcassonne-ucttuned395-vs-ucttuned445-1000its,922,914,2185.243145608,2124.119351009,8
carcassonne-uct195-vs-uct420-1000its,947,939,2148.387306329,2098.611984439,8
carcassonne-boltzmann430-vs-boltzmann310-1000its,703,694,2174.33046334,2152.489533547,9
carcassonne-boltzmann470-vs-boltzmann295-1000its,724,715,2197.982535283,2182.167963202,9
carcassonne-uct450-vs-uct330-1000its,733,724,2231.639363135,2222.287420175,9
carcassonne-uct160-vs-uct225-1000its,739,730,2172.704544342,2146.326551934,9
carcassonne-uct40-vs-uct215-1000its,741,732,2184.551734585,2156.534361223,9
carcassonne-uct20-vs-uct400-1000its,742,733,2202.04858865,2178.971040753,9
carcassonne-uct195-vs-uct105-1000its,747,738,2166.413288367,2060.784101371,9
carcassonne-ucttuned195-vs-ucttuned495-1000its,753,744,2206.634581098,2167.080406043,9
carcassonne-ucttuned260-vs-ucttuned395-1000its,753,744,2183.841853597,2130.006835911,9
carcassonne-boltzmann415-vs-boltzmann380-1000its,754,745,2182.405287064,2156.864086528,9
carcassonne-uct300-vs-uct205-1000its,754,745,2241.484555583,2181.719342552,9
carcassonne-boltzmann495-vs-boltzmann295-1000its,757,748,2262.558967056,2223.220596068,9
carcassonne-ucttuned495-vs-ucttuned235-1000its,760,751,2166.348527437,2110.742761213,9
carcassonne-uct180-vs-uct175-1000its,761,752,2187.410626188,2158.24957549,9
carcassonne-boltzmann285-vs-boltzmann435-1000its,762,753,2195.693241722,2120.816326536,9
carcassonne-ucttuned260-vs-ucttuned190-1000its,763,754,2156.724644131,2122.773176415,9
carcassonne-uct335-vs-uct340-1000its,766,757,2213.408343341,2192.079245166,9
carcassonne-uct65-vs-uct290-1000its,769,760,2177.285440181,2146.785921236,9
carcassonne-ucttuned185-vs-ucttuned80-1000its,770,761,2227.396622084,2171.864780087,9
carcassonne-boltzmann5-vs-boltzmann440-1000its,772,763,2181.494307176,2148.979987067,9
carcassonne-uct200-vs-uct240-1000its,772,763,2232.492338764,2151.341631731,9
carcassonne-uct190-vs-uct400-1000its,774,765,2176.188785224,2157.827109169,9
carcassonne-ucttuned120-vs-ucttuned130-1000its,776,767,2174.765167917,2163.678336321,9
carcassonne-boltzmann235-vs-boltzmann340-1000its,777,768,2229.006645973,2203.016845247,9
carcassonne-ucttuned35-vs-ucttuned395-1000its,777,768,2148.675568874,2116.990794401,9
carcassonne-uct110-vs-uct425-1000its,778,769,2144.584177816,2065.849033348,9
carcassonne-boltzmann485-vs-boltzmann100-1000its,779,770,2224.890581006,2198.618490099,9
carcassonne-ucttuned155-vs-ucttuned435-1000its,779,770,2230.70074557,2181.202975751,9
carcassonne-boltzmann455-vs-boltzmann20-1000its,781,772,2303.893560737,2270.685567861,9
carcassonne-ucttuned285-vs-ucttuned390-1000its,781,772,2255.075022564,2209.895364864,9
carcassonne-boltzmann45-vs-boltzmann160-1000its,782,773,2204.198760642,2154.81860834,9
carcassonne-uct380-vs-uct75-1000its,783,774,2206.150120927,2171.967006639,9
carcassonne-boltzmann370-vs-boltzmann380-1000its,784,775,2167.122712771,2122.608310271,9
carcassonne-ucttuned75-vs-ucttuned130-1000its,784,775,2179.85244134,2102.864262301,9
carcassonne-boltzmann175-vs-boltzmann290-1000its,787,778,2183.345882351,2162.234970471,9
carcassonne-boltzmann185-vs-boltzmann255-1000its,787,778,2184.533050928,2169.398179279,9
carcassonne-ucttuned420-vs-ucttuned80-1000its,787,778,2176.442937675,2152.128217557,9
carcassonne-boltzmann165-vs-boltzmann340-1000its,788,779,2231.342232441,2160.100436373,9
carcassonne-ucttuned170-vs-ucttuned215-1000its,789,780,2203.62327272,2177.411973137,9
carcassonne-ucttuned315-vs-ucttuned20-1000its,790,781,2218.169963085,2205.59493855,9
carcassonne-ucttuned445-vs-ucttuned340-1000its,790,781,2144.697199822,2127.590815152,9
carcassonne-boltzmann290-vs-boltzmann425-1000its,791,782,2249.657963681,2191.994565017,9
carcassonne-boltzmann455-vs-boltzmann385-1000its,791,782,2197.804273726,2163.589518514,9
carcassonne-uct160-vs-uct50-1000its,791,782,2207.455931385,2178.518215005,9
carcassonne-ucttuned165-vs-ucttuned120-1000its,792,783,2183.342637107,2139.733980034,9
carcassonne-uct345-vs-uct90-1000its,793,784,2203.081740463,2157.919067397,9
carcassonne-boltzmann100-vs-boltzmann60-1000its,794,785,2226.238059251,2178.589780197,9
carcassonne-boltzmann485-vs-boltzmann380-1000its,794,785,2154.654275358,2137.461285511,9
carcassonne-boltzmann255-vs-boltzmann310-1000its,795,786,2200.950492566,2154.084096233,9
carcassonne-boltzmann280-vs-boltzmann35-1000its,795,786,2186.656603602,2118.242448439,9
carcassonne-boltzmann95-vs-boltzmann475-1000its,795,786,2184.497367379,2085.286550182,9
carcassonne-uct220-vs-uct180-1000its,795,786,2167.238558277,2137.487113543,9
carcassonne-uct405-vs-uct350-1000its,795,786,2217.748437188,2178.745119071,9
carcassonne-ucttuned80-vs-ucttuned370-1000its,796,787,2243.783352036,2115.064064902,9
carcassonne-boltzmann375-vs-boltzmann275-1000its,797,788,2137.457011297,2099.561036167,9
carcassonne-ucttuned350-vs-ucttuned170-1000its,797,788,2284.631014971,2231.864753716,9
carcassonne-boltzmann260-vs-boltzmann345-1000its,798,789,2185.55177531,2159.410045083,9
carcassonne-ucttuned305-vs-ucttuned280-1000its,800,791,2220.929686066,2163.095931709,9
carcassonne-uct65-vs-uct430-1000its,801,792,2238.937790823,2223.522063441,9
carcassonne-uct165-vs-uct190-1000its,803,794,2208.335834652,2146.897503299,9
carcassonne-boltzmann120-vs-boltzmann310-1000its,804,795,2169.966195318,2155.573480767,9
carcassonne-boltzmann290-vs-boltzmann160-1000its,804,795,2128.613111934,2090.54112634,9
carcassonne-uct250-vs-uct305-1000its,804,795,2142.674405962,2065.072254732,9
carcassonne-uct375-vs-uct315-1000its,805,796,2181.391540593,2134.474784056,9
carcassonne-uct30-vs-uct10-1000its,806,797,2230.748890486,2180.627773101,9
carcassonne-uct360-vs-uct355-1000its,806,797,2197.460103547,2149.941005373,9
carcassonne-ucttuned300-vs-ucttuned240-1000its,806,797,2184.40715628,2174.562817562,9
carcassonne-ucttuned200-vs-ucttuned455-1000its,807,798,2195.435694944,2179.783389614,9
carcassonne-boltzmann365-vs-boltzmann135-1000its,809,800,2304.860522954,2259.84385578,9
carcassonne-uct30-vs-uct370-1000its,809,800,2180.264198115,2129.866132562,9
carcassonne-boltzmann150-vs-boltzmann105-1000its,810,801,2258.133968985,2229.063929078,9
carcassonne-boltzmann325-vs-boltzmann270-1000its,810,801,2235.051288207,2185.813276322,9
carcassonne-uct155-vs-uct490-1000its,810,801,2221.389827363,2158.174659458,9
carcassonne-boltzmann25-vs-boltzmann290-1000its,811,802,2251.921695527,2206.158938648,9
carcassonne-ucttuned240-vs-ucttuned465-1000its,811,802,2187.586795257,2155.166851991,9
carcassonne-boltzmann395-vs-boltzmann465-1000its,812,803,2224.549710875,2188.614524358,9
carcassonne-boltzmann475-vs-boltzmann30-1000its,813,804,2217.772989658,2179.364619792,9
carcassonne-uct350-vs-uct490-1000its,813,804,2192.447958145,2108.104379235,9
carcassonne-ucttuned470-vs-ucttuned295-1000its,813,804,2221.697566601,2197.153685671,9
carcassonne-uct175-vs-uct115-1000its,814,805,2265.255670132,2215.920555708,9
carcassonne-uct325-vs-uct285-1000its,815,806,2213.918580491,2160.290920755,9
carcassonne-ucttuned165-vs-ucttuned390-1000its,815,806,2192.411284769,2130.49505058,9
carcassonne-ucttuned410-vs-ucttuned335-1000its,815,806,2205.384294174,2166.450376124,9
carcassonne-boltzmann80-vs-boltzmann115-1000its,816,807,2176.303425797,2113.777155765,9
carcassonne-ucttuned400-vs-ucttuned110-1000its,816,807,2271.230090264,2210.234116195,9
carcassonne-boltzmann340-vs-boltzmann65-1000its,817,808,2268.581407058,2174.895080761,9
carcassonne-uct375-vs-uct410-1000its,817,808,2152.314096616,2119.066823526,9
carcassonne-uct75-vs-uct150-1000its,817,808,2232.56088157,2175.279446946,9
carcassonne-ucttuned20-vs-ucttuned440-1000its,817,808,2206.481300729,2131.26977638,9
carcassonne-ucttuned320-vs-ucttuned220-1000its,817,808,2258.977849666,2231.907408535,9
carcassonne-boltzmann70-vs-boltzmann230-1000its,818,809,2206.596527766,2109.856390836,9
carcassonne-uct145-vs-uct290-1000its,818,809,2207.010882994,2157.641824465,9
carcassonne-ucttuned380-vs-ucttuned160-1000its,819,810,2126.093361661,2078.796076881,9
carcassonne-ucttuned90-vs-ucttuned135-1000its,819,810,2242.533166306,2204.425554271,9
carcassonne-uct125-vs-uct135-1000its,820,811,2297.880641887,2277.471260087,9
carcassonne-uct155-vs-uct75-1000its,820,811,2154.18707326,2070.777566017,9
carcassonne-ucttuned95-vs-ucttuned340-1000its,822,813,2159.305283752,2126.327454287,9
carcassonne-ucttuned420-vs-ucttuned35-1000its,823,814,2256.992238602,2159.410822505,9
carcassonne-uct245-vs-uct395-1000its,825,816,2235.398490521,2171.229562241,9
carcassonne-ucttuned335-vs-ucttuned185-1000its,825,816,2226.416817289,2172.278026798,9
carcassonne-boltzmann140-vs-boltzmann440-1000its,826,817,2145.964180473,2117.943882918,9
carcassonne-ucttuned115-vs-ucttuned150-1000its,826,817,2161.516311909,2105.894365318,9
carcassonne-boltzmann280-vs-boltzmann100-1000its,827,818,2190.815789517,2114.791064368,9
carcassonne-uct285-vs-uct180-1000its,827,818,2195.269637627,2147.245025362,9
carcassonne-ucttuned250-vs-ucttuned215-1000its,827,818,2178.527912352,2140.538766154,9
carcassonne-boltzmann170-vs-boltzmann440-1000its,829,820,2263.366305539,2221.709624518,9
carcassonne-uct75-vs-uct430-1000its,829,820,2241.088698046,2182.700892147,9
carcassonne-boltzmann345-vs-boltzmann40-1000its,834,825,2175.458904683,2147.750224856,9
carcassonne-boltzmann450-vs-boltzmann470-1000its,834,825,2159.07129344,2173.826680939,9
carcassonne-uct245-vs-uct345-1000its,835,826,2199.676982446,2155.58645208,9
carcassonne-uct60-vs-uct50-1000its,835,826,2228.477328848,2178.039475641,9
carcassonne-boltzmann140-vs-boltzmann330-1000its,837,828,2186.068109257,2143.020528781,9
carcassonne-boltzmann230-vs-boltzmann445-1000its,837,828,2222.35797129,2156.726748753,9
carcassonne-ucttuned335-vs-ucttuned150-1000its,837,828,2173.615800015,2111.208400537,9
carcassonne-boltzmann285-vs-boltzmann255-1000its,838,829,2288.265680909,2249.881816217,9
carcassonne-uct345-vs-uct280-1000its,838,829,2130.843922423,2128.886789766,9
carcassonne-boltzmann375-vs-boltzmann405-1000its,839,830,2206.23198628,2124.141835274,9
carcassonne-ucttuned80-vs-ucttuned390-1000its,840,831,2177.002061222,2167.754314327,9
carcassonne-uct280-vs-uct320-1000its,841,832,2273.380171066,2205.999693819,9
carcassonne-ucttuned180-vs-ucttuned160-1000its,841,832,2208.918542206,2152.074780834,9
carcassonne-ucttuned450-vs-ucttuned130-1000its,842,833,2197.484765234,2107.649391952,9
carcassonne-boltzmann390-vs-boltzmann330-1000its,844,835,2170.577669043,2134.320952051,9
carcassonne-ucttuned230-vs-ucttuned275-1000its,844,835,2230.889323169,2215.472621265,9
carcassonne-uct290-vs-uct320-1000its,846,837,2192.653378926,2165.851283536,9
carcassonne-uct325-vs-uct430-1000its,847,838,2237.89340006,2150.711783695,9
carcassonne-uct150-vs-uct290-1000its,849,840,2189.977788025,2115.547399948,9
carcassonne-uct155-vs-uct290-1000its,850,841,2150.237541731,2112.876621018,9
carcassonne-boltzmann75-vs-boltzmann460-1000its,851,842,2223.767572435,2134.819548801,9
carcassonne-uct35-vs-uct175-1000its,852,843,2195.152959187,2157.831477669,9
carcassonne-uct255-vs-uct310-1000its,854,845,2236.730095161,2155.654133818,9
carcassonne-uct150-vs-uct355-1000its,855,846,2231.868070629,2189.207601932,9
carcassonne-uct310-vs-uct100-1000its,855,846,2205.082593347,2157.223676249,9
carcassonne-uct5-vs-uct285-1000its,855,846,2209.997879421,2186.647080631,9
carcassonne-boltzmann285-vs-boltzmann350-1000its,858,849,2205.546836077,2169.398188345,9
carcassonne-boltzmann400-vs-boltzmann340-1000its,858,849,2189.912573109,2166.293318788,9
carcassonne-boltzmann195-vs-boltzmann135-1000its,859,850,2199.359155976,2173.225093999,9
carcassonne-boltzmann300-vs-boltzmann215-1000its,860,851,2204.346394058,2173.151859066,9
carcassonne-uct250-vs-uct420-1000its,861,852,2268.72348057,2197.157804457,9
carcassonne-ucttuned290-vs-ucttuned30-1000its,863,854,2167.552921401,2149.168105909,9
carcassonne-ucttuned5-vs-ucttuned355-1000its,864,855,2242.926850332,2178.092464906,9
carcassonne-boltzmann375-vs-boltzmann190-1000its,865,856,2280.405987594,2221.638917758,9
carcassonne-boltzmann360-vs-boltzmann115-1000its,868,859,2144.96594778,2079.027485871,9
carcassonne-ucttuned100-vs-ucttuned365-1000its,868,859,2202.96474542,2144.486034493,9
carcassonne-ucttuned315-vs-ucttuned435-1000its,868,859,2132.204971634,2073.776272117,9
carcassonne-boltzmann420-vs-boltzmann480-1000its,870,861,2158.895974279,2142.459425519,9
carcassonne-uct65-vs-uct345-1000its,873,864,2237.07590132,2230.656263255,9
carcassonne-boltzmann310-vs-boltzmann10-1000its,881,872,2194.074281325,2166.525799662,9
carcassonne-ucttuned475-vs-ucttuned300-1000its,886,877,2253.615253777,2174.141586774,9
carcassonne-boltzmann265-vs-boltzmann35-1000its,888,879,2272.782710937,2214.99600631,9
carcassonne-boltzmann170-vs-boltzmann60-1000its,889,880,2189.168636922,2117.65089814,9
carcassonne-ucttuned180-vs-ucttuned55-1000its,899,890,2169.083464364,2153.971902412,9
carcassonne-ucttuned420-vs-ucttuned20-1000its,899,890,2238.294867326,2209.265065559,9
carcassonne-ucttuned5-vs-ucttuned35-1000its,902,893,2173.280917062,2109.750041704,9
carcassonne-uct265-vs-uct45-1000its,905,896,2188.792887869,2171.608948557,9
carcassonne-ucttuned390-vs-ucttuned255-1000its,911,902,2189.756186681,2123.650363785,9
carcassonne-uct385-vs-uct290-1000its,915,906,2194.478337386,2148.353516949,9
carcassonne-ucttuned190-vs-ucttuned475-1000its,919,910,2182.500705983,2181.348778906,9
carcassonne-uct400-vs-uct265-1000its,928,919,2219.06605329,2167.28970996,9
carcassonne-ucttuned435-vs-ucttuned75-1000its,965,956,2233.202638556,2155.482761637,9
carcassonne-boltzmann385-vs-boltzmann70-1000its,711,701,2224.417816882,2161.760986587,10
carcassonne-boltzmann330-vs-boltzmann220-1000its,728,718,2265.961050013,2184.881676784,10
carcassonne-boltzmann25-vs-boltzmann205-1000its,730,720,2217.929410843,2184.247054246,10
carcassonne-ucttuned350-vs-ucttuned320-1000its,736,726,2198.943441977,2115.635398633,10
carcassonne-boltzmann195-vs-boltzmann395-1000its,741,731,2218.395354009,2183.898441392,10
carcassonne-ucttuned225-vs-ucttuned185-1000its,743,733,2118.269842572,2101.006485138,10
carcassonne-boltzmann260-vs-boltzmann5-1000its,745,735,2139.137901017,2142.631557281,10
carcassonne-boltzmann330-vs-boltzmann490-1000its,745,735,2195.695147636,2112.791347652,10
carcassonne-ucttuned35-vs-ucttuned410-1000its,746,736,2197.168471395,2109.614391767,10
carcassonne-boltzmann15-vs-boltzmann115-1000its,747,737,2232.476100676,2187.469123573,10
carcassonne-boltzmann335-vs-boltzmann155-1000its,749,739,2219.81191825,2213.029333702,10
carcassonne-boltzmann395-vs-boltzmann285-1000its,749,739,2176.14452207,2156.339315117,10
carcassonne-uct120-vs-uct325-1000its,754,744,2156.177595041,2151.029288492,10
carcassonne-boltzmann225-vs-boltzmann455-1000its,758,748,2230.367508368,2204.254493793,10
carcassonne-boltzmann195-vs-boltzmann160-1000its,759,749,2162.711057413,2153.849295346,10
carcassonne-boltzmann200-vs-boltzmann30-1000its,760,750,2166.64685747,2099.017067791,10
carcassonne-boltzmann130-vs-boltzmann120-1000its,768,758,2220.283592763,2171.334291719,10
carcassonne-uct250-vs-uct140-1000its,770,760,2214.187472517,2157.091139564,10
carcassonne-ucttuned310-vs-ucttuned370-1000its,770,760,2265.787419158,2166.57961848,10
carcassonne-boltzmann150-vs-boltzmann400-1000its,771,761,2222.61823373,2197.747691065,10
carcassonne-ucttuned150-vs-ucttuned30-1000its,772,762,2127.577274331,2141.615779461,10
carcassonne-boltzmann40-vs-boltzmann175-1000its,776,766,2241.515906307,2219.614295585,10
carcassonne-ucttuned365-vs-ucttuned470-1000its,776,766,2201.69187762,2197.266520227,10
carcassonne-boltzmann25-vs-boltzmann105-1000its,777,767,2199.393757755,2209.213470944,10
carcassonne-ucttuned5-vs-ucttuned235-1000its,778,768,2163.42015685,2144.366070806,10
carcassonne-ucttuned475-vs-ucttuned395-1000its,780,770,2113.890661723,2109.805086813,10
carcassonne-boltzmann150-vs-boltzmann175-1000its,781,771,2167.41699987,2143.311290128,10
carcassonne-ucttuned220-vs-ucttuned85-1000its,781,771,2134.388443634,2141.657139181,10
carcassonne-boltzmann325-vs-boltzmann295-1000its,782,772,2250.655612234,2197.290995861,10
carcassonne-boltzmann95-vs-boltzmann135-1000its,782,772,2202.571487508,2153.408015706,10
carcassonne-ucttuned160-vs-ucttuned345-1000its,782,772,2172.458300956,2171.087956067,10
carcassonne-boltzmann85-vs-boltzmann215-1000its,785,775,2190.093852263,2126.497466683,10
carcassonne-uct105-vs-uct370-1000its,785,775,2190.621359741,2145.371627283,10
carcassonne-ucttuned410-vs-ucttuned330-1000its,785,775,2229.683011513,2160.866801723,10
carcassonne-boltzmann475-vs-boltzmann340-1000its,786,776,2332.388566142,2282.226999079,10
carcassonne-uct240-vs-uct235-1000its,786,776,2152.179580491,2125.485394014,10
carcassonne-uct380-vs-uct100-1000its,786,776,2205.776029991,2199.326270221,10
carcassonne-uct480-vs-uct470-1000its,786,776,2213.802068448,2116.874184347,10
carcassonne-boltzmann95-vs-boltzmann285-1000its,788,778,2178.823856538,2139.24714471,10
carcassonne-boltzmann320-vs-boltzmann70-1000its,789,779,2218.146359773,2194.808119604,10
carcassonne-boltzmann75-vs-boltzmann245-1000its,789,779,2239.946467593,2207.599534271,10
carcassonne-uct20-vs-uct305-1000its,790,780,2213.082805229,2139.210568239,10
carcassonne-uct355-vs-uct450-1000its,790,780,2137.892111646,2127.97141911,10
carcassonne-ucttuned20-vs-ucttuned185-1000its,790,780,2172.868003282,2125.382412191,10
carcassonne-ucttuned465-vs-ucttuned140-1000its,793,783,2215.444073431,2169.029450795,10
carcassonne-boltzmann220-vs-boltzmann250-1000its,794,784,2240.473374592,2179.394507535,10
carcassonne-uct40-vs-uct400-1000its,794,784,2150.639477787,2110.142939449,10
carcassonne-uct55-vs-uct325-1000its,794,784,2164.512205559,2120.993703341,10
carcassonne-boltzmann135-vs-boltzmann435-1000its,796,786,2220.714663744,2168.681629543,10
carcassonne-boltzmann495-vs-boltzmann185-1000its,797,787,2165.850233241,2122.016451828,10
carcassonne-ucttuned260-vs-ucttuned460-1000its,797,787,2235.295648224,2174.012162532,10
carcassonne-ucttuned340-vs-ucttuned245-1000its,797,787,2190.840397327,2167.492716022,10
carcassonne-boltzmann215-vs-boltzmann455-1000its,799,789,2195.391807119,2121.055065478,10
carcassonne-uct480-vs-uct25-1000its,800,790,2197.939607079,2166.972913448,10
carcassonne-uct75-vs-uct145-1000its,800,790,2198.031247598,2128.458235413,10
carcassonne-ucttuned230-vs-ucttuned150-1000its,800,790,2206.590133431,2135.5732401,10
carcassonne-boltzmann110-vs-boltzmann400-1000its,802,792,2197.537780541,2107.416618414,10
carcassonne-uct455-vs-uct430-1000its,802,792,2289.717975807,2164.174978162,10
carcassonne-boltzmann480-vs-boltzmann495-1000its,803,793,2242.58894607,2185.840688093,10
carcassonne-uct155-vs-uct310-1000its,803,793,2196.435296704,2140.394563206,10
carcassonne-uct85-vs-uct245-1000its,803,793,2209.536762395,2143.997217713,10
carcassonne-ucttuned15-vs-ucttuned380-1000its,803,793,2258.697030976,2206.213204366,10
carcassonne-boltzmann420-vs-boltzmann375-1000its,804,794,2167.178270988,2164.489270488,10
carcassonne-boltzmann5-vs-boltzmann20-1000its,804,794,2251.696836192,2203.503548503,10
carcassonne-uct140-vs-uct25-1000its,804,794,2153.250634924,2132.702335837,10
carcassonne-ucttuned15-vs-ucttuned270-1000its,804,794,2235.840553988,2210.772282531,10
carcassonne-ucttuned220-vs-ucttuned225-1000its,804,794,2200.286993893,2130.853097667,10
carcassonne-ucttuned375-vs-ucttuned215-1000its,804,794,2240.454910062,2175.593027521,10
carcassonne-boltzmann345-vs-boltzmann135-1000its,805,795,2162.335968973,2178.082890829,10
carcassonne-boltzmann235-vs-boltzmann90-1000its,807,797,2178.315924377,2151.184884359,10
carcassonne-boltzmann450-vs-boltzmann240-1000its,808,798,2175.807859195,2123.109451014,10
carcassonne-uct170-vs-uct230-1000its,808,798,2179.195389024,2149.327417159,10
carcassonne-uct270-vs-uct160-1000its,808,798,2188.630205144,2179.530426158,10
carcassonne-uct425-vs-uct215-1000its,808,798,2224.302248244,2115.867916129,10
carcassonne-uct165-vs-uct430-1000its,809,799,2252.157468553,2158.670515904,10
carcassonne-ucttuned395-vs-ucttuned135-1000its,810,800,2127.196194281,2093.365473435,10
carcassonne-boltzmann490-vs-boltzmann370-1000its,811,801,2235.145925702,2204.895096089,10
carcassonne-uct475-vs-uct20-1000its,811,801,2235.491520248,2234.483139042,10
carcassonne-uct480-vs-uct150-1000its,812,802,2189.790324622,2142.402178673,10
carcassonne-ucttuned400-vs-ucttuned190-1000its,813,803,2213.15275337,2207.732233394,10
carcassonne-boltzmann330-vs-boltzmann45-1000its,814,804,2199.990170887,2118.947212577,10
carcassonne-ucttuned55-vs-ucttuned230-1000its,814,804,2194.276374189,2126.615536041,10
carcassonne-uct70-vs-uct300-1000its,815,805,2293.781509603,2253.736123245,10
carcassonne-uct125-vs-uct285-1000its,816,806,2186.489010348,2196.787485255,10
carcassonne-ucttuned425-vs-ucttuned100-1000its,816,806,2259.575735912,2226.493078346,10
carcassonne-boltzmann115-vs-boltzmann320-1000its,817,807,2242.155660619,2187.391518551,10
carcassonne-ucttuned300-vs-ucttuned365-1000its,817,807,2224.68943033,2182.660904296,10
carcassonne-uct105-vs-uct165-1000its,818,808,2149.031238209,2154.234499054,10
carcassonne-boltzmann440-vs-boltzmann75-1000its,821,811,2150.091005725,2080.744920468,10
carcassonne-boltzmann345-vs-boltzmann100-1000its,822,812,2249.552550815,2209.261908406,10
carcassonne-ucttuned240-vs-ucttuned145-1000its,822,812,2204.97760797,2164.246258626,10
carcassonne-ucttuned365-vs-ucttuned135-1000its,822,812,2192.352438165,2156.723570694,10
carcassonne-ucttuned480-vs-ucttuned40-1000its,823,813,2219.27813073,2102.176005072,10
carcassonne-ucttuned380-vs-ucttuned75-1000its,824,814,2267.145463093,2227.611284084,10
carcassonne-ucttuned170-vs-ucttuned85-1000its,825,815,2223.512096505,2168.606464932,10
carcassonne-ucttuned360-vs-ucttuned130-1000its,825,815,2241.70939436,2215.732692129,10
carcassonne-boltzmann165-vs-boltzmann415-1000its,826,816,2149.586802753,2113.236381494,10
carcassonne-boltzmann265-vs-boltzmann270-1000its,826,816,2210.57896759,2174.068596759,10
carcassonne-boltzmann305-vs-boltzmann125-1000its,827,817,2136.946516593,2102.27548559,10
carcassonne-uct250-vs-uct280-1000its,828,818,2268.328238056,2250.433868871,10
carcassonne-ucttuned295-vs-ucttuned460-1000its,829,819,2163.806650564,2129.219746918,10
carcassonne-boltzmann85-vs-boltzmann115-1000its,830,820,2199.271131871,2169.204981612,10
carcassonne-uct175-vs-uct50-1000its,830,820,2168.737955914,2094.215521041,10
carcassonne-uct495-vs-uct250-1000its,830,820,2159.657852208,2156.13742828,10
carcassonne-ucttuned145-vs-ucttuned285-1000its,830,820,2150.737156023,2127.383562749,10
carcassonne-ucttuned330-vs-ucttuned65-1000its,831,821,2163.728189326,2153.448827674,10
carcassonne-boltzmann125-vs-boltzmann95-1000its,832,822,2207.089962613,2168.051185945,10
carcassonne-uct60-vs-uct80-1000its,834,824,2211.349107209,2184.541298578,10
carcassonne-ucttuned255-vs-ucttuned140-1000its,834,824,2166.818467111,2123.370757574,10
carcassonne-boltzmann410-vs-boltzmann360-1000its,837,827,2181.709945034,2157.405942289,10
carcassonne-boltzmann90-vs-boltzmann165-1000its,837,827,2223.078465458,2169.807517695,10
carcassonne-ucttuned425-vs-ucttuned55-1000its,838,828,2187.038112581,2135.284090936,10
carcassonne-uct490-vs-uct315-1000its,839,829,2246.266674844,2205.363425569,10
carcassonne-uct55-vs-uct180-1000its,839,829,2163.718917941,2105.18580617,10
carcassonne-uct415-vs-uct495-1000its,840,830,2202.208110913,2193.918920242,10
carcassonne-uct70-vs-uct475-1000its,840,830,2277.318704995,2226.313868405,10
carcassonne-boltzmann25-vs-boltzmann195-1000its,841,831,2175.202543395,2132.912320838,10
carcassonne-boltzmann45-vs-boltzmann440-1000its,842,832,2198.786197935,2188.056866186,10
carcassonne-uct240-vs-uct370-1000its,843,833,2184.781643084,2136.084183721,10
carcassonne-uct335-vs-uct240-1000its,844,834,2302.051777525,2260.453666243,10
carcassonne-boltzmann45-vs-boltzmann50-1000its,846,836,2202.992697425,2173.846161246,10
carcassonne-ucttuned385-vs-ucttuned320-1000its,846,836,2153.103617955,2077.703652659,10
carcassonne-boltzmann310-vs-boltzmann465-1000its,847,837,2166.523652528,2132.302038404,10
carcassonne-boltzmann465-vs-boltzmann495-1000its,850,840,2204.428469639,2162.251329311,10
carcassonne-uct385-vs-uct265-1000its,850,840,2245.703326762,2194.087511743,10
carcassonne-ucttuned35-vs-ucttuned245-1000its,851,841,2242.104358405,2154.685235934,10
carcassonne-uct325-vs-uct420-1000its,852,842,2264.618410594,2198.895488587,10
carcassonne-uct335-vs-uct160-1000its,852,842,2233.664712992,2122.649914312,10
carcassonne-uct10-vs-uct310-1000its,854,844,2209.658948954,2172.074849771,10
carcassonne-uct325-vs-uct45-1000its,855,845,2198.627537857,2168.506528351,10
carcassonne-ucttuned440-vs-ucttuned395-1000its,856,846,2223.44237059,2144.093778621,10
carcassonne-ucttuned370-vs-ucttuned65-1000its,859,849,2163.637358477,2141.766402861,10
carcassonne-uct165-vs-uct485-1000its,861,851,2214.526130675,2176.083606892,10
carcassonne-boltzmann485-vs-boltzmann155-1000its,867,857,2167.089375394,2162.957144143,10
carcassonne-uct130-vs-uct195-1000its,867,857,2253.652535211,2182.106805392,10
carcassonne-ucttuned135-vs-ucttuned80-1000its,867,857,2159.156514463,2134.970765774,10
carcassonne-uct260-vs-uct135-1000its,868,858,2186.328478229,2156.820493218,10
carcassonne-ucttuned200-vs-ucttuned155-1000its,869,859,2167.615174158,2158.359734217,10
carcassonne-ucttuned260-vs-ucttuned120-1000its,871,861,2248.251545874,2212.322577832,10
carcassonne-ucttuned315-vs-ucttuned255-1000its,873,863,2177.551535222,2120.632409921,10
carcassonne-uct430-vs-uct25-1000its,874,864,2241.193616184,2235.616813414,10
carcassonne-uct425-vs-uct180-1000its,877,867,2234.656941866,2197.819254842,10
carcassonne-uct465-vs-uct125-1000its,878,868,2107.114210222,2104.973547569,10
carcassonne-uct225-vs-uct295-1000its,881,871,2247.521183489,2170.954932499,10
carcassonne-boltzmann25-vs-boltzmann315-1000its,883,873,2165.084389988,2058.526740849,10
carcassonne-uct255-vs-uct445-1000its,883,873,2194.466446983,2190.213445108,10
carcassonne-ucttuned175-vs-ucttuned230-1000its,883,873,2224.738207136,2178.513816553,10
carcassonne-ucttuned40-vs-ucttuned125-1000its,886,876,2229.527727438,2154.228202427,10
carcassonne-boltzmann420-vs-boltzmann155-1000its,891,881,2165.763066244,2151.34117972,10
carcassonne-boltzmann10-vs-boltzmann100-1000its,893,883,2325.4430966,2231.602273053,10
carcassonne-uct175-vs-uct185-1000its,893,883,2226.775442614,2211.903804137,10
carcassonne-boltzmann495-vs-boltzmann265-1000its,894,884,2223.973125598,2204.015150565,10
carcassonne-uct335-vs-uct245-1000its,894,884,2146.631226681,2133.966804399,10
carcassonne-ucttuned25-vs-ucttuned270-1000its,909,899,2212.633427149,2165.448412456,10
carcassonne-ucttuned160-vs-ucttuned265-1000its,918,908,2149.699170003,2147.795869928,10
carcassonne-boltzmann45-vs-boltzmann215-1000its,940,930,2252.401766243,2181.418781445,10
carcassonne-ucttuned215-vs-ucttuned175-1000its,650,639,1833.437011641,1720.438868787,11
carcassonne-uct290-vs-uct100-1000its,664,653,1769.795102658,1715.755439209,11
carcassonne-boltzmann370-vs-boltzmann145-1000its,726,715,2223.214940926,2177.646051179,11
carcassonne-ucttuned315-vs-ucttuned310-1000its,740,729,2191.562725893,2150.617767234,11
carcassonne-uct285-vs-uct450-1000its,746,735,2161.50594138,2094.401443955,11
carcassonne-uct455-vs-uct220-1000its,746,735,2199.808271692,2154.792522073,11
carcassonne-ucttuned25-vs-ucttuned60-1000its,747,736,2176.318719673,2099.671444897,11
carcassonne-uct115-vs-uct215-1000its,749,738,2223.849568142,2139.718536617,11
carcassonne-uct100-vs-uct325-1000its,752,741,2174.749412557,2141.449184288,11
carcassonne-boltzmann75-vs-boltzmann60-1000its,756,745,2278.839877227,2185.291283251,11
carcassonne-uct245-vs-uct260-1000its,756,745,2238.652156048,2164.601549571,11
carcassonne-boltzmann495-vs-boltzmann125-1000its,757,746,2164.383093493,2085.233936212,11
carcassonne-boltzmann465-vs-boltzmann460-1000its,758,747,2157.429985018,2162.102172807,11
carcassonne-uct75-vs-uct270-1000its,758,747,2225.547815997,2165.03397495,11
carcassonne-uct130-vs-uct165-1000its,761,750,2160.399887297,2125.602340799,11
carcassonne-ucttuned200-vs-ucttuned225-1000its,761,750,2212.842253915,2182.264781304,11
carcassonne-uct490-vs-uct410-1000its,763,752,2213.889909878,2182.153642179,11
carcassonne-boltzmann30-vs-boltzmann120-1000its,764,753,2218.39311204,2191.261022912,11
carcassonne-ucttuned230-vs-ucttuned355-1000its,764,753,2136.612456463,2104.924245021,11
carcassonne-boltzmann265-vs-boltzmann485-1000its,765,754,2176.662392986,2150.7948579,11
carcassonne-boltzmann445-vs-boltzmann305-1000its,768,757,2238.293009134,2239.301230222,11
carcassonne-ucttuned325-vs-ucttuned75-1000its,769,758,2228.95523084,2187.045328174,11
carcassonne-boltzmann180-vs-boltzmann105-1000its,772,761,2229.690728849,2151.950631489,11
carcassonne-ucttuned130-vs-ucttuned275-1000its,772,761,2207.672269318,2136.915024035,11
carcassonne-ucttuned415-vs-ucttuned250-1000its,772,761,2206.435727531,2146.405848573,11
carcassonne-boltzmann25-vs-boltzmann390-1000its,773,762,2200.676356154,2158.380097807,11
carcassonne-boltzmann410-vs-boltzmann425-1000its,773,762,2128.436903127,2041.539829549,11
carcassonne-ucttuned405-vs-ucttuned130-1000its,775,764,2219.579877448,2187.843454444,11
carcassonne-ucttuned205-vs-ucttuned160-1000its,776,765,2193.43524332,2171.289459245,11
carcassonne-ucttuned435-vs-ucttuned470-1000its,776,765,2229.843537676,2190.820445546,11
carcassonne-boltzmann440-vs-boltzmann140-1000its,777,766,2220.701547489,2193.030450127,11
carcassonne-ucttuned75-vs-ucttuned295-1000its,777,766,2164.778496271,2108.84811683,11
carcassonne-boltzmann110-vs-boltzmann155-1000its,779,768,2276.939183249,2211.090172914,11
carcassonne-uct315-vs-uct420-1000its,779,768,2188.219507705,2157.043676215,11
carcassonne-uct490-vs-uct355-1000its,779,768,2147.796543537,2115.758918962,11
carcassonne-uct135-vs-uct455-1000its,780,769,2137.078305579,2094.975081795,11
carcassonne-ucttuned460-vs-ucttuned400-1000its,781,770,2211.604056984,2205.88367264,11
carcassonne-boltzmann135-vs-boltzmann230-1000its,782,771,2253.751653431,2245.847277269,11
carcassonne-boltzmann190-vs-boltzmann495-1000its,782,771,2236.061625663,2177.117606049,11
carcassonne-uct335-vs-uct270-1000its,782,771,2179.112200604,2169.561538762,11
carcassonne-uct295-vs-uct70-1000its,783,772,2202.991951752,2140.74503289,11
carcassonne-ucttuned70-vs-ucttuned365-1000its,783,772,2123.905765843,2097.836690443,11
carcassonne-uct165-vs-uct315-1000its,785,774,2182.02197218,2193.324700002,11
carcassonne-boltzmann480-vs-boltzmann230-1000its,786,775,2160.960092312,2112.304078345,11
carcassonne-uct335-vs-uct225-1000its,786,775,2219.096065341,2172.486838078,11
carcassonne-uct360-vs-uct255-1000its,787,776,2234.464415799,2195.766937523,11
carcassonne-boltzmann110-vs-boltzmann495-1000its,790,779,2170.868133627,2135.130870907,11
carcassonne-uct145-vs-uct260-1000its,792,781,2143.682000865,2124.050898422,11
carcassonne-uct470-vs-uct430-1000its,792,781,2211.02979013,2167.220652208,11
carcassonne-boltzmann415-vs-boltzmann210-1000its,793,782,2117.72345449,2091.284826889,11
carcassonne-ucttuned235-vs-ucttuned75-1000its,793,782,2264.335700672,2209.802281428,11
carcassonne-ucttuned490-vs-ucttuned350-1000its,793,782,2238.894099586,2176.320679986,11
carcassonne-boltzmann290-vs-boltzmann165-1000its,794,783,2134.875537388,2130.669225066,11
carcassonne-uct125-vs-uct475-1000its,795,784,2217.633937956,2167.112059829,11
carcassonne-ucttuned305-vs-ucttuned60-1000its,796,785,2262.434072822,2206.430440275,11
carcassonne-boltzmann115-vs-boltzmann305-1000its,797,786,2199.298423711,2154.934652154,11
carcassonne-boltzmann295-vs-boltzmann350-1000its,797,786,2273.478608072,2209.839194058,11
carcassonne-boltzmann470-vs-boltzmann145-1000its,800,789,2160.598242564,2159.773530323,11
carcassonne-boltzmann40-vs-boltzmann195-1000its,801,790,2174.846895912,2160.163966785,11
carcassonne-uct60-vs-uct55-1000its,802,791,2155.038154566,2119.050674734,11
carcassonne-ucttuned370-vs-ucttuned215-1000its,802,791,2223.343607752,2142.362916755,11
carcassonne-uct335-vs-uct380-1000its,803,792,2249.884688485,2217.00114481,11
carcassonne-ucttuned330-vs-ucttuned20-1000its,803,792,2213.841763704,2164.685826769,11
carcassonne-boltzmann465-vs-boltzmann60-1000its,804,793,2182.377678141,2151.144376802,11
carcassonne-uct265-vs-uct245-1000its,804,793,2237.155432102,2184.307536867,11
carcassonne-uct310-vs-uct465-1000its,805,794,2248.119533412,2188.030517826,11
carcassonne-boltzmann120-vs-boltzmann375-1000its,806,795,2214.324843742,2185.652001414,11
carcassonne-boltzmann130-vs-boltzmann45-1000its,806,795,2207.155367568,2124.070478167,11
carcassonne-uct355-vs-uct395-1000its,806,795,2195.492956392,2186.832217753,11
carcassonne-uct50-vs-uct260-1000its,807,796,2154.821326705,2114.269600034,11
carcassonne-uct355-vs-uct435-1000its,808,797,2241.316728755,2220.570363326,11
carcassonne-ucttuned355-vs-ucttuned485-1000its,810,799,2229.642784511,2196.254954572,11
carcassonne-boltzmann40-vs-boltzmann475-1000its,811,800,2153.044639048,2092.828633857,11
carcassonne-boltzmann330-vs-boltzmann295-1000its,812,801,2250.897749343,2210.002212664,11
carcassonne-ucttuned440-vs-ucttuned150-1000its,812,801,2178.987105089,2125.390379204,11
carcassonne-boltzmann255-vs-boltzmann300-1000its,813,802,2152.457946359,2133.626580513,11
carcassonne-boltzmann5-vs-boltzmann450-1000its,813,802,2254.182574383,2207.990135124,11
carcassonne-uct210-vs-uct130-1000its,813,802,2173.487022304,2116.859814031,11
carcassonne-ucttuned115-vs-ucttuned340-1000its,813,802,2191.739064543,2133.378180289,11
carcassonne-ucttuned25-vs-ucttuned380-1000its,813,802,2235.33838342,2183.931407437,11
carcassonne-boltzmann245-vs-boltzmann435-1000its,814,803,2206.9391633,2196.722384445,11
carcassonne-uct215-vs-uct260-1000its,814,803,2166.903598579,2152.348431164,11
carcassonne-ucttuned225-vs-ucttuned170-1000its,814,803,2147.196997147,2089.113483392,11
carcassonne-boltzmann495-vs-boltzmann440-1000its,815,804,2132.230528413,2132.24156731,11
carcassonne-uct140-vs-uct55-1000its,815,804,2146.593437105,2125.621084826,11
carcassonne-uct115-vs-uct375-1000its,816,805,2177.494621091,2124.364052407,11
carcassonne-uct215-vs-uct450-1000its,816,805,2226.766580438,2177.091677636,11
carcassonne-boltzmann225-vs-boltzmann50-1000its,817,806,2198.376175941,2139.555510472,11
carcassonne-boltzmann225-vs-boltzmann40-1000its,818,807,2177.398166677,2115.634748846,11
carcassonne-boltzmann285-vs-boltzmann305-1000its,818,807,2202.766888288,2179.658382405,11
carcassonne-ucttuned210-vs-ucttuned320-1000its,818,807,2179.034272347,2172.356630139,11
carcassonne-ucttuned290-vs-ucttuned140-1000its,819,808,2289.549911434,2184.847426827,11
carcassonne-boltzmann400-vs-boltzmann210-1000its,820,809,2162.020402453,2105.868581704,11
carcassonne-boltzmann145-vs-boltzmann425-1000its,821,810,2214.270921236,2158.709550382,11
carcassonne-uct365-vs-uct495-1000its,823,812,2234.187245454,2157.247656526,11
carcassonne-boltzmann95-vs-boltzmann195-1000its,824,813,2257.035982721,2154.722617684,11
carcassonne-ucttuned125-vs-ucttuned470-1000its,824,813,2162.000151011,2092.228085217,11
carcassonne-uct10-vs-uct420-1000its,825,814,2168.895852663,2085.675114033,11
carcassonne-uct445-vs-uct380-1000its,825,814,2243.812579209,2213.298623885,11
carcassonne-ucttuned305-vs-ucttuned380-1000its,826,815,2189.608041513,2148.202180108,11
carcassonne-ucttuned395-vs-ucttuned435-1000its,826,815,2227.407139133,2194.882690661,11
carcassonne-ucttuned480-vs-ucttuned425-1000its,826,815,2175.497782793,2104.100443387,11
carcassonne-uct305-vs-uct395-1000its,827,816,2171.934124957,2115.6909064,11
carcassonne-uct395-vs-uct30-1000its,827,816,2201.808108581,2174.376819175,11
carcassonne-uct55-vs-uct415-1000its,827,816,2174.112935939,2130.294180348,11
carcassonne-ucttuned300-vs-ucttuned30-1000its,827,816,2237.88676362,2230.59485972,11
carcassonne-boltzmann460-vs-boltzmann95-1000its,829,818,2134.096761662,2080.105331645,11
carcassonne-boltzmann125-vs-boltzmann425-1000its,830,819,2210.691361976,2151.647652551,11
carcassonne-uct185-vs-uct195-1000its,831,820,2208.806983169,2163.006102803,11
carcassonne-ucttuned210-vs-ucttuned250-1000its,832,821,2207.929792405,2183.666169701,11
carcassonne-boltzmann105-vs-boltzmann215-1000its,833,822,2191.366003579,2183.89373957,11
carcassonne-uct100-vs-uct240-1000its,834,823,2250.114503024,2188.030275404,11
carcassonne-ucttuned350-vs-ucttuned335-1000its,834,823,2254.915379529,2229.171895371,11
carcassonne-uct70-vs-uct265-1000its,836,825,2180.638036649,2160.966795795,11
carcassonne-boltzmann135-vs-boltzmann200-1000its,837,826,2231.8754978,2208.009775129,11
carcassonne-uct300-vs-uct495-1000its,837,826,2186.877340924,2145.432724174,11
carcassonne-uct125-vs-uct260-1000its,838,827,2214.985538418,2203.343702937,11
carcassonne-ucttuned410-vs-ucttuned80-1000its,839,828,2185.773084209,2106.174331741,11
carcassonne-ucttuned135-vs-ucttuned300-1000its,841,830,2213.284297379,2147.048752727,11
carcassonne-boltzmann235-vs-boltzmann465-1000its,842,831,2222.430120821,2169.183894205,11
carcassonne-ucttuned80-vs-ucttuned120-1000its,843,832,2242.126341537,2212.654621392,11
carcassonne-ucttuned170-vs-ucttuned230-1000its,844,833,2258.69128496,2221.484046954,11
carcassonne-ucttuned5-vs-ucttuned140-1000its,844,833,2219.676230553,2175.494334125,11
carcassonne-boltzmann185-vs-boltzmann100-1000its,845,834,2192.762395831,2151.369754358,11
carcassonne-boltzmann375-vs-boltzmann415-1000its,845,834,2238.083397325,2202.209581149,11
carcassonne-ucttuned240-vs-ucttuned50-1000its,845,834,2136.759646041,2129.012830308,11
carcassonne-boltzmann205-vs-boltzmann415-1000its,848,837,2216.398792792,2157.214416218,11
carcassonne-ucttuned270-vs-ucttuned295-1000its,848,837,2204.516988152,2156.987164944,11
carcassonne-boltzmann185-vs-boltzmann50-1000its,849,838,2182.082584381,2139.949564637,11
carcassonne-uct330-vs-uct495-1000its,849,838,2190.125667923,2146.575816037,11
carcassonne-ucttuned475-vs-ucttuned225-1000its,850,839,2128.769647911,2096.442282209,11
carcassonne-uct245-vs-uct120-1000its,853,842,2149.343696979,2133.126380583,11
carcassonne-uct390-vs-uct280-1000its,853,842,2237.313391161,2207.250853878,11
carcassonne-uct455-vs-uct285-1000its,853,842,2220.567714557,2178.670275368,11
carcassonne-uct495-vs-uct230-1000its,853,842,2165.920235194,2135.610491583,11
carcassonne-ucttuned70-vs-ucttuned15-1000its,855,844,2128.870610837,2051.088915034,11
carcassonne-boltzmann260-vs-boltzmann215-1000its,856,845,2233.379040224,2145.570289606,11
carcassonne-uct215-vs-uct415-1000its,856,845,2186.789379014,2101.09539447,11
carcassonne-boltzmann115-vs-boltzmann30-1000its,857,846,2201.114245588,2164.342371743,11
carcassonne-uct320-vs-uct10-1000its,857,846,2163.259580392,2117.139380901,11
carcassonne-ucttuned340-vs-ucttuned330-1000its,861,850,2195.379961209,2178.073602914,11
carcassonne-boltzmann65-vs-boltzmann355-1000its,862,851,2232.654323143,2170.01665477,11
carcassonne-boltzmann240-vs-boltzmann420-1000its,863,852,2192.280674118,2122.507821291,11
carcassonne-boltzmann140-vs-boltzmann310-1000its,866,855,2242.274879766,2161.29659453,11
carcassonne-uct375-vs-uct355-1000its,866,855,2207.165198591,2109.117415354,11
carcassonne-ucttuned220-vs-ucttuned115-1000its,867,856,2175.240721491,2122.194578681,11
carcassonne-ucttuned290-vs-ucttuned125-1000its,867,856,2190.708120534,2125.713952126,11
carcassonne-ucttuned485-vs-ucttuned145-1000its,867,856,2271.815109185,2192.240250339,11
carcassonne-ucttuned180-vs-ucttuned465-1000its,868,857,2216.927657421,2132.594200235,11
carcassonne-boltzmann275-vs-boltzmann55-1000its,869,858,2217.785628169,2155.587777607,11
carcassonne-ucttuned205-vs-ucttuned165-1000its,872,861,2248.801084309,2202.191730989,11
carcassonne-ucttuned375-vs-ucttuned360-1000its,872,861,2202.912289875,2179.628455636,11
carcassonne-boltzmann450-vs-boltzmann320-1000its,873,862,2201.775240274,2186.603747132,11
carcassonne-ucttuned395-vs-ucttuned180-1000its,873,862,2171.174184041,2136.924124248,11
carcassonne-ucttuned60-vs-ucttuned415-1000its,875,864,2201.647226143,2144.495158902,11
carcassonne-boltzmann165-vs-boltzmann330-1000its,876,865,2198.100093902,2163.889203423,11
carcassonne-ucttuned130-vs-ucttuned50-1000its,876,865,2145.008405474,2089.81647074,11
carcassonne-ucttuned400-vs-ucttuned175-1000its,878,867,2184.94721531,2179.649920455,11
carcassonne-boltzmann75-vs-boltzmann495-1000its,886,875,2207.46818215,2124.515289951,11
carcassonne-uct50-vs-uct325-1000its,888,877,2135.574127528,2083.021550504,11
carcassonne-boltzmann120-vs-boltzmann295-1000its,890,879,2247.831618444,2145.155305735,11
carcassonne-boltzmann170-vs-boltzmann375-1000its,892,881,2155.288954048,2048.552640933,11
carcassonne-boltzmann495-vs-boltzmann270-1000its,895,884,2204.731297164,2159.178160413,11
carcassonne-ucttuned105-vs-ucttuned85-1000its,895,884,2179.941346111,2155.953197584,11
carcassonne-uct210-vs-uct285-1000its,896,885,2174.862937318,2149.52925932,11
carcassonne-ucttuned440-vs-ucttuned330-1000its,897,886,2190.598660226,2155.315819537,11
carcassonne-ucttuned230-vs-ucttuned375-1000its,905,894,2176.62786626,2101.776522574,11
carcassonne-ucttuned485-vs-ucttuned300-1000its,907,896,2188.292861729,2143.684111061,11
carcassonne-uct15-vs-uct260-1000its,920,909,2222.4125411,2128.527561074,11
carcassonne-uct355-vs-uct405-1000its,956,945,2226.951320741,2175.672379418,11
carcassonne-ucttuned340-vs-ucttuned180-1000its,631,619,1747.203577311,1725.395724138,12
carcassonne-ucttuned355-vs-ucttuned385-1000its,710,698,2211.160627337,2163.397957974,12
carcassonne-boltzmann155-vs-boltzmann430-1000its,722,710,2184.026006912,2109.283127805,12
carcassonne-uct25-vs-uct490-1000its,748,736,2218.301352269,2176.275136165,12
carcassonne-ucttuned180-vs-ucttuned5-1000its,748,736,2171.975126167,2149.012409151,12
carcassonne-ucttuned265-vs-ucttuned195-1000its,748,736,2183.875985796,2102.19010675,12
carcassonne-boltzmann475-vs-boltzmann285-1000its,750,738,2241.920364316,2214.393252752,12
carcassonne-boltzmann360-vs-boltzmann305-1000its,752,740,2164.102156984,2104.176237152,12
carcassonne-boltzmann485-vs-boltzmann165-1000its,752,740,2173.16471057,2187.888624635,12
carcassonne-boltzmann160-vs-boltzmann200-1000its,757,745,2225.951229664,2151.60720791,12
carcassonne-uct405-vs-uct375-1000its,757,745,2153.431459499,2171.237853031,12
carcassonne-ucttuned415-vs-ucttuned225-1000its,760,748,2259.248857116,2224.05029791,12
carcassonne-boltzmann170-vs-boltzmann135-1000its,761,749,2193.034965339,2143.758625095,12
carcassonne-ucttuned365-vs-ucttuned5-1000its,761,749,2189.04491142,2176.19239935,12
carcassonne-uct495-vs-uct275-1000its,766,754,2230.887590703,2206.072977641,12
carcassonne-boltzmann270-vs-boltzmann175-1000its,770,758,2277.000531164,2211.396343863,12
carcassonne-boltzmann310-vs-boltzmann230-1000its,771,759,2195.970409958,2132.291701059,12
carcassonne-ucttuned80-vs-ucttuned290-1000its,771,759,2196.821154286,2133.755733503,12
carcassonne-uct60-vs-uct165-1000its,772,760,2219.844604199,2166.29411206,12
carcassonne-ucttuned55-vs-ucttuned205-1000its,772,760,2192.796815995,2178.046449846,12
carcassonne-boltzmann30-vs-boltzmann385-1000its,773,761,2168.102112952,2141.690612935,12
carcassonne-ucttuned110-vs-ucttuned390-1000its,773,761,2178.691415141,2123.699064941,12
carcassonne-uct70-vs-uct355-1000its,775,763,2143.140744954,2102.668656803,12
carcassonne-ucttuned250-vs-ucttuned285-1000its,779,767,2240.674735566,2159.993012473,12
carcassonne-uct65-vs-uct180-1000its,781,769,2220.867975716,2177.948015252,12
carcassonne-boltzmann235-vs-boltzmann375-1000its,783,771,2173.105965299,2126.121138115,12
carcassonne-uct390-vs-uct80-1000its,783,771,2252.23191057,2221.384870634,12
carcassonne-ucttuned40-vs-ucttuned130-1000its,783,771,2185.321323737,2121.413694722,12
carcassonne-boltzmann185-vs-boltzmann310-1000its,784,772,2173.916076207,2130.77482031,12
carcassonne-boltzmann305-vs-boltzmann400-1000its,784,772,2148.738060384,2101.692823111,12
carcassonne-ucttuned325-vs-ucttuned175-1000its,785,773,2227.168249303,2213.264862348,12
carcassonne-boltzmann105-vs-boltzmann35-1000its,786,774,2140.501914153,2154.998748183,12
carcassonne-uct445-vs-uct455-1000its,786,774,2157.913544063,2166.572031857,12
carcassonne-ucttuned230-vs-ucttuned445-1000its,786,774,2181.814223284,2118.231681167,12
carcassonne-boltzmann115-vs-boltzmann465-1000its,787,775,2207.612077527,2153.991097156,12
carcassonne-uct305-vs-uct365-1000its,788,776,2156.140848136,2152.92820039,12
carcassonne-ucttuned100-vs-ucttuned150-1000its,788,776,2229.076349882,2218.299198942,12
carcassonne-boltzmann85-vs-boltzmann190-1000its,789,777,2140.380926581,2137.484880595,12
carcassonne-boltzmann410-vs-boltzmann305-1000its,790,778,2212.430000539,2190.049228978,12
carcassonne-boltzmann50-vs-boltzmann275-1000its,791,779,2208.088019603,2140.554000458,12
carcassonne-uct260-vs-uct230-1000its,792,780,2161.405949204,2150.794789407,12
carcassonne-uct300-vs-uct345-1000its,792,780,2257.235425979,2189.077285313,12
carcassonne-uct325-vs-uct365-1000its,792,780,2235.770996095,2161.015587317,12
carcassonne-uct60-vs-uct150-1000its,792,780,2191.324304329,2129.272572888,12
carcassonne-uct40-vs-uct25-1000its,794,782,2199.668210812,2137.080176005,12
carcassonne-uct225-vs-uct345-1000its,795,783,2296.899264795,2267.369941336,12
carcassonne-uct290-vs-uct255-1000its,797,785,2139.626566551,2075.105389709,12
carcassonne-boltzmann345-vs-boltzmann470-1000its,798,786,2271.622412511,2218.733545703,12
carcassonne-ucttuned175-vs-ucttuned65-1000its,799,787,2190.391050486,2196.145180108,12
carcassonne-ucttuned375-vs-ucttuned490-1000its,799,787,2163.492470119,2136.608904268,12
carcassonne-ucttuned75-vs-ucttuned180-1000its,799,787,2246.946313414,2158.586534485,12
carcassonne-uct230-vs-uct485-1000its,800,788,2205.507333838,2177.417916821,12
carcassonne-boltzmann155-vs-boltzmann340-1000its,801,789,2222.041586797,2184.28814656,12
carcassonne-uct200-vs-uct75-1000its,801,789,2143.502369246,2101.25168847,12
carcassonne-boltzmann185-vs-boltzmann455-1000its,802,790,2202.562107492,2121.226667528,12
carcassonne-uct215-vs-uct20-1000its,802,790,2139.760418548,2132.537509427,12
carcassonne-uct40-vs-uct140-1000its,803,791,2159.35552016,2109.984333695,12
carcassonne-ucttuned220-vs-ucttuned35-1000its,803,791,2189.77239656,2096.058684635,12
carcassonne-ucttuned250-vs-ucttuned140-1000its,804,792,2195.488321589,2125.759594705,12
carcassonne-ucttuned305-vs-ucttuned335-1000its,804,792,2232.20276509,2174.813447801,12
carcassonne-boltzmann300-vs-boltzmann130-1000its,805,793,2205.993986812,2139.818442799,12
carcassonne-boltzmann45-vs-boltzmann15-1000its,805,793,2180.329162547,2136.850997664,12
carcassonne-ucttuned205-vs-ucttuned440-1000its,805,793,2203.314324216,2157.165561295,12
carcassonne-ucttuned350-vs-ucttuned370-1000its,807,795,2205.072369171,2166.852709557,12
carcassonne-boltzmann40-vs-boltzmann120-1000its,810,798,2213.349045146,2209.103268897,12
carcassonne-uct230-vs-uct320-1000its,810,798,2190.298989017,2144.977277544,12
carcassonne-ucttuned255-vs-ucttuned350-1000its,810,798,2271.425935555,2209.483569818,12
carcassonne-ucttuned400-vs-ucttuned445-1000its,810,798,2233.970431202,2201.121146189,12
carcassonne-uct480-vs-uct435-1000its,811,799,2252.478758641,2156.899005251,12
carcassonne-ucttuned80-vs-ucttuned130-1000its,811,799,2203.063815372,2124.740906072,12
carcassonne-boltzmann380-vs-boltzmann495-1000its,812,800,2266.90799417,2231.190476168,12
carcassonne-boltzmann300-vs-boltzmann230-1000its,813,801,2218.104527501,2214.593115452,12
carcassonne-ucttuned90-vs-ucttuned320-1000its,814,802,2150.972612227,2094.07096106,12
carcassonne-boltzmann320-vs-boltzmann295-1000its,815,803,2238.452373927,2191.305634396,12
carcassonne-uct255-vs-uct405-1000its,815,803,2183.283583667,2104.085470685,12
carcassonne-uct285-vs-uct225-1000its,815,803,2227.740619676,2185.288617795,12
carcassonne-uct350-vs-uct430-1000its,815,803,2110.942765425,2074.214975925,12
carcassonne-ucttuned305-vs-ucttuned290-1000its,815,803,2190.235107965,2154.75183383,12
carcassonne-ucttuned415-vs-ucttuned165-1000its,815,803,2248.893798588,2134.072467839,12
carcassonne-boltzmann100-vs-boltzmann480-1000its,816,804,2200.953054466,2185.791400526,12
carcassonne-uct20-vs-uct90-1000its,816,804,2183.289227512,2117.802616453,12
carcassonne-ucttuned240-vs-ucttuned40-1000its,816,804,2164.936746253,2143.959425081,12
carcassonne-boltzmann455-vs-boltzmann115-1000its,818,806,2193.73562171,2144.093095966,12
carcassonne-boltzmann55-vs-boltzmann335-1000its,818,806,2198.212825189,2139.756875424,12
carcassonne-uct450-vs-uct15-1000its,818,806,2121.059944973,2097.561372783,12
carcassonne-ucttuned155-vs-ucttuned220-1000its,818,806,2182.782235914,2174.72086286,12
carcassonne-boltzmann470-vs-boltzmann50-1000its,819,807,2199.2873151,2129.639565315,12
carcassonne-boltzmann75-vs-boltzmann360-1000its,819,807,2213.602607992,2184.587822739,12
carcassonne-uct390-vs-uct130-1000its,819,807,2184.19098632,2170.234073403,12
carcassonne-boltzmann250-vs-boltzmann305-1000its,820,808,2203.350980283,2158.789534987,12
carcassonne-ucttuned390-vs-ucttuned140-1000its,820,808,2194.989738841,2153.29570764,12
carcassonne-boltzmann265-vs-boltzmann165-1000its,821,809,2162.995260524,2115.74431912,12
carcassonne-uct160-vs-uct370-1000its,821,809,2189.522533876,2138.202000253,12
carcassonne-uct405-vs-uct250-1000its,821,809,2239.718406463,2199.391663402,12
carcassonne-boltzmann150-vs-boltzmann155-1000its,822,810,2180.722148204,2137.258584906,12
carcassonne-uct150-vs-uct400-1000its,822,810,2176.716537875,2157.141179896,12
carcassonne-uct225-vs-uct415-1000its,822,810,2267.613955088,2251.974573431,12
carcassonne-uct205-vs-uct350-1000its,823,811,2269.802143669,2212.704826317,12
carcassonne-uct385-vs-uct415-1000its,823,811,2160.169367773,2137.776740261,12
carcassonne-ucttuned285-vs-ucttuned480-1000its,823,811,2120.794455071,2102.493466063,12
carcassonne-boltzmann460-vs-boltzmann85-1000its,825,813,2200.080027202,2134.422744061,12
carcassonne-uct160-vs-uct465-1000its,826,814,2177.112195133,2172.723234038,12
carcassonne-ucttuned415-vs-ucttuned140-1000its,826,814,2208.240543318,2181.078838168,12
carcassonne-ucttuned95-vs-ucttuned155-1000its,826,814,2145.178414704,2106.915396047,12
carcassonne-boltzmann190-vs-boltzmann240-1000its,827,815,2219.471693279,2148.089587736,12
carcassonne-uct310-vs-uct315-1000its,827,815,2238.597150344,2191.096060321,12
carcassonne-ucttuned335-vs-ucttuned120-1000its,828,816,2200.133337259,2165.951088335,12
carcassonne-boltzmann480-vs-boltzmann475-1000its,829,817,2191.417807568,2149.176477583,12
carcassonne-uct190-vs-uct300-1000its,829,817,2189.479651501,2119.056749569,12
carcassonne-uct330-vs-uct145-1000its,829,817,2145.844183491,2133.705068009,12
carcassonne-ucttuned120-vs-ucttuned285-1000its,830,818,2207.516455364,2207.735687754,12
carcassonne-uct165-vs-uct385-1000its,831,819,2290.806912044,2244.357231369,12
carcassonne-uct495-vs-uct110-1000its,831,819,2264.36165368,2206.574613708,12
carcassonne-boltzmann490-vs-boltzmann215-1000its,834,822,2155.239509623,2053.240184826,12
carcassonne-uct50-vs-uct330-1000its,835,823,2186.286375182,2170.762445762,12
carcassonne-ucttuned130-vs-ucttuned430-1000its,835,823,2353.164416327,2250.096013797,12
carcassonne-boltzmann35-vs-boltzmann40-1000its,836,824,2245.131869424,2164.11172545,12
carcassonne-ucttuned265-vs-ucttuned95-1000its,836,824,2180.034551806,2116.172892192,12
carcassonne-uct335-vs-uct490-1000its,839,827,2186.864656664,2134.247087114,12
carcassonne-boltzmann430-vs-boltzmann185-1000its,840,828,2137.385854275,2088.810819937,12
carcassonne-boltzmann85-vs-boltzmann475-1000its,840,828,2188.31152605,2106.65581746,12
carcassonne-ucttuned15-vs-ucttuned70-1000its,841,829,2155.379226786,2108.232403735,12
carcassonne-uct45-vs-uct215-1000its,843,831,2147.541815765,2119.912976103,12
carcassonne-ucttuned95-vs-ucttuned400-1000its,843,831,2134.932024905,2086.712559817,12
carcassonne-uct350-vs-uct410-1000its,844,832,2255.738798141,2191.05032716,12
carcassonne-uct485-vs-uct475-1000its,844,832,2214.99538847,2173.545986407,12
carcassonne-uct25-vs-uct320-1000its,845,833,2176.141669194,2107.518273408,12
carcassonne-ucttuned400-vs-ucttuned280-1000its,845,833,2280.585225788,2273.918810747,12
carcassonne-ucttuned485-vs-ucttuned325-1000its,845,833,2153.733177475,2113.503550269,12
carcassonne-ucttuned405-vs-ucttuned90-1000its,846,834,2244.194623361,2231.716926388,12
carcassonne-ucttuned110-vs-ucttuned355-1000its,851,839,2278.197449436,2186.908249786,12
carcassonne-ucttuned180-vs-ucttuned350-1000its,851,839,2157.07844327,2124.887580978,12
carcassonne-ucttuned265-vs-ucttuned140-1000its,851,839,2219.738620644,2197.139271555,12
carcassonne-uct240-vs-uct165-1000its,852,840,2178.586586447,2169.869662835,12
carcassonne-ucttuned125-vs-ucttuned50-1000its,852,840,2184.417619238,2181.118373285,12
carcassonne-ucttuned400-vs-ucttuned70-1000its,853,841,2224.684268134,2129.116561542,12
carcassonne-ucttuned425-vs-ucttuned230-1000its,853,841,2251.735671544,2240.277914316,12
carcassonne-boltzmann70-vs-boltzmann455-1000its,855,843,2160.546747068,2130.852968775,12
carcassonne-uct475-vs-uct275-1000its,856,844,2192.83149008,2139.530204473,12
carcassonne-boltzmann475-vs-boltzmann25-1000its,862,850,2236.224999076,2159.233456774,12
carcassonne-uct295-vs-uct255-1000its,863,851,2201.789417119,2172.638685266,12
carcassonne-ucttuned455-vs-ucttuned35-1000its,865,853,2177.346663784,2127.771001519,12
carcassonne-ucttuned145-vs-ucttuned370-1000its,866,854,2163.72870828,2078.628955707,12
carcassonne-ucttuned110-vs-ucttuned55-1000its,867,855,2215.037667354,2188.018303301,12
carcassonne-ucttuned155-vs-ucttuned295-1000its,868,856,2202.889195967,2134.142279799,12
carcassonne-boltzmann20-vs-boltzmann285-1000its,874,862,2204.18642145,2161.275736343,12
carcassonne-uct220-vs-uct425-1000its,879,867,2228.052904272,2222.367460223,12
carcassonne-boltzmann85-vs-boltzmann485-1000its,883,871,2222.686490751,2128.872852771,12
carcassonne-ucttuned460-vs-ucttuned410-1000its,884,872,2177.936665199,2161.218346647,12
carcassonne-ucttuned370-vs-ucttuned85-1000its,886,874,2239.540146952,2191.003955883,12
carcassonne-uct65-vs-uct230-1000its,896,884,2177.17488973,2138.549267122,12
carcassonne-ucttuned380-vs-ucttuned170-1000its,896,884,2197.660237918,2149.591750765,12
carcassonne-boltzmann360-vs-boltzmann260-1000its,897,885,2263.761410616,2275.303174995,12
carcassonne-uct170-vs-uct85-1000its,901,889,2189.183481806,2098.278313169,12
carcassonne-uct120-vs-uct335-1000its,906,894,2224.765466556,2124.093526587,12
carcassonne-ucttuned85-vs-ucttuned430-1000its,912,900,2198.879649308,2139.265336014,12
carcassonne-boltzmann165-vs-boltzmann115-1000its,932,920,2239.758227853,2158.282109196,12
carcassonne-ucttuned380-vs-ucttuned360-1000its,934,922,2166.101290245,2154.24274059,12
carcassonne-boltzmann150-vs-boltzmann370-1000its,957,945,2196.25830806,2173.614948828,12
carcassonne-boltzmann320-vs-boltzmann155-1000its,693,680,2124.3398717,2132.883479289,13
carcassonne-uct85-vs-uct325-1000its,721,708,2167.437016143,2124.269043073,13
carcassonne-uct460-vs-uct80-1000its,724,711,2248.387253953,2158.234626376,13
carcassonne-ucttuned410-vs-ucttuned210-1000its,730,717,2177.276361496,2115.120161596,13
carcassonne-uct210-vs-uct400-1000its,738,725,2167.122094188,2191.71865343,13
carcassonne-boltzmann280-vs-boltzmann330-1000its,740,727,2136.652661714,2106.303232158,13
carcassonne-ucttuned160-vs-ucttuned105-1000its,740,727,2169.333938452,2133.83712268,13
carcassonne-boltzmann355-vs-boltzmann360-1000its,743,730,2180.062292272,2115.206168984,13
carcassonne-ucttuned230-vs-ucttuned330-1000its,744,731,2209.563427216,2171.069604291,13
carcassonne-uct95-vs-uct430-1000its,746,733,2188.579183966,2171.727224165,13
carcassonne-boltzmann115-vs-boltzmann445-1000its,748,735,2149.75691083,2102.9154684,13
carcassonne-boltzmann185-vs-boltzmann335-1000its,750,737,2195.053915384,2166.144251692,13
carcassonne-boltzmann270-vs-boltzmann225-1000its,752,739,2243.169857709,2185.88109012,13
carcassonne-ucttuned265-vs-ucttuned475-1000its,754,741,2170.629574954,2181.490038231,13
carcassonne-ucttuned270-vs-ucttuned165-1000its,756,743,2327.194217092,2262.675651964,13
carcassonne-uct330-vs-uct385-1000its,762,749,2207.983648592,2158.399010114,13
carcassonne-ucttuned180-vs-ucttuned345-1000its,765,752,2182.016554296,2133.104001272,13
carcassonne-uct290-vs-uct225-1000its,766,753,2134.641481611,2088.327392719,13
carcassonne-uct360-vs-uct425-1000its,766,753,2257.491388429,2221.14878895,13
carcassonne-ucttuned155-vs-ucttuned330-1000its,769,756,2206.130324427,2178.171833886,13
carcassonne-boltzmann105-vs-boltzmann65-1000its,772,759,2203.735039151,2153.081716769,13
carcassonne-boltzmann180-vs-boltzmann35-1000its,772,759,2198.249061096,2186.012096562,13
carcassonne-ucttuned355-vs-ucttuned460-1000its,773,760,2133.363034065,2029.99717662,13
carcassonne-boltzmann200-vs-boltzmann385-1000its,774,761,2138.497543058,2102.93020817,13
carcassonne-uct315-vs-uct465-1000its,775,762,2206.965114813,2177.170089551,13
carcassonne-boltzmann395-vs-boltzmann215-1000its,776,763,2277.209970393,2234.078168295,13
carcassonne-uct485-vs-uct465-1000its,776,763,2227.275913142,2125.464809636,13
carcassonne-boltzmann275-vs-boltzmann95-1000its,777,764,2175.41874208,2100.293921757,13
carcassonne-boltzmann485-vs-boltzmann85-1000its,777,764,2240.210502699,2158.110845989,13
carcassonne-boltzmann320-vs-boltzmann150-1000its,779,766,2157.191482246,2134.680222431,13
carcassonne-ucttuned250-vs-ucttuned445-1000its,780,767,2243.115174094,2179.527275518,13
carcassonne-ucttuned345-vs-ucttuned420-1000its,780,767,2191.415811763,2139.852527981,13
carcassonne-boltzmann265-vs-boltzmann230-1000its,781,768,2173.780659206,2119.495463087,13
carcassonne-uct85-vs-uct495-1000its,782,769,2227.948984205,2149.085885307,13
carcassonne-boltzmann460-vs-boltzmann260-1000its,783,770,2226.548653439,2179.539258537,13
carcassonne-ucttuned325-vs-ucttuned195-1000its,784,771,2154.123946238,2144.027239041,13
carcassonne-boltzmann330-vs-boltzmann110-1000its,785,772,2229.086952819,2195.582585188,13
carcassonne-boltzmann400-vs-boltzmann180-1000its,785,772,2266.967998493,2196.963866659,13
carcassonne-boltzmann420-vs-boltzmann150-1000its,785,772,2215.691421945,2198.506751933,13
carcassonne-ucttuned105-vs-ucttuned35-1000its,785,772,2075.451765372,2057.277275318,13
carcassonne-boltzmann130-vs-boltzmann175-1000its,786,773,2222.997473528,2174.186599364,13
carcassonne-boltzmann110-vs-boltzmann130-1000its,787,774,2136.227692841,2115.653818118,13
carcassonne-uct205-vs-uct390-1000its,788,775,2207.443566868,2201.423882076,13
carcassonne-uct385-vs-uct170-1000its,788,775,2167.263426651,2151.537853916,13
carcassonne-ucttuned445-vs-ucttuned350-1000its,788,775,2183.143667411,2145.457111222,13
carcassonne-boltzmann210-vs-boltzmann255-1000its,790,777,2173.659654756,2155.835790554,13
carcassonne-uct465-vs-uct470-1000its,790,777,2221.001980038,2156.363595501,13
carcassonne-boltzmann230-vs-boltzmann210-1000its,791,778,2214.460056262,2191.816238731,13
carcassonne-boltzmann470-vs-boltzmann135-1000its,791,778,2161.566263704,2143.775898777,13
carcassonne-boltzmann310-vs-boltzmann350-1000its,792,779,2153.43840423,2091.925324518,13
carcassonne-boltzmann15-vs-boltzmann225-1000its,793,780,2155.702252939,2091.504080308,13
carcassonne-boltzmann135-vs-boltzmann470-1000its,795,782,2229.493690153,2180.708779554,13
carcassonne-uct20-vs-uct275-1000its,795,782,2194.355616986,2121.384668175,13
carcassonne-boltzmann160-vs-boltzmann345-1000its,796,783,2265.761669255,2218.268458606,13
carcassonne-uct130-vs-uct290-1000its,796,783,2201.728299074,2152.675948121,13
carcassonne-uct85-vs-uct110-1000its,796,783,2282.962367939,2227.657117274,13
carcassonne-ucttuned465-vs-ucttuned145-1000its,796,783,2164.266002577,2156.743755783,13
carcassonne-boltzmann380-vs-boltzmann455-1000its,798,785,2191.173061629,2134.920544737,13
carcassonne-uct25-vs-uct190-1000its,798,785,2218.81893871,2160.025454183,13
carcassonne-ucttuned355-vs-ucttuned10-1000its,798,785,2164.156549013,2115.973334974,13
carcassonne-boltzmann475-vs-boltzmann230-1000its,801,788,2195.67486731,2151.398124755,13
carcassonne-uct210-vs-uct375-1000its,801,788,2242.990754975,2148.014700118,13
carcassonne-boltzmann120-vs-boltzmann90-1000its,802,789,2242.198283614,2148.917022287,13
carcassonne-boltzmann255-vs-boltzmann355-1000its,802,789,2189.168889293,2168.454929863,13
carcassonne-boltzmann175-vs-boltzmann25-1000its,804,791,2182.981148475,2135.889627094,13
carcassonne-uct225-vs-uct220-1000its,804,791,2211.309847688,2157.515766831,13
carcassonne-ucttuned210-vs-ucttuned215-1000its,804,791,2259.581557653,2214.406845825,13
carcassonne-ucttuned115-vs-ucttuned45-1000its,805,792,2294.825835185,2209.636524886,13
carcassonne-boltzmann130-vs-boltzmann400-1000its,806,793,2214.966087595,2167.808953465,13
carcassonne-uct180-vs-uct440-1000its,806,793,2210.260494147,2177.889796354,13
carcassonne-uct465-vs-uct445-1000its,806,793,2324.525042948,2320.853944308,13
carcassonne-boltzmann165-vs-boltzmann490-1000its,807,794,2177.872501045,2150.242978754,13
carcassonne-boltzmann35-vs-boltzmann335-1000its,807,794,2213.892290769,2161.853260496,13
carcassonne-uct455-vs-uct415-1000its,809,796,2178.986684587,2157.582169078,13
carcassonne-boltzmann230-vs-boltzmann380-1000its,810,797,2265.286197751,2192.623404826,13
carcassonne-uct385-vs-uct350-1000its,810,797,2181.772303193,2143.813481632,13
carcassonne-ucttuned390-vs-ucttuned350-1000its,811,798,2358.520256082,2242.709804776,13
carcassonne-boltzmann220-vs-boltzmann50-1000its,812,799,2207.805551509,2161.061686677,13
carcassonne-boltzmann250-vs-boltzmann490-1000its,812,799,2170.042988266,2099.63059394,13
carcassonne-ucttuned170-vs-ucttuned260-1000its,812,799,2206.552847723,2155.671038268,13
carcassonne-uct470-vs-uct130-1000its,814,801,2190.104001156,2125.322421783,13
carcassonne-ucttuned145-vs-ucttuned40-1000its,814,801,2134.558966418,2107.593871928,13
carcassonne-uct190-vs-uct10-1000its,815,802,2174.718454604,2112.262020572,13
carcassonne-uct50-vs-uct60-1000its,815,802,2224.448418495,2193.159416704,13
carcassonne-ucttuned205-vs-ucttuned330-1000its,815,802,2251.146888548,2211.160116458,13
carcassonne-boltzmann280-vs-boltzmann380-1000its,816,803,2202.496452667,2190.123474969,13
carcassonne-boltzmann400-vs-boltzmann425-1000its,816,803,2143.564398129,2087.14642776,13
carcassonne-boltzmann85-vs-boltzmann50-1000its,816,803,2173.077374637,2096.312154982,13
carcassonne-uct25-vs-uct15-1000its,816,803,2169.073581021,2123.805187507,13
carcassonne-uct5-vs-uct345-1000its,817,804,2189.123580785,2090.420426537,13
carcassonne-ucttuned315-vs-ucttuned45-1000its,817,804,2206.346105913,2158.152682138,13
carcassonne-uct475-vs-uct375-1000its,818,805,2132.408860989,2100.663198902,13
carcassonne-boltzmann295-vs-boltzmann175-1000its,819,806,2220.151231769,2152.259426726,13
carcassonne-uct180-vs-uct275-1000its,820,807,2202.86136072,2132.495465185,13
carcassonne-ucttuned270-vs-ucttuned430-1000its,820,807,2208.410696203,2201.747484925,13
carcassonne-ucttuned80-vs-ucttuned50-1000its,821,808,2171.086515245,2151.596644366,13
carcassonne-boltzmann160-vs-boltzmann335-1000its,822,809,2199.778526342,2150.326693306,13
carcassonne-boltzmann240-vs-boltzmann95-1000its,824,811,2155.238695258,2119.300598745,13
carcassonne-ucttuned150-vs-ucttuned20-1000its,825,812,2152.859362875,2140.567920228,13
carcassonne-uct285-vs-uct95-1000its,826,813,2172.565616621,2175.826738776,13
carcassonne-uct410-vs-uct35-1000its,826,813,2170.535190291,2121.50700108,13
carcassonne-boltzmann235-vs-boltzmann10-1000its,827,814,2138.658884205,2093.439775189,13
carcassonne-uct60-vs-uct90-1000its,827,814,2259.040329051,2227.899166487,13
carcassonne-boltzmann195-vs-boltzmann100-1000its,829,816,2163.543809804,2184.928075965,13
carcassonne-ucttuned390-vs-ucttuned465-1000its,829,816,2170.277304345,2149.161521088,13
carcassonne-ucttuned360-vs-ucttuned110-1000its,831,818,2167.946347871,2110.876874991,13
carcassonne-boltzmann130-vs-boltzmann200-1000its,833,820,2204.580810449,2169.023748209,13
carcassonne-uct210-vs-uct80-1000its,833,820,2221.944411649,2182.6489697,13
carcassonne-ucttuned200-vs-ucttuned110-1000its,833,820,2151.853567102,2054.31416056,13
carcassonne-uct80-vs-uct415-1000its,834,821,2181.086945125,2117.325865238,13
carcassonne-uct160-vs-uct180-1000its,835,822,2215.264223692,2165.756407789,13
carcassonne-ucttuned375-vs-ucttuned365-1000its,835,822,2196.678423978,2127.589235118,13
carcassonne-boltzmann125-vs-boltzmann405-1000its,836,823,2136.011593204,2087.350678891,13
carcassonne-boltzmann380-vs-boltzmann305-1000its,836,823,2202.603812157,2182.144577266,13
carcassonne-uct255-vs-uct410-1000its,837,824,2232.025905867,2211.834524282,13
carcassonne-ucttuned470-vs-ucttuned95-1000its,837,824,2173.82260388,2118.385112436,13
carcassonne-boltzmann355-vs-boltzmann55-1000its,839,826,2159.727470653,2132.08259805,13
carcassonne-ucttuned375-vs-ucttuned405-1000its,840,827,2280.635030386,2243.280812998,13
carcassonne-boltzmann385-vs-boltzmann255-1000its,843,830,2123.653036588,2112.190089532,13
carcassonne-ucttuned185-vs-ucttuned415-1000its,843,830,2192.147554264,2196.998103175,13
carcassonne-boltzmann165-vs-boltzmann335-1000its,844,831,2204.873103633,2115.357792374,13
carcassonne-boltzmann265-vs-boltzmann100-1000its,844,831,2149.309631543,2155.83038812,13
carcassonne-uct225-vs-uct370-1000its,847,834,2216.483327537,2203.130714973,13
carcassonne-uct5-vs-uct115-1000its,847,834,2279.412522254,2207.141844804,13
carcassonne-ucttuned220-vs-ucttuned125-1000its,847,834,2169.727276577,2127.31758171,13
carcassonne-ucttuned475-vs-ucttuned415-1000its,847,834,2279.568503603,2232.721297606,13
carcassonne-ucttuned40-vs-ucttuned210-1000its,848,835,2247.14596092,2136.829579664,13
carcassonne-boltzmann90-vs-boltzmann195-1000its,850,837,2237.342753873,2180.598172284,13
carcassonne-uct335-vs-uct60-1000its,853,840,2270.9222211,2239.046665744,13
carcassonne-uct30-vs-uct255-1000its,854,841,2280.413054146,2180.448966423,13
carcassonne-uct420-vs-uct235-1000its,854,841,2128.996754489,2061.609106465,13
carcassonne-ucttuned185-vs-ucttuned135-1000its,854,841,2172.645047087,2155.489441845,13
carcassonne-ucttuned310-vs-ucttuned105-1000its,854,841,2348.233699816,2311.181720765,13
carcassonne-boltzmann15-vs-boltzmann325-1000its,856,843,2193.383250462,2154.323914764,13
carcassonne-uct180-vs-uct165-1000its,858,845,2132.953046305,2116.328802071,13
carcassonne-uct450-vs-uct190-1000its,858,845,2148.821179175,2131.306615074,13
carcassonne-ucttuned20-vs-ucttuned65-1000its,858,845,2165.081551956,2121.906701545,13
carcassonne-boltzmann190-vs-boltzmann20-1000its,861,848,2175.039219465,2169.032691429,13
carcassonne-boltzmann245-vs-boltzmann295-1000its,864,851,2208.283279405,2166.33015605,13
carcassonne-ucttuned30-vs-ucttuned120-1000its,864,851,2228.540669421,2155.653906067,13
carcassonne-ucttuned425-vs-ucttuned45-1000its,864,851,2179.655241568,2123.024382307,13
carcassonne-boltzmann365-vs-boltzmann465-1000its,866,853,2210.696361551,2163.343869667,13
carcassonne-uct465-vs-uct370-1000its,869,856,2183.749772421,2115.917954057,13
carcassonne-boltzmann10-vs-boltzmann20-1000its,870,857,2192.206113073,2150.28966408,13
carcassonne-uct310-vs-uct285-1000its,870,857,2127.10814021,2093.538973523,13
carcassonne-boltzmann225-vs-boltzmann85-1000its,873,860,2137.941090873,2096.732984936,13
carcassonne-uct80-vs-uct270-1000its,874,861,2139.78940011,2084.474410405,13
carcassonne-ucttuned320-vs-ucttuned5-1000its,876,863,2169.078427159,2072.05148399,13
carcassonne-ucttuned50-vs-ucttuned115-1000its,878,865,2174.352133051,2139.118435303,13
carcassonne-uct155-vs-uct20-1000its,879,866,2215.421262231,2154.120903476,13
carcassonne-ucttuned370-vs-ucttuned115-1000its,879,866,2195.988039312,2166.90259102,13
carcassonne-boltzmann255-vs-boltzmann90-1000its,880,867,2131.972016883,2105.329267239,13
carcassonne-uct245-vs-uct385-1000its,888,875,2270.612807637,2208.97652042,13
carcassonne-ucttuned200-vs-ucttuned470-1000its,890,877,2305.382822987,2227.511877766,13
carcassonne-boltzmann40-vs-boltzmann460-1000its,891,878,2238.116587726,2167.440861485,13
carcassonne-boltzmann380-vs-boltzmann265-1000its,893,880,2238.30022472,2172.478096747,13
carcassonne-ucttuned280-vs-ucttuned65-1000its,902,889,2282.831888376,2221.426172345,13
carcassonne-ucttuned245-vs-ucttuned65-1000its,914,901,2180.913762907,2131.532833495,13
carcassonne-boltzmann465-vs-boltzmann335-1000its,923,910,2236.67963192,2185.419127913,13
carcassonne-uct220-vs-uct260-1000its,707,693,2170.728867806,2112.541372494,14
carcassonne-boltzmann435-vs-boltzmann335-1000its,733,719,2227.756457591,2208.531475786,14
carcassonne-boltzmann75-vs-boltzmann330-1000its,734,720,2151.767922505,2062.392837342,14
carcassonne-boltzmann180-vs-boltzmann480-1000its,738,724,2182.104627318,2147.438526716,14
carcassonne-boltzmann390-vs-boltzmann420-1000its,743,729,2204.566846336,2157.657646959,14
carcassonne-ucttuned35-vs-ucttuned235-1000its,743,729,2239.798201065,2197.480107595,14
carcassonne-uct415-vs-uct430-1000its,748,734,2198.919404772,2154.358433103,14
carcassonne-ucttuned145-vs-ucttuned495-1000its,749,735,2168.257730056,2143.734934533,14
carcassonne-boltzmann125-vs-boltzmann110-1000its,754,740,2241.705147094,2139.995784831,14
carcassonne-boltzmann210-vs-boltzmann175-1000its,756,742,2171.549283646,2136.638764337,14
carcassonne-boltzmann335-vs-boltzmann360-1000its,756,742,2217.415164922,2181.815802851,14
carcassonne-uct175-vs-uct150-1000its,756,742,2239.717323616,2177.162665459,14
carcassonne-ucttuned115-vs-ucttuned475-1000its,757,743,2177.49928037,2121.345576011,14
carcassonne-uct350-vs-uct365-1000its,758,744,2224.007449469,2180.869699527,14
carcassonne-uct235-vs-uct450-1000its,761,747,2209.62965026,2138.473660584,14
carcassonne-ucttuned110-vs-ucttuned200-1000its,764,750,2195.430439465,2126.699278028,14
carcassonne-boltzmann190-vs-boltzmann155-1000its,765,751,2203.446756107,2177.382529484,14
carcassonne-boltzmann395-vs-boltzmann385-1000its,765,751,2202.293613672,2202.29819867,14
carcassonne-boltzmann155-vs-boltzmann210-1000its,766,752,2175.748618461,2161.147969493,14
carcassonne-ucttuned325-vs-ucttuned95-1000its,767,753,2185.477113407,2173.656511639,14
carcassonne-ucttuned480-vs-ucttuned105-1000its,767,753,2238.647284207,2209.557905654,14
carcassonne-boltzmann50-vs-boltzmann355-1000its,768,754,2225.279283914,2131.69916236,14
carcassonne-uct160-vs-uct300-1000its,769,755,2266.569365794,2195.383308536,14
carcassonne-ucttuned270-vs-ucttuned30-1000its,770,756,2200.115719607,2148.413591231,14
carcassonne-uct210-vs-uct120-1000its,771,757,2162.709121744,2124.806809577,14
carcassonne-uct255-vs-uct470-1000its,772,758,2253.006767752,2169.57470345,14
carcassonne-ucttuned450-vs-ucttuned70-1000its,777,763,2195.824095718,2169.365065539,14
carcassonne-uct190-vs-uct470-1000its,779,765,2238.87719891,2223.592277413,14
carcassonne-boltzmann145-vs-boltzmann485-1000its,781,767,2180.609084079,2110.702479455,14
carcassonne-boltzmann365-vs-boltzmann410-1000its,781,767,2247.027899714,2206.250842216,14
carcassonne-boltzmann405-vs-boltzmann150-1000its,783,769,2176.483053397,2135.853462108,14
carcassonne-uct255-vs-uct85-1000its,783,769,2181.758684117,2119.736009849,14
carcassonne-uct405-vs-uct190-1000its,783,769,2213.14356263,2165.173634333,14
carcassonne-boltzmann495-vs-boltzmann25-1000its,784,770,2173.532078391,2124.400793846,14
carcassonne-boltzmann60-vs-boltzmann275-1000its,784,770,2167.588528548,2140.642934273,14
carcassonne-uct195-vs-uct150-1000its,785,771,2202.207721827,2168.726519854,14
carcassonne-uct280-vs-uct415-1000its,785,771,2268.7736603,2196.628733364,14
carcassonne-uct455-vs-uct235-1000its,785,771,2199.530080324,2158.45112909,14
carcassonne-ucttuned350-vs-ucttuned195-1000its,787,773,2203.286442626,2173.156244352,14
carcassonne-boltzmann240-vs-boltzmann220-1000its,789,775,2158.368731961,2114.619467688,14
carcassonne-boltzmann445-vs-boltzmann255-1000its,789,775,2257.968605045,2235.975752962,14
carcassonne-ucttuned70-vs-ucttuned295-1000its,789,775,2177.764053848,2074.588633578,14
carcassonne-ucttuned85-vs-ucttuned90-1000its,791,777,2300.170406009,2230.273332617,14
carcassonne-boltzmann455-vs-boltzmann445-1000its,793,779,2231.685575721,2143.653430672,14
carcassonne-ucttuned360-vs-ucttuned215-1000its,793,779,2159.379775764,2138.322231861,14
carcassonne-boltzmann120-vs-boltzmann105-1000its,794,780,2182.220923488,2115.976086112,14
carcassonne-boltzmann55-vs-boltzmann430-1000its,794,780,2159.347502956,2109.612758699,14
carcassonne-ucttuned10-vs-ucttuned360-1000its,794,780,2302.043807025,2262.558947342,14
carcassonne-ucttuned165-vs-ucttuned110-1000its,794,780,2212.643628222,2169.901526693,14
carcassonne-ucttuned445-vs-ucttuned435-1000its,794,780,2244.336048462,2163.941406217,14
carcassonne-ucttuned55-vs-ucttuned100-1000its,794,780,2183.459843005,2118.529936796,14
carcassonne-uct55-vs-uct5-1000its,795,781,2133.841524237,2070.410770841,14
carcassonne-uct415-vs-uct435-1000its,797,783,2204.219713091,2186.61627332,14
carcassonne-boltzmann150-vs-boltzmann340-1000its,798,784,2187.487075444,2152.736399083,14
carcassonne-boltzmann445-vs-boltzmann490-1000its,798,784,2247.16355153,2204.771214878,14
carcassonne-uct260-vs-uct60-1000its,798,784,2158.601720787,2125.609859673,14
carcassonne-ucttuned20-vs-ucttuned425-1000its,798,784,2197.617042963,2126.013778908,14
carcassonne-ucttuned30-vs-ucttuned280-1000its,798,784,2123.350872548,2100.198826742,14
carcassonne-uct450-vs-uct120-1000its,799,785,2157.741919864,2106.805899945,14
carcassonne-boltzmann110-vs-boltzmann415-1000its,800,786,2222.572931924,2176.627814452,14
carcassonne-uct210-vs-uct425-1000its,800,786,2145.120464993,2080.351484732,14
carcassonne-uct465-vs-uct400-1000its,800,786,2202.774598699,2161.777897829,14
carcassonne-ucttuned230-vs-ucttuned310-1000its,800,786,2224.611788555,2156.572161378,14
carcassonne-uct55-vs-uct265-1000its,801,787,2203.103319325,2160.799922065,14
carcassonne-ucttuned345-vs-ucttuned145-1000its,801,787,2242.820569642,2237.234606413,14
carcassonne-boltzmann230-vs-boltzmann455-1000its,802,788,2264.133570528,2207.831407867,14
carcassonne-ucttuned170-vs-ucttuned40-1000its,803,789,2242.603616403,2210.612286402,14
carcassonne-ucttuned360-vs-ucttuned430-1000its,803,789,2133.982541026,2079.749014115,14
carcassonne-ucttuned475-vs-ucttuned410-1000its,803,789,2228.766401615,2165.07268455,14
carcassonne-boltzmann35-vs-boltzmann170-1000its,804,790,2181.422340888,2134.71038472,14
carcassonne-boltzmann380-vs-boltzmann115-1000its,804,790,2200.468533582,2101.884654708,14
carcassonne-boltzmann400-vs-boltzmann265-1000its,805,791,2217.49973583,2144.848565421,14
carcassonne-boltzmann70-vs-boltzmann405-1000its,805,791,2246.634352937,2171.581044986,14
carcassonne-ucttuned470-vs-ucttuned70-1000its,805,791,2217.179466699,2191.721754218,14
carcassonne-boltzmann315-vs-boltzmann50-1000its,806,792,2238.836426436,2155.146785622,14
carcassonne-uct440-vs-uct40-1000its,806,792,2276.257659238,2219.607733368,14
carcassonne-ucttuned230-vs-ucttuned115-1000its,806,792,2173.715474143,2127.22617913,14
carcassonne-boltzmann160-vs-boltzmann90-1000its,808,794,2183.791409525,2160.176944846,14
carcassonne-boltzmann335-vs-boltzmann110-1000its,808,794,2208.502217448,2118.565481366,14
carcassonne-ucttuned250-vs-ucttuned115-1000its,808,794,2215.768217495,2155.50597127,14
carcassonne-boltzmann105-vs-boltzmann5-1000its,809,795,2133.099662014,2149.864239903,14
carcassonne-uct455-vs-uct370-1000its,812,798,2233.295862714,2185.345136467,14
carcassonne-boltzmann250-vs-boltzmann300-1000its,813,799,2261.224206502,2206.225656863,14
carcassonne-boltzmann45-vs-boltzmann120-1000its,813,799,2227.672964343,2195.293758543,14
carcassonne-ucttuned300-vs-ucttuned200-1000its,814,800,2167.46569485,2125.660697885,14
carcassonne-ucttuned355-vs-ucttuned285-1000its,814,800,2200.195793566,2152.156464313,14
carcassonne-boltzmann65-vs-boltzmann45-1000its,816,802,2174.829162025,2148.448435662,14
carcassonne-uct310-vs-uct50-1000its,816,802,2145.157318449,2100.393543631,14
carcassonne-boltzmann255-vs-boltzmann160-1000its,817,803,2194.092373773,2155.37422915,14
carcassonne-uct260-vs-uct50-1000its,817,803,2207.290476272,2174.267327163,14
carcassonne-boltzmann110-vs-boltzmann65-1000its,818,804,2149.922897287,2116.593963689,14
carcassonne-ucttuned215-vs-ucttuned90-1000its,818,804,2137.430845124,2128.24323979,14
carcassonne-boltzmann320-vs-boltzmann270-1000its,819,805,2208.342331565,2139.61624871,14
carcassonne-boltzmann375-vs-boltzmann300-1000its,819,805,2149.833062982,2116.329720093,14
carcassonne-boltzmann480-vs-boltzmann360-1000its,819,805,2277.811962146,2178.595106992,14
carcassonne-boltzmann135-vs-boltzmann245-1000its,820,806,2208.226488368,2200.483122623,14
carcassonne-ucttuned120-vs-ucttuned480-1000its,820,806,2111.964622964,2115.018193041,14
carcassonne-boltzmann180-vs-boltzmann145-1000its,821,807,2244.214728291,2209.029209212,14
carcassonne-uct280-vs-uct90-1000its,821,807,2265.903882412,2208.08135775,14
carcassonne-boltzmann330-vs-boltzmann470-1000its,822,808,2168.024909867,2134.298036252,14
carcassonne-ucttuned105-vs-ucttuned355-1000its,822,808,2189.950978463,2134.756792012,14
carcassonne-ucttuned160-vs-ucttuned275-1000its,822,808,2211.057736979,2173.666946611,14
carcassonne-uct135-vs-uct330-1000its,824,810,2131.170869474,2076.669898529,14
carcassonne-ucttuned475-vs-ucttuned80-1000its,825,811,2165.458812382,2102.117588727,14
carcassonne-ucttuned495-vs-ucttuned430-1000its,825,811,2194.670883903,2174.572687017,14
carcassonne-uct360-vs-uct310-1000its,826,812,2196.649559013,2177.673406226,14
carcassonne-uct485-vs-uct25-1000its,827,813,2140.208021743,2098.790757485,14
carcassonne-boltzmann100-vs-boltzmann325-1000its,828,814,2199.95155604,2109.573461059,14
carcassonne-ucttuned60-vs-ucttuned250-1000its,828,814,2153.609385885,2110.228680091,14
carcassonne-boltzmann470-vs-boltzmann370-1000its,829,815,2156.267267845,2121.746111729,14
carcassonne-boltzmann400-vs-boltzmann125-1000its,831,817,2207.932539109,2175.025544202,14
carcassonne-ucttuned110-vs-ucttuned300-1000its,831,817,2216.110607426,2221.707967523,14
carcassonne-ucttuned120-vs-ucttuned300-1000its,831,817,2221.141865184,2180.829151964,14
carcassonne-ucttuned390-vs-ucttuned165-1000its,831,817,2121.00927412,2082.031511115,14
carcassonne-boltzmann455-vs-boltzmann285-1000its,833,819,2229.331928553,2169.791326622,14
carcassonne-uct205-vs-uct110-1000its,835,821,2173.912766458,2145.637052095,14
carcassonne-uct300-vs-uct285-1000its,835,821,2195.724857735,2191.408806945,14
carcassonne-uct310-vs-uct390-1000its,835,821,2152.833640374,2126.923342207,14
carcassonne-ucttuned400-vs-ucttuned485-1000its,835,821,2224.689750444,2207.555487213,14
carcassonne-boltzmann295-vs-boltzmann440-1000its,837,823,2207.531773606,2194.752898086,14
carcassonne-boltzmann120-vs-boltzmann370-1000its,838,824,2179.28211765,2125.419221329,14
carcassonne-boltzmann345-vs-boltzmann285-1000its,838,824,2209.91350826,2161.067905717,14
carcassonne-ucttuned65-vs-ucttuned445-1000its,839,825,2242.772849064,2204.697204395,14
carcassonne-boltzmann425-vs-boltzmann55-1000its,842,828,2175.570727977,2114.304948501,14
carcassonne-boltzmann355-vs-boltzmann220-1000its,845,831,2247.53065917,2191.304694591,14
carcassonne-ucttuned455-vs-ucttuned375-1000its,845,831,2188.505364677,2166.920771918,14
carcassonne-boltzmann255-vs-boltzmann345-1000its,846,832,2163.484906073,2121.113773139,14
carcassonne-boltzmann395-vs-boltzmann55-1000its,846,832,2169.593574134,2106.685053048,14
carcassonne-boltzmann270-vs-boltzmann485-1000its,849,835,2198.223035425,2126.953290652,14
carcassonne-boltzmann40-vs-boltzmann480-1000its,849,835,2279.456986609,2204.637193924,14
carcassonne-uct260-vs-uct470-1000its,849,835,2274.505957182,2252.298598006,14
carcassonne-uct295-vs-uct50-1000its,851,837,2197.361730189,2182.259778361,14
carcassonne-ucttuned110-vs-ucttuned155-1000its,851,837,2221.732916324,2180.792172155,14
carcassonne-boltzmann485-vs-boltzmann430-1000its,852,838,2141.647479875,2087.695682279,14
carcassonne-uct425-vs-uct470-1000its,852,838,2171.627395467,2130.101470206,14
carcassonne-ucttuned155-vs-ucttuned65-1000its,852,838,2229.728149371,2192.815132107,14
carcassonne-ucttuned245-vs-ucttuned110-1000its,852,838,2164.592066448,2123.214910486,14
carcassonne-ucttuned340-vs-ucttuned375-1000its,852,838,2227.267479251,2155.505489787,14
carcassonne-ucttuned460-vs-ucttuned20-1000its,853,839,2230.794025189,2197.166599161,14
carcassonne-boltzmann25-vs-boltzmann470-1000its,854,840,2139.200748508,2119.231427509,14
carcassonne-boltzmann190-vs-boltzmann350-1000its,855,841,2161.009957153,2160.782207707,14
carcassonne-uct320-vs-uct15-1000its,855,841,2184.443085015,2138.214990643,14
carcassonne-uct495-vs-uct475-1000its,856,842,2171.156938699,2152.483347603,14
carcassonne-boltzmann80-vs-boltzmann70-1000its,859,845,2278.436669955,2196.568484343,14
carcassonne-boltzmann200-vs-boltzmann365-1000its,860,846,2219.074662132,2170.016761051,14
carcassonne-boltzmann150-vs-boltzmann390-1000its,862,848,2174.967753251,2122.958438896,14
carcassonne-ucttuned230-vs-ucttuned395-1000its,862,848,2169.088452797,2138.465687169,14
carcassonne-ucttuned95-vs-ucttuned440-1000its,862,848,2172.651616199,2123.759646467,14
carcassonne-uct80-vs-uct145-1000its,863,849,2201.435694666,2133.173233796,14
carcassonne-uct175-vs-uct160-1000its,864,850,2149.409809506,2125.188028969,14
carcassonne-ucttuned485-vs-ucttuned495-1000its,865,851,2208.345059551,2171.858970292,14
carcassonne-ucttuned420-vs-ucttuned490-1000its,867,853,2140.114907214,2114.228779462,14
carcassonne-uct335-vs-uct435-1000its,868,854,2186.855138045,2154.235768201,14
carcassonne-uct100-vs-uct475-1000its,869,855,2207.775978333,2155.174471601,14
carcassonne-uct65-vs-uct405-1000its,869,855,2189.594168402,2135.69283402,14
carcassonne-ucttuned40-vs-ucttuned15-1000its,870,856,2183.717628014,2099.369919055,14
carcassonne-ucttuned50-vs-ucttuned235-1000its,871,857,2220.861005268,2174.431120422,14
carcassonne-boltzmann315-vs-boltzmann340-1000its,872,858,2217.096761135,2198.366878463,14
carcassonne-uct490-vs-uct330-1000its,872,858,2181.624517081,2142.408970876,14
carcassonne-ucttuned40-vs-ucttuned260-1000its,872,858,2194.201322614,2181.830459216,14
carcassonne-ucttuned70-vs-ucttuned225-1000its,872,858,2207.347891514,2149.999560703,14
carcassonne-uct375-vs-uct385-1000its,875,861,2183.951597359,2132.586486589,14
carcassonne-boltzmann190-vs-boltzmann200-1000its,876,862,2217.174172723,2133.975048605,14
carcassonne-uct420-vs-uct60-1000its,877,863,2144.708431103,2129.026721924,14
carcassonne-ucttuned55-vs-ucttuned45-1000its,877,863,2165.653410612,2113.047692787,14
carcassonne-uct175-vs-uct285-1000its,882,868,2161.953044273,2128.035555387,14
carcassonne-ucttuned215-vs-ucttuned80-1000its,889,875,2189.685372509,2144.945981302,14
carcassonne-boltzmann230-vs-boltzmann90-1000its,891,877,2207.506292731,2157.81110671,14
carcassonne-uct140-vs-uct15-1000its,892,878,2234.15723029,2179.353439619,14
carcassonne-ucttuned330-vs-ucttuned80-1000its,898,884,2158.780441701,2117.001343514,14
carcassonne-ucttuned155-vs-ucttuned75-1000its,929,915,2221.011927526,2209.933863056,14
carcassonne-boltzmann30-vs-boltzmann330-1000its,745,730,2227.234053153,2177.030288906,15
carcassonne-ucttuned345-vs-ucttuned270-1000its,758,743,2209.363108625,2177.221916826,15
carcassonne-boltzmann415-vs-boltzmann275-1000its,762,747,2203.981338779,2151.839747011,15
carcassonne-boltzmann175-vs-boltzmann465-1000its,764,749,2236.445199989,2166.373220442,15
carcassonne-ucttuned210-vs-ucttuned330-1000its,764,749,2170.727431747,2130.76005435,15
carcassonne-uct380-vs-uct330-1000its,765,750,2212.487559195,2159.139752322,15
carcassonne-uct350-vs-uct360-1000its,766,751,2193.337251721,2132.293666804,15
carcassonne-uct460-vs-uct410-1000its,766,751,2260.4104326,2184.034632772,15
carcassonne-uct230-vs-uct180-1000its,767,752,2244.493997802,2163.03901433,15
carcassonne-ucttuned90-vs-ucttuned445-1000its,768,753,2167.495299195,2152.59140611,15
carcassonne-boltzmann420-vs-boltzmann370-1000its,770,755,2152.572093397,2117.789577392,15
carcassonne-boltzmann200-vs-boltzmann95-1000its,774,759,2122.300601904,2135.392099202,15
carcassonne-uct215-vs-uct355-1000its,774,759,2229.980636086,2206.53318127,15
carcassonne-ucttuned400-vs-ucttuned155-1000its,774,759,2171.321992315,2143.081718556,15
carcassonne-boltzmann125-vs-boltzmann275-1000its,777,762,2215.309252569,2164.391456455,15
carcassonne-boltzmann85-vs-boltzmann205-1000its,778,763,2190.127037226,2182.144778016,15
carcassonne-uct35-vs-uct360-1000its,778,763,2144.569723082,2115.227830622,15
carcassonne-boltzmann190-vs-boltzmann90-1000its,779,764,2231.021978966,2174.3530864,15
carcassonne-uct225-vs-uct395-1000its,780,765,2230.344707568,2147.196942871,15
carcassonne-boltzmann75-vs-boltzmann390-1000its,782,767,2167.140657347,2138.608395737,15
carcassonne-uct465-vs-uct150-1000its,782,767,2248.655526608,2217.043359569,15
carcassonne-boltzmann150-vs-boltzmann135-1000its,783,768,2232.131334176,2205.798418009,15
carcassonne-uct395-vs-uct290-1000its,783,768,2177.91120002,2136.025248651,15
carcassonne-uct135-vs-uct320-1000its,784,769,2229.894285253,2172.274510579,15
carcassonne-ucttuned470-vs-ucttuned265-1000its,785,770,2242.142681878,2186.451020102,15
carcassonne-boltzmann110-vs-boltzmann310-1000its,786,771,2195.780411632,2165.854364993,15
carcassonne-boltzmann55-vs-boltzmann490-1000its,787,772,2171.204384713,2104.215182031,15
carcassonne-boltzmann465-vs-boltzmann275-1000its,789,774,2196.832179093,2135.266772374,15
carcassonne-boltzmann60-vs-boltzmann410-1000its,789,774,2214.146048753,2149.373009163,15
carcassonne-boltzmann85-vs-boltzmann435-1000its,789,774,2208.796063229,2140.600620837,15
carcassonne-uct90-vs-uct15-1000its,789,774,2283.812147262,2244.700165073,15
carcassonne-boltzmann395-vs-boltzmann380-1000its,791,776,2297.532496157,2268.578616097,15
carcassonne-boltzmann435-vs-boltzmann300-1000its,791,776,2223.715350814,2191.985160781,15
carcassonne-boltzmann435-vs-boltzmann445-1000its,791,776,2269.609625849,2247.06348595,15
carcassonne-uct485-vs-uct400-1000its,791,776,2206.386302188,2196.299513056,15
carcassonne-boltzmann35-vs-boltzmann420-1000its,792,777,2142.522497771,2105.215301254,15
carcassonne-boltzmann435-vs-boltzmann195-1000its,792,777,2247.129522763,2197.665163025,15
carcassonne-uct80-vs-uct70-1000its,792,777,2201.728164659,2152.670545592,15
carcassonne-ucttuned375-vs-ucttuned440-1000its,792,777,2207.503388624,2215.523227511,15
carcassonne-boltzmann145-vs-boltzmann245-1000its,793,778,2207.571283315,2157.893322708,15
carcassonne-uct245-vs-uct375-1000its,794,779,2221.250225048,2167.142521232,15
carcassonne-ucttuned5-vs-ucttuned185-1000its,795,780,2148.137701575,2123.371896007,15
carcassonne-boltzmann415-vs-boltzmann125-1000its,796,781,2203.288441756,2147.441268224,15
carcassonne-ucttuned120-vs-ucttuned145-1000its,796,781,2147.739649005,2102.914590333,15
carcassonne-ucttuned470-vs-ucttuned215-1000its,796,781,2199.233279532,2172.0869075,15
carcassonne-boltzmann315-vs-boltzmann55-1000its,797,782,2151.200582788,2096.996104798,15
carcassonne-boltzmann410-vs-boltzmann260-1000its,797,782,2217.646095144,2169.124589407,15
carcassonne-uct265-vs-uct145-1000its,797,782,2167.973967973,2114.76777444,15
carcassonne-ucttuned305-vs-ucttuned155-1000its,797,782,2226.819586696,2182.197324364,15
carcassonne-ucttuned400-vs-ucttuned220-1000its,797,782,2192.844782304,2136.054374761,15
carcassonne-uct100-vs-uct180-1000its,799,784,2212.754134023,2146.51993372,15
carcassonne-uct20-vs-uct440-1000its,800,785,2129.291967634,2126.230246574,15
carcassonne-ucttuned285-vs-ucttuned435-1000its,800,785,2197.920800178,2170.803514986,15
carcassonne-boltzmann155-vs-boltzmann465-1000its,801,786,2131.63284735,2122.256678665,15
carcassonne-ucttuned375-vs-ucttuned450-1000its,801,786,2250.466879034,2211.036780148,15
carcassonne-ucttuned410-vs-ucttuned120-1000its,801,786,2160.814751638,2088.611250918,15
carcassonne-ucttuned255-vs-ucttuned215-1000its,802,787,2187.894211275,2136.029077447,15
carcassonne-ucttuned280-vs-ucttuned390-1000its,802,787,2179.428335583,2129.004981027,15
carcassonne-ucttuned445-vs-ucttuned375-1000its,802,787,2172.474817221,2164.779560737,15
carcassonne-boltzmann100-vs-boltzmann285-1000its,805,790,2131.032851839,2106.760227892,15
carcassonne-uct85-vs-uct175-1000its,805,790,2239.184878424,2192.355565182,15
carcassonne-boltzmann415-vs-boltzmann335-1000its,807,792,2218.049888754,2175.428390548,15
carcassonne-ucttuned260-vs-ucttuned490-1000its,807,792,2179.808634624,2146.44816867,15
carcassonne-boltzmann60-vs-boltzmann155-1000its,808,793,2196.932393495,2166.12106016,15
carcassonne-uct210-vs-uct145-1000its,808,793,2227.310404725,2145.431147841,15
carcassonne-uct345-vs-uct325-1000its,808,793,2137.16376767,2110.013009198,15
carcassonne-uct45-vs-uct180-1000its,808,793,2209.469682744,2162.711057298,15
carcassonne-ucttuned365-vs-ucttuned475-1000its,808,793,2231.963888618,2202.066746073,15
carcassonne-uct390-vs-uct120-1000its,810,795,2305.629263722,2250.465860879,15
carcassonne-ucttuned105-vs-ucttuned420-1000its,810,795,2183.706969341,2152.266062251,15
carcassonne-ucttuned60-vs-ucttuned55-1000its,810,795,2192.961386733,2173.350979488,15
carcassonne-boltzmann125-vs-boltzmann50-1000its,811,796,2159.391370813,2129.957896185,15
carcassonne-boltzmann400-vs-boltzmann410-1000its,811,796,2192.227091404,2107.245377973,15
carcassonne-uct465-vs-uct475-1000its,811,796,2225.01168623,2193.477298616,15
carcassonne-uct230-vs-uct265-1000its,813,798,2233.897426809,2171.695795483,15
carcassonne-ucttuned335-vs-ucttuned145-1000its,813,798,2175.496592994,2153.802524577,15
carcassonne-uct105-vs-uct475-1000its,814,799,2197.985317362,2167.987428315,15
carcassonne-uct445-vs-uct140-1000its,814,799,2222.923503565,2127.010074968,15
carcassonne-uct160-vs-uct265-1000its,815,800,2274.126191649,2255.7750766,15
carcassonne-boltzmann195-vs-boltzmann470-1000its,816,801,2274.03421092,2179.310720036,15
carcassonne-ucttuned130-vs-ucttuned345-1000its,816,801,2191.221988578,2181.067124884,15
carcassonne-ucttuned255-vs-ucttuned50-1000its,816,801,2195.834847526,2174.053543239,15
carcassonne-uct335-vs-uct65-1000its,817,802,2254.31105901,2236.21964631,15
carcassonne-ucttuned230-vs-ucttuned315-1000its,818,803,2210.773690782,2117.283872912,15
carcassonne-ucttuned40-vs-ucttuned455-1000its,818,803,2153.110013184,2090.044622043,15
carcassonne-uct55-vs-uct355-1000its,819,804,2218.205621216,2217.052094178,15
carcassonne-ucttuned360-vs-ucttuned165-1000its,819,804,2189.801822932,2157.182829248,15
carcassonne-ucttuned245-vs-ucttuned305-1000its,820,805,2209.101517631,2166.959191396,15
carcassonne-ucttuned400-vs-ucttuned330-1000its,820,805,2160.571592996,2125.2604429,15
carcassonne-boltzmann225-vs-boltzmann175-1000its,821,806,2177.150074122,2084.157671581,15
carcassonne-uct485-vs-uct470-1000its,821,806,2261.538608409,2198.608591201,15
carcassonne-boltzmann25-vs-boltzmann460-1000its,822,807,2201.899066797,2151.061297756,15
carcassonne-uct480-vs-uct360-1000its,824,809,2222.818350492,2212.535941808,15
carcassonne-boltzmann275-vs-boltzmann200-1000its,825,810,2242.176276318,2245.901086329,15
carcassonne-boltzmann400-vs-boltzmann395-1000its,825,810,2154.99794102,2141.444760656,15
carcassonne-uct105-vs-uct485-1000its,825,810,2282.804853064,2208.701446048,15
carcassonne-uct115-vs-uct275-1000its,825,810,2172.495741686,2142.508387075,15
carcassonne-ucttuned270-vs-ucttuned440-1000its,826,811,2172.652151546,2155.282401284,15
carcassonne-ucttuned55-vs-ucttuned35-1000its,826,811,2291.197025033,2289.798535361,15
carcassonne-uct80-vs-uct175-1000its,827,812,2259.576767917,2202.54467766,15
carcassonne-ucttuned215-vs-ucttuned230-1000its,827,812,2249.391590288,2200.951501329,15
carcassonne-ucttuned330-vs-ucttuned200-1000its,827,812,2190.646767276,2190.159031593,15
carcassonne-boltzmann430-vs-boltzmann75-1000its,828,813,2196.656380436,2163.026507063,15
carcassonne-ucttuned110-vs-ucttuned5-1000its,828,813,2244.376361098,2192.43408176,15
carcassonne-boltzmann135-vs-boltzmann80-1000its,830,815,2201.082464948,2145.971244797,15
carcassonne-uct90-vs-uct130-1000its,830,815,2202.051759261,2182.710567481,15
carcassonne-ucttuned345-vs-ucttuned215-1000its,831,816,2162.987574157,2084.314440962,15
carcassonne-boltzmann235-vs-boltzmann205-1000its,833,818,2162.04408453,2140.63067963,15
carcassonne-uct385-vs-uct110-1000its,833,818,2192.023963577,2171.464637922,15
carcassonne-ucttuned155-vs-ucttuned165-1000its,835,820,2277.412882037,2216.476986322,15
carcassonne-ucttuned155-vs-ucttuned185-1000its,835,820,2246.188961107,2209.304294198,15
carcassonne-uct350-vs-uct340-1000its,837,822,2206.953070245,2181.917128333,15
carcassonne-uct225-vs-uct355-1000its,838,823,2190.995588765,2123.683487764,15
carcassonne-boltzmann280-vs-boltzmann245-1000its,841,826,2175.496605071,2150.442783055,15
carcassonne-ucttuned90-vs-ucttuned370-1000its,841,826,2248.967990287,2210.089873274,15
carcassonne-ucttuned480-vs-ucttuned330-1000its,844,829,2169.797844067,2113.453277907,15
carcassonne-uct100-vs-uct185-1000its,845,830,2144.316763036,2105.295862492,15
carcassonne-uct140-vs-uct270-1000its,846,831,2226.221804268,2211.299014647,15
carcassonne-ucttuned240-vs-ucttuned80-1000its,846,831,2237.732717891,2144.859705641,15
carcassonne-uct50-vs-uct255-1000its,847,832,2198.63448229,2157.398493328,15
carcassonne-boltzmann90-vs-boltzmann190-1000its,848,833,2202.206465227,2136.590950754,15
carcassonne-boltzmann35-vs-boltzmann455-1000its,849,834,2214.193199423,2176.694361931,15
carcassonne-ucttuned30-vs-ucttuned255-1000its,849,834,2203.866248995,2181.328646484,15
carcassonne-ucttuned25-vs-ucttuned15-1000its,850,835,2232.525358023,2184.860350839,15
carcassonne-boltzmann210-vs-boltzmann15-1000its,851,836,2181.040842338,2134.907572929,15
carcassonne-uct205-vs-uct375-1000its,851,836,2140.526213048,2109.537246505,15
carcassonne-uct365-vs-uct270-1000its,851,836,2177.549609542,2117.865923189,15
carcassonne-boltzmann60-vs-boltzmann120-1000its,852,837,2148.953921425,2116.833570659,15
carcassonne-ucttuned370-vs-ucttuned15-1000its,852,837,2162.74953987,2161.82941263,15
carcassonne-boltzmann420-vs-boltzmann355-1000its,854,839,2196.738314428,2179.192928578,15
carcassonne-boltzmann440-vs-boltzmann40-1000its,855,840,2181.186608743,2126.272918153,15
carcassonne-ucttuned405-vs-ucttuned290-1000its,855,840,2241.095345307,2167.35245452,15
carcassonne-boltzmann30-vs-boltzmann360-1000its,856,841,2182.118018125,2140.993188591,15
carcassonne-ucttuned445-vs-ucttuned155-1000its,856,841,2216.902625075,2166.40061927,15
carcassonne-ucttuned330-vs-ucttuned260-1000its,857,842,2219.905970201,2184.388237102,15
carcassonne-ucttuned60-vs-ucttuned475-1000its,857,842,2215.433343396,2200.776539687,15
carcassonne-boltzmann60-vs-boltzmann280-1000its,862,847,2198.619416626,2156.691349715,15
carcassonne-boltzmann470-vs-boltzmann415-1000its,863,848,2239.662341935,2192.037223484,15
carcassonne-uct20-vs-uct220-1000its,866,851,2208.181150172,2140.033082992,15
carcassonne-uct380-vs-uct95-1000its,866,851,2282.920428806,2222.775979536,15
carcassonne-uct435-vs-uct380-1000its,869,854,2173.55479523,2134.662819933,15
carcassonne-ucttuned10-vs-ucttuned135-1000its,869,854,2192.46591078,2090.603959201,15
carcassonne-boltzmann210-vs-boltzmann80-1000its,870,855,2146.10551416,2108.401639437,15
carcassonne-uct185-vs-uct395-1000its,870,855,2176.685842916,2147.922157464,15
carcassonne-uct490-vs-uct440-1000its,871,856,2153.934918697,2175.401635237,15
carcassonne-ucttuned300-vs-ucttuned310-1000its,871,856,2179.40186194,2144.474533512,15
carcassonne-uct230-vs-uct65-1000its,872,857,2193.660974699,2123.740873975,15
carcassonne-uct175-vs-uct15-1000its,873,858,2210.911409359,2150.811650689,15
carcassonne-ucttuned485-vs-ucttuned85-1000its,873,858,2175.520842753,2128.312948051,15
carcassonne-boltzmann90-vs-boltzmann460-1000its,886,871,2229.704106016,2165.077159005,15
carcassonne-ucttuned425-vs-ucttuned285-1000its,887,872,2203.777996799,2163.145743046,15
carcassonne-ucttuned455-vs-ucttuned210-1000its,890,875,2207.14637825,2176.377276646,15
carcassonne-ucttuned90-vs-ucttuned235-1000its,890,875,2282.389702495,2200.273850966,15
carcassonne-ucttuned245-vs-ucttuned175-1000its,896,881,2204.938579504,2193.41659652,15
carcassonne-ucttuned465-vs-ucttuned235-1000its,896,881,2178.661531019,2148.676026554,15
carcassonne-ucttuned450-vs-ucttuned475-1000its,898,883,2279.331344868,2205.030044133,15
carcassonne-ucttuned165-vs-ucttuned465-1000its,901,886,2196.528429522,2171.737883853,15
carcassonne-boltzmann300-vs-boltzmann395-1000its,903,888,2257.337430075,2227.127349378,15
carcassonne-ucttuned440-vs-ucttuned245-1000its,904,889,2235.747433264,2194.604832983,15
carcassonne-ucttuned225-vs-ucttuned280-1000its,917,902,2179.385371692,2116.437375253,15
carcassonne-ucttuned315-vs-ucttuned110-1000its,926,911,2146.788612394,2101.540554293,15
carcassonne-ucttuned420-vs-ucttuned85-1000its,612,596,1712.342525677,1673.19322903,16
carcassonne-boltzmann130-vs-boltzmann185-1000its,723,707,2192.878015172,2119.370235137,16
carcassonne-boltzmann80-vs-boltzmann395-1000its,736,720,2183.825356775,2102.111615686,16
carcassonne-boltzmann85-vs-boltzmann465-1000its,740,724,2182.564781059,2103.297179976,16
carcassonne-boltzmann95-vs-boltzmann260-1000its,752,736,2153.364338261,2159.667632712,16
carcassonne-ucttuned345-vs-ucttuned155-1000its,752,736,2267.29784408,2184.567624136,16
carcassonne-boltzmann185-vs-boltzmann330-1000its,756,740,2142.982445183,2099.16914577,16
carcassonne-boltzmann460-vs-boltzmann190-1000its,759,743,2249.435870966,2191.907497596,16
carcassonne-uct365-vs-uct245-1000its,759,743,2243.789720905,2211.283627576,16
carcassonne-ucttuned225-vs-ucttuned250-1000its,761,745,2261.03266067,2241.291622414,16
carcassonne-uct185-vs-uct370-1000its,763,747,2242.680672527,2215.180394999,16
carcassonne-uct465-vs-uct115-1000its,768,752,2136.554651638,2091.203022822,16
carcassonne-uct65-vs-uct235-1000its,768,752,2152.59200634,2075.328846697,16
carcassonne-boltzmann140-vs-boltzmann385-1000its,769,753,2222.660521503,2172.799737529,16
carcassonne-uct385-vs-uct485-1000its,769,753,2138.669680348,2121.592982479,16
carcassonne-ucttuned280-vs-ucttuned240-1000its,769,753,2265.057965998,2219.148151693,16
carcassonne-boltzmann410-vs-boltzmann100-1000its,770,754,2316.307612059,2294.920360337,16
carcassonne-boltzmann210-vs-boltzmann180-1000its,772,756,2152.615503809,2109.990432686,16
carcassonne-boltzmann75-vs-boltzmann65-1000its,772,756,2218.106882926,2162.521424625,16
carcassonne-boltzmann480-vs-boltzmann240-1000its,773,757,2284.35620499,2214.53453638,16
carcassonne-ucttuned370-vs-ucttuned245-1000its,773,757,2221.978947374,2150.946868902,16
carcassonne-boltzmann325-vs-boltzmann105-1000its,774,758,2194.464332822,2202.299570817,16
carcassonne-uct465-vs-uct295-1000its,774,758,2209.166587103,2158.361602521,16
carcassonne-boltzmann290-vs-boltzmann495-1000its,777,761,2198.849425172,2175.248055346,16
carcassonne-uct390-vs-uct75-1000its,777,761,2194.162308321,2134.228152912,16
carcassonne-ucttuned405-vs-ucttuned25-1000its,778,762,2208.325289057,2192.649743385,16
carcassonne-boltzmann90-vs-boltzmann50-1000its,779,763,2218.912425994,2171.738136121,16
carcassonne-boltzmann120-vs-boltzmann260-1000its,781,765,2152.571591343,2115.929750649,16
carcassonne-uct300-vs-uct20-1000its,781,765,2229.724989746,2200.626887429,16
carcassonne-uct380-vs-uct490-1000its,781,765,2237.896201158,2256.860526273,16
carcassonne-ucttuned135-vs-ucttuned420-1000its,781,765,2275.740127867,2170.810736849,16
carcassonne-ucttuned70-vs-ucttuned335-1000its,781,765,2212.880612698,2169.948975855,16
carcassonne-ucttuned95-vs-ucttuned50-1000its,781,765,2210.51692524,2182.18200324,16
carcassonne-uct375-vs-uct230-1000its,782,766,2187.63174782,2074.345191834,16
carcassonne-boltzmann50-vs-boltzmann390-1000its,783,767,2162.124096411,2114.216172144,16
carcassonne-boltzmann170-vs-boltzmann65-1000its,785,769,2235.62802075,2158.675149773,16
carcassonne-uct260-vs-uct240-1000its,786,770,2128.752890652,2089.294804824,16
carcassonne-uct170-vs-uct290-1000its,788,772,2139.06518577,2086.694444743,16
carcassonne-ucttuned495-vs-ucttuned370-1000its,789,773,2139.873451469,2144.965654159,16
carcassonne-boltzmann445-vs-boltzmann145-1000its,790,774,2167.150489914,2134.743228515,16
carcassonne-boltzmann485-vs-boltzmann360-1000its,790,774,2205.632284094,2164.828210676,16
carcassonne-boltzmann380-vs-boltzmann235-1000its,791,775,2243.928267776,2203.40629192,16
carcassonne-uct490-vs-uct370-1000its,793,777,2196.671461496,2159.035833827,16
carcassonne-uct275-vs-uct245-1000its,795,779,2185.113166385,2167.157104192,16
carcassonne-ucttuned235-vs-ucttuned160-1000its,795,779,2183.04208001,2133.159323327,16
carcassonne-ucttuned355-vs-ucttuned60-1000its,796,780,2184.355231074,2144.062178012,16
carcassonne-boltzmann275-vs-boltzmann465-1000its,798,782,2231.966718573,2150.534234959,16
carcassonne-boltzmann145-vs-boltzmann125-1000its,799,783,2205.902479278,2153.865290115,16
carcassonne-ucttuned35-vs-ucttuned130-1000its,799,783,2130.218674727,2118.586957648,16
carcassonne-boltzmann205-vs-boltzmann410-1000its,805,789,2244.943910052,2196.741119643,16
carcassonne-boltzmann305-vs-boltzmann445-1000its,805,789,2213.081864325,2199.288149748,16
carcassonne-uct65-vs-uct460-1000its,805,789,2186.660637041,2136.383286195,16
carcassonne-ucttuned455-vs-ucttuned120-1000its,806,790,2217.451125799,2210.50785709,16
carcassonne-uct115-vs-uct235-1000its,807,791,2215.290191327,2152.643963702,16
carcassonne-boltzmann150-vs-boltzmann355-1000its,808,792,2220.53966106,2163.523586467,16
carcassonne-boltzmann335-vs-boltzmann65-1000its,809,793,2202.577047862,2108.4217258,16
carcassonne-ucttuned360-vs-ucttuned495-1000its,809,793,2169.612615482,2119.166204801,16
carcassonne-uct220-vs-uct30-1000its,811,795,2225.877472618,2188.845415809,16
carcassonne-boltzmann130-vs-boltzmann270-1000its,812,796,2251.367484517,2187.067214271,16
carcassonne-boltzmann410-vs-boltzmann450-1000its,812,796,2175.413028452,2136.787575537,16
carcassonne-boltzmann280-vs-boltzmann480-1000its,813,797,2167.223626592,2164.438516261,16
carcassonne-boltzmann30-vs-boltzmann90-1000its,814,798,2140.717412377,2097.179363812,16
carcassonne-boltzmann425-vs-boltzmann310-1000its,814,798,2158.645246586,2131.266727211,16
carcassonne-uct180-vs-uct5-1000its,814,798,2129.213289293,2099.133931517,16
carcassonne-uct345-vs-uct235-1000its,814,798,2259.89653823,2196.246509253,16
carcassonne-ucttuned135-vs-ucttuned365-1000its,814,798,2191.836493567,2173.705078873,16
carcassonne-ucttuned465-vs-ucttuned200-1000its,814,798,2129.432076275,2113.493562686,16
carcassonne-uct420-vs-uct320-1000its,815,799,2154.690729015,2099.807283472,16
carcassonne-boltzmann375-vs-boltzmann160-1000its,817,801,2312.796641548,2281.213170365,16
carcassonne-uct350-vs-uct180-1000its,817,801,2197.162149698,2138.104489199,16
carcassonne-uct430-vs-uct345-1000its,817,801,2183.712972282,2144.019921652,16
carcassonne-ucttuned225-vs-ucttuned190-1000its,820,804,2169.47138167,2134.902588664,16
carcassonne-boltzmann130-vs-boltzmann145-1000its,821,805,2146.052481456,2127.048496059,16
carcassonne-uct45-vs-uct400-1000its,821,805,2203.055969838,2157.727596348,16
carcassonne-boltzmann190-vs-boltzmann280-1000its,822,806,2214.939546393,2161.147340509,16
carcassonne-ucttuned395-vs-ucttuned80-1000its,822,806,2256.836530681,2185.473321074,16
carcassonne-ucttuned65-vs-ucttuned195-1000its,822,806,2281.98399195,2246.451571761,16
carcassonne-boltzmann255-vs-boltzmann135-1000its,823,807,2181.686737093,2092.351084773,16
carcassonne-uct25-vs-uct150-1000its,823,807,2223.158599383,2155.151757721,16
carcassonne-uct355-vs-uct485-1000its,823,807,2185.480743569,2153.609335118,16
carcassonne-uct480-vs-uct355-1000its,823,807,2177.251759749,2159.748403121,16
carcassonne-ucttuned310-vs-ucttuned335-1000its,823,807,2204.589620589,2214.541957794,16
carcassonne-ucttuned355-vs-ucttuned95-1000its,823,807,2180.308943096,2148.946244859,16
carcassonne-boltzmann345-vs-boltzmann180-1000its,824,808,2185.388608378,2163.873659514,16
carcassonne-uct285-vs-uct270-1000its,824,808,2173.941638268,2125.056434519,16
carcassonne-ucttuned155-vs-ucttuned100-1000its,824,808,2237.563829578,2239.308003886,16
carcassonne-ucttuned155-vs-ucttuned395-1000its,824,808,2242.488179785,2158.345710179,16
carcassonne-boltzmann215-vs-boltzmann195-1000its,826,810,2195.822962157,2189.86356068,16
carcassonne-ucttuned190-vs-ucttuned375-1000its,826,810,2201.905968364,2118.453002481,16
carcassonne-uct210-vs-uct240-1000its,828,812,2222.266249336,2177.941537656,16
carcassonne-ucttuned460-vs-ucttuned160-1000its,828,812,2128.434182705,2060.899974995,16
carcassonne-boltzmann415-vs-boltzmann365-1000its,829,813,2247.839479454,2208.277742138,16
carcassonne-boltzmann235-vs-boltzmann405-1000its,830,814,2257.700554729,2156.210257955,16
carcassonne-ucttuned385-vs-ucttuned285-1000its,830,814,2182.765655589,2088.252826107,16
carcassonne-uct320-vs-uct250-1000its,831,815,2214.527144163,2180.033010295,16
carcassonne-uct430-vs-uct465-1000its,831,815,2196.351929412,2191.493060443,16
carcassonne-boltzmann60-vs-boltzmann350-1000its,832,816,2170.401426851,2136.776340749,16
carcassonne-ucttuned230-vs-ucttuned305-1000its,832,816,2183.782644935,2169.541762753,16
carcassonne-uct150-vs-uct460-1000its,833,817,2190.864327134,2129.272507222,16
carcassonne-boltzmann125-vs-boltzmann45-1000its,834,818,2261.032357168,2219.69760111,16
carcassonne-boltzmann115-vs-boltzmann165-1000its,835,819,2160.411553889,2148.407888375,16
carcassonne-boltzmann190-vs-boltzmann95-1000its,835,819,2215.150488641,2169.251457193,16
carcassonne-ucttuned170-vs-ucttuned470-1000its,835,819,2237.888745415,2139.725777865,16
carcassonne-uct460-vs-uct445-1000its,836,820,2227.803850568,2162.803292973,16
carcassonne-uct165-vs-uct335-1000its,837,821,2220.198832693,2155.363097867,16
carcassonne-uct70-vs-uct250-1000its,837,821,2176.340745011,2099.01553016,16
carcassonne-boltzmann205-vs-boltzmann480-1000its,838,822,2202.22537837,2142.731382956,16
carcassonne-ucttuned435-vs-ucttuned135-1000its,838,822,2219.569711685,2164.807012764,16
carcassonne-boltzmann160-vs-boltzmann390-1000its,839,823,2208.076918206,2163.646225615,16
carcassonne-boltzmann280-vs-boltzmann55-1000its,840,824,2209.190132595,2181.212208436,16
carcassonne-uct40-vs-uct355-1000its,840,824,2181.347023946,2099.843601483,16
carcassonne-uct445-vs-uct200-1000its,840,824,2214.858875309,2206.181059769,16
carcassonne-ucttuned250-vs-ucttuned335-1000its,840,824,2211.767989832,2182.138063775,16
carcassonne-uct110-vs-uct135-1000its,841,825,2152.784978135,2133.465057398,16
carcassonne-uct255-vs-uct325-1000its,841,825,2221.321484554,2161.085806946,16
carcassonne-uct445-vs-uct460-1000its,841,825,2185.657665711,2150.991111871,16
carcassonne-ucttuned260-vs-ucttuned110-1000its,841,825,2265.446270472,2213.052182527,16
carcassonne-ucttuned285-vs-ucttuned245-1000its,841,825,2151.365270947,2054.385544435,16
carcassonne-boltzmann255-vs-boltzmann375-1000its,843,827,2163.646364319,2097.044012549,16
carcassonne-ucttuned85-vs-ucttuned300-1000its,843,827,2185.212726067,2149.994771674,16
carcassonne-uct75-vs-uct470-1000its,844,828,2157.706481923,2101.577519803,16
carcassonne-boltzmann415-vs-boltzmann285-1000its,846,830,2194.719769017,2157.033417793,16
carcassonne-boltzmann475-vs-boltzmann380-1000its,846,830,2224.267858665,2205.573983052,16
carcassonne-uct295-vs-uct460-1000its,846,830,2182.58739942,2119.816868006,16
carcassonne-ucttuned340-vs-ucttuned490-1000its,846,830,2173.135058956,2147.840251306,16
carcassonne-ucttuned450-vs-ucttuned20-1000its,848,832,2200.97185368,2118.421634522,16
carcassonne-boltzmann100-vs-boltzmann415-1000its,850,834,2145.763596468,2143.481380709,16
carcassonne-boltzmann485-vs-boltzmann420-1000its,850,834,2189.207552579,2100.077759138,16
carcassonne-boltzmann420-vs-boltzmann130-1000its,853,837,2150.716690088,2120.772855562,16
carcassonne-ucttuned480-vs-ucttuned175-1000its,854,838,2175.041388887,2123.410621185,16
carcassonne-ucttuned115-vs-ucttuned305-1000its,855,839,2197.393055542,2176.40695817,16
carcassonne-uct25-vs-uct35-1000its,856,840,2120.219179405,2100.627756994,16
carcassonne-uct490-vs-uct320-1000its,856,840,2262.985684992,2184.488024153,16
carcassonne-boltzmann310-vs-boltzmann440-1000its,857,841,2139.477911084,2110.291990747,16
carcassonne-ucttuned125-vs-ucttuned145-1000its,859,843,2211.642547959,2182.100464405,16
carcassonne-uct315-vs-uct285-1000its,860,844,2180.728571678,2131.687708901,16
carcassonne-boltzmann15-vs-boltzmann160-1000its,863,847,2166.439637441,2146.122701365,16
carcassonne-uct390-vs-uct105-1000its,863,847,2098.852331845,2094.291598611,16
carcassonne-ucttuned30-vs-ucttuned265-1000its,865,849,2181.430123877,2155.682262596,16
carcassonne-ucttuned345-vs-ucttuned350-1000its,865,849,2268.01730941,2258.81564755,16
carcassonne-ucttuned80-vs-ucttuned265-1000its,865,849,2249.509383055,2220.212540067,16
carcassonne-boltzmann235-vs-boltzmann45-1000its,868,852,2230.821076306,2176.063679227,16
carcassonne-ucttuned295-vs-ucttuned40-1000its,869,853,2172.827618173,2106.749897824,16
carcassonne-uct15-vs-uct65-1000its,870,854,2218.626966304,2181.044604249,16
carcassonne-uct255-vs-uct345-1000its,870,854,2135.41792628,2105.220210155,16
carcassonne-ucttuned405-vs-ucttuned420-1000its,870,854,2214.746371084,2142.867585257,16
carcassonne-ucttuned85-vs-ucttuned255-1000its,874,858,2195.560400596,2150.189505298,16
carcassonne-ucttuned265-vs-ucttuned280-1000its,875,859,2285.036941446,2241.90155038,16
carcassonne-ucttuned85-vs-ucttuned220-1000its,876,860,2143.999956028,2136.077641393,16
carcassonne-uct120-vs-uct370-1000its,877,861,2210.271258659,2179.845928707,16
carcassonne-uct20-vs-uct405-1000its,878,862,2212.669861249,2197.224776966,16
carcassonne-ucttuned135-vs-ucttuned320-1000its,881,865,2141.16567394,2116.138487515,16
carcassonne-boltzmann110-vs-boltzmann105-1000its,882,866,2177.333211353,2132.946560274,16
carcassonne-uct150-vs-uct120-1000its,882,866,2130.9238824,2112.241681141,16
carcassonne-uct410-vs-uct100-1000its,883,867,2301.138914884,2264.531125202,16
carcassonne-uct60-vs-uct205-1000its,883,867,2249.11850212,2176.484754444,16
carcassonne-ucttuned480-vs-ucttuned390-1000its,885,869,2202.709809646,2160.958785033,16
carcassonne-ucttuned440-vs-ucttuned40-1000its,894,878,2199.289224277,2167.452730344,16
carcassonne-uct70-vs-uct30-1000its,898,882,2186.893830763,2167.069200039,16
carcassonne-ucttuned130-vs-ucttuned35-1000its,906,890,2198.009049212,2153.817803076,16
carcassonne-ucttuned35-vs-ucttuned455-1000its,907,891,2176.697989062,2125.210426105,16
carcassonne-uct195-vs-uct320-1000its,913,897,2174.569860193,2154.343328083,16
carcassonne-uct5-vs-uct390-1000its,942,926,2175.773623121,2125.222616371,16
carcassonne-boltzmann490-vs-boltzmann190-1000its,950,934,2215.971672482,2158.74115593,16
carcassonne-ucttuned435-vs-ucttuned140-1000its,719,702,2225.619176547,2199.401416932,17
carcassonne-boltzmann280-vs-boltzmann40-1000its,745,728,2210.068489124,2231.555572228,17
carcassonne-boltzmann20-vs-boltzmann415-1000its,747,730,2196.000559802,2169.267650675,17
carcassonne-ucttuned105-vs-ucttuned490-1000its,751,734,2197.328044091,2135.619599512,17
carcassonne-ucttuned415-vs-ucttuned365-1000its,752,735,2204.561040965,2187.227303413,17
carcassonne-uct60-vs-uct340-1000its,753,736,2240.405676712,2233.473190567,17
carcassonne-uct430-vs-uct275-1000its,755,738,2180.359567426,2132.878213985,17
carcassonne-ucttuned420-vs-ucttuned90-1000its,756,739,2240.643301136,2226.129141426,17
carcassonne-ucttuned370-vs-ucttuned465-1000its,760,743,2248.181591133,2142.375733564,17
carcassonne-ucttuned100-vs-ucttuned325-1000its,761,744,2224.24005582,2189.838866327,17
carcassonne-uct475-vs-uct360-1000its,763,746,2156.054327999,2098.49062723,17
carcassonne-uct160-vs-uct30-1000its,764,747,2241.122594741,2209.036639232,17
carcassonne-uct200-vs-uct410-1000its,764,747,2148.510779169,2143.172226804,17
carcassonne-uct460-vs-uct15-1000its,773,756,2166.02469197,2166.292116742,17
carcassonne-ucttuned330-vs-ucttuned10-1000its,774,757,2156.180653228,2118.449515474,17
carcassonne-uct145-vs-uct285-1000its,775,758,2136.208840335,2118.147269161,17
carcassonne-uct305-vs-uct65-1000its,776,759,2163.943128826,2144.058935817,17
carcassonne-uct340-vs-uct480-1000its,776,759,2135.310254039,2106.186822526,17
carcassonne-ucttuned45-vs-ucttuned435-1000its,776,759,2182.821945826,2170.937378433,17
carcassonne-uct420-vs-uct260-1000its,777,760,2209.86189275,2193.794996409,17
carcassonne-boltzmann115-vs-boltzmann140-1000its,780,763,2211.247061282,2172.458217389,17
carcassonne-boltzmann305-vs-boltzmann455-1000its,780,763,2196.723712674,2173.469617476,17
carcassonne-ucttuned470-vs-ucttuned225-1000its,780,763,2196.451479202,2156.756711856,17
carcassonne-uct280-vs-uct435-1000its,781,764,2236.041815297,2187.888475119,17
carcassonne-boltzmann195-vs-boltzmann125-1000its,782,765,2264.009752757,2195.284952935,17
carcassonne-uct175-vs-uct345-1000its,782,765,2245.792447382,2204.618757371,17
carcassonne-ucttuned5-vs-ucttuned10-1000its,783,766,2234.214549268,2196.829920306,17
carcassonne-ucttuned5-vs-ucttuned290-1000its,783,766,2188.648365676,2144.384295439,17
carcassonne-ucttuned355-vs-ucttuned335-1000its,784,767,2189.314984111,2129.925536525,17
carcassonne-ucttuned90-vs-ucttuned225-1000its,785,768,2161.816672703,2129.379748506,17
carcassonne-boltzmann260-vs-boltzmann455-1000its,786,769,2137.571432399,2103.822109003,17
carcassonne-uct425-vs-uct130-1000its,786,769,2267.486212225,2212.813138613,17
carcassonne-uct95-vs-uct170-1000its,787,770,2119.914519202,2092.286780579,17
carcassonne-ucttuned20-vs-ucttuned400-1000its,788,771,2183.51266584,2151.14019262,17
carcassonne-boltzmann365-vs-boltzmann55-1000its,789,772,2263.247985472,2242.014388608,17
carcassonne-boltzmann155-vs-boltzmann170-1000its,790,773,2223.405671152,2161.413379946,17
carcassonne-boltzmann35-vs-boltzmann215-1000its,790,773,2188.436654386,2171.511731385,17
carcassonne-boltzmann200-vs-boltzmann265-1000its,792,775,2205.192141116,2178.480780293,17
carcassonne-uct345-vs-uct15-1000its,793,776,2162.011377442,2122.657465504,17
carcassonne-ucttuned315-vs-ucttuned375-1000its,793,776,2205.037165441,2126.603795301,17
carcassonne-boltzmann275-vs-boltzmann90-1000its,794,777,2254.495104239,2160.898963346,17
carcassonne-uct65-vs-uct370-1000its,794,777,2223.312113995,2181.431017117,17
carcassonne-ucttuned255-vs-ucttuned80-1000its,794,777,2175.1274149,2133.236733873,17
carcassonne-boltzmann330-vs-boltzmann185-1000its,795,778,2215.842961702,2133.314130997,17
carcassonne-uct230-vs-uct340-1000its,795,778,2226.934462568,2152.848211937,17
carcassonne-uct250-vs-uct435-1000its,796,779,2252.228045017,2204.270865186,17
carcassonne-uct35-vs-uct425-1000its,796,779,2190.658290721,2140.401740808,17
carcassonne-ucttuned415-vs-ucttuned65-1000its,796,779,2259.531432357,2190.694668038,17
carcassonne-ucttuned495-vs-ucttuned225-1000its,796,779,2214.95583576,2183.599884357,17
carcassonne-uct225-vs-uct365-1000its,797,780,2222.193575697,2189.175178083,17
carcassonne-boltzmann425-vs-boltzmann260-1000its,798,781,2189.856373733,2140.244257097,17
carcassonne-ucttuned305-vs-ucttuned160-1000its,798,781,2154.030858424,2128.718053311,17
carcassonne-uct60-vs-uct400-1000its,799,782,2201.187183857,2154.678095339,17
carcassonne-ucttuned260-vs-ucttuned360-1000its,799,782,2227.846038607,2155.827341883,17
carcassonne-boltzmann350-vs-boltzmann260-1000its,800,783,2150.134863549,2118.771425632,17
carcassonne-uct435-vs-uct170-1000its,800,783,2259.226713499,2218.905312684,17
carcassonne-boltzmann180-vs-boltzmann485-1000its,801,784,2173.80640976,2088.644546095,17
carcassonne-uct190-vs-uct405-1000its,802,785,2145.654725636,2130.969898777,17
carcassonne-boltzmann200-vs-boltzmann340-1000its,803,786,2150.783958166,2119.787383769,17
carcassonne-boltzmann55-vs-boltzmann270-1000its,804,787,2188.826462684,2129.324110233,17
carcassonne-uct345-vs-uct355-1000its,804,787,2197.130875397,2136.661356793,17
carcassonne-ucttuned220-vs-ucttuned95-1000its,804,787,2158.01015853,2123.620645486,17
carcassonne-ucttuned60-vs-ucttuned150-1000its,804,787,2152.409436754,2144.366755942,17
carcassonne-boltzmann475-vs-boltzmann220-1000its,806,789,2216.020916293,2157.844831543,17
carcassonne-uct365-vs-uct340-1000its,806,789,2222.721492454,2236.426179329,17
carcassonne-boltzmann355-vs-boltzmann330-1000its,808,791,2228.547233939,2184.610956061,17
carcassonne-uct230-vs-uct55-1000its,808,791,2174.210666229,2144.984766567,17
carcassonne-ucttuned310-vs-ucttuned330-1000its,808,791,2222.965773831,2241.693752479,17
carcassonne-boltzmann105-vs-boltzmann140-1000its,809,792,2188.324080851,2180.409708677,17
carcassonne-boltzmann135-vs-boltzmann305-1000its,809,792,2208.12672023,2136.375224362,17
carcassonne-uct290-vs-uct470-1000its,809,792,2178.272906749,2172.939660372,17
carcassonne-uct350-vs-uct165-1000its,809,792,2199.408732723,2119.952553461,17
carcassonne-boltzmann245-vs-boltzmann205-1000its,810,793,2217.062275413,2122.966271872,17
carcassonne-uct25-vs-uct260-1000its,810,793,2180.722660992,2121.335880323,17
carcassonne-boltzmann45-vs-boltzmann430-1000its,811,794,2197.742483061,2097.080530166,17
carcassonne-uct95-vs-uct415-1000its,811,794,2238.569862793,2190.565450394,17
carcassonne-ucttuned100-vs-ucttuned465-1000its,811,794,2203.375219048,2134.123302214,17
carcassonne-uct315-vs-uct235-1000its,812,795,2236.956577598,2202.760451605,17
carcassonne-uct395-vs-uct350-1000its,812,795,2172.291692247,2114.708726669,17
carcassonne-boltzmann240-vs-boltzmann175-1000its,813,796,2201.279884134,2145.801169342,17
carcassonne-ucttuned35-vs-ucttuned135-1000its,813,796,2188.242772887,2125.918173782,17
carcassonne-uct110-vs-uct300-1000its,814,797,2168.52983785,2126.226577455,17
carcassonne-ucttuned220-vs-ucttuned230-1000its,814,797,2151.96439143,2114.726291861,17
carcassonne-ucttuned390-vs-ucttuned275-1000its,814,797,2155.715914784,2151.933544353,17
carcassonne-boltzmann140-vs-boltzmann235-1000its,815,798,2210.789988199,2148.866369625,17
carcassonne-ucttuned420-vs-ucttuned40-1000its,816,799,2239.205963462,2199.899715689,17
carcassonne-boltzmann270-vs-boltzmann330-1000its,817,800,2182.74277372,2120.675791224,17
carcassonne-boltzmann390-vs-boltzmann455-1000its,817,800,2186.610059252,2119.033641396,17
carcassonne-ucttuned410-vs-ucttuned285-1000its,817,800,2160.822195982,2163.283602635,17
carcassonne-ucttuned405-vs-ucttuned350-1000its,818,801,2201.785355645,2131.965459173,17
carcassonne-boltzmann460-vs-boltzmann240-1000its,821,804,2184.706496767,2132.440610277,17
carcassonne-ucttuned195-vs-ucttuned220-1000its,821,804,2250.235446392,2187.661637002,17
carcassonne-ucttuned255-vs-ucttuned295-1000its,821,804,2188.08302023,2139.705428042,17
carcassonne-boltzmann230-vs-boltzmann305-1000its,822,805,2221.612402539,2203.534424619,17
carcassonne-boltzmann370-vs-boltzmann245-1000its,824,807,2227.355657208,2201.43929171,17
carcassonne-ucttuned380-vs-ucttuned5-1000its,824,807,2127.081157011,2097.151361385,17
carcassonne-uct275-vs-uct395-1000its,825,808,2176.711221447,2124.325190351,17
carcassonne-boltzmann95-vs-boltzmann255-1000its,826,809,2197.915050248,2166.344513474,17
carcassonne-uct255-vs-uct180-1000its,826,809,2245.785797611,2207.001530071,17
carcassonne-ucttuned280-vs-ucttuned320-1000its,826,809,2270.687074559,2224.355202078,17
carcassonne-ucttuned350-vs-ucttuned145-1000its,826,809,2146.208208873,2170.792373742,17
carcassonne-boltzmann70-vs-boltzmann200-1000its,827,810,2204.123864198,2155.468315713,17
carcassonne-boltzmann400-vs-boltzmann445-1000its,828,811,2188.902706055,2152.644720127,17
carcassonne-uct345-vs-uct185-1000its,828,811,2202.679413321,2186.251502628,17
carcassonne-uct470-vs-uct240-1000its,828,811,2195.086824134,2133.154364778,17
carcassonne-boltzmann40-vs-boltzmann370-1000its,829,812,2171.159711164,2135.036672596,17
carcassonne-ucttuned215-vs-ucttuned475-1000its,830,813,2242.420669271,2162.063831328,17
carcassonne-ucttuned70-vs-ucttuned155-1000its,832,815,2180.502659748,2126.796811062,17
carcassonne-boltzmann5-vs-boltzmann35-1000its,833,816,2220.688548885,2190.295113086,17
carcassonne-uct175-vs-uct45-1000its,833,816,2175.951035487,2131.881293966,17
carcassonne-uct110-vs-uct370-1000its,835,818,2194.127278463,2170.210894108,17
carcassonne-ucttuned160-vs-ucttuned450-1000its,835,818,2200.992213392,2165.980738023,17
carcassonne-ucttuned320-vs-ucttuned450-1000its,835,818,2229.785701408,2191.246120147,17
carcassonne-boltzmann385-vs-boltzmann260-1000its,836,819,2189.513277212,2174.413703701,17
carcassonne-ucttuned210-vs-ucttuned265-1000its,836,819,2160.025256747,2151.298204557,17
carcassonne-ucttuned440-vs-ucttuned280-1000its,837,820,2169.033667691,2125.657060223,17
carcassonne-ucttuned470-vs-ucttuned260-1000its,837,820,2182.03167669,2102.05392317,17
carcassonne-boltzmann115-vs-boltzmann235-1000its,840,823,2245.801707879,2227.300132574,17
carcassonne-uct210-vs-uct10-1000its,841,824,2230.521476098,2163.268352892,17
carcassonne-uct275-vs-uct425-1000its,841,824,2192.437976847,2160.621191882,17
carcassonne-uct5-vs-uct295-1000its,841,824,2246.986392406,2159.872671119,17
carcassonne-ucttuned110-vs-ucttuned465-1000its,842,825,2178.906706235,2131.992936116,17
carcassonne-uct345-vs-uct75-1000its,843,826,2239.752593466,2158.342294975,17
carcassonne-boltzmann255-vs-boltzmann335-1000its,844,827,2137.570556741,2101.251905746,17
carcassonne-uct135-vs-uct400-1000its,846,829,2247.614496843,2150.90199275,17
carcassonne-uct330-vs-uct90-1000its,848,831,2220.947929178,2202.897282558,17
carcassonne-ucttuned265-vs-ucttuned460-1000its,848,831,2154.273432575,2143.28479238,17
carcassonne-ucttuned50-vs-ucttuned280-1000its,849,832,2214.179983467,2148.162233907,17
carcassonne-boltzmann190-vs-boltzmann75-1000its,850,833,2149.220425702,2073.464296673,17
carcassonne-boltzmann240-vs-boltzmann405-1000its,850,833,2180.825636636,2117.072930502,17
carcassonne-boltzmann165-vs-boltzmann350-1000its,851,834,2197.400526093,2160.72101276,17
carcassonne-uct60-vs-uct380-1000its,851,834,2194.650166355,2143.221000477,17
carcassonne-boltzmann80-vs-boltzmann170-1000its,852,835,2180.206688036,2126.386499011,17
carcassonne-uct150-vs-uct320-1000its,852,835,2143.26756821,2139.804063478,17
carcassonne-boltzmann250-vs-boltzmann140-1000its,853,836,2235.151791938,2164.192515771,17
carcassonne-ucttuned120-vs-ucttuned335-1000its,853,836,2241.622127889,2164.116716322,17
carcassonne-ucttuned25-vs-ucttuned445-1000its,854,837,2170.285100629,2148.568798922,17
carcassonne-uct475-vs-uct110-1000its,855,838,2205.588431847,2177.810781184,17
carcassonne-ucttuned470-vs-ucttuned435-1000its,859,842,2193.63704761,2156.388736473,17
carcassonne-ucttuned130-vs-ucttuned270-1000its,860,843,2200.755999334,2151.070227657,17
carcassonne-ucttuned60-vs-ucttuned465-1000its,860,843,2276.178094467,2208.010042268,17
carcassonne-uct140-vs-uct130-1000its,861,844,2215.969330894,2166.211899182,17
carcassonne-ucttuned195-vs-ucttuned385-1000its,861,844,2150.881277254,2128.319539105,17
carcassonne-uct410-vs-uct210-1000its,862,845,2304.204053634,2224.427888272,17
carcassonne-boltzmann240-vs-boltzmann235-1000its,863,846,2238.640068775,2138.607456238,17
carcassonne-ucttuned330-vs-ucttuned290-1000its,863,846,2245.295869931,2180.032012889,17
carcassonne-ucttuned100-vs-ucttuned160-1000its,865,848,2216.058208151,2183.997364327,17
carcassonne-boltzmann115-vs-boltzmann120-1000its,866,849,2217.626822901,2168.494032212,17
carcassonne-ucttuned150-vs-ucttuned480-1000its,870,853,2256.832917813,2212.480759489,17
carcassonne-ucttuned115-vs-ucttuned390-1000its,872,855,2248.319168301,2227.338133551,17
carcassonne-boltzmann155-vs-boltzmann65-1000its,878,861,2160.872267307,2089.196877701,17
carcassonne-uct355-vs-uct90-1000its,879,862,2173.499519459,2153.123644337,17
carcassonne-ucttuned405-vs-ucttuned490-1000its,879,862,2228.609591804,2184.920774226,17
carcassonne-boltzmann115-vs-boltzmann60-1000its,884,867,2205.014095795,2134.671720615,17
carcassonne-ucttuned430-vs-ucttuned375-1000its,885,868,2138.776627265,2102.55718927,17
carcassonne-boltzmann475-vs-boltzmann330-1000its,894,877,2260.180214916,2220.600791411,17
carcassonne-uct435-vs-uct50-1000its,900,883,2196.399197737,2147.551098114,17
carcassonne-ucttuned430-vs-ucttuned140-1000its,903,886,2258.200046009,2228.27093755,17
carcassonne-boltzmann480-vs-boltzmann490-1000its,914,897,2148.200398129,2134.998878752,17
carcassonne-uct5-vs-uct415-1000its,927,910,2183.687643364,2151.30982716,17
carcassonne-uct370-vs-uct70-1000its,666,648,1731.39539153,1689.431051997,18
carcassonne-ucttuned130-vs-ucttuned485-1000its,668,650,1865.933522682,1830.780391375,18
carcassonne-boltzmann285-vs-boltzmann120-1000its,702,684,2199.477077371,2169.18624372,18
carcassonne-boltzmann95-vs-boltzmann455-1000its,707,689,2147.787695572,2138.547037829,18
carcassonne-boltzmann45-vs-boltzmann390-1000its,719,701,2208.507897786,2156.424169444,18
carcassonne-boltzmann220-vs-boltzmann435-1000its,737,719,2227.121543465,2202.050397037,18
carcassonne-uct230-vs-uct110-1000its,738,720,2221.081353388,2164.50427718,18
carcassonne-boltzmann400-vs-boltzmann205-1000its,744,726,2244.457804286,2174.951161109,18
carcassonne-ucttuned470-vs-ucttuned325-1000its,747,729,2153.533124064,2125.460175855,18
carcassonne-ucttuned490-vs-ucttuned385-1000its,747,729,2186.666558143,2133.36845223,18
carcassonne-ucttuned150-vs-ucttuned240-1000its,748,730,2201.789096409,2137.883790396,18
carcassonne-uct90-vs-uct405-1000its,754,736,2212.984530522,2183.317652782,18
carcassonne-uct75-vs-uct455-1000its,755,737,2229.117052313,2199.440099625,18
carcassonne-boltzmann470-vs-boltzmann125-1000its,756,738,2151.018432272,2066.818365716,18
carcassonne-boltzmann95-vs-boltzmann390-1000its,756,738,2132.091717633,2036.411421898,18
carcassonne-boltzmann405-vs-boltzmann385-1000its,757,739,2168.52934966,2178.477104211,18
carcassonne-uct105-vs-uct430-1000its,758,740,2204.27524283,2185.420106536,18
carcassonne-boltzmann255-vs-boltzmann10-1000its,760,742,2201.572148769,2161.598710932,18
carcassonne-boltzmann105-vs-boltzmann345-1000its,761,743,2176.130538542,2180.54666262,18
carcassonne-boltzmann205-vs-boltzmann355-1000its,761,743,2275.644845566,2222.879555577,18
carcassonne-ucttuned425-vs-ucttuned220-1000its,762,744,2168.92973935,2161.727801798,18
carcassonne-boltzmann435-vs-boltzmann75-1000its,763,745,2202.728135217,2170.728305448,18
carcassonne-uct370-vs-uct175-1000its,765,747,2260.836410663,2246.603182748,18
carcassonne-boltzmann315-vs-boltzmann350-1000its,767,749,2205.43753529,2156.974311133,18
carcassonne-boltzmann430-vs-boltzmann130-1000its,769,751,2180.6637681,2109.348059307,18
carcassonne-uct455-vs-uct440-1000its,769,751,2246.017074206,2187.721666981,18
carcassonne-uct340-vs-uct425-1000its,770,752,2238.647657465,2139.154305253,18
carcassonne-uct60-vs-uct125-1000its,770,752,2239.181147046,2198.551160604,18
carcassonne-ucttuned355-vs-ucttuned370-1000its,770,752,2194.073142022,2165.667394431,18
carcassonne-uct175-vs-uct340-1000its,771,753,2151.080751085,2123.168535173,18
carcassonne-boltzmann25-vs-boltzmann75-1000its,773,755,2193.534581887,2147.735292512,18
carcassonne-boltzmann65-vs-boltzmann440-1000its,773,755,2111.188956661,2091.024950852,18
carcassonne-boltzmann495-vs-boltzmann100-1000its,774,756,2264.635652684,2219.633834089,18
carcassonne-boltzmann215-vs-boltzmann285-1000its,778,760,2179.770492878,2104.769955212,18
carcassonne-uct285-vs-uct205-1000its,780,762,2156.726493822,2125.975316092,18
carcassonne-uct405-vs-uct340-1000its,780,762,2203.822434111,2136.567570243,18
carcassonne-ucttuned40-vs-ucttuned265-1000its,780,762,2258.151771321,2210.386015398,18
carcassonne-boltzmann255-vs-boltzmann430-1000its,781,763,2203.702707538,2110.393229753,18
carcassonne-boltzmann230-vs-boltzmann265-1000its,782,764,2199.117668789,2182.214602501,18
carcassonne-boltzmann240-vs-boltzmann210-1000its,783,765,2208.433863009,2167.761142648,18
carcassonne-uct290-vs-uct25-1000its,783,765,2259.079709936,2192.206124197,18
carcassonne-boltzmann265-vs-boltzmann310-1000its,784,766,2224.35005949,2209.139578306,18
carcassonne-boltzmann430-vs-boltzmann415-1000its,784,766,2187.037506773,2150.902627983,18
carcassonne-ucttuned175-vs-ucttuned305-1000its,784,766,2164.142269371,2121.286900938,18
carcassonne-boltzmann375-vs-boltzmann90-1000its,785,767,2233.056622008,2148.998189558,18
carcassonne-uct355-vs-uct225-1000its,785,767,2190.167599332,2120.762540358,18
carcassonne-ucttuned50-vs-ucttuned185-1000its,786,768,2159.661361378,2094.739606743,18
carcassonne-uct65-vs-uct80-1000its,788,770,2209.780696047,2100.76619083,18
carcassonne-ucttuned285-vs-ucttuned415-1000its,788,770,2193.608307745,2130.647871199,18
carcassonne-boltzmann180-vs-boltzmann205-1000its,789,771,2169.598837983,2129.371669533,18
carcassonne-boltzmann240-vs-boltzmann80-1000its,791,773,2132.768469976,2090.114421998,18
carcassonne-boltzmann330-vs-boltzmann265-1000its,792,774,2209.833326895,2172.302179684,18
carcassonne-uct150-vs-uct365-1000its,792,774,2124.086859042,2041.112195141,18
carcassonne-boltzmann335-vs-boltzmann50-1000its,793,775,2162.553913406,2121.747627933,18
carcassonne-uct225-vs-uct150-1000its,793,775,2248.569181335,2249.126881301,18
carcassonne-uct445-vs-uct485-1000its,793,775,2113.002211818,2051.192897988,18
carcassonne-boltzmann470-vs-boltzmann130-1000its,794,776,2214.533057945,2190.550364188,18
carcassonne-ucttuned360-vs-ucttuned450-1000its,795,777,2171.832574691,2099.317730266,18
carcassonne-ucttuned120-vs-ucttuned450-1000its,797,779,2205.717893041,2096.927542576,18
carcassonne-boltzmann30-vs-boltzmann420-1000its,798,780,2190.563516249,2114.71158953,18
carcassonne-ucttuned380-vs-ucttuned105-1000its,798,780,2201.052748218,2176.06200868,18
carcassonne-boltzmann265-vs-boltzmann205-1000its,799,781,2197.671740014,2191.761966868,18
carcassonne-boltzmann50-vs-boltzmann485-1000its,799,781,2231.542480959,2230.842088373,18
carcassonne-uct465-vs-uct305-1000its,799,781,2165.277783392,2142.036311331,18
carcassonne-uct465-vs-uct165-1000its,800,782,2182.430686647,2096.587319236,18
carcassonne-boltzmann340-vs-boltzmann40-1000its,801,783,2177.602826604,2150.311676937,18
carcassonne-boltzmann460-vs-boltzmann135-1000its,801,783,2159.813040451,2120.01430974,18
carcassonne-ucttuned240-vs-ucttuned400-1000its,801,783,2212.316686361,2195.376364269,18
carcassonne-boltzmann250-vs-boltzmann365-1000its,802,784,2207.723466562,2215.190203462,18
carcassonne-ucttuned45-vs-ucttuned105-1000its,803,785,2172.009260273,2118.757825719,18
carcassonne-boltzmann45-vs-boltzmann395-1000its,804,786,2187.557448538,2167.731874723,18
carcassonne-uct5-vs-uct95-1000its,804,786,2182.8844684,2134.387365285,18
carcassonne-boltzmann150-vs-boltzmann220-1000its,805,787,2177.939414473,2104.326698328,18
carcassonne-boltzmann270-vs-boltzmann400-1000its,805,787,2171.83076858,2097.694752122,18
carcassonne-uct275-vs-uct390-1000its,806,788,2220.681332347,2213.308912346,18
carcassonne-uct410-vs-uct295-1000its,806,788,2208.880192436,2221.605506801,18
carcassonne-ucttuned225-vs-ucttuned115-1000its,806,788,2155.075904272,2113.197297263,18
carcassonne-boltzmann140-vs-boltzmann295-1000its,807,789,2165.227380546,2140.998823171,18
carcassonne-uct350-vs-uct455-1000its,807,789,2227.719114209,2183.304681691,18
carcassonne-ucttuned235-vs-ucttuned255-1000its,807,789,2209.095924818,2202.782367753,18
carcassonne-boltzmann455-vs-boltzmann210-1000its,808,790,2206.479406307,2146.502330497,18
carcassonne-boltzmann425-vs-boltzmann120-1000its,810,792,2196.063530118,2173.412075681,18
carcassonne-uct265-vs-uct455-1000its,810,792,2198.912537692,2183.611584451,18
carcassonne-uct325-vs-uct110-1000its,810,792,2171.991128917,2155.105044069,18
carcassonne-ucttuned375-vs-ucttuned150-1000its,811,793,2291.317003311,2226.249448682,18
carcassonne-boltzmann55-vs-boltzmann235-1000its,812,794,2230.717264286,2156.491089268,18
carcassonne-ucttuned230-vs-ucttuned405-1000its,814,796,2169.546525786,2101.072956999,18
carcassonne-uct25-vs-uct225-1000its,815,797,2243.145746033,2174.073037398,18
carcassonne-ucttuned460-vs-ucttuned450-1000its,815,797,2225.620249818,2175.236177504,18
carcassonne-ucttuned95-vs-ucttuned250-1000its,816,798,2246.340355928,2185.828312072,18
carcassonne-boltzmann330-vs-boltzmann35-1000its,817,799,2207.683717696,2173.184658195,18
carcassonne-boltzmann440-vs-boltzmann105-1000its,817,799,2310.18507396,2247.487148437,18
carcassonne-ucttuned95-vs-ucttuned325-1000its,817,799,2216.301838414,2171.456102225,18
carcassonne-boltzmann60-vs-boltzmann455-1000its,819,801,2188.462231012,2105.667092986,18
carcassonne-ucttuned205-vs-ucttuned190-1000its,819,801,2196.322076761,2140.537914837,18
carcassonne-uct300-vs-uct390-1000its,820,802,2218.34226657,2151.25675696,18
carcassonne-ucttuned275-vs-ucttuned40-1000its,820,802,2209.889367511,2140.576331257,18
carcassonne-uct340-vs-uct25-1000its,821,803,2188.061478899,2159.834940055,18
carcassonne-uct285-vs-uct255-1000its,822,804,2232.665933799,2182.705355127,18
carcassonne-uct320-vs-uct105-1000its,822,804,2186.689544032,2139.804335398,18
carcassonne-uct265-vs-uct400-1000its,823,805,2185.535334925,2148.698927489,18
carcassonne-boltzmann315-vs-boltzmann70-1000its,824,806,2225.850391949,2188.939837842,18
carcassonne-boltzmann415-vs-boltzmann60-1000its,824,806,2180.009214443,2112.144319471,18
carcassonne-boltzmann55-vs-boltzmann395-1000its,824,806,2211.942781775,2153.260564637,18
carcassonne-uct230-vs-uct415-1000its,826,808,2294.201148418,2205.574831375,18
carcassonne-uct430-vs-uct220-1000its,827,809,2187.844405471,2107.222145628,18
carcassonne-boltzmann425-vs-boltzmann210-1000its,828,810,2304.63235128,2286.579358075,18
carcassonne-uct380-vs-uct440-1000its,828,810,2212.433692632,2177.203432856,18
carcassonne-uct185-vs-uct160-1000its,829,811,2208.772492872,2147.85298158,18
carcassonne-boltzmann405-vs-boltzmann420-1000its,830,812,2211.38077315,2152.983737417,18
carcassonne-ucttuned205-vs-ucttuned75-1000its,830,812,2203.316191304,2186.180506273,18
carcassonne-boltzmann220-vs-boltzmann185-1000its,831,813,2271.001723559,2182.176270976,18
carcassonne-uct325-vs-uct450-1000its,831,813,2181.38012081,2144.908194905,18
carcassonne-boltzmann55-vs-boltzmann345-1000its,832,814,2183.21335961,2166.570595868,18
carcassonne-uct225-vs-uct465-1000its,832,814,2193.491837763,2164.639406988,18
carcassonne-ucttuned365-vs-ucttuned310-1000its,832,814,2205.586766953,2169.856744103,18
carcassonne-ucttuned325-vs-ucttuned120-1000its,835,817,2189.068795251,2120.879498376,18
carcassonne-uct315-vs-uct140-1000its,836,818,2189.349038244,2186.230992176,18
carcassonne-ucttuned135-vs-ucttuned325-1000its,837,819,2150.954830761,2133.950110332,18
carcassonne-ucttuned340-vs-ucttuned350-1000its,837,819,2182.537243281,2181.831418371,18
carcassonne-boltzmann150-vs-boltzmann455-1000its,838,820,2141.154293869,2134.190942374,18
carcassonne-ucttuned400-vs-ucttuned120-1000its,838,820,2225.05374158,2163.32430804,18
carcassonne-ucttuned455-vs-ucttuned25-1000its,838,820,2101.219542311,2070.693645307,18
carcassonne-boltzmann110-vs-boltzmann235-1000its,839,821,2168.320852686,2130.571243316,18
carcassonne-boltzmann340-vs-boltzmann85-1000its,839,821,2239.182980016,2221.846632806,18
carcassonne-uct450-vs-uct40-1000its,840,822,2236.140308553,2200.007001415,18
carcassonne-ucttuned355-vs-ucttuned40-1000its,841,823,2322.193345756,2269.538856013,18
carcassonne-uct190-vs-uct460-1000its,842,824,2116.921744537,2094.147200586,18
carcassonne-boltzmann65-vs-boltzmann415-1000its,843,825,2238.797858699,2175.05197777,18
carcassonne-boltzmann65-vs-boltzmann460-1000its,844,826,2207.089901034,2152.389090896,18
carcassonne-ucttuned130-vs-ucttuned455-1000its,844,826,2173.965287471,2117.249815632,18
carcassonne-ucttuned30-vs-ucttuned125-1000its,845,827,2254.565188012,2216.439514507,18
carcassonne-ucttuned440-vs-ucttuned410-1000its,845,827,2208.329888906,2142.536968386,18
carcassonne-ucttuned185-vs-ucttuned325-1000its,846,828,2169.882855006,2093.268544657,18
carcassonne-boltzmann5-vs-boltzmann120-1000its,847,829,2222.634318526,2161.739672058,18
carcassonne-uct115-vs-uct380-1000its,847,829,2263.400700056,2198.229644565,18
carcassonne-uct155-vs-uct235-1000its,848,830,2133.048759664,2139.154279457,18
carcassonne-uct290-vs-uct215-1000its,849,831,2231.327354678,2188.288859321,18
carcassonne-uct460-vs-uct390-1000its,849,831,2298.173262395,2193.961279556,18
carcassonne-ucttuned445-vs-ucttuned195-1000its,851,833,2184.94978756,2138.120698895,18
carcassonne-ucttuned245-vs-ucttuned25-1000its,853,835,2218.264549518,2171.337915399,18
carcassonne-boltzmann410-vs-boltzmann225-1000its,854,836,2188.926852965,2170.060867604,18
carcassonne-uct140-vs-uct145-1000its,855,837,2249.772054151,2162.284196141,18
carcassonne-ucttuned460-vs-ucttuned40-1000its,856,838,2292.34038782,2249.914253557,18
carcassonne-boltzmann490-vs-boltzmann230-1000its,857,839,2182.049811409,2152.204235788,18
carcassonne-uct270-vs-uct400-1000its,860,842,2177.322949608,2161.218146365,18
carcassonne-boltzmann130-vs-boltzmann455-1000its,861,843,2194.022412874,2196.092707206,18
carcassonne-ucttuned50-vs-ucttuned255-1000its,863,845,2249.314034568,2178.264729902,18
carcassonne-ucttuned355-vs-ucttuned105-1000its,866,848,2206.820617541,2202.29380024,18
carcassonne-boltzmann235-vs-boltzmann75-1000its,869,851,2257.721897,2260.911296177,18
carcassonne-ucttuned20-vs-ucttuned445-1000its,869,851,2207.866970254,2129.444276575,18
carcassonne-ucttuned145-vs-ucttuned75-1000its,873,855,2188.314884353,2180.506381845,18
carcassonne-boltzmann70-vs-boltzmann150-1000its,875,857,2227.122748466,2156.590932336,18
carcassonne-ucttuned220-vs-ucttuned105-1000its,875,857,2218.89996959,2163.000143476,18
carcassonne-uct120-vs-uct185-1000its,877,859,2259.972054641,2236.297418067,18
carcassonne-ucttuned15-vs-ucttuned80-1000its,877,859,2187.739349529,2138.625866251,18
carcassonne-boltzmann435-vs-boltzmann65-1000its,878,860,2177.597632402,2127.535228179,18
carcassonne-uct275-vs-uct335-1000its,881,863,2203.544949609,2168.761815636,18
carcassonne-boltzmann10-vs-boltzmann260-1000its,882,864,2204.691158303,2174.144437749,18
carcassonne-uct180-vs-uct65-1000its,882,864,2259.642652382,2224.324016946,18
carcassonne-ucttuned345-vs-ucttuned120-1000its,884,866,2216.993685681,2179.42365456,18
carcassonne-ucttuned35-vs-ucttuned155-1000its,904,886,2227.811675163,2215.950904398,18
carcassonne-boltzmann465-vs-boltzmann185-1000its,905,887,2219.574812196,2173.876801089,18
carcassonne-uct360-vs-uct100-1000its,907,889,2197.29158914,2125.552474805,18
carcassonne-ucttuned195-vs-ucttuned185-1000its,910,892,2193.016728107,2106.542958048,18
carcassonne-uct480-vs-uct30-1000its,730,711,2128.834066761,2096.146861668,19
carcassonne-boltzmann235-vs-boltzmann155-1000its,744,725,2264.816868349,2218.099251446,19
carcassonne-boltzmann435-vs-boltzmann40-1000its,744,725,2161.828229199,2109.364033874,19
carcassonne-boltzmann145-vs-boltzmann295-1000its,747,728,2228.319956376,2165.542328641,19
carcassonne-boltzmann175-vs-boltzmann370-1000its,749,730,2130.063951424,2104.348523758,19
carcassonne-boltzmann175-vs-boltzmann5-1000its,757,738,2244.26135612,2242.966318669,19
carcassonne-boltzmann105-vs-boltzmann125-1000its,759,740,2139.444803944,2110.770281364,19
carcassonne-boltzmann90-vs-boltzmann310-1000its,760,741,2182.20527418,2149.825154995,19
carcassonne-boltzmann210-vs-boltzmann360-1000its,765,746,2212.864985694,2193.108437501,19
carcassonne-uct290-vs-uct30-1000its,767,748,2250.364157631,2167.350923914,19
carcassonne-boltzmann410-vs-boltzmann480-1000its,768,749,2120.223028902,2073.837813337,19
carcassonne-ucttuned300-vs-ucttuned440-1000its,769,750,2283.302730045,2247.582462124,19
carcassonne-uct285-vs-uct140-1000its,770,751,2167.581486634,2090.90701987,19
carcassonne-ucttuned395-vs-ucttuned375-1000its,770,751,2205.378515089,2161.94511215,19
carcassonne-boltzmann390-vs-boltzmann195-1000its,773,754,2101.583120448,2086.027310383,19
carcassonne-boltzmann390-vs-boltzmann315-1000its,773,754,2228.864395969,2186.572796455,19
carcassonne-boltzmann420-vs-boltzmann395-1000its,773,754,2165.331193725,2172.550408152,19
carcassonne-ucttuned60-vs-ucttuned435-1000its,773,754,2278.327288012,2194.188972763,19
carcassonne-uct145-vs-uct310-1000its,778,759,2254.72996282,2226.339568453,19
carcassonne-ucttuned105-vs-ucttuned445-1000its,778,759,2245.074220591,2191.598259581,19
carcassonne-ucttuned385-vs-ucttuned315-1000its,778,759,2158.641899015,2118.532076617,19
carcassonne-ucttuned345-vs-ucttuned475-1000its,779,760,2195.923758873,2145.018661669,19
carcassonne-boltzmann165-vs-boltzmann345-1000its,780,761,2173.861641348,2157.257116619,19
carcassonne-boltzmann55-vs-boltzmann45-1000its,780,761,2284.920722758,2241.918851002,19
carcassonne-boltzmann385-vs-boltzmann445-1000its,781,762,2245.504276258,2192.132078471,19
carcassonne-uct290-vs-uct485-1000its,781,762,2160.202382884,2141.818417555,19
carcassonne-ucttuned355-vs-ucttuned275-1000its,782,763,2179.827028693,2108.7172473,19
carcassonne-boltzmann145-vs-boltzmann140-1000its,783,764,2181.235137329,2119.817069182,19
carcassonne-ucttuned255-vs-ucttuned205-1000its,784,765,2204.105991859,2143.588142868,19
carcassonne-boltzmann125-vs-boltzmann85-1000its,785,766,2204.037647078,2167.567424929,19
carcassonne-boltzmann355-vs-boltzmann95-1000its,787,768,2231.265674569,2152.242820624,19
carcassonne-boltzmann475-vs-boltzmann20-1000its,787,768,2200.297209619,2149.723031719,19
carcassonne-boltzmann60-vs-boltzmann125-1000its,787,768,2190.350794726,2151.014963467,19
carcassonne-boltzmann490-vs-boltzmann275-1000its,788,769,2144.121501532,2068.834034981,19
carcassonne-uct45-vs-uct390-1000its,790,771,2269.130085914,2177.314558708,19
carcassonne-boltzmann210-vs-boltzmann60-1000its,792,773,2192.83413796,2171.443302064,19
carcassonne-boltzmann285-vs-boltzmann115-1000its,792,773,2236.59294421,2191.109604271,19
carcassonne-uct260-vs-uct20-1000its,793,774,2162.244381882,2096.062320589,19
carcassonne-uct315-vs-uct75-1000its,793,774,2239.963321761,2220.860207093,19
carcassonne-boltzmann380-vs-boltzmann190-1000its,794,775,2254.012673802,2152.75364207,19
carcassonne-boltzmann70-vs-boltzmann395-1000its,794,775,2211.765127909,2183.304319131,19
carcassonne-boltzmann160-vs-boltzmann195-1000its,795,776,2389.508242816,2262.873640652,19
carcassonne-boltzmann275-vs-boltzmann85-1000its,795,776,2149.787762602,2119.827448028,19
carcassonne-boltzmann390-vs-boltzmann100-1000its,796,777,2232.984610254,2194.975785226,19
carcassonne-uct400-vs-uct460-1000its,797,778,2198.43959719,2188.499354749,19
carcassonne-boltzmann325-vs-boltzmann125-1000its,799,780,2183.797878989,2149.73936558,19
carcassonne-uct345-vs-uct155-1000its,799,780,2256.031776942,2194.737748121,19
carcassonne-uct375-vs-uct490-1000its,799,780,2192.68150638,2160.598225953,19
carcassonne-boltzmann90-vs-boltzmann70-1000its,800,781,2197.186287413,2097.869000639,19
carcassonne-uct330-vs-uct110-1000its,800,781,2248.359473313,2218.707814757,19
carcassonne-boltzmann105-vs-boltzmann265-1000its,801,782,2168.506200399,2145.456616022,19
carcassonne-ucttuned235-vs-ucttuned115-1000its,802,783,2274.197316745,2226.311503299,19
carcassonne-ucttuned345-vs-ucttuned330-1000its,802,783,2152.100982948,2100.96761589,19
carcassonne-ucttuned325-vs-ucttuned235-1000its,803,784,2196.09999191,2104.994473601,19
carcassonne-boltzmann350-vs-boltzmann450-1000its,804,785,2220.916307691,2207.943134995,19
carcassonne-uct235-vs-uct145-1000its,804,785,2205.355503948,2127.438935083,19
carcassonne-uct45-vs-uct90-1000its,804,785,2211.235558635,2203.397234337,19
carcassonne-boltzmann80-vs-boltzmann440-1000its,806,787,2221.835710108,2204.149708573,19
carcassonne-uct415-vs-uct485-1000its,806,787,2101.509125325,2114.185379418,19
carcassonne-ucttuned360-vs-ucttuned315-1000its,807,788,2202.274090925,2126.79585204,19
carcassonne-uct405-vs-uct175-1000its,808,789,2133.0006381,2078.586874859,19
carcassonne-ucttuned225-vs-ucttuned430-1000its,808,789,2233.218518658,2178.919777386,19
carcassonne-boltzmann105-vs-boltzmann55-1000its,809,790,2108.154327318,2066.909909275,19
carcassonne-uct125-vs-uct325-1000its,809,790,2221.328169166,2199.857633373,19
carcassonne-uct395-vs-uct165-1000its,810,791,2186.929767031,2140.809764854,19
carcassonne-boltzmann25-vs-boltzmann90-1000its,811,792,2175.607566337,2155.564756025,19
carcassonne-boltzmann375-vs-boltzmann115-1000its,811,792,2225.741872337,2136.56307509,19
carcassonne-boltzmann250-vs-boltzmann405-1000its,812,793,2234.877301481,2219.094994034,19
carcassonne-uct445-vs-uct60-1000its,813,794,2130.364545826,2109.365948413,19
carcassonne-boltzmann45-vs-boltzmann375-1000its,815,796,2138.722571951,2094.595755596,19
carcassonne-uct190-vs-uct125-1000its,815,796,2238.560082599,2191.869303804,19
carcassonne-boltzmann145-vs-boltzmann175-1000its,816,797,2168.496915539,2143.485739679,19
carcassonne-boltzmann40-vs-boltzmann90-1000its,816,797,2168.514698312,2121.174090122,19
carcassonne-uct135-vs-uct220-1000its,816,797,2306.645245799,2250.100676694,19
carcassonne-ucttuned435-vs-ucttuned255-1000its,816,797,2210.181452872,2163.489658722,19
carcassonne-boltzmann80-vs-boltzmann400-1000its,817,798,2212.894709873,2183.844050342,19
carcassonne-ucttuned15-vs-ucttuned445-1000its,817,798,2175.823594147,2135.794166037,19
carcassonne-ucttuned450-vs-ucttuned95-1000its,817,798,2214.393226059,2167.959421857,19
carcassonne-boltzmann330-vs-boltzmann140-1000its,818,799,2208.390299181,2222.92804412,19
carcassonne-uct310-vs-uct360-1000its,818,799,2221.384414896,2160.360885856,19
carcassonne-ucttuned25-vs-ucttuned475-1000its,818,799,2155.064490608,2144.447689223,19
carcassonne-boltzmann305-vs-boltzmann210-1000its,819,800,2253.159002808,2141.126428991,19
carcassonne-ucttuned270-vs-ucttuned245-1000its,819,800,2233.1819354,2220.166514045,19
carcassonne-ucttuned305-vs-ucttuned470-1000its,819,800,2177.304001845,2157.919441628,19
carcassonne-uct295-vs-uct330-1000its,820,801,2244.038594498,2182.288293067,19
carcassonne-ucttuned100-vs-ucttuned195-1000its,820,801,2141.186180625,2109.751136899,19
carcassonne-boltzmann460-vs-boltzmann195-1000its,821,802,2173.529614356,2163.205035509,19
carcassonne-uct370-vs-uct165-1000its,821,802,2168.069302804,2152.084183192,19
carcassonne-ucttuned235-vs-ucttuned425-1000its,822,803,2177.727215143,2119.730209412,19
carcassonne-boltzmann260-vs-boltzmann155-1000its,823,804,2297.205964926,2235.031545599,19
carcassonne-ucttuned155-vs-ucttuned260-1000its,824,805,2244.261162927,2168.784859023,19
carcassonne-boltzmann170-vs-boltzmann40-1000its,825,806,2239.821659639,2212.705689397,19
carcassonne-ucttuned110-vs-ucttuned295-1000its,825,806,2183.050872412,2166.707562763,19
carcassonne-uct95-vs-uct360-1000its,826,807,2166.403987103,2121.534839244,19
carcassonne-uct230-vs-uct290-1000its,830,811,2221.404958359,2172.622700136,19
carcassonne-uct485-vs-uct385-1000its,830,811,2189.054081953,2155.310357362,19
carcassonne-uct70-vs-uct295-1000its,830,811,2187.679338738,2161.635659262,19
carcassonne-uct280-vs-uct25-1000its,831,812,2169.991991785,2154.215947281,19
carcassonne-ucttuned120-vs-ucttuned435-1000its,831,812,2147.6271007,2097.774487748,19
carcassonne-ucttuned140-vs-ucttuned245-1000its,831,812,2206.185307923,2200.98830679,19
carcassonne-ucttuned305-vs-ucttuned440-1000its,833,814,2213.477640831,2188.451425352,19
carcassonne-ucttuned50-vs-ucttuned310-1000its,833,814,2240.453293712,2146.966838295,19
carcassonne-uct290-vs-uct375-1000its,834,815,2274.954684107,2214.220371821,19
carcassonne-ucttuned375-vs-ucttuned425-1000its,834,815,2167.937172741,2118.611415014,19
carcassonne-boltzmann460-vs-boltzmann340-1000its,835,816,2171.044995377,2117.181249194,19
carcassonne-ucttuned100-vs-ucttuned315-1000its,835,816,2207.92638916,2176.862317222,19
carcassonne-boltzmann310-vs-boltzmann170-1000its,837,818,2145.847001883,2102.08065844,19
carcassonne-boltzmann440-vs-boltzmann395-1000its,838,819,2211.1343182,2188.081941516,19
carcassonne-boltzmann330-vs-boltzmann105-1000its,839,820,2242.520450101,2168.913158991,19
carcassonne-ucttuned95-vs-ucttuned205-1000its,839,820,2243.889605438,2242.96183632,19
carcassonne-boltzmann70-vs-boltzmann310-1000its,840,821,2200.309542688,2118.782905145,19
carcassonne-ucttuned275-vs-ucttuned140-1000its,840,821,2241.031631796,2190.154321249,19
carcassonne-ucttuned195-vs-ucttuned395-1000its,842,823,2212.103170746,2151.19010147,19
carcassonne-boltzmann110-vs-boltzmann305-1000its,843,824,2197.499947691,2169.426261862,19
carcassonne-boltzmann60-vs-boltzmann45-1000its,844,825,2186.686513462,2193.162423316,19
carcassonne-uct30-vs-uct40-1000its,844,825,2200.610467057,2179.048688903,19
carcassonne-uct430-vs-uct260-1000its,844,825,2203.838238938,2149.542818912,19
carcassonne-boltzmann65-vs-boltzmann230-1000its,845,826,2197.216542899,2128.50916837,19
carcassonne-ucttuned145-vs-ucttuned175-1000its,845,826,2152.453526028,2084.625261439,19
carcassonne-boltzmann10-vs-boltzmann475-1000its,846,827,2203.201859392,2155.932046347,19
carcassonne-boltzmann400-vs-boltzmann355-1000its,846,827,2172.920228624,2149.761530277,19
carcassonne-uct25-vs-uct135-1000its,846,827,2216.679033151,2164.118715358,19
carcassonne-ucttuned295-vs-ucttuned240-1000its,846,827,2183.353330806,2173.924918005,19
carcassonne-uct175-vs-uct400-1000its,847,828,2246.067384998,2181.602219206,19
carcassonne-ucttuned10-vs-ucttuned490-1000its,848,829,2122.149897756,2059.803885465,19
carcassonne-ucttuned325-vs-ucttuned55-1000its,848,829,2213.004819667,2171.887620732,19
carcassonne-uct5-vs-uct450-1000its,849,830,2192.898946527,2141.657146991,19
carcassonne-ucttuned115-vs-ucttuned120-1000its,849,830,2096.023964189,2129.714765625,19
carcassonne-boltzmann340-vs-boltzmann110-1000its,851,832,2193.455056572,2144.143601279,19
carcassonne-uct325-vs-uct30-1000its,851,832,2215.538084507,2191.395586251,19
carcassonne-ucttuned80-vs-ucttuned170-1000its,851,832,2239.752760257,2200.865773724,19
carcassonne-boltzmann345-vs-boltzmann90-1000its,854,835,2232.572364729,2188.801016639,19
carcassonne-ucttuned60-vs-ucttuned135-1000its,854,835,2175.200364326,2117.758099648,19
carcassonne-ucttuned265-vs-ucttuned30-1000its,855,836,2152.753737456,2139.885277517,19
carcassonne-uct410-vs-uct240-1000its,856,837,2224.141151567,2160.224578662,19
carcassonne-ucttuned385-vs-ucttuned75-1000its,858,839,2207.734939159,2185.875691791,19
carcassonne-boltzmann125-vs-boltzmann410-1000its,859,840,2127.852034886,2103.36279709,19
carcassonne-ucttuned220-vs-ucttuned70-1000its,860,841,2152.173441176,2126.896557932,19
carcassonne-ucttuned460-vs-ucttuned405-1000its,861,842,2229.213741948,2155.912677772,19
carcassonne-ucttuned35-vs-ucttuned40-1000its,862,843,2182.058034854,2142.28415632,19
carcassonne-uct445-vs-uct165-1000its,863,844,2225.429041724,2174.964425999,19
carcassonne-uct230-vs-uct380-1000its,864,845,2164.782267947,2099.112402015,19
carcassonne-uct25-vs-uct420-1000its,865,846,2176.729284912,2138.513461312,19
carcassonne-boltzmann230-vs-boltzmann50-1000its,866,847,2159.943563621,2119.209339605,19
carcassonne-ucttuned460-vs-ucttuned255-1000its,867,848,2195.914233383,2152.633181189,19
carcassonne-boltzmann475-vs-boltzmann415-1000its,871,852,2226.825719816,2163.500420785,19
carcassonne-boltzmann460-vs-boltzmann170-1000its,873,854,2218.507825716,2164.599695333,19
carcassonne-ucttuned125-vs-ucttuned70-1000its,873,854,2180.53799757,2173.003512774,19
carcassonne-uct215-vs-uct250-1000its,880,861,2221.689820019,2147.654132054,19
carcassonne-ucttuned80-vs-ucttuned260-1000its,889,870,2219.101708855,2191.637387727,19
carcassonne-ucttuned225-vs-ucttuned305-1000its,895,876,2183.188701252,2184.095115377,19
carcassonne-ucttuned240-vs-ucttuned300-1000its,901,882,2245.599158796,2205.452504615,19
carcassonne-uct40-vs-uct385-1000its,913,894,2270.840267032,2226.22322978,19
carcassonne-ucttuned475-vs-ucttuned220-1000its,914,895,2263.649412245,2260.049251975,19
carcassonne-uct150-vs-uct265-1000its,915,896,2181.331122076,2162.105416103,19
carcassonne-ucttuned285-vs-ucttuned250-1000its,918,899,2235.664607338,2170.646658011,19
carcassonne-uct225-vs-uct165-1000its,927,908,2242.837593479,2211.992759505,19
carcassonne-boltzmann375-vs-boltzmann315-1000its,738,718,2199.823776823,2123.283491093,20
carcassonne-ucttuned90-vs-ucttuned65-1000its,738,718,2214.668037387,2144.715110762,20
carcassonne-boltzmann70-vs-boltzmann40-1000its,739,719,2262.492305343,2215.341173596,20
carcassonne-boltzmann435-vs-boltzmann30-1000its,743,723,2212.492603997,2150.532012129,20
carcassonne-uct40-vs-uct300-1000its,744,724,2153.601286397,2105.320965881,20
carcassonne-uct475-vs-uct185-1000its,744,724,2222.84176651,2121.263668584,20
carcassonne-boltzmann210-vs-boltzmann435-1000its,748,728,2160.60585112,2074.500452198,20
carcassonne-boltzmann130-vs-boltzmann165-1000its,751,731,2234.778131266,2183.822986813,20
carcassonne-ucttuned435-vs-ucttuned345-1000its,752,732,2169.628462782,2136.904129458,20
carcassonne-uct240-vs-uct195-1000its,756,736,2205.195930249,2165.171784742,20
carcassonne-boltzmann325-vs-boltzmann390-1000its,758,738,2220.762750371,2136.49282305,20
carcassonne-boltzmann360-vs-boltzmann265-1000its,759,739,2172.515717505,2150.130342367,20
carcassonne-uct410-vs-uct150-1000its,759,739,2180.870509119,2159.71627414,20
carcassonne-boltzmann390-vs-boltzmann105-1000its,760,740,2224.768989841,2187.627490449,20
carcassonne-boltzmann100-vs-boltzmann320-1000its,762,742,2225.642537977,2139.07043986,20
carcassonne-uct450-vs-uct30-1000its,769,749,2225.182589883,2130.533858178,20
carcassonne-boltzmann415-vs-boltzmann195-1000its,771,751,2228.90829101,2173.602094153,20
carcassonne-boltzmann470-vs-boltzmann465-1000its,771,751,2211.556240911,2080.602236709,20
carcassonne-ucttuned310-vs-ucttuned170-1000its,771,751,2139.870008992,2088.509011718,20
carcassonne-uct120-vs-uct95-1000its,773,753,2129.889392179,2117.354886656,20
carcassonne-boltzmann295-vs-boltzmann465-1000its,776,756,2217.812521338,2169.877522707,20
carcassonne-uct240-vs-uct335-1000its,776,756,2202.556728005,2074.762199256,20
carcassonne-boltzmann100-vs-boltzmann80-1000its,778,758,2131.317447495,2100.503768843,20
carcassonne-uct260-vs-uct210-1000its,778,758,2209.010717464,2139.56563489,20
carcassonne-uct430-vs-uct395-1000its,779,759,2118.946378145,2085.021406002,20
carcassonne-boltzmann320-vs-boltzmann445-1000its,780,760,2196.914307,2137.677435884,20
carcassonne-boltzmann215-vs-boltzmann5-1000its,782,762,2113.669164308,2069.872755002,20
carcassonne-ucttuned400-vs-ucttuned210-1000its,782,762,2131.399514919,2139.44629925,20
carcassonne-boltzmann175-vs-boltzmann20-1000its,783,763,2200.935699834,2142.769075443,20
carcassonne-ucttuned425-vs-ucttuned105-1000its,783,763,2224.817274277,2172.110406249,20
carcassonne-boltzmann85-vs-boltzmann415-1000its,784,764,2195.558868814,2129.013870466,20
carcassonne-ucttuned115-vs-ucttuned270-1000its,784,764,2272.500041196,2204.892032137,20
carcassonne-uct225-vs-uct20-1000its,785,765,2232.983744103,2168.932177787,20
carcassonne-ucttuned220-vs-ucttuned485-1000its,785,765,2196.240749041,2193.841635845,20
carcassonne-boltzmann135-vs-boltzmann495-1000its,788,768,2263.982212832,2144.353014915,20
carcassonne-ucttuned25-vs-ucttuned255-1000its,788,768,2251.501905569,2202.334450466,20
carcassonne-ucttuned405-vs-ucttuned180-1000its,791,771,2156.859134377,2093.816064182,20
carcassonne-boltzmann410-vs-boltzmann45-1000its,792,772,2249.244410987,2218.896010957,20
carcassonne-boltzmann70-vs-boltzmann100-1000its,792,772,2162.401353681,2090.622183757,20
carcassonne-boltzmann200-vs-boltzmann250-1000its,793,773,2186.030637401,2178.339416662,20
carcassonne-boltzmann240-vs-boltzmann300-1000its,793,773,2164.792678551,2177.554976111,20
carcassonne-boltzmann315-vs-boltzmann215-1000its,793,773,2176.913215628,2127.895653956,20
carcassonne-uct140-vs-uct225-1000its,793,773,2154.533059735,2133.275967079,20
carcassonne-uct215-vs-uct190-1000its,794,774,2159.80660766,2097.904228132,20
carcassonne-uct410-vs-uct5-1000its,795,775,2181.732614572,2132.551982732,20
carcassonne-boltzmann285-vs-boltzmann245-1000its,796,776,2196.320571642,2174.514549501,20
carcassonne-boltzmann110-vs-boltzmann70-1000its,797,777,2214.147064045,2145.020952748,20
carcassonne-boltzmann370-vs-boltzmann180-1000its,798,778,2202.804365951,2140.885822233,20
carcassonne-uct50-vs-uct20-1000its,798,778,2196.844417475,2097.568583193,20
carcassonne-uct35-vs-uct455-1000its,799,779,2177.11290519,2121.593082733,20
carcassonne-ucttuned105-vs-ucttuned335-1000its,799,779,2180.784229698,2082.407575266,20
carcassonne-ucttuned480-vs-ucttuned245-1000its,799,779,2170.355070696,2121.31802264,20
carcassonne-ucttuned330-vs-ucttuned205-1000its,801,781,2289.118663906,2207.976082312,20
carcassonne-boltzmann140-vs-boltzmann470-1000its,803,783,2196.069569193,2159.684778936,20
carcassonne-boltzmann15-vs-boltzmann85-1000its,804,784,2285.169393402,2263.05370927,20
carcassonne-ucttuned185-vs-ucttuned195-1000its,806,786,2203.500604882,2212.926070581,20
carcassonne-boltzmann360-vs-boltzmann85-1000its,807,787,2203.70613192,2166.928989457,20
carcassonne-uct385-vs-uct375-1000its,807,787,2220.498332719,2166.678852975,20
carcassonne-uct105-vs-uct95-1000its,809,789,2116.239453193,2086.586361464,20
carcassonne-uct480-vs-uct55-1000its,809,789,2139.931427937,2096.699979773,20
carcassonne-ucttuned235-vs-ucttuned215-1000its,809,789,2208.403476257,2181.776034949,20
carcassonne-ucttuned485-vs-ucttuned150-1000its,809,789,2231.064802314,2165.316192527,20
carcassonne-uct105-vs-uct45-1000its,810,790,2139.142352499,2110.380123621,20
carcassonne-boltzmann145-vs-boltzmann280-1000its,811,791,2158.139796802,2128.015130602,20
carcassonne-boltzmann285-vs-boltzmann260-1000its,811,791,2161.453774804,2110.62769875,20
carcassonne-boltzmann250-vs-boltzmann315-1000its,815,795,2176.167792454,2191.16025882,20
carcassonne-ucttuned495-vs-ucttuned400-1000its,815,795,2210.047911313,2164.77150799,20
carcassonne-ucttuned320-vs-ucttuned20-1000its,816,796,2171.534619254,2145.143467796,20
carcassonne-uct260-vs-uct70-1000its,818,798,2297.807205299,2270.630511828,20
carcassonne-ucttuned255-vs-ucttuned180-1000its,821,801,2179.305520861,2103.868425819,20
carcassonne-boltzmann50-vs-boltzmann285-1000its,822,802,2198.33350515,2188.111977317,20
carcassonne-uct25-vs-uct205-1000its,822,802,2156.154230564,2149.083827136,20
carcassonne-uct290-vs-uct440-1000its,822,802,2180.079143796,2154.310491273,20
carcassonne-uct35-vs-uct125-1000its,823,803,2170.284140033,2096.779540914,20
carcassonne-uct305-vs-uct85-1000its,825,805,2195.199847053,2165.37417415,20
carcassonne-ucttuned175-vs-ucttuned210-1000its,825,805,2163.458081288,2158.546280162,20
carcassonne-boltzmann365-vs-boltzmann95-1000its,827,807,2123.459445886,2093.363168124,20
carcassonne-ucttuned275-vs-ucttuned110-1000its,827,807,2271.294992539,2197.520010839,20
carcassonne-boltzmann220-vs-boltzmann165-1000its,828,808,2228.819399355,2193.457003629,20
carcassonne-boltzmann165-vs-boltzmann160-1000its,831,811,2202.625596816,2172.91068359,20
carcassonne-uct205-vs-uct305-1000its,832,812,2199.441987495,2130.19996921,20
carcassonne-ucttuned325-vs-ucttuned135-1000its,832,812,2150.345142027,2140.725303787,20
carcassonne-boltzmann185-vs-boltzmann495-1000its,833,813,2177.063247675,2144.083444641,20
carcassonne-uct50-vs-uct80-1000its,834,814,2253.544077951,2199.671605861,20
carcassonne-ucttuned50-vs-ucttuned240-1000its,835,815,2172.010602181,2123.241617903,20
carcassonne-boltzmann130-vs-boltzmann155-1000its,837,817,2207.005242366,2149.463959616,20
carcassonne-ucttuned340-vs-ucttuned310-1000its,837,817,2132.295377162,2091.320110128,20
carcassonne-boltzmann255-vs-boltzmann415-1000its,839,819,2202.175870452,2144.422189444,20
carcassonne-uct115-vs-uct265-1000its,839,819,2200.715464114,2176.019358171,20
carcassonne-uct360-vs-uct125-1000its,839,819,2214.692623481,2170.295058504,20
carcassonne-uct450-vs-uct55-1000its,839,819,2238.396629523,2164.528895928,20
carcassonne-ucttuned155-vs-ucttuned495-1000its,840,820,2229.085676773,2182.118476286,20
carcassonne-ucttuned475-vs-ucttuned450-1000its,840,820,2232.33313141,2214.39170276,20
carcassonne-ucttuned55-vs-ucttuned170-1000its,840,820,2148.82528528,2109.314996139,20
carcassonne-boltzmann10-vs-boltzmann355-1000its,842,822,2276.302101658,2196.40364545,20
carcassonne-uct10-vs-uct50-1000its,842,822,2192.633187453,2117.14110041,20
carcassonne-ucttuned240-vs-ucttuned390-1000its,842,822,2206.424638748,2191.558606435,20
carcassonne-ucttuned450-vs-ucttuned415-1000its,842,822,2287.958357054,2267.309401143,20
carcassonne-uct435-vs-uct15-1000its,843,823,2103.854284147,2066.975635518,20
carcassonne-uct495-vs-uct45-1000its,843,823,2127.194629833,2106.699692082,20
carcassonne-uct380-vs-uct335-1000its,844,824,2254.09168111,2229.234281685,20
carcassonne-ucttuned245-vs-ucttuned115-1000its,844,824,2308.522090786,2240.360607918,20
carcassonne-uct100-vs-uct395-1000its,845,825,2219.599793391,2183.067612266,20
carcassonne-ucttuned40-vs-ucttuned100-1000its,845,825,2155.897151747,2122.76317911,20
carcassonne-uct360-vs-uct230-1000its,846,826,2313.178895516,2218.525076611,20
carcassonne-ucttuned75-vs-ucttuned290-1000its,847,827,2172.617937373,2144.159493227,20
carcassonne-boltzmann385-vs-boltzmann210-1000its,848,828,2202.242900221,2123.53038024,20
carcassonne-boltzmann405-vs-boltzmann390-1000its,848,828,2189.896787573,2119.597434627,20
carcassonne-uct355-vs-uct165-1000its,848,828,2237.286300158,2177.135561085,20
carcassonne-uct45-vs-uct110-1000its,848,828,2193.637371393,2149.240855841,20
carcassonne-ucttuned440-vs-ucttuned435-1000its,849,829,2154.007815109,2102.987856732,20
carcassonne-ucttuned330-vs-ucttuned105-1000its,850,830,2199.322418377,2183.379528231,20
carcassonne-boltzmann180-vs-boltzmann70-1000its,852,832,2216.210860533,2159.278636166,20
carcassonne-uct70-vs-uct90-1000its,853,833,2270.625652404,2201.721979068,20
carcassonne-ucttuned355-vs-ucttuned265-1000its,855,835,2232.435853,2216.120224999,20
carcassonne-uct110-vs-uct65-1000its,856,836,2130.92095061,2124.164666429,20
carcassonne-uct410-vs-uct165-1000its,856,836,2193.642991351,2138.904546061,20
carcassonne-uct305-vs-uct315-1000its,857,837,2165.510020793,2133.985705927,20
carcassonne-uct430-vs-uct55-1000its,858,838,2190.446709681,2163.20619772,20
carcassonne-ucttuned215-vs-ucttuned210-1000its,858,838,2295.53548203,2267.047978559,20
carcassonne-boltzmann135-vs-boltzmann455-1000its,859,839,2212.616876681,2139.362106261,20
carcassonne-ucttuned450-vs-ucttuned145-1000its,860,840,2174.65223643,2155.12129347,20
carcassonne-boltzmann75-vs-boltzmann170-1000its,861,841,2239.933629644,2135.841136665,20
carcassonne-uct265-vs-uct115-1000its,861,841,2161.376723618,2134.420591497,20
carcassonne-ucttuned475-vs-ucttuned445-1000its,861,841,2163.701588617,2149.619333627,20
carcassonne-boltzmann425-vs-boltzmann90-1000its,862,842,2147.443948869,2131.526969094,20
carcassonne-uct470-vs-uct160-1000its,862,842,2216.333838292,2145.532839666,20
carcassonne-uct145-vs-uct465-1000its,863,843,2241.840345536,2153.931351774,20
carcassonne-ucttuned465-vs-ucttuned35-1000its,863,843,2188.933681907,2193.944674082,20
carcassonne-uct380-vs-uct285-1000its,865,845,2177.730807033,2146.116507287,20
carcassonne-uct385-vs-uct130-1000its,865,845,2190.75561907,2136.354157827,20
carcassonne-boltzmann165-vs-boltzmann70-1000its,866,846,2149.776959973,2114.331896033,20
carcassonne-uct350-vs-uct200-1000its,867,847,2228.388483858,2224.004871552,20
carcassonne-uct420-vs-uct430-1000its,868,848,2213.85992108,2173.59782224,20
carcassonne-ucttuned290-vs-ucttuned90-1000its,869,849,2168.162354767,2146.529605344,20
carcassonne-ucttuned375-vs-ucttuned455-1000its,870,850,2235.915131038,2144.387706604,20
carcassonne-uct175-vs-uct85-1000its,874,854,2259.159238432,2232.824689488,20
carcassonne-ucttuned100-vs-ucttuned345-1000its,876,856,2127.702860384,2109.943616748,20
carcassonne-boltzmann265-vs-boltzmann325-1000its,879,859,2205.39760885,2137.934799168,20
carcassonne-uct195-vs-uct30-1000its,884,864,2221.948474236,2188.310846324,20
carcassonne-ucttuned5-vs-ucttuned420-1000its,887,867,2194.283472995,2185.46719495,20
carcassonne-uct15-vs-uct95-1000its,889,869,2236.825190393,2183.422177501,20
carcassonne-uct25-vs-uct200-1000its,891,871,2197.432897059,2141.515743698,20
carcassonne-uct345-vs-uct85-1000its,905,885,2253.886331427,2204.175697711,20
carcassonne-uct415-vs-uct295-1000its,905,885,2166.995478275,2136.969112086,20
carcassonne-ucttuned90-vs-ucttuned305-1000its,905,885,2183.216006771,2140.279172707,20
carcassonne-ucttuned285-vs-ucttuned90-1000its,914,894,2192.074688737,2121.730142755,20
carcassonne-uct35-vs-uct280-1000its,916,896,2197.984800955,2179.924313102,20
carcassonne-boltzmann200-vs-boltzmann455-1000its,923,903,2233.711534111,2118.155854286,20
carcassonne-ucttuned250-vs-ucttuned275-1000its,930,910,2186.655358798,2149.897782825,20
carcassonne-uct340-vs-uct380-1000its,664,643,1720.691464399,1677.917593512,21
carcassonne-boltzmann225-vs-boltzmann215-1000its,667,646,1761.114580433,1745.885722454,21
carcassonne-ucttuned370-vs-ucttuned165-1000its,716,695,2133.761224609,2087.919397874,21
carcassonne-ucttuned155-vs-ucttuned420-1000its,746,725,2217.845722655,2183.236268726,21
carcassonne-boltzmann55-vs-boltzmann145-1000its,752,731,2161.03971222,2098.279477589,21
carcassonne-uct420-vs-uct405-1000its,752,731,2157.279786047,2117.692779865,21
carcassonne-uct170-vs-uct410-1000its,753,732,2226.404270861,2154.689787315,21
carcassonne-boltzmann190-vs-boltzmann30-1000its,754,733,2179.283517757,2134.641280773,21
carcassonne-boltzmann275-vs-boltzmann70-1000its,759,738,2201.777686891,2116.678306202,21
carcassonne-boltzmann455-vs-boltzmann470-1000its,760,739,2181.829031666,2165.738170653,21
carcassonne-boltzmann90-vs-boltzmann285-1000its,762,741,2141.550308454,2111.743956015,21
carcassonne-uct490-vs-uct35-1000its,762,741,2287.285798882,2226.322429629,21
carcassonne-ucttuned70-vs-ucttuned445-1000its,763,742,2153.937161822,2081.003874636,21
carcassonne-ucttuned55-vs-ucttuned185-1000its,764,743,2107.044138216,2092.897215271,21
carcassonne-boltzmann125-vs-boltzmann430-1000its,767,746,2236.484453788,2151.653682219,21
carcassonne-boltzmann215-vs-boltzmann495-1000its,767,746,2226.706225306,2160.433198433,21
carcassonne-boltzmann225-vs-boltzmann330-1000its,767,746,2166.908150918,2170.762816311,21
carcassonne-boltzmann215-vs-boltzmann295-1000its,768,747,2227.547862219,2195.461913694,21
carcassonne-boltzmann285-vs-boltzmann25-1000its,768,747,2250.278801736,2218.240755578,21
carcassonne-boltzmann435-vs-boltzmann235-1000its,773,752,2188.619344064,2107.584989963,21
carcassonne-uct455-vs-uct40-1000its,773,752,2170.678689415,2143.153217052,21
carcassonne-uct235-vs-uct405-1000its,774,753,2163.376309868,2135.911717243,21
carcassonne-ucttuned170-vs-ucttuned65-1000its,775,754,2230.766837217,2148.187837769,21
carcassonne-uct315-vs-uct125-1000its,776,755,2215.930503564,2194.861385144,21
carcassonne-uct135-vs-uct300-1000its,777,756,2214.092612513,2160.818090766,21
carcassonne-ucttuned265-vs-ucttuned275-1000its,777,756,2159.441352647,2121.478993813,21
carcassonne-uct445-vs-uct290-1000its,778,757,2204.419755264,2146.534713395,21
carcassonne-ucttuned405-vs-ucttuned110-1000its,779,758,2269.696735661,2237.979776094,21
carcassonne-ucttuned460-vs-ucttuned465-1000its,785,764,2165.391514174,2106.964549245,21
carcassonne-uct225-vs-uct65-1000its,786,765,2135.075379172,2111.384708304,21
carcassonne-ucttuned30-vs-ucttuned85-1000its,786,765,2214.30556487,2216.990312419,21
carcassonne-ucttuned105-vs-ucttuned310-1000its,788,767,2240.905165268,2218.23498804,21
carcassonne-ucttuned335-vs-ucttuned470-1000its,788,767,2252.753452111,2237.742505409,21
carcassonne-boltzmann400-vs-boltzmann150-1000its,789,768,2165.316650045,2135.890253808,21
carcassonne-boltzmann435-vs-boltzmann220-1000its,789,768,2192.401866485,2140.498771931,21
carcassonne-uct325-vs-uct345-1000its,789,768,2224.439899055,2156.294778881,21
carcassonne-uct240-vs-uct20-1000its,790,769,2102.714386029,2055.681999188,21
carcassonne-boltzmann390-vs-boltzmann355-1000its,791,770,2096.204443193,2103.781573305,21
carcassonne-boltzmann75-vs-boltzmann470-1000its,792,771,2218.674605991,2168.864694666,21
carcassonne-boltzmann150-vs-boltzmann430-1000its,793,772,2300.007919745,2232.317232258,21
carcassonne-boltzmann290-vs-boltzmann230-1000its,794,773,2172.111582787,2143.174909375,21
carcassonne-boltzmann405-vs-boltzmann135-1000its,794,773,2159.332085088,2139.618542419,21
carcassonne-ucttuned20-vs-ucttuned125-1000its,794,773,2184.048173884,2135.942182634,21
carcassonne-uct45-vs-uct275-1000its,795,774,2183.107827798,2148.268756856,21
carcassonne-uct280-vs-uct240-1000its,798,777,2228.523369242,2179.807524303,21
carcassonne-boltzmann205-vs-boltzmann270-1000its,799,778,2178.601427934,2149.227390588,21
carcassonne-uct260-vs-uct490-1000its,799,778,2204.762839713,2143.644142631,21
carcassonne-ucttuned320-vs-ucttuned150-1000its,799,778,2215.983976419,2125.875591193,21
carcassonne-uct75-vs-uct120-1000its,802,781,2215.59075084,2186.262674248,21
carcassonne-boltzmann435-vs-boltzmann390-1000its,804,783,2199.069768576,2159.282771717,21
carcassonne-ucttuned35-vs-ucttuned125-1000its,804,783,2279.462587318,2226.058911017,21
carcassonne-ucttuned490-vs-ucttuned165-1000its,804,783,2149.075235997,2097.589871248,21
carcassonne-boltzmann40-vs-boltzmann20-1000its,805,784,2246.624805183,2169.802172853,21
carcassonne-ucttuned300-vs-ucttuned390-1000its,807,786,2175.496578341,2125.386119106,21
carcassonne-uct115-vs-uct400-1000its,809,788,2273.616615937,2199.83059566,21
carcassonne-uct420-vs-uct180-1000its,809,788,2205.456229585,2179.612582623,21
carcassonne-ucttuned5-vs-ucttuned275-1000its,809,788,2171.186840184,2143.413615457,21
carcassonne-boltzmann430-vs-boltzmann395-1000its,810,789,2148.036468472,2102.062126822,21
carcassonne-ucttuned235-vs-ucttuned85-1000its,810,789,2155.07578734,2139.821714945,21
carcassonne-ucttuned240-vs-ucttuned440-1000its,810,789,2135.936685478,2101.348557416,21
carcassonne-uct425-vs-uct30-1000its,811,790,2144.150548711,2080.790229849,21
carcassonne-ucttuned75-vs-ucttuned185-1000its,811,790,2200.299297281,2145.057271115,21
carcassonne-boltzmann10-vs-boltzmann410-1000its,812,791,2210.575436028,2133.879569884,21
carcassonne-boltzmann160-vs-boltzmann495-1000its,814,793,2172.181292715,2138.828367086,21
carcassonne-boltzmann60-vs-boltzmann220-1000its,814,793,2175.037695811,2129.803190059,21
carcassonne-boltzmann85-vs-boltzmann470-1000its,814,793,2176.976333895,2131.583300938,21
carcassonne-uct430-vs-uct125-1000its,814,793,2208.198685344,2122.365315839,21
carcassonne-ucttuned450-vs-ucttuned340-1000its,816,795,2209.82481203,2123.314075921,21
carcassonne-ucttuned110-vs-ucttuned270-1000its,817,796,2234.356315797,2175.993262081,21
carcassonne-boltzmann130-vs-boltzmann265-1000its,818,797,2231.404898875,2134.932219858,21
carcassonne-boltzmann235-vs-boltzmann135-1000its,820,799,2164.467447519,2136.856749466,21
carcassonne-boltzmann340-vs-boltzmann290-1000its,820,799,2229.858847867,2220.921298371,21
carcassonne-uct215-vs-uct365-1000its,820,799,2203.390104241,2163.664795969,21
carcassonne-ucttuned280-vs-ucttuned315-1000its,821,800,2310.263956685,2264.900731966,21
carcassonne-boltzmann370-vs-boltzmann85-1000its,822,801,2285.61059683,2184.293828338,21
carcassonne-boltzmann205-vs-boltzmann200-1000its,823,802,2219.963394942,2156.95440292,21
carcassonne-uct415-vs-uct100-1000its,823,802,2291.270863338,2257.176135601,21
carcassonne-boltzmann405-vs-boltzmann215-1000its,824,803,2117.189915965,2083.549379992,21
carcassonne-boltzmann275-vs-boltzmann420-1000its,825,804,2237.904889058,2220.669246385,21
carcassonne-boltzmann395-vs-boltzmann10-1000its,825,804,2184.756874044,2189.058269688,21
carcassonne-uct290-vs-uct405-1000its,825,804,2224.587123064,2182.942323841,21
carcassonne-uct40-vs-uct480-1000its,825,804,2133.478775756,2159.174571443,21
carcassonne-ucttuned125-vs-ucttuned285-1000its,825,804,2213.143197987,2165.855156957,21
carcassonne-boltzmann40-vs-boltzmann260-1000its,828,807,2209.243439255,2154.516495074,21
carcassonne-boltzmann365-vs-boltzmann385-1000its,829,808,2200.298678499,2147.738642807,21
carcassonne-uct305-vs-uct60-1000its,829,808,2190.958536952,2169.300248559,21
carcassonne-boltzmann20-vs-boltzmann145-1000its,830,809,2281.275494718,2210.9723847,21
carcassonne-boltzmann385-vs-boltzmann425-1000its,830,809,2149.654167789,2134.945399032,21
carcassonne-uct485-vs-uct415-1000its,830,809,2223.977714521,2198.253999329,21
carcassonne-ucttuned485-vs-ucttuned120-1000its,830,809,2209.38036319,2142.625051104,21
carcassonne-ucttuned170-vs-ucttuned105-1000its,831,810,2204.830475443,2126.30655107,21
carcassonne-boltzmann295-vs-boltzmann100-1000its,833,812,2211.262648433,2209.316936642,21
carcassonne-ucttuned345-vs-ucttuned140-1000its,833,812,2227.470797943,2192.809222344,21
carcassonne-ucttuned400-vs-ucttuned45-1000its,833,812,2262.302552631,2222.555060467,21
carcassonne-boltzmann190-vs-boltzmann255-1000its,835,814,2240.889602636,2130.48152357,21
carcassonne-uct65-vs-uct475-1000its,835,814,2184.036685391,2143.584502222,21
carcassonne-ucttuned225-vs-ucttuned350-1000its,835,814,2235.7095955,2206.126140523,21
carcassonne-boltzmann465-vs-boltzmann250-1000its,836,815,2146.81576618,2121.950185207,21
carcassonne-uct150-vs-uct220-1000its,836,815,2211.09553315,2120.739599724,21
carcassonne-ucttuned235-vs-ucttuned405-1000its,837,816,2201.17574456,2183.360607025,21
carcassonne-uct135-vs-uct215-1000its,838,817,2262.15787776,2224.84997543,21
carcassonne-uct245-vs-uct360-1000its,838,817,2211.154022421,2174.423629597,21
carcassonne-ucttuned100-vs-ucttuned55-1000its,838,817,2173.172902536,2127.193380512,21
carcassonne-ucttuned245-vs-ucttuned195-1000its,838,817,2227.820831865,2204.003837763,21
carcassonne-boltzmann55-vs-boltzmann190-1000its,839,818,2191.3925774,2130.048246645,21
carcassonne-ucttuned290-vs-ucttuned260-1000its,840,819,2176.559167708,2150.066436857,21
carcassonne-boltzmann265-vs-boltzmann185-1000its,841,820,2248.070694427,2160.707695896,21
carcassonne-uct170-vs-uct470-1000its,841,820,2143.122936928,2126.909624403,21
carcassonne-ucttuned450-vs-ucttuned165-1000its,841,820,2206.623405258,2117.900302908,21
carcassonne-ucttuned430-vs-ucttuned130-1000its,842,821,2148.832195,2142.664010311,21
carcassonne-boltzmann365-vs-boltzmann335-1000its,844,823,2202.885063244,2149.752976791,21
carcassonne-uct35-vs-uct415-1000its,844,823,2163.592525313,2119.628735979,21
carcassonne-uct405-vs-uct140-1000its,844,823,2218.146490254,2190.553053211,21
carcassonne-uct330-vs-uct285-1000its,846,825,2203.76226008,2197.163721879,21
carcassonne-uct335-vs-uct20-1000its,846,825,2211.015076772,2129.997391635,21
carcassonne-ucttuned40-vs-ucttuned315-1000its,846,825,2203.420163931,2132.016668367,21
carcassonne-boltzmann120-vs-boltzmann160-1000its,847,826,2217.355952824,2178.771697632,21
carcassonne-uct465-vs-uct30-1000its,847,826,2160.502736909,2089.42188922,21
carcassonne-boltzmann205-vs-boltzmann30-1000its,849,828,2159.773753081,2086.503469615,21
carcassonne-ucttuned360-vs-ucttuned230-1000its,851,830,2235.662082415,2127.881841579,21
carcassonne-boltzmann435-vs-boltzmann430-1000its,853,832,2216.643186689,2136.201560591,21
carcassonne-uct100-vs-uct335-1000its,853,832,2173.65693154,2157.178653634,21
carcassonne-uct430-vs-uct230-1000its,853,832,2239.762729667,2173.21808404,21
carcassonne-ucttuned340-vs-ucttuned225-1000its,854,833,2107.630534519,2070.438493364,21
carcassonne-ucttuned405-vs-ucttuned280-1000its,855,834,2209.866625319,2183.901585851,21
carcassonne-boltzmann200-vs-boltzmann485-1000its,856,835,2213.994514898,2182.411076965,21
carcassonne-ucttuned155-vs-ucttuned470-1000its,857,836,2166.229186397,2150.556215351,21
carcassonne-uct350-vs-uct265-1000its,858,837,2251.121787825,2211.448388698,21
carcassonne-uct75-vs-uct365-1000its,859,838,2252.746830846,2201.487547881,21
carcassonne-boltzmann270-vs-boltzmann200-1000its,860,839,2219.726823332,2196.338065788,21
carcassonne-ucttuned275-vs-ucttuned145-1000its,860,839,2218.321006258,2166.201363841,21
carcassonne-ucttuned215-vs-ucttuned390-1000its,862,841,2146.715145118,2094.019877437,21
carcassonne-uct235-vs-uct440-1000its,863,842,2180.663406379,2166.351479853,21
carcassonne-uct15-vs-uct415-1000its,867,846,2202.72209207,2159.314390167,21
carcassonne-uct435-vs-uct475-1000its,867,846,2227.035550139,2184.990837675,21
carcassonne-uct115-vs-uct280-1000its,868,847,2195.355057338,2103.114343963,21
carcassonne-uct470-vs-uct220-1000its,868,847,2208.194089595,2143.912969071,21
carcassonne-ucttuned150-vs-ucttuned430-1000its,868,847,2168.307880455,2138.697762251,21
carcassonne-boltzmann225-vs-boltzmann25-1000its,869,848,2255.824414901,2143.46605573,21
carcassonne-uct365-vs-uct180-1000its,869,848,2194.625778559,2179.674194538,21
carcassonne-ucttuned260-vs-ucttuned385-1000its,870,849,2185.893370039,2136.914933666,21
carcassonne-ucttuned395-vs-ucttuned480-1000its,871,850,2179.787507578,2137.044876028,21
carcassonne-boltzmann240-vs-boltzmann395-1000its,872,851,2282.263653282,2232.920831303,21
carcassonne-ucttuned450-vs-ucttuned135-1000its,873,852,2200.950122223,2138.683392854,21
carcassonne-boltzmann390-vs-boltzmann290-1000its,875,854,2185.76218735,2152.456411684,21
carcassonne-ucttuned145-vs-ucttuned200-1000its,875,854,2185.281977459,2141.556206929,21
carcassonne-ucttuned5-vs-ucttuned75-1000its,876,855,2159.059210824,2117.54563439,21
carcassonne-boltzmann150-vs-boltzmann490-1000its,880,859,2235.34841899,2208.863178445,21
carcassonne-uct15-vs-uct420-1000its,880,859,2212.089188139,2139.324689507,21
carcassonne-uct470-vs-uct360-1000its,880,859,2133.103321908,2116.886870666,21
carcassonne-ucttuned465-vs-ucttuned380-1000its,883,862,2239.267890571,2139.99640397,21
carcassonne-boltzmann495-vs-boltzmann405-1000its,887,866,2240.963178461,2199.057144744,21
carcassonne-uct420-vs-uct340-1000its,888,867,2203.692121714,2125.132759351,21
carcassonne-ucttuned210-vs-ucttuned115-1000its,892,871,2263.495121835,2215.624044434,21
carcassonne-uct55-vs-uct45-1000its,893,872,2168.389337914,2147.322253008,21
carcassonne-uct20-vs-uct315-1000its,894,873,2191.003073836,2143.504053973,21
carcassonne-boltzmann195-vs-boltzmann105-1000its,895,874,2200.744774154,2185.664334795,21
carcassonne-ucttuned10-vs-ucttuned245-1000its,895,874,2219.206630686,2162.636297387,21
carcassonne-ucttuned100-vs-ucttuned90-1000its,898,877,2201.486371447,2170.511898802,21
carcassonne-ucttuned245-vs-ucttuned200-1000its,898,877,2208.545856987,2135.902400253,21
carcassonne-boltzmann295-vs-boltzmann20-1000its,901,880,2246.127148136,2181.299790744,21
carcassonne-boltzmann495-vs-boltzmann470-1000its,901,880,2218.113664181,2161.633725796,21
carcassonne-ucttuned240-vs-ucttuned270-1000its,928,907,2186.35992242,2164.858647911,21
carcassonne-uct260-vs-uct175-1000its,710,688,2232.867616977,2140.204152048,22
carcassonne-boltzmann55-vs-boltzmann30-1000its,720,698,2146.123625772,2140.508731711,22
carcassonne-ucttuned35-vs-ucttuned465-1000its,733,711,2261.035203375,2171.995657062,22
carcassonne-uct220-vs-uct240-1000its,741,719,2227.11759359,2120.371156488,22
carcassonne-uct330-vs-uct35-1000its,745,723,2237.749973778,2220.01521891,22
carcassonne-boltzmann275-vs-boltzmann430-1000its,747,725,2127.202198965,2122.47665696,22
carcassonne-boltzmann185-vs-boltzmann240-1000its,748,726,2229.275430199,2148.604301486,22
carcassonne-boltzmann10-vs-boltzmann80-1000its,750,728,2200.480072127,2122.773228402,22
carcassonne-ucttuned495-vs-ucttuned220-1000its,755,733,2184.467416993,2127.599393609,22
carcassonne-ucttuned85-vs-ucttuned490-1000its,759,737,2321.151700954,2252.297721921,22
carcassonne-boltzmann225-vs-boltzmann160-1000its,761,739,2163.718018148,2119.142461285,22
carcassonne-boltzmann490-vs-boltzmann165-1000its,762,740,2219.654290194,2235.82662322,22
carcassonne-boltzmann5-vs-boltzmann220-1000its,762,740,2311.088964483,2243.288929306,22
carcassonne-uct185-vs-uct200-1000its,762,740,2124.552615546,2067.472810971,22
carcassonne-uct55-vs-uct35-1000its,762,740,2150.305993581,2180.927849187,22
carcassonne-uct235-vs-uct455-1000its,767,745,2147.795722928,2114.648394676,22
carcassonne-boltzmann185-vs-boltzmann150-1000its,768,746,2152.95426068,2134.811887606,22
carcassonne-uct155-vs-uct40-1000its,771,749,2337.454928896,2304.236000376,22
carcassonne-ucttuned235-vs-ucttuned200-1000its,771,749,2210.455048615,2182.916155351,22
carcassonne-uct215-vs-uct70-1000its,772,750,2236.926472285,2209.816288594,22
carcassonne-uct45-vs-uct295-1000its,772,750,2219.915959613,2155.096902551,22
carcassonne-ucttuned120-vs-ucttuned15-1000its,772,750,2203.279285954,2124.757795424,22
carcassonne-uct245-vs-uct265-1000its,773,751,2145.462926924,2141.862813261,22
carcassonne-boltzmann100-vs-boltzmann450-1000its,774,752,2215.684639055,2172.797580876,22
carcassonne-ucttuned210-vs-ucttuned465-1000its,777,755,2278.923681496,2257.460664937,22
carcassonne-ucttuned475-vs-ucttuned320-1000its,780,758,2199.648574431,2183.409617229,22
carcassonne-uct370-vs-uct325-1000its,784,762,2097.35287379,2085.213040416,22
carcassonne-boltzmann140-vs-boltzmann360-1000its,786,764,2226.281092345,2167.531611094,22
carcassonne-boltzmann65-vs-boltzmann295-1000its,789,767,2217.586988141,2143.6538008,22
carcassonne-ucttuned355-vs-ucttuned250-1000its,789,767,2303.999276048,2232.668178028,22
carcassonne-uct380-vs-uct465-1000its,790,768,2167.305714708,2102.554271308,22
carcassonne-boltzmann255-vs-boltzmann125-1000its,793,771,2198.814272202,2122.850043416,22
carcassonne-boltzmann270-vs-boltzmann255-1000its,793,771,2263.212786478,2256.87548385,22
carcassonne-ucttuned115-vs-ucttuned445-1000its,794,772,2175.081900365,2153.501084135,22
carcassonne-boltzmann465-vs-boltzmann450-1000its,795,773,2164.809222722,2127.149524192,22
carcassonne-uct45-vs-uct480-1000its,795,773,2128.442421939,2086.684904329,22
carcassonne-boltzmann55-vs-boltzmann80-1000its,796,774,2295.804228018,2255.013199031,22
carcassonne-uct335-vs-uct100-1000its,796,774,2227.261243679,2211.790710289,22
carcassonne-boltzmann190-vs-boltzmann430-1000its,797,775,2227.388458848,2165.784775987,22
carcassonne-boltzmann340-vs-boltzmann440-1000its,798,776,2223.904125945,2134.344144944,22
carcassonne-boltzmann35-vs-boltzmann380-1000its,798,776,2162.986766145,2116.826628254,22
carcassonne-boltzmann150-vs-boltzmann460-1000its,799,777,2086.401004329,2041.636337901,22
carcassonne-boltzmann80-vs-boltzmann270-1000its,799,777,2175.385974863,2142.791076248,22
carcassonne-uct410-vs-uct305-1000its,799,777,2127.58684254,2104.913828998,22
carcassonne-ucttuned215-vs-ucttuned350-1000its,800,778,2150.659901659,2126.24613589,22
carcassonne-boltzmann300-vs-boltzmann85-1000its,801,779,2288.870375921,2227.804170431,22
carcassonne-boltzmann390-vs-boltzmann190-1000its,801,779,2173.400361317,2175.94871676,22
carcassonne-uct25-vs-uct455-1000its,801,779,2316.031661575,2273.806704382,22
carcassonne-ucttuned270-vs-ucttuned470-1000its,802,780,2170.696649404,2102.456617562,22
carcassonne-boltzmann110-vs-boltzmann140-1000its,804,782,2231.200067699,2230.695952907,22
carcassonne-boltzmann75-vs-boltzmann30-1000its,804,782,2180.773520216,2139.630977862,22
carcassonne-ucttuned360-vs-ucttuned175-1000its,804,782,2187.909617642,2168.130215193,22
carcassonne-boltzmann340-vs-boltzmann15-1000its,805,783,2233.103603101,2215.809983859,22
carcassonne-ucttuned480-vs-ucttuned95-1000its,805,783,2177.687015994,2070.065683909,22
carcassonne-uct310-vs-uct130-1000its,806,784,2248.466647334,2164.271859447,22
carcassonne-boltzmann35-vs-boltzmann95-1000its,807,785,2140.281168646,2079.716478341,22
carcassonne-ucttuned270-vs-ucttuned305-1000its,807,785,2246.815441252,2146.739032298,22
carcassonne-boltzmann190-vs-boltzmann345-1000its,808,786,2122.201064614,2080.550113305,22
carcassonne-boltzmann75-vs-boltzmann230-1000its,808,786,2147.311045825,2127.595394417,22
carcassonne-uct300-vs-uct80-1000its,809,787,2167.994703889,2114.629781599,22
carcassonne-ucttuned195-vs-ucttuned180-1000its,809,787,2266.336453103,2217.902864363,22
carcassonne-ucttuned265-vs-ucttuned235-1000its,809,787,2196.613787498,2134.233216691,22
carcassonne-uct310-vs-uct265-1000its,810,788,2172.574048322,2095.341676265,22
carcassonne-ucttuned145-vs-ucttuned415-1000its,810,788,2221.919942934,2154.653273407,22
carcassonne-ucttuned455-vs-ucttuned55-1000its,810,788,2207.114830988,2158.159607216,22
carcassonne-uct190-vs-uct185-1000its,812,790,2245.432850552,2195.181227005,22
carcassonne-boltzmann455-vs-boltzmann80-1000its,813,791,2180.763760445,2140.9905214,22
carcassonne-uct110-vs-uct430-1000its,813,791,2142.146628169,2100.527942896,22
carcassonne-uct345-vs-uct435-1000its,813,791,2204.067773133,2153.460599575,22
carcassonne-uct385-vs-uct305-1000its,813,791,2204.773377131,2142.66383027,22
carcassonne-uct465-vs-uct255-1000its,813,791,2158.088638635,2083.934084935,22
carcassonne-boltzmann340-vs-boltzmann175-1000its,814,792,2187.661180776,2118.15795408,22
carcassonne-uct95-vs-uct385-1000its,815,793,2180.716510114,2122.14492991,22
carcassonne-ucttuned325-vs-ucttuned310-1000its,815,793,2232.647628612,2136.376323136,22
carcassonne-uct200-vs-uct445-1000its,816,794,2211.198344774,2163.990125197,22
carcassonne-ucttuned115-vs-ucttuned160-1000its,816,794,2248.116057816,2159.125215035,22
carcassonne-ucttuned205-vs-ucttuned415-1000its,816,794,2187.271077375,2139.612204296,22
carcassonne-boltzmann170-vs-boltzmann455-1000its,818,796,2161.046304202,2164.384884548,22
carcassonne-uct210-vs-uct115-1000its,820,798,2177.939781372,2101.397483967,22
carcassonne-ucttuned315-vs-ucttuned480-1000its,820,798,2222.682886663,2208.526883729,22
carcassonne-uct140-vs-uct305-1000its,821,799,2224.558428154,2186.606694151,22
carcassonne-boltzmann450-vs-boltzmann340-1000its,823,801,2335.27364872,2282.522610033,22
carcassonne-uct460-vs-uct400-1000its,825,803,2111.031546994,2085.440020335,22
carcassonne-ucttuned435-vs-ucttuned55-1000its,825,803,2179.448812994,2158.650283139,22
carcassonne-uct215-vs-uct160-1000its,826,804,2149.403685558,2141.521991826,22
carcassonne-uct220-vs-uct20-1000its,826,804,2230.064923138,2173.487808064,22
carcassonne-boltzmann30-vs-boltzmann15-1000its,828,806,2235.270215138,2179.354892695,22
carcassonne-ucttuned160-vs-ucttuned115-1000its,829,807,2140.713138778,2069.255562774,22
carcassonne-ucttuned460-vs-ucttuned25-1000its,829,807,2192.700191132,2148.040096999,22
carcassonne-uct155-vs-uct245-1000its,830,808,2227.437165817,2191.034916979,22
carcassonne-uct275-vs-uct280-1000its,830,808,2143.550811547,2124.906165832,22
carcassonne-boltzmann310-vs-boltzmann65-1000its,831,809,2171.896166139,2103.327878672,22
carcassonne-ucttuned25-vs-ucttuned345-1000its,832,810,2208.39607255,2151.699140632,22
carcassonne-boltzmann330-vs-boltzmann5-1000its,833,811,2188.799690919,2158.783342818,22
carcassonne-uct160-vs-uct130-1000its,833,811,2228.611886366,2177.616634399,22
carcassonne-boltzmann305-vs-boltzmann480-1000its,835,813,2187.74274984,2109.46175993,22
carcassonne-ucttuned100-vs-ucttuned185-1000its,835,813,2169.145681332,2101.757927864,22
carcassonne-ucttuned5-vs-ucttuned430-1000its,835,813,2259.818475411,2211.757981105,22
carcassonne-ucttuned60-vs-ucttuned175-1000its,836,814,2211.89782541,2167.46081133,22
carcassonne-boltzmann5-vs-boltzmann160-1000its,837,815,2187.510788222,2171.086236597,22
carcassonne-uct210-vs-uct160-1000its,837,815,2228.264729184,2171.264844121,22
carcassonne-uct75-vs-uct55-1000its,837,815,2216.461908487,2181.911511939,22
carcassonne-ucttuned205-vs-ucttuned200-1000its,837,815,2209.325948272,2149.770158997,22
carcassonne-ucttuned85-vs-ucttuned175-1000its,837,815,2175.404991678,2177.395468545,22
carcassonne-boltzmann65-vs-boltzmann110-1000its,838,816,2195.001684938,2122.349946785,22
carcassonne-ucttuned280-vs-ucttuned195-1000its,838,816,2185.687018122,2079.131359187,22
carcassonne-ucttuned30-vs-ucttuned45-1000its,839,817,2180.196884943,2122.318157827,22
carcassonne-ucttuned400-vs-ucttuned355-1000its,839,817,2177.01820228,2119.998045936,22
carcassonne-boltzmann260-vs-boltzmann170-1000its,841,819,2191.349028729,2150.411840697,22
carcassonne-uct15-vs-uct365-1000its,841,819,2126.366683926,2098.554881957,22
carcassonne-uct155-vs-uct465-1000its,842,820,2220.225168326,2164.597218603,22
carcassonne-ucttuned335-vs-ucttuned395-1000its,847,825,2250.108217764,2155.126205027,22
carcassonne-uct385-vs-uct330-1000its,848,826,2175.36367648,2140.279062975,22
carcassonne-boltzmann280-vs-boltzmann250-1000its,849,827,2202.821395178,2135.633826564,22
carcassonne-ucttuned295-vs-ucttuned135-1000its,849,827,2177.60595676,2148.564006293,22
carcassonne-ucttuned360-vs-ucttuned220-1000its,849,827,2249.704164941,2227.574672862,22
carcassonne-uct240-vs-uct190-1000its,851,829,2290.33958533,2247.938988887,22
carcassonne-uct155-vs-uct315-1000its,853,831,2231.447292177,2142.652685247,22
carcassonne-uct305-vs-uct195-1000its,853,831,2219.528287854,2210.530695915,22
carcassonne-uct475-vs-uct190-1000its,853,831,2177.251780244,2128.844502423,22
carcassonne-uct255-vs-uct55-1000its,854,832,2160.476909167,2105.200230253,22
carcassonne-uct460-vs-uct430-1000its,854,832,2234.77076771,2230.481658158,22
carcassonne-ucttuned485-vs-ucttuned475-1000its,854,832,2120.18157135,2087.736474974,22
carcassonne-boltzmann420-vs-boltzmann450-1000its,855,833,2294.920342677,2223.593470424,22
carcassonne-boltzmann285-vs-boltzmann65-1000its,856,834,2226.339899706,2240.328169946,22
carcassonne-uct85-vs-uct280-1000its,856,834,2164.827514695,2164.047481684,22
carcassonne-uct85-vs-uct490-1000its,856,834,2160.903999456,2097.253558294,22
carcassonne-boltzmann225-vs-boltzmann345-1000its,857,835,2231.577827458,2196.243189007,22
carcassonne-ucttuned305-vs-ucttuned210-1000its,857,835,2153.621972357,2108.959421737,22
carcassonne-uct175-vs-uct220-1000its,859,837,2182.8666122,2111.114001495,22
carcassonne-uct75-vs-uct320-1000its,859,837,2155.954195324,2136.785039821,22
carcassonne-ucttuned385-vs-ucttuned95-1000its,859,837,2111.318115224,2066.677762119,22
carcassonne-ucttuned325-vs-ucttuned410-1000its,864,842,2167.14634922,2118.826386914,22
carcassonne-boltzmann265-vs-boltzmann240-1000its,865,843,2233.162634389,2146.803930929,22
carcassonne-uct110-vs-uct100-1000its,865,843,2184.421521791,2131.450942877,22
carcassonne-ucttuned185-vs-ucttuned220-1000its,865,843,2148.657865824,2102.544111682,22
carcassonne-boltzmann465-vs-boltzmann170-1000its,867,845,2192.909294248,2091.696200659,22
carcassonne-uct190-vs-uct90-1000its,867,845,2164.433556684,2136.084275045,22
carcassonne-ucttuned325-vs-ucttuned230-1000its,867,845,2133.547300887,2087.07419674,22
carcassonne-ucttuned235-vs-ucttuned400-1000its,868,846,2319.872300867,2298.086266579,22
carcassonne-boltzmann85-vs-boltzmann445-1000its,869,847,2175.095936195,2081.410858542,22
carcassonne-ucttuned135-vs-ucttuned450-1000its,869,847,2181.766202897,2152.215617924,22
carcassonne-ucttuned165-vs-ucttuned380-1000its,869,847,2192.646069256,2158.804631515,22
carcassonne-ucttuned65-vs-ucttuned290-1000its,869,847,2220.52355263,2185.848352162,22
carcassonne-ucttuned440-vs-ucttuned125-1000its,870,848,2111.90423719,2067.069716109,22
carcassonne-boltzmann480-vs-boltzmann290-1000its,877,855,2218.045465295,2160.833973914,22
carcassonne-ucttuned300-vs-ucttuned490-1000its,877,855,2173.23070511,2117.451583143,22
carcassonne-boltzmann30-vs-boltzmann350-1000its,878,856,2211.164527169,2200.01268842,22
carcassonne-boltzmann205-vs-boltzmann20-1000its,883,861,2249.127409484,2205.187312529,22
carcassonne-uct85-vs-uct35-1000its,883,861,2114.382193533,2132.809517253,22
carcassonne-ucttuned115-vs-ucttuned275-1000its,886,864,2218.725982637,2132.806385918,22
carcassonne-uct145-vs-uct485-1000its,887,865,2248.024512008,2184.591267927,22
carcassonne-boltzmann280-vs-boltzmann255-1000its,891,869,2262.430799946,2204.859062365,22
carcassonne-boltzmann355-vs-boltzmann210-1000its,893,871,2261.165301642,2215.976021735,22
carcassonne-uct250-vs-uct15-1000its,895,873,2142.394102606,2123.153118042,22
carcassonne-boltzmann345-vs-boltzmann85-1000its,897,875,2196.508768068,2105.190350436,22
carcassonne-ucttuned450-vs-ucttuned465-1000its,898,876,2298.878539053,2215.689563163,22
carcassonne-ucttuned270-vs-ucttuned195-1000its,902,880,2212.513979845,2163.974236743,22
carcassonne-boltzmann470-vs-boltzmann180-1000its,912,890,2162.952258026,2127.46498127,22
carcassonne-ucttuned230-vs-ucttuned345-1000its,918,896,2226.458548759,2154.073637921,22
carcassonne-boltzmann420-vs-boltzmann145-1000its,920,898,2201.456785013,2156.353680511,22
carcassonne-ucttuned480-vs-ucttuned455-1000its,927,905,2203.626849528,2155.66761044,22
carcassonne-boltzmann270-vs-boltzmann110-1000its,949,927,2161.326118954,2082.827344817,22
carcassonne-boltzmann275-vs-boltzmann265-1000its,965,943,2235.715007675,2211.509624874,22
carcassonne-uct95-vs-uct350-1000its,738,715,2166.562245987,2134.205955827,23
carcassonne-ucttuned85-vs-ucttuned30-1000its,739,716,2213.107885091,2129.517919151,23
carcassonne-boltzmann370-vs-boltzmann400-1000its,740,717,2181.585329116,2155.052842032,23
carcassonne-uct395-vs-uct340-1000its,742,719,2206.762484439,2129.463394289,23
carcassonne-ucttuned430-vs-ucttuned495-1000its,744,721,2165.032561092,2141.137533117,23
carcassonne-boltzmann165-vs-boltzmann445-1000its,750,727,2188.092030672,2172.43168309,23
carcassonne-boltzmann210-vs-boltzmann445-1000its,751,728,2148.256807292,2117.152650273,23
carcassonne-boltzmann275-vs-boltzmann325-1000its,756,733,2212.787421875,2141.823121175,23
carcassonne-boltzmann250-vs-boltzmann110-1000its,760,737,2190.093465269,2136.491781922,23
carcassonne-boltzmann450-vs-boltzmann395-1000its,761,738,2202.058323783,2164.090105783,23
carcassonne-ucttuned65-vs-ucttuned10-1000its,761,738,2226.604712704,2195.916624819,23
carcassonne-boltzmann240-vs-boltzmann350-1000its,763,740,2180.391646341,2100.538921488,23
carcassonne-uct425-vs-uct460-1000its,763,740,2251.074654829,2152.261333337,23
carcassonne-boltzmann145-vs-boltzmann495-1000its,767,744,2212.989415195,2182.125851946,23
carcassonne-uct280-vs-uct300-1000its,768,745,2189.50286497,2140.437282427,23
carcassonne-uct485-vs-uct75-1000its,769,746,2172.849936932,2132.318455786,23
carcassonne-boltzmann495-vs-boltzmann165-1000its,770,747,2190.662136394,2104.718747624,23
carcassonne-ucttuned270-vs-ucttuned185-1000its,770,747,2224.240662583,2152.33167338,23
carcassonne-ucttuned450-vs-ucttuned125-1000its,771,748,2308.793444645,2231.511786005,23
carcassonne-uct270-vs-uct220-1000its,776,753,2191.632270015,2107.385066907,23
carcassonne-boltzmann130-vs-boltzmann205-1000its,777,754,2227.518140071,2154.341122743,23
carcassonne-ucttuned380-vs-ucttuned330-1000its,777,754,2137.707404168,2127.475080455,23
carcassonne-boltzmann385-vs-boltzmann285-1000its,778,755,2186.233288392,2161.772498727,23
carcassonne-boltzmann50-vs-boltzmann55-1000its,778,755,2189.280410353,2108.550276495,23
carcassonne-ucttuned290-vs-ucttuned205-1000its,778,755,2211.884302751,2171.116881091,23
carcassonne-boltzmann385-vs-boltzmann415-1000its,779,756,2204.975944196,2181.662191331,23
carcassonne-ucttuned175-vs-ucttuned275-1000its,780,757,2215.644554121,2191.093159886,23
carcassonne-ucttuned290-vs-ucttuned320-1000its,782,759,2197.73843965,2159.787476992,23
carcassonne-uct65-vs-uct200-1000its,783,760,2242.921242791,2207.592551002,23
carcassonne-boltzmann180-vs-boltzmann325-1000its,784,761,2203.306831526,2211.812886277,23
carcassonne-boltzmann400-vs-boltzmann85-1000its,784,761,2205.898548454,2165.425042856,23
carcassonne-ucttuned265-vs-ucttuned425-1000its,786,763,2238.285505489,2123.78278652,23
carcassonne-ucttuned245-vs-ucttuned455-1000its,789,766,2211.429766388,2159.762381426,23
carcassonne-boltzmann340-vs-boltzmann130-1000its,791,768,2175.032142798,2143.384512857,23
carcassonne-uct495-vs-uct265-1000its,791,768,2122.091045552,2124.889060315,23
carcassonne-ucttuned285-vs-ucttuned75-1000its,791,768,2126.274448039,2072.228962242,23
carcassonne-ucttuned30-vs-ucttuned335-1000its,791,768,2185.575913091,2113.333737725,23
carcassonne-boltzmann345-vs-boltzmann380-1000its,792,769,2247.942392324,2183.890232496,23
carcassonne-uct210-vs-uct460-1000its,792,769,2098.004186072,2058.981983405,23
carcassonne-boltzmann210-vs-boltzmann425-1000its,796,773,2176.30328137,2115.007233813,23
carcassonne-ucttuned195-vs-ucttuned280-1000its,796,773,2178.976805998,2127.409040677,23
carcassonne-ucttuned30-vs-ucttuned410-1000its,798,775,2172.705878145,2101.131298499,23
carcassonne-ucttuned490-vs-ucttuned270-1000its,798,775,2196.297866482,2132.883833253,23
carcassonne-uct100-vs-uct440-1000its,799,776,2197.987235654,2139.381767674,23
carcassonne-ucttuned80-vs-ucttuned100-1000its,799,776,2198.84492974,2193.19564759,23
carcassonne-boltzmann140-vs-boltzmann50-1000its,800,777,2141.956211845,2124.713794501,23
carcassonne-boltzmann140-vs-boltzmann70-1000its,800,777,2161.968340944,2154.558014421,23
carcassonne-boltzmann320-vs-boltzmann330-1000its,800,777,2246.31449326,2179.639212244,23
carcassonne-ucttuned275-vs-ucttuned115-1000its,800,777,2152.139223152,2106.410643541,23
carcassonne-boltzmann125-vs-boltzmann245-1000its,801,778,2184.262304524,2159.150890858,23
carcassonne-boltzmann345-vs-boltzmann410-1000its,801,778,2215.124006168,2197.79013235,23
carcassonne-uct185-vs-uct430-1000its,802,779,2294.073370064,2277.198325529,23
carcassonne-boltzmann395-vs-boltzmann370-1000its,803,780,2224.164587931,2174.260846965,23
carcassonne-boltzmann210-vs-boltzmann345-1000its,804,781,2201.273846608,2191.579392007,23
carcassonne-uct270-vs-uct320-1000its,805,782,2141.926277944,2106.620287176,23
carcassonne-uct45-vs-uct20-1000its,805,782,2215.577779975,2159.888336234,23
carcassonne-boltzmann285-vs-boltzmann75-1000its,806,783,2193.803812733,2145.500988818,23
carcassonne-uct440-vs-uct190-1000its,806,783,2175.884506462,2095.724060123,23
carcassonne-uct95-vs-uct150-1000its,806,783,2227.983178464,2171.70622595,23
carcassonne-boltzmann200-vs-boltzmann345-1000its,809,786,2231.438465416,2151.270144743,23
carcassonne-boltzmann335-vs-boltzmann270-1000its,809,786,2192.442546956,2148.992268228,23
carcassonne-boltzmann440-vs-boltzmann265-1000its,809,786,2157.798366313,2130.378493718,23
carcassonne-boltzmann5-vs-boltzmann485-1000its,810,787,2262.267982894,2205.181281072,23
carcassonne-ucttuned200-vs-ucttuned440-1000its,810,787,2200.331987211,2172.845170779,23
carcassonne-boltzmann85-vs-boltzmann380-1000its,811,788,2195.947475386,2143.841524548,23
carcassonne-uct250-vs-uct295-1000its,812,789,2270.221013805,2260.144243317,23
carcassonne-ucttuned455-vs-ucttuned445-1000its,813,790,2214.41845954,2160.593228017,23
carcassonne-boltzmann285-vs-boltzmann490-1000its,815,792,2179.119167037,2129.174457458,23
carcassonne-uct110-vs-uct450-1000its,815,792,2219.495091073,2199.004775507,23
carcassonne-ucttuned395-vs-ucttuned210-1000its,815,792,2235.758340765,2172.2137207,23
carcassonne-ucttuned370-vs-ucttuned350-1000its,817,794,2248.499191583,2172.094245256,23
carcassonne-boltzmann320-vs-boltzmann45-1000its,818,795,2156.859896788,2070.736888729,23
carcassonne-boltzmann340-vs-boltzmann10-1000its,818,795,2169.108602777,2127.591830229,23
carcassonne-uct220-vs-uct330-1000its,818,795,2255.685331837,2202.110516588,23
carcassonne-boltzmann55-vs-boltzmann485-1000its,820,797,2131.658562681,2103.504961417,23
carcassonne-ucttuned100-vs-ucttuned240-1000its,821,798,2175.781260409,2150.37595195,23
carcassonne-boltzmann65-vs-boltzmann475-1000its,822,799,2128.80772002,2084.486622328,23
carcassonne-boltzmann375-vs-boltzmann70-1000its,823,800,2218.805061237,2167.039117751,23
carcassonne-ucttuned120-vs-ucttuned490-1000its,823,800,2193.874511765,2172.885234564,23
carcassonne-ucttuned450-vs-ucttuned310-1000its,823,800,2268.49370052,2154.071061934,23
carcassonne-boltzmann340-vs-boltzmann205-1000its,824,801,2248.399305825,2208.04800245,23
carcassonne-uct170-vs-uct385-1000its,825,802,2258.070792676,2249.321323035,23
carcassonne-uct335-vs-uct175-1000its,825,802,2202.276905289,2173.292557502,23
carcassonne-ucttuned155-vs-ucttuned400-1000its,825,802,2235.908537009,2192.899423098,23
carcassonne-uct10-vs-uct45-1000its,826,803,2291.884138929,2249.096102583,23
carcassonne-ucttuned405-vs-ucttuned485-1000its,826,803,2284.286426179,2203.473323435,23
carcassonne-boltzmann145-vs-boltzmann75-1000its,827,804,2145.332869518,2125.42573431,23
carcassonne-ucttuned460-vs-ucttuned165-1000its,827,804,2187.456572087,2168.642368129,23
carcassonne-boltzmann250-vs-boltzmann470-1000its,828,805,2177.485367731,2125.299025188,23
carcassonne-boltzmann310-vs-boltzmann15-1000its,828,805,2233.864595992,2210.184587761,23
carcassonne-boltzmann325-vs-boltzmann195-1000its,828,805,2289.872837036,2241.293337202,23
carcassonne-uct400-vs-uct345-1000its,828,805,2238.667782692,2267.945041042,23
carcassonne-ucttuned120-vs-ucttuned290-1000its,828,805,2192.113195879,2150.526267864,23
carcassonne-ucttuned420-vs-ucttuned285-1000its,830,807,2188.545253404,2156.023601034,23
carcassonne-boltzmann80-vs-boltzmann285-1000its,831,808,2148.598519361,2141.769305507,23
carcassonne-ucttuned410-vs-ucttuned360-1000its,831,808,2202.311172288,2162.798580684,23
carcassonne-boltzmann25-vs-boltzmann140-1000its,832,809,2171.473913374,2121.15153847,23
carcassonne-uct380-vs-uct395-1000its,832,809,2132.608561532,2064.517999704,23
carcassonne-ucttuned200-vs-ucttuned450-1000its,833,810,2190.95638101,2148.703516061,23
carcassonne-ucttuned360-vs-ucttuned375-1000its,833,810,2220.629245135,2223.58860209,23
carcassonne-uct485-vs-uct360-1000its,834,811,2249.401206841,2149.842070298,23
carcassonne-boltzmann150-vs-boltzmann130-1000its,835,812,2218.12917195,2143.817984256,23
carcassonne-uct100-vs-uct95-1000its,835,812,2137.939448763,2117.70025464,23
carcassonne-ucttuned425-vs-ucttuned455-1000its,835,812,2209.821986199,2178.81427066,23
carcassonne-uct330-vs-uct70-1000its,836,813,2155.596595392,2090.813820047,23
carcassonne-ucttuned205-vs-ucttuned375-1000its,836,813,2172.847691005,2128.144863394,23
carcassonne-ucttuned55-vs-ucttuned65-1000its,837,814,2206.533088214,2144.75369249,23
carcassonne-boltzmann215-vs-boltzmann220-1000its,838,815,2220.233708331,2183.205104384,23
carcassonne-ucttuned25-vs-ucttuned225-1000its,839,816,2246.857797734,2211.148602966,23
carcassonne-ucttuned435-vs-ucttuned150-1000its,839,816,2213.289309509,2132.926979209,23
carcassonne-boltzmann410-vs-boltzmann400-1000its,840,817,2166.549326488,2155.760024666,23
carcassonne-boltzmann440-vs-boltzmann30-1000its,840,817,2171.629958532,2123.699184791,23
carcassonne-uct130-vs-uct445-1000its,841,818,2181.048521817,2122.092706033,23
carcassonne-uct165-vs-uct365-1000its,846,823,2144.104412392,2102.066502528,23
carcassonne-uct110-vs-uct390-1000its,848,825,2182.663365524,2155.695750233,23
carcassonne-boltzmann195-vs-boltzmann480-1000its,849,826,2248.786489471,2224.948226779,23
carcassonne-boltzmann30-vs-boltzmann450-1000its,850,827,2180.994275318,2136.418035618,23
carcassonne-uct205-vs-uct415-1000its,852,829,2189.773674769,2147.634152789,23
carcassonne-uct205-vs-uct55-1000its,852,829,2192.883849442,2145.471356969,23
carcassonne-ucttuned435-vs-ucttuned35-1000its,855,832,2246.301395172,2186.674895448,23
carcassonne-ucttuned35-vs-ucttuned205-1000its,856,833,2210.486284288,2137.683053485,23
carcassonne-uct445-vs-uct270-1000its,857,834,2204.273114409,2147.831249388,23
carcassonne-ucttuned190-vs-ucttuned495-1000its,859,836,2188.315106457,2096.027733812,23
carcassonne-uct490-vs-uct465-1000its,860,837,2264.026445108,2229.985815476,23
carcassonne-boltzmann220-vs-boltzmann305-1000its,863,840,2139.194756506,2132.652103763,23
carcassonne-boltzmann485-vs-boltzmann55-1000its,866,843,2175.781978627,2165.54455661,23
carcassonne-uct170-vs-uct360-1000its,866,843,2310.747551954,2292.053391438,23
carcassonne-boltzmann40-vs-boltzmann355-1000its,869,846,2203.108743209,2202.66731261,23
carcassonne-ucttuned210-vs-ucttuned335-1000its,869,846,2220.491052705,2134.503226913,23
carcassonne-boltzmann135-vs-boltzmann475-1000its,870,847,2186.024176965,2131.595220524,23
carcassonne-ucttuned315-vs-ucttuned235-1000its,871,848,2159.620227471,2134.812837853,23
carcassonne-uct15-vs-uct305-1000its,878,855,2140.549529016,2065.944137119,23
carcassonne-uct465-vs-uct290-1000its,880,857,2136.193095113,2091.30777254,23
carcassonne-ucttuned370-vs-ucttuned420-1000its,882,859,2153.358473423,2132.338025157,23
carcassonne-boltzmann355-vs-boltzmann150-1000its,886,863,2130.585781868,2116.929479659,23
carcassonne-ucttuned5-vs-ucttuned495-1000its,899,876,2187.286476121,2150.281718684,23
carcassonne-uct355-vs-uct10-1000its,900,877,2232.446826368,2206.628800961,23
carcassonne-ucttuned420-vs-ucttuned215-1000its,901,878,2188.233980681,2161.5126454,23
carcassonne-uct370-vs-uct300-1000its,736,712,2226.62388428,2161.706885331,24
carcassonne-boltzmann350-vs-boltzmann195-1000its,739,715,2228.300671613,2210.078516587,24
carcassonne-uct490-vs-uct125-1000its,750,726,2178.09214178,2161.351345385,24
carcassonne-ucttuned95-vs-ucttuned415-1000its,750,726,2261.037518037,2226.037584823,24
carcassonne-uct205-vs-uct245-1000its,756,732,2130.936637498,2078.852270007,24
carcassonne-uct410-vs-uct345-1000its,758,734,2315.441134366,2207.211863649,24
carcassonne-uct105-vs-uct315-1000its,762,738,2190.134333061,2134.120227077,24
carcassonne-ucttuned280-vs-ucttuned295-1000its,762,738,2264.774089287,2216.691985859,24
carcassonne-ucttuned385-vs-ucttuned55-1000its,769,745,2267.269990762,2238.116409744,24
carcassonne-uct495-vs-uct75-1000its,777,753,2184.193174758,2106.533111154,24
carcassonne-uct130-vs-uct375-1000its,779,755,2258.476120672,2217.255217966,24
carcassonne-ucttuned380-vs-ucttuned370-1000its,780,756,2221.125474562,2204.611433342,24
carcassonne-boltzmann425-vs-boltzmann395-1000its,781,757,2276.959022513,2220.744944162,24
carcassonne-ucttuned240-vs-ucttuned255-1000its,781,757,2202.233696063,2188.70384341,24
carcassonne-uct285-vs-uct115-1000its,782,758,2254.46452202,2214.365812341,24
carcassonne-boltzmann435-vs-boltzmann110-1000its,784,760,2150.272455279,2110.011515531,24
carcassonne-ucttuned195-vs-ucttuned420-1000its,786,762,2195.248329648,2182.220308632,24
carcassonne-ucttuned400-vs-ucttuned310-1000its,788,764,2206.164503402,2185.016789008,24
carcassonne-uct355-vs-uct50-1000its,789,765,2175.312108777,2132.384856312,24
carcassonne-ucttuned330-vs-ucttuned185-1000its,789,765,2281.288267669,2217.966201677,24
carcassonne-uct415-vs-uct275-1000its,790,766,2242.248477931,2175.23173665,24
carcassonne-ucttuned290-vs-ucttuned475-1000its,790,766,2214.458206049,2148.512767081,24
carcassonne-uct35-vs-uct350-1000its,792,768,2184.419250064,2175.315998069,24
carcassonne-uct285-vs-uct395-1000its,794,770,2221.089709451,2216.354910829,24
carcassonne-ucttuned235-vs-ucttuned320-1000its,794,770,2179.87570913,2167.801634057,24
carcassonne-boltzmann170-vs-boltzmann55-1000its,796,772,2246.707868324,2172.05842333,24
carcassonne-ucttuned185-vs-ucttuned50-1000its,796,772,2165.756572902,2168.404978124,24
carcassonne-boltzmann240-vs-boltzmann130-1000its,797,773,2183.267382139,2107.989650503,24
carcassonne-uct385-vs-uct215-1000its,798,774,2311.892357249,2238.693816371,24
carcassonne-ucttuned105-vs-ucttuned115-1000its,798,774,2228.621278279,2156.139452955,24
carcassonne-boltzmann35-vs-boltzmann260-1000its,801,777,2253.228643387,2220.360226007,24
carcassonne-uct465-vs-uct480-1000its,802,778,2208.136410907,2189.021468861,24
carcassonne-ucttuned305-vs-ucttuned130-1000its,802,778,2195.967211934,2206.002521875,24
carcassonne-uct185-vs-uct450-1000its,803,779,2144.141379962,2115.256285385,24
carcassonne-boltzmann20-vs-boltzmann475-1000its,804,780,2162.442130697,2114.280284186,24
carcassonne-ucttuned150-vs-ucttuned435-1000its,804,780,2192.851890817,2139.34157257,24
carcassonne-ucttuned360-vs-ucttuned190-1000its,806,782,2160.672414918,2119.768059344,24
carcassonne-uct110-vs-uct345-1000its,807,783,2261.776954047,2190.587742685,24
carcassonne-uct275-vs-uct480-1000its,808,784,2162.788295801,2091.612451118,24
carcassonne-ucttuned115-vs-ucttuned130-1000its,808,784,2251.221337061,2156.765830511,24
carcassonne-ucttuned280-vs-ucttuned260-1000its,808,784,2225.776143934,2180.087757488,24
carcassonne-ucttuned280-vs-ucttuned360-1000its,808,784,2242.223694294,2213.971934835,24
carcassonne-ucttuned455-vs-ucttuned460-1000its,808,784,2144.586054921,2073.24308874,24
carcassonne-ucttuned335-vs-ucttuned85-1000its,809,785,2235.169086467,2186.873888461,24
carcassonne-ucttuned415-vs-ucttuned335-1000its,809,785,2208.220332989,2160.244376012,24
carcassonne-ucttuned165-vs-ucttuned140-1000its,810,786,2286.881224931,2253.415355922,24
carcassonne-boltzmann435-vs-boltzmann395-1000its,811,787,2260.97579686,2217.908906925,24
carcassonne-uct490-vs-uct395-1000its,811,787,2154.959399534,2155.788260865,24
carcassonne-ucttuned445-vs-ucttuned395-1000its,811,787,2171.136783012,2109.297535396,24
carcassonne-ucttuned480-vs-ucttuned200-1000its,811,787,2147.632039347,2100.795499713,24
carcassonne-boltzmann365-vs-boltzmann80-1000its,812,788,2187.605201698,2156.732249597,24
carcassonne-boltzmann380-vs-boltzmann85-1000its,812,788,2119.345207436,2078.312530287,24
carcassonne-boltzmann395-vs-boltzmann150-1000its,813,789,2137.201189191,2133.540949983,24
carcassonne-boltzmann5-vs-boltzmann225-1000its,813,789,2148.868685554,2099.601846638,24
carcassonne-uct325-vs-uct275-1000its,813,789,2156.9482607,2085.113081155,24
carcassonne-boltzmann130-vs-boltzmann95-1000its,814,790,2117.645445244,2117.943754832,24
carcassonne-boltzmann65-vs-boltzmann50-1000its,816,792,2262.073750379,2198.608346191,24
carcassonne-uct360-vs-uct490-1000its,816,792,2194.493122573,2146.895277731,24
carcassonne-uct430-vs-uct130-1000its,816,792,2161.406334173,2140.817091221,24
carcassonne-ucttuned170-vs-ucttuned345-1000its,816,792,2279.340179181,2196.352129067,24
carcassonne-boltzmann440-vs-boltzmann320-1000its,817,793,2261.586335188,2191.297179917,24
carcassonne-boltzmann165-vs-boltzmann85-1000its,818,794,2213.145870867,2160.876631651,24
carcassonne-uct375-vs-uct225-1000its,818,794,2164.368213926,2149.309001854,24
carcassonne-ucttuned60-vs-ucttuned410-1000its,818,794,2264.340990244,2204.834153229,24
carcassonne-boltzmann265-vs-boltzmann280-1000its,819,795,2163.441300462,2156.400307744,24
carcassonne-boltzmann65-vs-boltzmann225-1000its,819,795,2236.770254286,2179.687625039,24
carcassonne-boltzmann440-vs-boltzmann355-1000its,820,796,2291.166458322,2217.024829528,24
carcassonne-uct420-vs-uct70-1000its,820,796,2263.237178368,2231.455728206,24
carcassonne-ucttuned245-vs-ucttuned425-1000its,822,798,2247.032301329,2215.038079946,24
carcassonne-boltzmann195-vs-boltzmann245-1000its,823,799,2272.029390882,2245.03373438,24
carcassonne-uct75-vs-uct355-1000its,823,799,2141.974424403,2081.331190278,24
carcassonne-boltzmann250-vs-boltzmann390-1000its,825,801,2187.546905014,2135.074352818,24
carcassonne-ucttuned280-vs-ucttuned450-1000its,825,801,2287.6143545,2214.986256341,24
carcassonne-boltzmann395-vs-boltzmann445-1000its,826,802,2147.793198108,2132.721531955,24
carcassonne-uct380-vs-uct155-1000its,826,802,2250.980141433,2237.604147334,24
carcassonne-boltzmann210-vs-boltzmann340-1000its,827,803,2170.133352305,2083.822373065,24
carcassonne-boltzmann85-vs-boltzmann450-1000its,827,803,2153.736106859,2118.928575135,24
carcassonne-boltzmann10-vs-boltzmann435-1000its,828,804,2213.274284949,2168.4409247,24
carcassonne-uct45-vs-uct140-1000its,830,806,2171.419915211,2129.299968632,24
carcassonne-ucttuned450-vs-ucttuned470-1000its,830,806,2197.729100083,2180.563061788,24
carcassonne-uct170-vs-uct185-1000its,831,807,2215.521561283,2195.539666548,24
carcassonne-uct475-vs-uct140-1000its,831,807,2237.367491926,2166.67261502,24
carcassonne-boltzmann265-vs-boltzmann20-1000its,832,808,2300.257221449,2266.860713435,24
carcassonne-boltzmann140-vs-boltzmann285-1000its,833,809,2193.835485436,2130.276333171,24
carcassonne-boltzmann185-vs-boltzmann170-1000its,833,809,2175.89706853,2139.659738742,24
carcassonne-uct445-vs-uct35-1000its,833,809,2168.081956043,2122.437221211,24
carcassonne-ucttuned340-vs-ucttuned315-1000its,833,809,2208.852367234,2142.72874548,24
carcassonne-ucttuned470-vs-ucttuned110-1000its,833,809,2249.456774045,2216.383556453,24
carcassonne-ucttuned210-vs-ucttuned350-1000its,834,810,2211.528653037,2184.67818737,24
carcassonne-ucttuned260-vs-ucttuned5-1000its,834,810,2232.942746683,2191.666759542,24
carcassonne-boltzmann490-vs-boltzmann425-1000its,835,811,2158.226390594,2141.340294585,24
carcassonne-ucttuned100-vs-ucttuned280-1000its,835,811,2190.772926495,2133.668071391,24
carcassonne-uct245-vs-uct240-1000its,837,813,2230.426590623,2168.992974174,24
carcassonne-uct275-vs-uct150-1000its,837,813,2147.371336257,2100.681007022,24
carcassonne-uct100-vs-uct65-1000its,840,816,2231.353879215,2162.508868571,24
carcassonne-uct375-vs-uct110-1000its,840,816,2137.492706292,2126.669409806,24
carcassonne-uct420-vs-uct65-1000its,840,816,2159.799271866,2139.433118464,24
carcassonne-ucttuned420-vs-ucttuned170-1000its,841,817,2184.243069685,2183.166355448,24
carcassonne-uct385-vs-uct320-1000its,842,818,2157.093235809,2131.852001764,24
carcassonne-ucttuned280-vs-ucttuned375-1000its,842,818,2190.508985016,2142.885713638,24
carcassonne-uct170-vs-uct130-1000its,846,822,2290.831231754,2239.358476237,24
carcassonne-boltzmann245-vs-boltzmann460-1000its,848,824,2238.551838733,2163.735134494,24
carcassonne-boltzmann375-vs-boltzmann45-1000its,848,824,2255.006676258,2197.88704562,24
carcassonne-uct55-vs-uct235-1000its,849,825,2199.355481816,2142.270431471,24
carcassonne-ucttuned5-vs-ucttuned65-1000its,849,825,2163.881268362,2137.155462887,24
carcassonne-ucttuned445-vs-ucttuned440-1000its,850,826,2262.460443815,2149.118755289,24
carcassonne-boltzmann275-vs-boltzmann30-1000its,851,827,2134.004784178,2133.412755563,24
carcassonne-ucttuned360-vs-ucttuned445-1000its,852,828,2172.894857449,2074.771453635,24
carcassonne-boltzmann10-vs-boltzmann165-1000its,854,830,2218.435453375,2192.716753191,24
carcassonne-boltzmann395-vs-boltzmann490-1000its,854,830,2145.415873859,2108.866083531,24
carcassonne-uct405-vs-uct365-1000its,855,831,2145.685876446,2077.24258552,24
carcassonne-uct470-vs-uct145-1000its,855,831,2178.215838349,2100.385380179,24
carcassonne-boltzmann490-vs-boltzmann195-1000its,859,835,2265.424309061,2202.918667714,24
carcassonne-uct370-vs-uct140-1000its,860,836,2226.782286606,2135.710588845,24
carcassonne-ucttuned180-vs-ucttuned460-1000its,861,837,2182.273288278,2148.698848989,24
carcassonne-uct165-vs-uct175-1000its,862,838,2250.176341387,2257.196713903,24
carcassonne-uct20-vs-uct385-1000its,863,839,2236.095124198,2164.75982771,24
carcassonne-boltzmann210-vs-boltzmann355-1000its,864,840,2185.659955263,2137.066116248,24
carcassonne-ucttuned270-vs-ucttuned125-1000its,866,842,2191.92270336,2136.9594145,24
carcassonne-uct175-vs-uct230-1000its,867,843,2183.170860638,2125.231416258,24
carcassonne-ucttuned260-vs-ucttuned50-1000its,867,843,2109.999916201,2069.594182654,24
carcassonne-boltzmann330-vs-boltzmann405-1000its,868,844,2083.354412924,2098.853480667,24
carcassonne-ucttuned270-vs-ucttuned10-1000its,868,844,2154.766560314,2128.663370203,24
carcassonne-ucttuned430-vs-ucttuned135-1000its,868,844,2168.081352044,2135.042636836,24
carcassonne-boltzmann200-vs-boltzmann185-1000its,869,845,2247.86872933,2202.673297722,24
carcassonne-ucttuned15-vs-ucttuned140-1000its,870,846,2164.476867271,2070.912675105,24
carcassonne-uct10-vs-uct60-1000its,871,847,2206.711799496,2173.426260197,24
carcassonne-ucttuned300-vs-ucttuned5-1000its,871,847,2164.913034766,2136.652490023,24
carcassonne-boltzmann230-vs-boltzmann100-1000its,873,849,2257.055821827,2227.524319183,24
carcassonne-boltzmann90-vs-boltzmann230-1000its,874,850,2200.994960493,2143.294619924,24
carcassonne-ucttuned85-vs-ucttuned445-1000its,877,853,2209.11758285,2196.84548163,24
carcassonne-ucttuned215-vs-ucttuned85-1000its,878,854,2186.69690331,2195.6297407,24
carcassonne-boltzmann255-vs-boltzmann210-1000its,882,858,2193.187741006,2124.27501557,24
carcassonne-ucttuned305-vs-ucttuned115-1000its,883,859,2255.301664044,2189.312341253,24
carcassonne-ucttuned220-vs-ucttuned490-1000its,885,861,2222.732492714,2193.139176223,24
carcassonne-ucttuned405-vs-ucttuned270-1000its,894,870,2220.161288008,2189.833299707,24
carcassonne-ucttuned415-vs-ucttuned85-1000its,897,873,2134.767317801,2097.228815819,24
carcassonne-boltzmann150-vs-boltzmann35-1000its,904,880,2203.157067842,2164.287067822,24
carcassonne-ucttuned395-vs-ucttuned40-1000its,904,880,2208.605052575,2131.068730129,24
carcassonne-ucttuned380-vs-ucttuned215-1000its,905,881,2202.533103181,2178.760476506,24
carcassonne-ucttuned415-vs-ucttuned470-1000its,674,649,1758.985386743,1752.895295286,25
carcassonne-ucttuned370-vs-ucttuned200-1000its,734,709,2287.750566963,2267.213228766,25
carcassonne-boltzmann180-vs-boltzmann490-1000its,744,719,2161.740045978,2127.465016327,25
carcassonne-uct145-vs-uct220-1000its,746,721,2235.785826791,2241.438939401,25
carcassonne-uct335-vs-uct320-1000its,753,728,2203.431233593,2162.23197213,25
carcassonne-boltzmann430-vs-boltzmann40-1000its,755,730,2217.424328794,2164.779984122,25
carcassonne-uct235-vs-uct265-1000its,756,731,2176.400521665,2112.66852451,25
carcassonne-boltzmann255-vs-boltzmann465-1000its,759,734,2165.050293685,2070.808856197,25
carcassonne-ucttuned325-vs-ucttuned35-1000its,761,736,2244.129786921,2213.236762355,25
carcassonne-boltzmann310-vs-boltzmann400-1000its,774,749,2243.480200338,2168.046077569,25
carcassonne-boltzmann130-vs-boltzmann355-1000its,776,751,2215.357315429,2146.657813559,25
carcassonne-boltzmann65-vs-boltzmann55-1000its,776,751,2192.101130014,2162.559813944,25
carcassonne-boltzmann260-vs-boltzmann160-1000its,779,754,2160.675854499,2109.453044757,25
carcassonne-boltzmann265-vs-boltzmann210-1000its,779,754,2278.484401254,2227.001114912,25
carcassonne-boltzmann65-vs-boltzmann205-1000its,779,754,2294.73901377,2245.166748598,25
carcassonne-uct120-vs-uct210-1000its,779,754,2166.712722964,2167.594774606,25
carcassonne-uct10-vs-uct110-1000its,780,755,2180.300863695,2145.13041307,25
carcassonne-uct225-vs-uct95-1000its,781,756,2262.935581903,2153.686746635,25
carcassonne-uct220-vs-uct420-1000its,782,757,2235.716334839,2174.394513776,25
carcassonne-boltzmann205-vs-boltzmann485-1000its,783,758,2132.373588313,2153.323743705,25
carcassonne-uct55-vs-uct290-1000its,785,760,2250.862557232,2162.874944243,25
carcassonne-boltzmann170-vs-boltzmann410-1000its,786,761,2233.883258519,2226.596768515,25
carcassonne-uct340-vs-uct290-1000its,786,761,2188.816988275,2196.881870869,25
carcassonne-boltzmann475-vs-boltzmann145-1000its,787,762,2221.751810538,2191.518195604,25
carcassonne-ucttuned165-vs-ucttuned485-1000its,788,763,2242.348907139,2147.994823039,25
carcassonne-ucttuned475-vs-ucttuned210-1000its,789,764,2226.525407391,2196.471034555,25
carcassonne-boltzmann460-vs-boltzmann350-1000its,790,765,2264.413267978,2217.092272713,25
carcassonne-ucttuned255-vs-ucttuned90-1000its,790,765,2233.919970225,2172.889014515,25
carcassonne-boltzmann430-vs-boltzmann175-1000its,792,767,2211.51947861,2200.878112232,25
carcassonne-ucttuned80-vs-ucttuned355-1000its,794,769,2208.645120977,2192.713004807,25
carcassonne-uct380-vs-uct105-1000its,795,770,2166.394415926,2143.658395543,25
carcassonne-boltzmann170-vs-boltzmann160-1000its,796,771,2177.972466064,2119.894147105,25
carcassonne-uct15-vs-uct175-1000its,796,771,2202.939451763,2163.552718727,25
carcassonne-uct330-vs-uct470-1000its,796,771,2227.163400476,2132.682292628,25
carcassonne-uct310-vs-uct385-1000its,797,772,2212.285130166,2163.085355364,25
carcassonne-boltzmann20-vs-boltzmann340-1000its,800,775,2157.413886225,2110.23198177,25
carcassonne-uct465-vs-uct200-1000its,800,775,2156.08047054,2109.214239982,25
carcassonne-ucttuned185-vs-ucttuned380-1000its,801,776,2195.511311048,2204.438248577,25
carcassonne-boltzmann355-vs-boltzmann295-1000its,802,777,2193.874924208,2137.419256196,25
carcassonne-uct200-vs-uct370-1000its,802,777,2246.28950065,2204.879059543,25
carcassonne-boltzmann350-vs-boltzmann415-1000its,803,778,2157.685736435,2105.44805509,25
carcassonne-uct10-vs-uct445-1000its,803,778,2179.797119491,2148.883986106,25
carcassonne-ucttuned165-vs-ucttuned135-1000its,803,778,2142.576535208,2095.823531601,25
carcassonne-ucttuned5-vs-ucttuned285-1000its,803,778,2188.412247593,2156.982834199,25
carcassonne-ucttuned460-vs-ucttuned170-1000its,804,779,2162.570031144,2125.885960251,25
carcassonne-uct50-vs-uct350-1000its,805,780,2256.361865218,2202.740909826,25
carcassonne-ucttuned350-vs-ucttuned10-1000its,805,780,2229.204437265,2195.274164361,25
carcassonne-boltzmann140-vs-boltzmann255-1000its,806,781,2140.413924499,2067.291804023,25
carcassonne-boltzmann420-vs-boltzmann380-1000its,807,782,2183.730053786,2088.968857148,25
carcassonne-uct95-vs-uct60-1000its,807,782,2181.247886438,2149.189332229,25
carcassonne-boltzmann300-vs-boltzmann420-1000its,809,784,2199.412717788,2179.487383151,25
carcassonne-boltzmann370-vs-boltzmann285-1000its,810,785,2221.993406148,2169.397971353,25
carcassonne-uct135-vs-uct245-1000its,810,785,2239.454517305,2147.104919263,25
carcassonne-uct20-vs-uct340-1000its,810,785,2167.339794733,2146.761457669,25
carcassonne-uct60-vs-uct440-1000its,811,786,2128.282771829,2142.057607958,25
carcassonne-uct375-vs-uct365-1000its,812,787,2240.849175259,2195.048063135,25
carcassonne-ucttuned220-vs-ucttuned45-1000its,812,787,2218.984016293,2150.161198828,25
carcassonne-ucttuned235-vs-ucttuned340-1000its,812,787,2223.663062226,2139.602033594,25
carcassonne-ucttuned405-vs-ucttuned60-1000its,812,787,2137.942169364,2145.980223321,25
carcassonne-boltzmann360-vs-boltzmann5-1000its,813,788,2256.173895481,2214.397104151,25
carcassonne-ucttuned45-vs-ucttuned130-1000its,813,788,2228.826251963,2206.12273797,25
carcassonne-boltzmann80-vs-boltzmann100-1000its,814,789,2163.188657104,2139.725251805,25
carcassonne-uct300-vs-uct110-1000its,814,789,2158.651574498,2139.602308958,25
carcassonne-uct345-vs-uct450-1000its,814,789,2136.313340534,2106.127978557,25
carcassonne-uct180-vs-uct50-1000its,815,790,2162.855709108,2120.112970442,25
carcassonne-ucttuned310-vs-ucttuned320-1000its,815,790,2271.998236828,2169.440305848,25
carcassonne-boltzmann180-vs-boltzmann45-1000its,816,791,2230.997642861,2145.047420665,25
carcassonne-boltzmann265-vs-boltzmann235-1000its,816,791,2185.179346168,2151.330312767,25
carcassonne-uct305-vs-uct45-1000its,816,791,2171.457261011,2125.508203056,25
carcassonne-ucttuned395-vs-ucttuned270-1000its,816,791,2199.566137094,2154.393494637,25
carcassonne-ucttuned85-vs-ucttuned330-1000its,816,791,2150.61794728,2163.792973168,25
carcassonne-boltzmann310-vs-boltzmann480-1000its,818,793,2197.263421937,2161.502410714,25
carcassonne-ucttuned265-vs-ucttuned310-1000its,818,793,2157.883993264,2137.796956204,25
carcassonne-ucttuned310-vs-ucttuned465-1000its,821,796,2184.750084637,2155.053404217,25
carcassonne-boltzmann30-vs-boltzmann295-1000its,822,797,2258.280758403,2175.249401137,25
carcassonne-uct50-vs-uct150-1000its,823,798,2170.313126534,2163.474017345,25
carcassonne-boltzmann465-vs-boltzmann90-1000its,825,800,2179.949003708,2129.65248071,25
carcassonne-ucttuned110-vs-ucttuned315-1000its,825,800,2153.845869852,2090.794900054,25
carcassonne-boltzmann135-vs-boltzmann45-1000its,826,801,2117.871232002,2098.471157493,25
carcassonne-boltzmann440-vs-boltzmann255-1000its,826,801,2179.203247249,2183.663547167,25
carcassonne-uct155-vs-uct305-1000its,826,801,2251.465712662,2213.493812146,25
carcassonne-ucttuned450-vs-ucttuned75-1000its,826,801,2155.61482289,2137.747209588,25
carcassonne-boltzmann90-vs-boltzmann370-1000its,827,802,2178.055913611,2115.643676329,25
carcassonne-boltzmann425-vs-boltzmann290-1000its,828,803,2162.333853078,2113.850873906,25
carcassonne-uct335-vs-uct420-1000its,828,803,2144.830881367,2119.810447885,25
carcassonne-uct145-vs-uct495-1000its,832,807,2188.030239903,2134.435845741,25
carcassonne-ucttuned455-vs-ucttuned80-1000its,832,807,2154.456396586,2124.25728164,25
carcassonne-uct475-vs-uct485-1000its,833,808,2167.616085833,2130.766385407,25
carcassonne-boltzmann115-vs-boltzmann20-1000its,835,810,2206.681968646,2151.609343564,25
carcassonne-boltzmann150-vs-boltzmann225-1000its,836,811,2128.109675792,2122.015611887,25
carcassonne-boltzmann180-vs-boltzmann245-1000its,838,813,2235.028099029,2176.519932674,25
carcassonne-uct85-vs-uct440-1000its,839,814,2168.442129207,2158.623928825,25
carcassonne-ucttuned275-vs-ucttuned430-1000its,839,814,2183.819639485,2115.733319245,25
carcassonne-boltzmann395-vs-boltzmann365-1000its,840,815,2183.96848521,2169.221309234,25
carcassonne-uct30-vs-uct340-1000its,840,815,2194.381509842,2154.235214685,25
carcassonne-uct360-vs-uct440-1000its,840,815,2218.977653334,2177.67681005,25
carcassonne-ucttuned280-vs-ucttuned85-1000its,840,815,2200.166972099,2185.372368789,25
carcassonne-boltzmann310-vs-boltzmann495-1000its,841,816,2202.172115314,2129.002245896,25
carcassonne-ucttuned330-vs-ucttuned475-1000its,841,816,2240.870229889,2195.011228638,25
carcassonne-ucttuned190-vs-ucttuned135-1000its,842,817,2191.339369576,2179.864625828,25
carcassonne-ucttuned255-vs-ucttuned390-1000its,843,818,2139.735525161,2116.03814036,25
carcassonne-ucttuned220-vs-ucttuned390-1000its,845,820,2244.238394076,2135.245738953,25
carcassonne-ucttuned315-vs-ucttuned465-1000its,845,820,2150.849184613,2089.691371808,25
carcassonne-ucttuned285-vs-ucttuned395-1000its,846,821,2182.20764532,2076.967781766,25
carcassonne-boltzmann455-vs-boltzmann120-1000its,847,822,2258.849625865,2197.520420249,25
carcassonne-ucttuned215-vs-ucttuned315-1000its,848,823,2170.187361865,2150.295973532,25
carcassonne-uct255-vs-uct25-1000its,849,824,2207.388008498,2174.912228354,25
carcassonne-uct405-vs-uct15-1000its,849,824,2170.413095906,2122.286887007,25
carcassonne-ucttuned310-vs-ucttuned365-1000its,849,824,2176.023643225,2119.374010876,25
carcassonne-uct160-vs-uct395-1000its,851,826,2232.304481886,2177.534106687,25
carcassonne-boltzmann430-vs-boltzmann290-1000its,852,827,2282.691180785,2247.702117666,25
carcassonne-uct195-vs-uct205-1000its,852,827,2218.041503825,2162.124971368,25
carcassonne-ucttuned175-vs-ucttuned245-1000its,852,827,2199.708465663,2152.450071836,25
carcassonne-boltzmann400-vs-boltzmann160-1000its,854,829,2222.530063158,2181.461010298,25
carcassonne-uct210-vs-uct330-1000its,854,829,2189.057542543,2168.328788244,25
carcassonne-boltzmann140-vs-boltzmann200-1000its,855,830,2199.309535742,2116.942588415,25
carcassonne-uct245-vs-uct130-1000its,855,830,2214.234045011,2162.296223496,25
carcassonne-ucttuned225-vs-ucttuned440-1000its,855,830,2216.123077414,2172.672443052,25
carcassonne-boltzmann105-vs-boltzmann460-1000its,858,833,2207.694132691,2142.841275362,25
carcassonne-boltzmann245-vs-boltzmann175-1000its,859,834,2214.466853736,2141.414649448,25
carcassonne-uct370-vs-uct395-1000its,859,834,2210.009717933,2118.308585475,25
carcassonne-uct185-vs-uct230-1000its,862,837,2173.406225191,2141.771851808,25
carcassonne-boltzmann25-vs-boltzmann405-1000its,863,838,2151.81643704,2137.326131027,25
carcassonne-boltzmann45-vs-boltzmann55-1000its,863,838,2182.993033684,2165.489933427,25
carcassonne-ucttuned40-vs-ucttuned470-1000its,864,839,2165.676435731,2088.230304486,25
carcassonne-uct235-vs-uct305-1000its,866,841,2149.081675463,2082.742638893,25
carcassonne-ucttuned250-vs-ucttuned75-1000its,867,842,2187.784776375,2151.93402296,25
carcassonne-ucttuned370-vs-ucttuned305-1000its,868,843,2231.084748515,2155.768644923,25
carcassonne-ucttuned95-vs-ucttuned90-1000its,868,843,2222.67959075,2184.982421678,25
carcassonne-boltzmann375-vs-boltzmann165-1000its,870,845,2244.564863307,2194.121119924,25
carcassonne-uct420-vs-uct85-1000its,870,845,2189.25532312,2135.822573388,25
carcassonne-boltzmann490-vs-boltzmann90-1000its,871,846,2149.198769034,2098.387968301,25
carcassonne-uct405-vs-uct170-1000its,871,846,2238.278394143,2172.089674213,25
carcassonne-boltzmann465-vs-boltzmann65-1000its,872,847,2178.587399635,2125.888331724,25
carcassonne-uct430-vs-uct320-1000its,872,847,2204.525087273,2137.151950575,25
carcassonne-uct165-vs-uct325-1000its,874,849,2238.184226373,2179.825745966,25
carcassonne-uct210-vs-uct390-1000its,874,849,2207.56375632,2178.781191964,25
carcassonne-ucttuned10-vs-ucttuned85-1000its,886,861,2192.604902352,2170.470401678,25
carcassonne-uct350-vs-uct295-1000its,889,864,2176.259705272,2121.320317387,25
carcassonne-ucttuned95-vs-ucttuned120-1000its,891,866,2170.172147545,2165.514194762,25
carcassonne-ucttuned110-vs-ucttuned405-1000its,899,874,2182.055062281,2150.687768363,25
carcassonne-uct110-vs-uct190-1000its,903,878,2183.789195125,2207.98880789,25
carcassonne-ucttuned235-vs-ucttuned95-1000its,907,882,2265.456428315,2215.251937545,25
carcassonne-ucttuned345-vs-ucttuned235-1000its,912,887,2207.618285703,2163.198934086,25
carcassonne-uct15-vs-uct370-1000its,914,889,2131.496838501,2080.974288389,25
carcassonne-ucttuned230-vs-ucttuned120-1000its,726,700,2195.021580398,2204.963786521,26
carcassonne-boltzmann10-vs-boltzmann350-1000its,744,718,2240.87192865,2156.84517977,26
carcassonne-boltzmann365-vs-boltzmann145-1000its,744,718,2144.417714519,2121.25206586,26
carcassonne-ucttuned410-vs-ucttuned5-1000its,746,720,2205.319248409,2132.523161602,26
carcassonne-ucttuned240-vs-ucttuned335-1000its,749,723,2193.306499202,2146.018116867,26
carcassonne-ucttuned195-vs-ucttuned465-1000its,753,727,2212.024293595,2139.795494459,26
carcassonne-boltzmann300-vs-boltzmann190-1000its,756,730,2170.193248219,2130.729724853,26
carcassonne-ucttuned365-vs-ucttuned260-1000its,761,735,2218.020957584,2153.966568607,26
carcassonne-ucttuned465-vs-ucttuned210-1000its,761,735,2183.506818186,2152.740647985,26
carcassonne-uct305-vs-uct435-1000its,762,736,2181.477308393,2151.570669982,26
carcassonne-ucttuned190-vs-ucttuned360-1000its,762,736,2298.186836738,2283.740498278,26
carcassonne-ucttuned275-vs-ucttuned465-1000its,763,737,2164.157570329,2091.382552553,26
carcassonne-boltzmann305-vs-boltzmann250-1000its,764,738,2255.720632455,2212.911251571,26
carcassonne-ucttuned425-vs-ucttuned450-1000its,764,738,2200.919472016,2155.84645286,26
carcassonne-boltzmann340-vs-boltzmann485-1000its,768,742,2132.101352186,2102.08134878,26
carcassonne-uct425-vs-uct90-1000its,768,742,2262.601626051,2156.983831206,26
carcassonne-boltzmann115-vs-boltzmann440-1000its,769,743,2130.993982736,2076.339718484,26
carcassonne-boltzmann200-vs-boltzmann380-1000its,772,746,2239.248646542,2171.274742,26
carcassonne-boltzmann340-vs-boltzmann280-1000its,774,748,2144.43901245,2117.665477398,26
carcassonne-uct345-vs-uct170-1000its,774,748,2204.390007174,2119.001956172,26
carcassonne-boltzmann280-vs-boltzmann375-1000its,775,749,2215.345220323,2165.349782098,26
carcassonne-uct480-vs-uct400-1000its,777,751,2221.343422839,2144.490685542,26
carcassonne-uct245-vs-uct105-1000its,778,752,2308.003039161,2225.398974755,26
carcassonne-uct295-vs-uct80-1000its,778,752,2178.471826843,2134.902397399,26
carcassonne-uct25-vs-uct10-1000its,779,753,2208.832294133,2187.279196398,26
carcassonne-boltzmann335-vs-boltzmann210-1000its,780,754,2131.573869875,2081.2416674,26
carcassonne-boltzmann375-vs-boltzmann120-1000its,781,755,2151.283028577,2095.416276715,26
carcassonne-ucttuned395-vs-ucttuned195-1000its,781,755,2209.334492514,2172.718141508,26
carcassonne-uct365-vs-uct125-1000its,784,758,2151.764827883,2092.268134511,26
carcassonne-boltzmann75-vs-boltzmann455-1000its,785,759,2227.356765335,2154.278853783,26
carcassonne-ucttuned140-vs-ucttuned280-1000its,786,760,2186.32592647,2157.202522669,26
carcassonne-ucttuned305-vs-ucttuned230-1000its,786,760,2164.753586183,2090.799423468,26
carcassonne-ucttuned415-vs-ucttuned245-1000its,786,760,2195.015686805,2201.148752273,26
carcassonne-ucttuned465-vs-ucttuned265-1000its,786,760,2181.196088317,2151.563367598,26
carcassonne-boltzmann490-vs-boltzmann75-1000its,787,761,2134.454768895,2103.589521417,26
carcassonne-ucttuned415-vs-ucttuned220-1000its,788,762,2145.766556202,2094.825608613,26
carcassonne-boltzmann150-vs-boltzmann265-1000its,789,763,2134.623045994,2156.215774755,26
carcassonne-ucttuned205-vs-ucttuned315-1000its,789,763,2161.315816311,2116.809886843,26
carcassonne-boltzmann470-vs-boltzmann45-1000its,791,765,2157.63148379,2150.477789937,26
carcassonne-uct285-vs-uct475-1000its,793,767,2159.438099778,2091.120138278,26
carcassonne-ucttuned440-vs-ucttuned265-1000its,793,767,2194.214416023,2178.897474706,26
carcassonne-uct190-vs-uct75-1000its,795,769,2159.994294711,2151.234670849,26
carcassonne-boltzmann350-vs-boltzmann485-1000its,796,770,2268.14693816,2199.609261947,26
carcassonne-boltzmann495-vs-boltzmann65-1000its,796,770,2212.028309851,2164.325655817,26
carcassonne-boltzmann205-vs-boltzmann225-1000its,797,771,2183.463207981,2076.047085301,26
carcassonne-ucttuned175-vs-ucttuned465-1000its,797,771,2230.068431132,2162.523405128,26
carcassonne-boltzmann75-vs-boltzmann110-1000its,798,772,2123.657142417,2005.078222418,26
carcassonne-ucttuned145-vs-ucttuned360-1000its,799,773,2195.63284994,2132.351492846,26
carcassonne-uct175-vs-uct295-1000its,800,774,2237.107262791,2168.317982452,26
carcassonne-ucttuned125-vs-ucttuned430-1000its,800,774,2253.472617445,2213.682602537,26
carcassonne-ucttuned465-vs-ucttuned275-1000its,801,775,2196.614403131,2158.807191852,26
carcassonne-uct245-vs-uct215-1000its,802,776,2192.445755352,2151.691349741,26
carcassonne-uct10-vs-uct470-1000its,803,777,2142.814963399,2109.51484788,26
carcassonne-boltzmann335-vs-boltzmann330-1000its,804,778,2172.547454127,2140.046529586,26
carcassonne-uct145-vs-uct280-1000its,805,779,2298.881183928,2240.003519237,26
carcassonne-uct85-vs-uct215-1000its,806,780,2203.179682973,2173.495010954,26
carcassonne-ucttuned380-vs-ucttuned385-1000its,806,780,2220.89779755,2134.816902458,26
carcassonne-uct145-vs-uct330-1000its,807,781,2265.619624316,2201.61847078,26
carcassonne-uct465-vs-uct395-1000its,809,783,2208.876078339,2150.422874589,26
carcassonne-ucttuned320-vs-ucttuned105-1000its,809,783,2140.409628482,2123.110374307,26
carcassonne-ucttuned390-vs-ucttuned180-1000its,810,784,2288.168713213,2245.169110437,26
carcassonne-uct185-vs-uct415-1000its,811,785,2186.223793946,2169.929633984,26
carcassonne-uct190-vs-uct60-1000its,811,785,2233.689722429,2178.347161298,26
carcassonne-ucttuned485-vs-ucttuned460-1000its,811,785,2222.407197234,2136.557175106,26
carcassonne-boltzmann305-vs-boltzmann240-1000its,812,786,2234.507972214,2168.948629347,26
carcassonne-uct40-vs-uct125-1000its,813,787,2181.225207745,2110.372344389,26
carcassonne-uct230-vs-uct70-1000its,816,790,2193.523621891,2155.200595709,26
carcassonne-uct325-vs-uct180-1000its,816,790,2165.828895782,2147.069895992,26
carcassonne-boltzmann70-vs-boltzmann420-1000its,817,791,2247.180411729,2170.855120292,26
carcassonne-boltzmann135-vs-boltzmann165-1000its,819,793,2210.845640292,2198.810020129,26
carcassonne-boltzmann445-vs-boltzmann415-1000its,821,795,2165.287567793,2105.180155163,26
carcassonne-uct395-vs-uct245-1000its,822,796,2198.353840684,2126.754203745,26
carcassonne-boltzmann415-vs-boltzmann245-1000its,824,798,2147.523677813,2109.658178259,26
carcassonne-uct420-vs-uct485-1000its,824,798,2296.039391669,2261.724793974,26
carcassonne-ucttuned460-vs-ucttuned250-1000its,825,799,2253.220405156,2193.823616686,26
carcassonne-uct185-vs-uct265-1000its,826,800,2241.501188439,2190.940643903,26
carcassonne-uct340-vs-uct420-1000its,827,801,2217.78934029,2154.001637307,26
carcassonne-uct480-vs-uct465-1000its,828,802,2185.77739359,2136.803243506,26
carcassonne-boltzmann350-vs-boltzmann405-1000its,829,803,2246.003032311,2124.958454851,26
carcassonne-uct265-vs-uct65-1000its,829,803,2214.937166281,2174.915837506,26
carcassonne-ucttuned270-vs-ucttuned325-1000its,829,803,2200.30083773,2147.787502222,26
carcassonne-uct320-vs-uct215-1000its,830,804,2197.372119646,2158.180715219,26
carcassonne-boltzmann100-vs-boltzmann10-1000its,832,806,2197.425560769,2169.640105645,26
carcassonne-boltzmann360-vs-boltzmann280-1000its,834,808,2219.450885971,2154.618627064,26
carcassonne-uct5-vs-uct55-1000its,835,809,2197.843373464,2123.181833344,26
carcassonne-boltzmann40-vs-boltzmann35-1000its,836,810,2158.599299607,2117.430515961,26
carcassonne-uct260-vs-uct340-1000its,836,810,2173.773210275,2119.709677057,26
carcassonne-ucttuned290-vs-ucttuned240-1000its,836,810,2180.622333937,2170.297923358,26
carcassonne-ucttuned40-vs-ucttuned150-1000its,836,810,2179.189095429,2136.238461145,26
carcassonne-ucttuned65-vs-ucttuned440-1000its,836,810,2246.523650958,2191.855693901,26
carcassonne-boltzmann60-vs-boltzmann110-1000its,837,811,2230.164285988,2231.376241339,26
carcassonne-boltzmann90-vs-boltzmann235-1000its,837,811,2181.534234454,2136.399510535,26
carcassonne-boltzmann165-vs-boltzmann420-1000its,839,813,2231.694198083,2169.417747101,26
carcassonne-boltzmann190-vs-boltzmann400-1000its,841,815,2138.695049732,2129.322774751,26
carcassonne-uct260-vs-uct125-1000its,842,816,2142.311299765,2130.984568816,26
carcassonne-uct410-vs-uct120-1000its,842,816,2170.364699129,2155.244961701,26
carcassonne-uct230-vs-uct185-1000its,843,817,2197.80148403,2127.519942003,26
carcassonne-uct40-vs-uct210-1000its,844,818,2175.790964833,2142.077168628,26
carcassonne-ucttuned325-vs-ucttuned30-1000its,844,818,2156.714188829,2133.59275372,26
carcassonne-boltzmann440-vs-boltzmann285-1000its,846,820,2147.179924952,2100.759482005,26
carcassonne-uct235-vs-uct290-1000its,846,820,2104.524587915,2041.549141731,26
carcassonne-uct320-vs-uct420-1000its,846,820,2114.311275211,2105.692890854,26
carcassonne-uct385-vs-uct140-1000its,850,824,2178.609151191,2160.155136776,26
carcassonne-ucttuned205-vs-ucttuned425-1000its,850,824,2168.767772303,2105.726777634,26
carcassonne-uct120-vs-uct150-1000its,851,825,2207.415988025,2206.59984361,26
carcassonne-boltzmann430-vs-boltzmann265-1000its,852,826,2202.001626002,2173.917405595,26
carcassonne-ucttuned85-vs-ucttuned470-1000its,853,827,2251.067975448,2208.474775666,26
carcassonne-ucttuned120-vs-ucttuned280-1000its,854,828,2264.308563905,2185.061837269,26
carcassonne-ucttuned55-vs-ucttuned20-1000its,854,828,2255.216195358,2172.2686627,26
carcassonne-ucttuned410-vs-ucttuned380-1000its,855,829,2188.103823604,2200.554417104,26
carcassonne-boltzmann415-vs-boltzmann135-1000its,857,831,2149.636633176,2116.134759514,26
carcassonne-boltzmann50-vs-boltzmann345-1000its,858,832,2218.49634627,2172.390967193,26
carcassonne-uct420-vs-uct100-1000its,862,836,2187.620424061,2152.322404438,26
carcassonne-ucttuned255-vs-ucttuned165-1000its,862,836,2209.116183489,2186.941948721,26
carcassonne-ucttuned460-vs-ucttuned55-1000its,864,838,2222.600948891,2166.918742849,26
carcassonne-uct470-vs-uct155-1000its,865,839,2215.739991568,2177.267275158,26
carcassonne-boltzmann55-vs-boltzmann50-1000its,868,842,2246.032242528,2188.560021006,26
carcassonne-uct60-vs-uct455-1000its,868,842,2188.59464336,2164.698381579,26
carcassonne-boltzmann450-vs-boltzmann250-1000its,871,845,2166.246083397,2130.309026796,26
carcassonne-uct240-vs-uct205-1000its,874,848,2273.711649118,2235.029936121,26
carcassonne-uct280-vs-uct75-1000its,874,848,2186.276169724,2121.825316123,26
carcassonne-ucttuned490-vs-ucttuned155-1000its,874,848,2144.977693887,2175.551135374,26
carcassonne-boltzmann85-vs-boltzmann285-1000its,876,850,2211.334041823,2204.772210652,26
carcassonne-boltzmann35-vs-boltzmann90-1000its,878,852,2223.323435233,2166.509005453,26
carcassonne-ucttuned130-vs-ucttuned360-1000its,881,855,2268.675518943,2165.373207919,26
carcassonne-boltzmann130-vs-boltzmann15-1000its,883,857,2175.480372593,2176.144270118,26
carcassonne-ucttuned115-vs-ucttuned140-1000its,887,861,2189.873240685,2160.431501144,26
carcassonne-uct155-vs-uct250-1000its,888,862,2094.276319632,2073.480626286,26
carcassonne-uct105-vs-uct240-1000its,890,864,2215.069532832,2176.927832021,26
carcassonne-boltzmann210-vs-boltzmann300-1000its,891,865,2176.675791181,2164.103231409,26
carcassonne-ucttuned255-vs-ucttuned270-1000its,892,866,2214.053444053,2131.370063603,26
carcassonne-uct315-vs-uct390-1000its,894,868,2169.276065926,2123.349114852,26
carcassonne-uct440-vs-uct385-1000its,894,868,2212.37764805,2143.477985615,26
carcassonne-ucttuned40-vs-ucttuned375-1000its,896,870,2147.833479882,2124.727736979,26
carcassonne-ucttuned485-vs-ucttuned210-1000its,896,870,2226.513974429,2131.131965843,26
carcassonne-ucttuned10-vs-ucttuned215-1000its,898,872,2125.028927725,2097.694605929,26
carcassonne-ucttuned375-vs-ucttuned380-1000its,913,887,2166.217880486,2120.270878394,26
carcassonne-uct325-vs-uct265-1000its,924,898,2224.88894224,2199.408380649,26
carcassonne-uct5-vs-uct365-1000its,928,902,2234.876606493,2139.446017861,26
carcassonne-ucttuned380-vs-ucttuned65-1000its,622,595,1731.765774231,1727.56033522,27
carcassonne-boltzmann350-vs-boltzmann265-1000its,715,688,2241.454116294,2129.927520994,27
carcassonne-ucttuned30-vs-ucttuned320-1000its,729,702,2163.073415975,2115.537063857,27
carcassonne-ucttuned100-vs-ucttuned295-1000its,734,707,2233.070391928,2185.435545668,27
carcassonne-uct15-vs-uct135-1000its,736,709,2177.715315011,2160.899874361,27
carcassonne-boltzmann195-vs-boltzmann55-1000its,742,715,2191.71737152,2123.874997817,27
carcassonne-boltzmann125-vs-boltzmann475-1000its,745,718,2170.829085314,2136.23209859,27
carcassonne-boltzmann400-vs-boltzmann300-1000its,747,720,2278.000458747,2225.009612405,27
carcassonne-ucttuned215-vs-ucttuned180-1000its,748,721,2163.431861689,2104.178973079,27
carcassonne-boltzmann380-vs-boltzmann220-1000its,749,722,2233.963273974,2172.199941239,27
carcassonne-ucttuned220-vs-ucttuned175-1000its,751,724,2159.615433835,2109.277051683,27
carcassonne-boltzmann110-vs-boltzmann185-1000its,753,726,2159.749922687,2128.59644756,27
carcassonne-uct375-vs-uct150-1000its,755,728,2179.1968188,2110.394670757,27
carcassonne-ucttuned200-vs-ucttuned230-1000its,764,737,2268.723659792,2209.600013367,27
carcassonne-ucttuned245-vs-ucttuned45-1000its,769,742,2213.263465993,2170.607377887,27
carcassonne-uct95-vs-uct40-1000its,772,745,2153.357154233,2088.388662068,27
carcassonne-uct435-vs-uct30-1000its,776,749,2213.781927476,2145.675066117,27
carcassonne-ucttuned35-vs-ucttuned345-1000its,777,750,2182.544927438,2144.207257791,27
carcassonne-boltzmann305-vs-boltzmann280-1000its,781,754,2256.157066795,2189.2214602,27
carcassonne-ucttuned365-vs-ucttuned270-1000its,781,754,2236.913251035,2120.72346991,27
carcassonne-boltzmann170-vs-boltzmann465-1000its,782,755,2215.312983041,2171.37933013,27
carcassonne-boltzmann55-vs-boltzmann365-1000its,783,756,2169.638838895,2129.630864432,27
carcassonne-boltzmann455-vs-boltzmann25-1000its,784,757,2184.600550454,2161.215455667,27
carcassonne-ucttuned130-vs-ucttuned45-1000its,784,757,2230.803467563,2180.042830691,27
carcassonne-boltzmann130-vs-boltzmann260-1000its,785,758,2204.773259177,2175.455958051,27
carcassonne-boltzmann240-vs-boltzmann375-1000its,785,758,2174.580605656,2182.715978839,27
carcassonne-uct150-vs-uct315-1000its,785,758,2132.882511305,2096.861144531,27
carcassonne-uct215-vs-uct475-1000its,785,758,2236.602316931,2223.049760137,27
carcassonne-uct320-vs-uct450-1000its,785,758,2252.200520046,2215.203625035,27
carcassonne-boltzmann330-vs-boltzmann465-1000its,786,759,2168.110524707,2169.76226613,27
carcassonne-boltzmann455-vs-boltzmann185-1000its,786,759,2258.887761242,2212.801228829,27
carcassonne-boltzmann425-vs-boltzmann420-1000its,787,760,2156.419475025,2120.223623683,27
carcassonne-boltzmann290-vs-boltzmann205-1000its,790,763,2148.195524705,2129.007451744,27
carcassonne-uct420-vs-uct330-1000its,790,763,2132.771155666,2101.194998157,27
carcassonne-boltzmann225-vs-boltzmann185-1000its,791,764,2196.010406129,2117.207506314,27
carcassonne-boltzmann375-vs-boltzmann230-1000its,793,766,2144.4528755,2133.58182231,27
carcassonne-uct395-vs-uct195-1000its,793,766,2203.44469929,2154.474007231,27
carcassonne-ucttuned100-vs-ucttuned485-1000its,793,766,2270.139727051,2222.044781529,27
carcassonne-boltzmann185-vs-boltzmann370-1000its,794,767,2145.224582383,2038.708654068,27
carcassonne-uct340-vs-uct450-1000its,796,769,2249.194206792,2226.571166965,27
carcassonne-ucttuned330-vs-ucttuned420-1000its,797,770,2291.20720816,2251.212732186,27
carcassonne-ucttuned365-vs-ucttuned160-1000its,800,773,2245.705736496,2209.081899906,27
carcassonne-boltzmann300-vs-boltzmann440-1000its,801,774,2212.197133889,2115.765921643,27
carcassonne-boltzmann220-vs-boltzmann375-1000its,802,775,2233.062197877,2170.706159525,27
carcassonne-boltzmann55-vs-boltzmann435-1000its,802,775,2177.593631377,2106.84553949,27
carcassonne-boltzmann65-vs-boltzmann175-1000its,802,775,2162.577888009,2145.072488542,27
carcassonne-uct175-vs-uct240-1000its,802,775,2166.085826126,2137.172261516,27
carcassonne-ucttuned175-vs-ucttuned105-1000its,802,775,2251.638329681,2150.059114445,27
carcassonne-ucttuned55-vs-ucttuned320-1000its,802,775,2157.894022121,2096.145329059,27
carcassonne-ucttuned265-vs-ucttuned450-1000its,804,777,2162.828407291,2092.021575507,27
carcassonne-boltzmann385-vs-boltzmann315-1000its,806,779,2151.86600851,2126.169859502,27
carcassonne-uct220-vs-uct230-1000its,806,779,2169.505290088,2130.306829581,27
carcassonne-uct350-vs-uct25-1000its,806,779,2138.293154704,2090.033542492,27
carcassonne-uct40-vs-uct220-1000its,807,780,2239.375765639,2153.978359078,27
carcassonne-boltzmann110-vs-boltzmann265-1000its,808,781,2255.406661644,2241.044386971,27
carcassonne-boltzmann420-vs-boltzmann425-1000its,808,781,2244.280143066,2207.989260798,27
carcassonne-boltzmann300-vs-boltzmann30-1000its,810,783,2184.620747137,2123.989923639,27
carcassonne-uct490-vs-uct90-1000its,810,783,2191.835589194,2158.60498399,27
carcassonne-uct85-vs-uct430-1000its,810,783,2164.120433031,2093.842639213,27
carcassonne-uct225-vs-uct75-1000its,811,784,2305.446043387,2201.562539025,27
carcassonne-ucttuned40-vs-ucttuned350-1000its,811,784,2224.215811196,2146.254378446,27
carcassonne-ucttuned60-vs-ucttuned350-1000its,812,785,2205.59294481,2161.271044825,27
carcassonne-boltzmann445-vs-boltzmann225-1000its,813,786,2222.730686598,2219.390784594,27
carcassonne-ucttuned200-vs-ucttuned380-1000its,813,786,2224.300336101,2177.490745217,27
carcassonne-ucttuned245-vs-ucttuned210-1000its,813,786,2224.2718509,2165.08866223,27
carcassonne-boltzmann395-vs-boltzmann300-1000its,814,787,2189.025798593,2134.694220636,27
carcassonne-ucttuned45-vs-ucttuned460-1000its,814,787,2263.875559349,2231.904759482,27
carcassonne-uct235-vs-uct365-1000its,815,788,2148.705831494,2111.805364375,27
carcassonne-boltzmann335-vs-boltzmann295-1000its,817,790,2304.841881429,2250.346817731,27
carcassonne-uct120-vs-uct100-1000its,817,790,2209.83260444,2187.02919169,27
carcassonne-uct195-vs-uct430-1000its,817,790,2241.814020811,2181.997666309,27
carcassonne-uct325-vs-uct260-1000its,817,790,2247.621300378,2207.323997469,27
carcassonne-ucttuned485-vs-ucttuned195-1000its,818,791,2235.476943288,2165.93978594,27
carcassonne-uct370-vs-uct45-1000its,819,792,2213.040976934,2201.056084847,27
carcassonne-ucttuned90-vs-ucttuned425-1000its,819,792,2182.972102722,2151.516853825,27
carcassonne-boltzmann355-vs-boltzmann5-1000its,820,793,2189.739807951,2174.85685492,27
carcassonne-uct380-vs-uct425-1000its,822,795,2147.833830894,2137.559151903,27
carcassonne-boltzmann420-vs-boltzmann110-1000its,823,796,2241.307626137,2181.060460178,27
carcassonne-boltzmann335-vs-boltzmann435-1000its,824,797,2198.80653529,2160.63659865,27
carcassonne-boltzmann370-vs-boltzmann320-1000its,824,797,2220.886846491,2165.77924343,27
carcassonne-boltzmann495-vs-boltzmann85-1000its,825,798,2116.424602876,2092.816454705,27
carcassonne-uct430-vs-uct330-1000its,825,798,2222.391310005,2136.792187294,27
carcassonne-uct465-vs-uct250-1000its,825,798,2220.862405871,2204.102950606,27
carcassonne-ucttuned25-vs-ucttuned490-1000its,825,798,2218.989357417,2169.640665588,27
carcassonne-boltzmann30-vs-boltzmann95-1000its,826,799,2193.607353126,2149.755937895,27
carcassonne-ucttuned45-vs-ucttuned190-1000its,826,799,2195.9927862,2170.959092187,27
carcassonne-uct255-vs-uct490-1000its,827,800,2174.806075287,2119.531913501,27
carcassonne-boltzmann80-vs-boltzmann475-1000its,829,802,2217.455946953,2156.410705139,27
carcassonne-uct240-vs-uct405-1000its,829,802,2163.328859368,2115.343279,27
carcassonne-ucttuned180-vs-ucttuned220-1000its,829,802,2180.250251403,2144.652048778,27
carcassonne-ucttuned25-vs-ucttuned180-1000its,829,802,2221.713602498,2149.78609811,27
carcassonne-ucttuned495-vs-ucttuned195-1000its,830,803,2182.672626477,2143.144010384,27
carcassonne-ucttuned415-vs-ucttuned370-1000its,831,804,2160.039307012,2120.240616624,27
carcassonne-ucttuned90-vs-ucttuned230-1000its,831,804,2226.188594551,2166.44339889,27
carcassonne-boltzmann300-vs-boltzmann425-1000its,833,806,2253.526418107,2176.943836138,27
carcassonne-ucttuned430-vs-ucttuned30-1000its,833,806,2248.181838695,2184.307597315,27
carcassonne-ucttuned285-vs-ucttuned80-1000its,834,807,2247.841415569,2252.181116027,27
carcassonne-boltzmann305-vs-boltzmann205-1000its,835,808,2174.795492637,2114.857618237,27
carcassonne-ucttuned210-vs-ucttuned160-1000its,836,809,2189.258422401,2128.927762553,27
carcassonne-boltzmann185-vs-boltzmann40-1000its,837,810,2262.963778848,2177.945485189,27
carcassonne-uct250-vs-uct255-1000its,837,810,2178.813061714,2094.886768822,27
carcassonne-boltzmann40-vs-boltzmann275-1000its,839,812,2150.341570464,2119.223357446,27
carcassonne-uct105-vs-uct190-1000its,840,813,2156.45535199,2117.406891097,27
carcassonne-uct120-vs-uct90-1000its,840,813,2247.630865724,2186.005327421,27
carcassonne-ucttuned130-vs-ucttuned210-1000its,840,813,2134.631128116,2130.135346771,27
carcassonne-ucttuned275-vs-ucttuned440-1000its,841,814,2150.564467378,2150.863788152,27
carcassonne-uct410-vs-uct385-1000its,842,815,2127.175937452,2030.443812961,27
carcassonne-boltzmann105-vs-boltzmann375-1000its,844,817,2206.907086698,2199.876343025,27
carcassonne-uct240-vs-uct270-1000its,845,818,2250.308129766,2163.47568895,27
carcassonne-ucttuned215-vs-ucttuned40-1000its,846,819,2188.498554337,2149.420874077,27
carcassonne-boltzmann100-vs-boltzmann15-1000its,847,820,2198.414473493,2128.377565875,27
carcassonne-uct40-vs-uct305-1000its,847,820,2219.760467045,2150.544613437,27
carcassonne-uct95-vs-uct200-1000its,848,821,2186.058104997,2141.647501091,27
carcassonne-boltzmann470-vs-boltzmann170-1000its,849,822,2158.990339576,2102.327493303,27
carcassonne-uct450-vs-uct310-1000its,850,823,2184.223807058,2091.068851021,27
carcassonne-uct365-vs-uct355-1000its,852,825,2170.54279223,2132.433926171,27
carcassonne-boltzmann170-vs-boltzmann245-1000its,854,827,2220.202000857,2092.167768992,27
carcassonne-uct15-vs-uct110-1000its,855,828,2253.547376855,2197.539363776,27
carcassonne-uct210-vs-uct60-1000its,855,828,2202.436159383,2132.851633456,27
carcassonne-uct345-vs-uct110-1000its,856,829,2198.002607225,2165.274768397,27
carcassonne-uct130-vs-uct170-1000its,857,830,2191.271104423,2127.863655208,27
carcassonne-uct480-vs-uct445-1000its,857,830,2218.681204477,2177.912251189,27
carcassonne-uct20-vs-uct175-1000its,858,831,2243.561851948,2198.800360784,27
carcassonne-boltzmann345-vs-boltzmann160-1000its,859,832,2174.897701835,2162.150307496,27
carcassonne-uct235-vs-uct40-1000its,859,832,2193.602536671,2118.686671849,27
carcassonne-boltzmann280-vs-boltzmann355-1000its,860,833,2210.902732803,2151.775797022,27
carcassonne-boltzmann355-vs-boltzmann100-1000its,863,836,2217.470602475,2166.85195421,27
carcassonne-ucttuned465-vs-ucttuned150-1000its,865,838,2221.027337122,2143.31013049,27
carcassonne-uct245-vs-uct70-1000its,866,839,2154.21209629,2129.013133087,27
carcassonne-uct15-vs-uct30-1000its,868,841,2175.53934875,2134.595640011,27
carcassonne-uct395-vs-uct300-1000its,869,842,2196.989744171,2185.524267014,27
carcassonne-ucttuned280-vs-ucttuned400-1000its,871,844,2198.840483161,2147.466407587,27
carcassonne-ucttuned435-vs-ucttuned175-1000its,871,844,2212.985161364,2187.075558316,27
carcassonne-uct295-vs-uct205-1000its,872,845,2172.489252123,2153.279604443,27
carcassonne-uct60-vs-uct430-1000its,872,845,2122.045892884,2061.781728721,27
carcassonne-boltzmann290-vs-boltzmann215-1000its,873,846,2168.63896237,2112.168522001,27
carcassonne-boltzmann55-vs-boltzmann355-1000its,873,846,2266.798129827,2239.232515342,27
carcassonne-uct380-vs-uct270-1000its,874,847,2173.735707484,2111.131301325,27
carcassonne-uct450-vs-uct465-1000its,874,847,2212.700902826,2142.946372546,27
carcassonne-boltzmann215-vs-boltzmann395-1000its,878,851,2229.140915397,2190.907172747,27
carcassonne-ucttuned290-vs-ucttuned335-1000its,883,856,2278.037667661,2203.523490051,27
carcassonne-ucttuned125-vs-ucttuned455-1000its,887,860,2260.761223917,2189.992929831,27
carcassonne-ucttuned480-vs-ucttuned250-1000its,887,860,2201.569360641,2153.759901931,27
carcassonne-ucttuned60-vs-ucttuned365-1000its,888,861,2232.356689685,2166.855296159,27
carcassonne-boltzmann470-vs-boltzmann5-1000its,890,863,2191.45911885,2169.138941107,27
carcassonne-uct495-vs-uct105-1000its,892,865,2167.260157211,2071.569190825,27
carcassonne-uct55-vs-uct65-1000its,892,865,2169.459440089,2143.894841051,27
carcassonne-uct395-vs-uct215-1000its,893,866,2269.273958857,2232.888612077,27
carcassonne-ucttuned40-vs-ucttuned30-1000its,899,872,2147.801080216,2127.173566046,27
carcassonne-ucttuned130-vs-ucttuned15-1000its,902,875,2209.297621523,2204.424623264,27
carcassonne-ucttuned450-vs-ucttuned65-1000its,905,878,2220.915019602,2158.930140352,27
carcassonne-uct425-vs-uct365-1000its,917,890,2166.308385715,2147.792792205,27
carcassonne-boltzmann70-vs-boltzmann435-1000its,949,922,2214.424904768,2152.803039373,27
carcassonne-uct245-vs-uct145-1000its,956,929,2187.757845174,2182.331280932,27
carcassonne-boltzmann60-vs-boltzmann30-1000its,738,710,2187.368428971,2145.804492398,28
carcassonne-uct250-vs-uct165-1000its,741,713,2242.729763513,2189.851220204,28
carcassonne-boltzmann230-vs-boltzmann395-1000its,744,716,2288.525950573,2183.961677635,28
carcassonne-uct280-vs-uct110-1000its,747,719,2197.701718193,2130.290149088,28
carcassonne-ucttuned60-vs-ucttuned305-1000its,748,720,2220.460016344,2177.798663995,28
carcassonne-boltzmann215-vs-boltzmann400-1000its,752,724,2215.823459948,2193.203870535,28
carcassonne-boltzmann135-vs-boltzmann235-1000its,754,726,2217.611527839,2136.142140571,28
carcassonne-boltzmann430-vs-boltzmann5-1000its,759,731,2188.480062289,2161.787537593,28
carcassonne-boltzmann170-vs-boltzmann300-1000its,762,734,2223.502618811,2157.902991743,28
carcassonne-uct355-vs-uct495-1000its,764,736,2201.794851268,2184.680858676,28
carcassonne-boltzmann215-vs-boltzmann45-1000its,766,738,2223.188418218,2192.395150421,28
carcassonne-boltzmann265-vs-boltzmann160-1000its,766,738,2211.740705069,2189.776693693,28
carcassonne-uct45-vs-uct50-1000its,769,741,2225.864085285,2190.606102532,28
carcassonne-uct240-vs-uct425-1000its,772,744,2263.144746649,2193.420030056,28
carcassonne-uct160-vs-uct220-1000its,774,746,2222.073121018,2160.204811661,28
carcassonne-uct490-vs-uct475-1000its,774,746,2168.90425019,2055.825772872,28
carcassonne-boltzmann275-vs-boltzmann240-1000its,776,748,2171.801841965,2126.400144863,28
carcassonne-uct335-vs-uct385-1000its,777,749,2228.950894485,2180.440877632,28
carcassonne-ucttuned330-vs-ucttuned265-1000its,777,749,2230.123390608,2133.514956719,28
carcassonne-uct110-vs-uct170-1000its,780,752,2162.00917228,2119.638369716,28
carcassonne-uct320-vs-uct295-1000its,780,752,2223.349887916,2183.061101979,28
carcassonne-ucttuned445-vs-ucttuned205-1000its,782,754,2122.850983952,2078.850886579,28
carcassonne-boltzmann110-vs-boltzmann300-1000its,783,755,2146.67167193,2115.744278871,28
carcassonne-boltzmann465-vs-boltzmann445-1000its,783,755,2173.207536293,2138.383533872,28
carcassonne-uct205-vs-uct45-1000its,784,756,2171.214948049,2145.84481945,28
carcassonne-ucttuned35-vs-ucttuned65-1000its,786,758,2203.506767648,2133.684382468,28
carcassonne-boltzmann130-vs-boltzmann85-1000its,787,759,2210.840232084,2104.221540275,28
carcassonne-boltzmann300-vs-boltzmann170-1000its,788,760,2142.240666261,2091.968539231,28
carcassonne-uct190-vs-uct330-1000its,790,762,2179.615290915,2156.311091888,28
carcassonne-boltzmann135-vs-boltzmann400-1000its,791,763,2191.456911517,2140.863793396,28
carcassonne-boltzmann395-vs-boltzmann175-1000its,791,763,2159.531496091,2161.863246743,28
carcassonne-boltzmann420-vs-boltzmann35-1000its,795,767,2292.073771766,2261.354729126,28
carcassonne-boltzmann90-vs-boltzmann325-1000its,795,767,2168.846411531,2132.867938027,28
carcassonne-boltzmann130-vs-boltzmann140-1000its,796,768,2282.537643079,2200.514581084,28
carcassonne-boltzmann325-vs-boltzmann65-1000its,796,768,2139.732796621,2092.554285931,28
carcassonne-ucttuned475-vs-ucttuned455-1000its,796,768,2223.480327748,2227.489416959,28
carcassonne-ucttuned95-vs-ucttuned335-1000its,796,768,2159.444287214,2099.839133624,28
carcassonne-boltzmann265-vs-boltzmann465-1000its,798,770,2199.216682737,2139.453060075,28
carcassonne-ucttuned235-vs-ucttuned220-1000its,798,770,2207.772207528,2135.746216791,28
carcassonne-ucttuned135-vs-ucttuned190-1000its,799,771,2340.786117311,2254.058683067,28
carcassonne-boltzmann455-vs-boltzmann195-1000its,801,773,2168.911634733,2133.95087884,28
carcassonne-uct375-vs-uct370-1000its,802,774,2117.470611054,2060.30260739,28
carcassonne-ucttuned445-vs-ucttuned240-1000its,802,774,2220.294744651,2171.449197079,28
carcassonne-boltzmann380-vs-boltzmann350-1000its,803,775,2252.579214825,2181.217065364,28
carcassonne-uct20-vs-uct240-1000its,804,776,2173.85020488,2142.503720428,28
carcassonne-ucttuned205-vs-ucttuned385-1000its,806,778,2191.049719426,2158.568186291,28
carcassonne-boltzmann95-vs-boltzmann90-1000its,809,781,2282.74050957,2221.917646334,28
carcassonne-uct330-vs-uct100-1000its,809,781,2278.258870601,2257.524889143,28
carcassonne-ucttuned315-vs-ucttuned440-1000its,809,781,2219.94318225,2169.33528161,28
carcassonne-boltzmann370-vs-boltzmann250-1000its,810,782,2274.08413079,2195.827986209,28
carcassonne-uct490-vs-uct390-1000its,812,784,2191.111192296,2146.845715887,28
carcassonne-ucttuned185-vs-ucttuned30-1000its,814,786,2236.309780314,2169.811671326,28
carcassonne-uct75-vs-uct160-1000its,815,787,2171.346748268,2131.320248514,28
carcassonne-boltzmann200-vs-boltzmann115-1000its,816,788,2216.30282819,2135.388580131,28
carcassonne-boltzmann285-vs-boltzmann175-1000its,816,788,2142.394245247,2110.620625872,28
carcassonne-uct55-vs-uct50-1000its,816,788,2170.240686706,2135.752377854,28
carcassonne-boltzmann280-vs-boltzmann490-1000its,818,790,2211.36054839,2164.370347548,28
carcassonne-boltzmann110-vs-boltzmann25-1000its,820,792,2208.70372397,2128.793425392,28
carcassonne-boltzmann250-vs-boltzmann135-1000its,820,792,2136.266516647,2135.320597138,28
carcassonne-uct145-vs-uct380-1000its,822,794,2175.91589663,2095.931689272,28
carcassonne-uct450-vs-uct340-1000its,822,794,2269.699138816,2220.11551015,28
carcassonne-ucttuned155-vs-ucttuned465-1000its,822,794,2208.337403663,2222.09602636,28
carcassonne-boltzmann240-vs-boltzmann250-1000its,823,795,2265.929285026,2191.083596131,28
carcassonne-uct450-vs-uct95-1000its,823,795,2237.639053706,2195.074661218,28
carcassonne-ucttuned440-vs-ucttuned85-1000its,823,795,2226.885054133,2170.349993327,28
carcassonne-ucttuned410-vs-ucttuned345-1000its,824,796,2147.600864061,2101.439477646,28
carcassonne-ucttuned110-vs-ucttuned275-1000its,826,798,2227.143138011,2193.554495688,28
carcassonne-uct355-vs-uct305-1000its,827,799,2191.62929428,2184.164887399,28
carcassonne-ucttuned300-vs-ucttuned325-1000its,827,799,2180.067858429,2150.664820647,28
carcassonne-uct380-vs-uct20-1000its,829,801,2308.503324582,2277.539401819,28
carcassonne-ucttuned200-vs-ucttuned160-1000its,829,801,2219.462450379,2165.643982364,28
carcassonne-uct230-vs-uct465-1000its,831,803,2222.278719561,2229.706455893,28
carcassonne-uct340-vs-uct190-1000its,833,805,2233.062842474,2177.779754726,28
carcassonne-boltzmann355-vs-boltzmann170-1000its,837,809,2311.351635245,2265.548584493,28
carcassonne-ucttuned400-vs-ucttuned235-1000its,837,809,2202.672063302,2123.916625923,28
carcassonne-ucttuned310-vs-ucttuned240-1000its,838,810,2226.847613308,2212.871231183,28
carcassonne-ucttuned340-vs-ucttuned435-1000its,838,810,2230.491341128,2160.445756004,28
carcassonne-boltzmann415-vs-boltzmann455-1000its,839,811,2218.606194552,2185.181763372,28
carcassonne-boltzmann210-vs-boltzmann380-1000its,840,812,2181.826625204,2149.132376476,28
carcassonne-boltzmann490-vs-boltzmann115-1000its,840,812,2178.399383344,2145.036937905,28
carcassonne-uct55-vs-uct190-1000its,840,812,2176.141863923,2188.152118212,28
carcassonne-ucttuned285-vs-ucttuned170-1000its,841,813,2196.808033175,2169.049483823,28
carcassonne-ucttuned245-vs-ucttuned60-1000its,842,814,2219.971222989,2150.327635472,28
carcassonne-uct20-vs-uct210-1000its,843,815,2117.035198879,2060.776792501,28
carcassonne-uct340-vs-uct210-1000its,843,815,2246.337384749,2185.371628978,28
carcassonne-uct55-vs-uct275-1000its,843,815,2185.869943419,2144.253151418,28
carcassonne-boltzmann35-vs-boltzmann400-1000its,847,819,2209.410175147,2148.076603648,28
carcassonne-boltzmann420-vs-boltzmann45-1000its,847,819,2256.980366137,2194.527948555,28
carcassonne-ucttuned165-vs-ucttuned225-1000its,847,819,2136.974841261,2080.675955207,28
carcassonne-boltzmann90-vs-boltzmann255-1000its,848,820,2320.189997761,2234.09211208,28
carcassonne-boltzmann135-vs-boltzmann5-1000its,851,823,2152.653934409,2179.891154137,28
carcassonne-ucttuned190-vs-ucttuned340-1000its,851,823,2179.366961224,2156.136965952,28
carcassonne-ucttuned315-vs-ucttuned185-1000its,851,823,2252.709605069,2181.899909102,28
carcassonne-uct415-vs-uct165-1000its,852,824,2227.379826575,2171.048087902,28
carcassonne-boltzmann70-vs-boltzmann20-1000its,853,825,2253.998299153,2226.139685942,28
carcassonne-boltzmann295-vs-boltzmann150-1000its,855,827,2210.133118914,2145.765524667,28
carcassonne-uct25-vs-uct145-1000its,855,827,2228.33992159,2229.877869456,28
carcassonne-ucttuned250-vs-ucttuned65-1000its,855,827,2197.682832929,2162.411706915,28
carcassonne-boltzmann60-vs-boltzmann380-1000its,857,829,2174.287341641,2161.782986058,28
carcassonne-ucttuned345-vs-ucttuned195-1000its,857,829,2154.989882481,2190.692990924,28
carcassonne-uct265-vs-uct210-1000its,858,830,2212.405117711,2146.244963955,28
carcassonne-uct95-vs-uct310-1000its,858,830,2225.889318526,2149.215740589,28
carcassonne-boltzmann210-vs-boltzmann135-1000its,859,831,2183.235086779,2151.009982993,28
carcassonne-boltzmann495-vs-boltzmann155-1000its,859,831,2163.668028278,2121.918537889,28
carcassonne-uct420-vs-uct25-1000its,860,832,2157.910344873,2093.966787375,28
carcassonne-uct150-vs-uct380-1000its,862,834,2231.783791654,2206.859533119,28
carcassonne-uct245-vs-uct480-1000its,864,836,2210.692688045,2197.264099976,28
carcassonne-ucttuned145-vs-ucttuned10-1000its,864,836,2212.478803941,2167.315406652,28
carcassonne-ucttuned150-vs-ucttuned170-1000its,864,836,2241.539045278,2195.435366959,28
carcassonne-boltzmann215-vs-boltzmann375-1000its,869,841,2157.478991339,2118.985672405,28
carcassonne-ucttuned260-vs-ucttuned445-1000its,870,842,2193.524491526,2147.207158247,28
carcassonne-uct150-vs-uct425-1000its,871,843,2189.096647855,2143.347873201,28
carcassonne-uct25-vs-uct395-1000its,871,843,2176.360042765,2120.593818116,28
carcassonne-uct420-vs-uct310-1000its,871,843,2246.360312609,2209.294782019,28
carcassonne-ucttuned130-vs-ucttuned165-1000its,876,848,2165.167213232,2109.653960022,28
carcassonne-uct130-vs-uct295-1000its,877,849,2177.036988238,2171.906337249,28
carcassonne-uct40-vs-uct445-1000its,877,849,2314.104054977,2259.999203263,28
carcassonne-uct455-vs-uct10-1000its,880,852,2240.717743281,2216.396702754,28
carcassonne-boltzmann360-vs-boltzmann25-1000its,881,853,2207.976174871,2177.978404675,28
carcassonne-boltzmann15-vs-boltzmann395-1000its,888,860,2247.857838892,2245.983357801,28
carcassonne-ucttuned315-vs-ucttuned205-1000its,888,860,2184.441063323,2122.379917037,28
carcassonne-boltzmann255-vs-boltzmann230-1000its,894,866,2226.16633791,2199.119965441,28
carcassonne-boltzmann95-vs-boltzmann130-1000its,894,866,2186.436553599,2146.66797335,28
carcassonne-uct215-vs-uct310-1000its,895,867,2211.89349658,2192.955766588,28
carcassonne-ucttuned80-vs-ucttuned410-1000its,900,872,2195.162712319,2141.153560691,28
carcassonne-ucttuned20-vs-ucttuned470-1000its,902,874,2251.135369175,2201.045300551,28
carcassonne-ucttuned450-vs-ucttuned225-1000its,906,878,2199.392869646,2175.233834969,28
carcassonne-uct105-vs-uct280-1000its,908,880,2207.139784979,2181.472147339,28
carcassonne-ucttuned50-vs-ucttuned245-1000its,908,880,2193.771052506,2097.840629482,28
carcassonne-ucttuned75-vs-ucttuned150-1000its,908,880,2161.115568601,2121.491171329,28
carcassonne-boltzmann145-vs-boltzmann35-1000its,728,699,2232.06686314,2153.084048792,29
carcassonne-boltzmann35-vs-boltzmann15-1000its,751,722,2193.46185181,2124.083292431,29
carcassonne-uct305-vs-uct240-1000its,759,730,2213.490318391,2154.121398413,29
carcassonne-boltzmann230-vs-boltzmann465-1000its,761,732,2260.584405096,2156.022599404,29
carcassonne-boltzmann150-vs-boltzmann115-1000its,762,733,2190.528347404,2106.260612295,29
carcassonne-boltzmann245-vs-boltzmann15-1000its,765,736,2223.953296553,2204.478347974,29
carcassonne-uct45-vs-uct240-1000its,766,737,2167.33660918,2138.180418692,29
carcassonne-boltzmann235-vs-boltzmann145-1000its,767,738,2114.127257335,2136.667094274,29
carcassonne-uct295-vs-uct285-1000its,768,739,2211.451710416,2184.321584181,29
carcassonne-uct165-vs-uct200-1000its,772,743,2151.132128807,2093.788165073,29
carcassonne-boltzmann155-vs-boltzmann280-1000its,773,744,2163.54749016,2118.447371159,29
carcassonne-ucttuned460-vs-ucttuned390-1000its,776,747,2179.354046558,2161.37442551,29
carcassonne-uct240-vs-uct260-1000its,777,748,2289.123933238,2193.730646245,29
carcassonne-ucttuned165-vs-ucttuned260-1000its,777,748,2260.789491973,2242.015912336,29
carcassonne-boltzmann170-vs-boltzmann280-1000its,780,751,2218.911118178,2187.792378696,29
carcassonne-boltzmann285-vs-boltzmann220-1000its,782,753,2216.143814588,2147.251418343,29
carcassonne-uct125-vs-uct180-1000its,784,755,2209.84582449,2133.874496258,29
carcassonne-ucttuned435-vs-ucttuned430-1000its,784,755,2175.092792941,2121.33981822,29
carcassonne-uct250-vs-uct120-1000its,785,756,2170.899872567,2151.969579952,29
carcassonne-ucttuned70-vs-ucttuned380-1000its,785,756,2235.221901505,2158.001737554,29
carcassonne-boltzmann120-vs-boltzmann415-1000its,787,758,2218.562593338,2156.145913273,29
carcassonne-uct215-vs-uct170-1000its,789,760,2216.934452816,2119.620810347,29
carcassonne-uct300-vs-uct210-1000its,791,762,2151.858360143,2089.007517524,29
carcassonne-uct305-vs-uct215-1000its,793,764,2227.095707819,2165.09447115,29
carcassonne-uct150-vs-uct420-1000its,796,767,2207.734883811,2178.14901353,29
carcassonne-uct225-vs-uct195-1000its,796,767,2235.679151656,2153.346272399,29
carcassonne-ucttuned145-vs-ucttuned465-1000its,796,767,2245.029261122,2194.762802673,29
carcassonne-boltzmann220-vs-boltzmann490-1000its,797,768,2287.925179725,2242.991815294,29
carcassonne-boltzmann330-vs-boltzmann395-1000its,797,768,2197.036293124,2184.446506158,29
carcassonne-uct275-vs-uct25-1000its,797,768,2220.70894934,2192.342059478,29
carcassonne-ucttuned190-vs-ucttuned225-1000its,797,768,2226.553606013,2213.159139376,29
carcassonne-uct155-vs-uct45-1000its,799,770,2175.626067121,2129.659366923,29
carcassonne-boltzmann160-vs-boltzmann385-1000its,800,771,2164.394946508,2100.546914277,29
carcassonne-uct10-vs-uct355-1000its,800,771,2272.779476303,2186.252607092,29
carcassonne-uct120-vs-uct130-1000its,800,771,2197.080207749,2143.145556681,29
carcassonne-boltzmann225-vs-boltzmann125-1000its,804,775,2244.908938036,2182.084945241,29
carcassonne-uct420-vs-uct80-1000its,805,776,2154.16651945,2141.850160008,29
carcassonne-ucttuned310-vs-ucttuned290-1000its,806,777,2297.825637673,2254.468600061,29
carcassonne-ucttuned395-vs-ucttuned190-1000its,807,778,2210.348937284,2178.81584331,29
carcassonne-ucttuned210-vs-ucttuned345-1000its,808,779,2174.195032836,2134.465330157,29
carcassonne-ucttuned410-vs-ucttuned145-1000its,808,779,2220.393401309,2208.53664175,29
carcassonne-boltzmann380-vs-boltzmann345-1000its,812,783,2179.160962756,2178.030057873,29
carcassonne-boltzmann470-vs-boltzmann220-1000its,813,784,2216.494366622,2153.069634236,29
carcassonne-uct15-vs-uct375-1000its,813,784,2173.725954986,2115.214401321,29
carcassonne-ucttuned95-vs-ucttuned430-1000its,813,784,2173.62184538,2137.955421587,29
carcassonne-boltzmann200-vs-boltzmann180-1000its,815,786,2184.523891798,2138.388732315,29
carcassonne-ucttuned425-vs-ucttuned405-1000its,815,786,2196.247816891,2135.013991859,29
carcassonne-ucttuned475-vs-ucttuned100-1000its,816,787,2159.220271906,2102.269267732,29
carcassonne-boltzmann385-vs-boltzmann150-1000its,819,790,2170.552615521,2154.745908676,29
carcassonne-ucttuned55-vs-ucttuned155-1000its,819,790,2186.489279757,2190.98562679,29
carcassonne-ucttuned210-vs-ucttuned420-1000its,821,792,2248.892606609,2198.844703371,29
carcassonne-boltzmann310-vs-boltzmann240-1000its,822,793,2211.784406768,2209.097746994,29
carcassonne-boltzmann330-vs-boltzmann50-1000its,822,793,2202.191809934,2126.069719385,29
carcassonne-ucttuned130-vs-ucttuned300-1000its,822,793,2183.49037988,2135.478808514,29
carcassonne-ucttuned215-vs-ucttuned75-1000its,822,793,2226.207080622,2177.50632935,29
carcassonne-ucttuned180-vs-ucttuned205-1000its,823,794,2164.939148578,2139.290342208,29
carcassonne-uct40-vs-uct205-1000its,824,795,2182.495254177,2119.691610994,29
carcassonne-boltzmann185-vs-boltzmann80-1000its,825,796,2141.297813851,2138.333570814,29
carcassonne-uct195-vs-uct185-1000its,826,797,2186.221595837,2165.26634757,29
carcassonne-boltzmann455-vs-boltzmann325-1000its,827,798,2232.200624667,2201.892822708,29
carcassonne-ucttuned190-vs-ucttuned115-1000its,828,799,2167.137957,2140.520149683,29
carcassonne-ucttuned380-vs-ucttuned310-1000its,829,800,2168.484765736,2135.189802616,29
carcassonne-uct35-vs-uct105-1000its,830,801,2210.489473138,2151.583827847,29
carcassonne-uct85-vs-uct485-1000its,830,801,2207.830480963,2134.429317603,29
carcassonne-ucttuned30-vs-ucttuned285-1000its,831,802,2256.573147451,2205.403526524,29
carcassonne-ucttuned385-vs-ucttuned15-1000its,831,802,2218.622378863,2190.674562337,29
carcassonne-ucttuned420-vs-ucttuned415-1000its,831,802,2145.40916681,2127.850667365,29
carcassonne-boltzmann225-vs-boltzmann490-1000its,832,803,2245.59786756,2169.885065853,29
carcassonne-boltzmann270-vs-boltzmann40-1000its,832,803,2181.884224541,2153.844627317,29
carcassonne-boltzmann50-vs-boltzmann375-1000its,832,803,2172.832933279,2088.574767106,29
carcassonne-uct65-vs-uct250-1000its,832,803,2239.273086228,2159.47427674,29
carcassonne-ucttuned375-vs-ucttuned155-1000its,835,806,2192.360561876,2127.283097264,29
carcassonne-boltzmann435-vs-boltzmann385-1000its,836,807,2293.561889916,2259.741994412,29
carcassonne-ucttuned15-vs-ucttuned320-1000its,836,807,2217.366751571,2127.976321421,29
carcassonne-ucttuned175-vs-ucttuned215-1000its,836,807,2145.711928934,2127.633414381,29
carcassonne-ucttuned300-vs-ucttuned90-1000its,836,807,2166.798381658,2141.59426303,29
carcassonne-boltzmann235-vs-boltzmann200-1000its,837,808,2176.648587006,2147.104364979,29
carcassonne-boltzmann465-vs-boltzmann330-1000its,837,808,2170.07115194,2118.517129784,29
carcassonne-boltzmann50-vs-boltzmann230-1000its,837,808,2187.679526565,2095.716617741,29
carcassonne-uct490-vs-uct265-1000its,837,808,2268.754371742,2238.019836773,29
carcassonne-ucttuned160-vs-ucttuned465-1000its,837,808,2207.397146757,2168.691989276,29
carcassonne-ucttuned255-vs-ucttuned330-1000its,837,808,2091.287064221,2036.703677773,29
carcassonne-ucttuned295-vs-ucttuned400-1000its,838,809,2214.483897619,2214.759160056,29
carcassonne-ucttuned105-vs-ucttuned435-1000its,839,810,2233.389266693,2198.738576777,29
carcassonne-ucttuned210-vs-ucttuned50-1000its,839,810,2215.567491039,2219.422346643,29
carcassonne-ucttuned260-vs-ucttuned370-1000its,839,810,2216.848424203,2159.446296375,29
carcassonne-ucttuned120-vs-ucttuned80-1000its,840,811,2131.490976836,2125.438591224,29
carcassonne-boltzmann170-vs-boltzmann490-1000its,843,814,2154.883238421,2141.448291754,29
carcassonne-uct470-vs-uct170-1000its,844,815,2165.570907505,2148.195361933,29
carcassonne-ucttuned395-vs-ucttuned165-1000its,845,816,2241.422487529,2195.189645153,29
carcassonne-ucttuned200-vs-ucttuned240-1000its,846,817,2202.170887634,2160.695251504,29
carcassonne-ucttuned60-vs-ucttuned420-1000its,846,817,2251.717658992,2204.389661836,29
carcassonne-ucttuned215-vs-ucttuned100-1000its,847,818,2185.662561119,2173.955928915,29
carcassonne-ucttuned280-vs-ucttuned110-1000its,848,819,2203.031679368,2209.489656897,29
carcassonne-ucttuned50-vs-ucttuned465-1000its,849,820,2171.222743205,2116.957502903,29
carcassonne-boltzmann70-vs-boltzmann165-1000its,850,821,2150.635709255,2101.626738435,29
carcassonne-uct290-vs-uct45-1000its,851,822,2188.11382034,2121.509685759,29
carcassonne-uct155-vs-uct145-1000its,853,824,2148.633369916,2134.621433284,29
carcassonne-uct80-vs-uct320-1000its,853,824,2195.528462549,2135.873368587,29
carcassonne-boltzmann220-vs-boltzmann200-1000its,854,825,2163.461447704,2112.938015957,29
carcassonne-uct235-vs-uct75-1000its,856,827,2201.177473419,2193.345192275,29
carcassonne-uct55-vs-uct285-1000its,856,827,2186.278129085,2103.868354622,29
carcassonne-ucttuned115-vs-ucttuned165-1000its,856,827,2209.065353288,2136.168331909,29
carcassonne-boltzmann185-vs-boltzmann325-1000its,858,829,2236.330561528,2194.61651331,29
carcassonne-ucttuned295-vs-ucttuned345-1000its,858,829,2215.215710874,2138.518723301,29
carcassonne-uct420-vs-uct225-1000its,859,830,2176.916606758,2157.315765302,29
carcassonne-uct95-vs-uct335-1000its,859,830,2142.851603517,2095.48324261,29
carcassonne-uct380-vs-uct165-1000its,860,831,2148.422949635,2106.467815094,29
carcassonne-ucttuned140-vs-ucttuned45-1000its,862,833,2173.19464719,2115.73380667,29
carcassonne-ucttuned65-vs-ucttuned375-1000its,863,834,2156.344201642,2124.552325439,29
carcassonne-uct335-vs-uct295-1000its,864,835,2188.638491713,2127.066744442,29
carcassonne-ucttuned485-vs-ucttuned20-1000its,864,835,2159.308350846,2085.676260051,29
carcassonne-ucttuned430-vs-ucttuned225-1000its,867,838,2233.582389087,2203.462619861,29
carcassonne-boltzmann460-vs-boltzmann30-1000its,868,839,2232.364449852,2164.795796584,29
carcassonne-uct435-vs-uct360-1000its,872,843,2152.917091528,2098.564349106,29
carcassonne-ucttuned50-vs-ucttuned85-1000its,872,843,2234.719581795,2175.046142422,29
carcassonne-uct170-vs-uct135-1000its,876,847,2233.682054739,2172.690565772,29
carcassonne-boltzmann90-vs-boltzmann250-1000its,878,849,2184.248326655,2188.993949229,29
carcassonne-uct370-vs-uct250-1000its,878,849,2182.743131817,2203.181490058,29
carcassonne-ucttuned25-vs-ucttuned120-1000its,881,852,2229.374278122,2154.071120872,29
carcassonne-ucttuned270-vs-ucttuned385-1000its,882,853,2249.982324265,2195.605924408,29
carcassonne-boltzmann240-vs-boltzmann275-1000its,883,854,2148.218224386,2116.401857403,29
carcassonne-ucttuned155-vs-ucttuned215-1000its,887,858,2167.492886618,2143.662508639,29
carcassonne-boltzmann275-vs-boltzmann250-1000its,890,861,2229.178135386,2153.646220181,29
carcassonne-boltzmann380-vs-boltzmann155-1000its,892,863,2189.036005382,2163.662230075,29
carcassonne-boltzmann60-vs-boltzmann265-1000its,894,865,2206.144265114,2193.400829549,29
carcassonne-ucttuned140-vs-ucttuned15-1000its,898,869,2223.909207232,2171.611100714,29
carcassonne-ucttuned165-vs-ucttuned90-1000its,900,871,2208.990990548,2171.986347523,29
carcassonne-ucttuned10-vs-ucttuned60-1000its,901,872,2228.646603352,2157.358425733,29
carcassonne-boltzmann430-vs-boltzmann285-1000its,907,878,2164.767030287,2187.518966448,29
carcassonne-uct450-vs-uct395-1000its,917,888,2300.690349364,2291.871473006,29
carcassonne-ucttuned445-vs-ucttuned190-1000its,939,910,2127.718608692,2073.230242144,29
carcassonne-ucttuned420-vs-ucttuned270-1000its,748,718,2122.25940051,2088.215740709,30
carcassonne-boltzmann135-vs-boltzmann280-1000its,750,720,2202.06690798,2132.356713704,30
carcassonne-uct15-vs-uct160-1000its,750,720,2139.782977059,2119.837949281,30
carcassonne-boltzmann275-vs-boltzmann460-1000its,752,722,2234.842203258,2171.176916713,30
carcassonne-uct425-vs-uct65-1000its,753,723,2267.426752221,2174.415684012,30
carcassonne-uct490-vs-uct110-1000its,757,727,2154.073319666,2144.293276392,30
carcassonne-uct345-vs-uct220-1000its,758,728,2173.530342997,2168.529573643,30
carcassonne-ucttuned275-vs-ucttuned130-1000its,758,728,2219.419454996,2177.404324796,30
carcassonne-boltzmann455-vs-boltzmann275-1000its,759,729,2231.262016794,2218.926191089,30
carcassonne-boltzmann170-vs-boltzmann225-1000its,766,736,2208.308320426,2162.145428897,30
carcassonne-uct285-vs-uct485-1000its,766,736,2170.110335207,2133.145077132,30
carcassonne-boltzmann410-vs-boltzmann345-1000its,769,739,2253.294726844,2223.785756586,30
carcassonne-boltzmann470-vs-boltzmann480-1000its,772,742,2251.034477498,2214.294703723,30
carcassonne-ucttuned160-vs-ucttuned50-1000its,774,744,2200.243263768,2173.416365944,30
carcassonne-boltzmann460-vs-boltzmann205-1000its,775,745,2235.719418441,2191.635746727,30
carcassonne-boltzmann95-vs-boltzmann465-1000its,777,747,2250.400458025,2152.330716058,30
carcassonne-uct430-vs-uct140-1000its,778,748,2272.629515408,2190.449731188,30
carcassonne-boltzmann225-vs-boltzmann135-1000its,783,753,2142.29116628,2148.341808454,30
carcassonne-ucttuned450-vs-ucttuned430-1000its,783,753,2209.356842193,2148.230761625,30
carcassonne-uct40-vs-uct115-1000its,785,755,2194.389613352,2148.631742784,30
carcassonne-boltzmann175-vs-boltzmann490-1000its,787,757,2194.431590127,2138.471076552,30
carcassonne-uct420-vs-uct385-1000its,787,757,2166.079973148,2122.373734445,30
carcassonne-uct75-vs-uct200-1000its,787,757,2205.841377711,2178.549191367,30
carcassonne-boltzmann100-vs-boltzmann55-1000its,788,758,2242.268179798,2167.400109562,30
carcassonne-boltzmann485-vs-boltzmann390-1000its,788,758,2211.139546974,2193.930455066,30
carcassonne-ucttuned480-vs-ucttuned295-1000its,788,758,2218.201322824,2135.592456623,30
carcassonne-boltzmann105-vs-boltzmann115-1000its,789,759,2210.666616475,2200.477211326,30
carcassonne-boltzmann415-vs-boltzmann80-1000its,790,760,2233.122341052,2149.25794664,30
carcassonne-uct225-vs-uct350-1000its,790,760,2244.860227267,2221.975752254,30
carcassonne-uct240-vs-uct225-1000its,791,761,2239.148411893,2185.063739156,30
carcassonne-boltzmann440-vs-boltzmann450-1000its,792,762,2190.306314659,2182.749732489,30
carcassonne-ucttuned160-vs-ucttuned185-1000its,792,762,2209.098778405,2127.247603519,30
carcassonne-ucttuned345-vs-ucttuned205-1000its,792,762,2200.066318332,2156.642204915,30
carcassonne-ucttuned65-vs-ucttuned485-1000its,792,762,2184.599396319,2083.321112485,30
carcassonne-boltzmann240-vs-boltzmann200-1000its,793,763,2129.7446374,2112.65484075,30
carcassonne-uct160-vs-uct235-1000its,793,763,2175.347778392,2165.03996827,30
carcassonne-boltzmann15-vs-boltzmann25-1000its,794,764,2210.293684347,2134.054906131,30
carcassonne-uct85-vs-uct30-1000its,797,767,2181.408424592,2119.189732128,30
carcassonne-uct350-vs-uct465-1000its,798,768,2154.459060672,2114.643563877,30
carcassonne-boltzmann135-vs-boltzmann95-1000its,799,769,2165.247623097,2176.973108639,30
carcassonne-boltzmann125-vs-boltzmann255-1000its,802,772,2151.152943912,2112.14730821,30
carcassonne-ucttuned265-vs-ucttuned270-1000its,803,773,2183.008224015,2134.726247957,30
carcassonne-ucttuned280-vs-ucttuned430-1000its,803,773,2106.467705916,2107.366934766,30
carcassonne-uct255-vs-uct330-1000its,804,774,2187.879635967,2147.011369919,30
carcassonne-ucttuned435-vs-ucttuned270-1000its,804,774,2184.250883411,2089.884263257,30
carcassonne-boltzmann400-vs-boltzmann415-1000its,807,777,2205.713935897,2159.65612796,30
carcassonne-uct335-vs-uct140-1000its,807,777,2174.086808902,2150.132513276,30
carcassonne-boltzmann95-vs-boltzmann60-1000its,808,778,2176.510228203,2144.773244542,30
carcassonne-ucttuned215-vs-ucttuned120-1000its,808,778,2237.835943081,2207.71636425,30
carcassonne-boltzmann120-vs-boltzmann460-1000its,809,779,2200.35263079,2152.374471702,30
carcassonne-ucttuned200-vs-ucttuned180-1000its,809,779,2215.074568604,2175.521846333,30
carcassonne-boltzmann95-vs-boltzmann435-1000its,810,780,2189.647926136,2160.850372817,30
carcassonne-ucttuned340-vs-ucttuned85-1000its,810,780,2237.734552944,2233.949440089,30
carcassonne-ucttuned60-vs-ucttuned260-1000its,810,780,2255.142929126,2192.739308366,30
carcassonne-ucttuned90-vs-ucttuned420-1000its,810,780,2144.722450082,2107.194190349,30
carcassonne-boltzmann120-vs-boltzmann70-1000its,811,781,2187.87163747,2172.673527245,30
carcassonne-boltzmann95-vs-boltzmann325-1000its,811,781,2218.461531881,2179.094815104,30
carcassonne-boltzmann230-vs-boltzmann20-1000its,812,782,2185.95383341,2144.098583575,30
carcassonne-boltzmann385-vs-boltzmann185-1000its,812,782,2167.692812472,2133.511609002,30
carcassonne-boltzmann420-vs-boltzmann90-1000its,812,782,2235.913571948,2129.190112307,30
carcassonne-uct75-vs-uct435-1000its,812,782,2117.951471218,2109.129630506,30
carcassonne-ucttuned195-vs-ucttuned70-1000its,812,782,2236.316459032,2173.735727037,30
carcassonne-uct430-vs-uct450-1000its,814,784,2219.942345057,2178.53512786,30
carcassonne-uct130-vs-uct155-1000its,815,785,2193.066416218,2191.316784234,30
carcassonne-uct190-vs-uct245-1000its,816,786,2278.960869514,2174.022433828,30
carcassonne-ucttuned190-vs-ucttuned175-1000its,816,786,2234.957652264,2214.961029262,30
carcassonne-boltzmann105-vs-boltzmann195-1000its,817,787,2238.578369661,2153.167009869,30
carcassonne-boltzmann160-vs-boltzmann275-1000its,817,787,2199.241603179,2164.387254677,30
carcassonne-ucttuned165-vs-ucttuned370-1000its,817,787,2247.822294816,2250.293495125,30
carcassonne-boltzmann150-vs-boltzmann45-1000its,818,788,2152.407084505,2119.256362664,30
carcassonne-boltzmann55-vs-boltzmann480-1000its,819,789,2221.310893414,2191.295880793,30
carcassonne-uct315-vs-uct25-1000its,819,789,2167.268086953,2169.033048475,30
carcassonne-ucttuned200-vs-ucttuned465-1000its,820,790,2112.281456516,2059.483759203,30
carcassonne-boltzmann290-vs-boltzmann305-1000its,821,791,2186.58032394,2170.042582403,30
carcassonne-ucttuned165-vs-ucttuned195-1000its,822,792,2222.252789252,2172.864785587,30
carcassonne-uct280-vs-uct470-1000its,825,795,2205.432252645,2175.805013243,30
carcassonne-ucttuned115-vs-ucttuned345-1000its,825,795,2202.957574648,2160.38658377,30
carcassonne-boltzmann120-vs-boltzmann85-1000its,826,796,2204.323105339,2159.847806212,30
carcassonne-boltzmann155-vs-boltzmann175-1000its,827,797,2149.834685069,2110.069965056,30
carcassonne-boltzmann155-vs-boltzmann260-1000its,827,797,2198.568001239,2169.89185095,30
carcassonne-ucttuned350-vs-ucttuned340-1000its,827,797,2155.896546872,2118.218305032,30
carcassonne-uct365-vs-uct430-1000its,828,798,2249.279968831,2197.87743689,30
carcassonne-boltzmann210-vs-boltzmann460-1000its,830,800,2187.675966114,2173.7958131,30
carcassonne-boltzmann230-vs-boltzmann245-1000its,830,800,2190.874070773,2180.004261664,30
carcassonne-uct240-vs-uct410-1000its,830,800,2186.053941032,2102.611940952,30
carcassonne-uct280-vs-uct305-1000its,830,800,2224.261294807,2216.493426196,30
carcassonne-ucttuned290-vs-ucttuned295-1000its,831,801,2217.954450004,2182.969471784,30
carcassonne-boltzmann285-vs-boltzmann15-1000its,832,802,2159.860511692,2117.011500609,30
carcassonne-boltzmann95-vs-boltzmann70-1000its,832,802,2250.533227565,2248.425786528,30
carcassonne-uct125-vs-uct195-1000its,832,802,2205.44800939,2166.555958231,30
carcassonne-uct80-vs-uct160-1000its,832,802,2287.653720687,2284.23165581,30
carcassonne-ucttuned180-vs-ucttuned225-1000its,834,804,2180.230686605,2121.032188388,30
carcassonne-ucttuned285-vs-ucttuned140-1000its,834,804,2292.626681034,2211.795189553,30
carcassonne-ucttuned145-vs-ucttuned195-1000its,836,806,2224.958971897,2182.02890414,30
carcassonne-ucttuned25-vs-ucttuned415-1000its,837,807,2187.205320953,2150.941593277,30
carcassonne-boltzmann340-vs-boltzmann170-1000its,838,808,2203.890100333,2172.571298483,30
carcassonne-ucttuned215-vs-ucttuned290-1000its,838,808,2159.668547415,2100.593111271,30
carcassonne-ucttuned430-vs-ucttuned380-1000its,838,808,2175.18157077,2108.580345289,30
carcassonne-ucttuned320-vs-ucttuned190-1000its,840,810,2245.772727577,2199.381301958,30
carcassonne-boltzmann155-vs-boltzmann440-1000its,841,811,2245.994364258,2191.69403821,30
carcassonne-boltzmann250-vs-boltzmann395-1000its,841,811,2261.818962674,2192.104573808,30
carcassonne-uct35-vs-uct285-1000its,841,811,2263.846683869,2234.061164842,30
carcassonne-ucttuned135-vs-ucttuned180-1000its,841,811,2184.173776321,2133.641319362,30
carcassonne-ucttuned140-vs-ucttuned295-1000its,841,811,2226.436560139,2144.194426998,30
carcassonne-ucttuned230-vs-ucttuned35-1000its,841,811,2110.171653979,2079.391169159,30
carcassonne-uct215-vs-uct275-1000its,842,812,2154.614297088,2119.538273672,30
carcassonne-boltzmann95-vs-boltzmann310-1000its,843,813,2166.01174284,2096.547198194,30
carcassonne-uct395-vs-uct255-1000its,843,813,2226.845000311,2206.97724512,30
carcassonne-ucttuned225-vs-ucttuned175-1000its,843,813,2161.305806775,2112.866532714,30
carcassonne-ucttuned155-vs-ucttuned105-1000its,844,814,2195.358818735,2166.355800355,30
carcassonne-ucttuned65-vs-ucttuned480-1000its,844,814,2144.634123969,2138.040012943,30
carcassonne-boltzmann300-vs-boltzmann445-1000its,845,815,2268.011292156,2189.279803462,30
carcassonne-uct180-vs-uct210-1000its,845,815,2203.421758609,2140.768860162,30
carcassonne-boltzmann350-vs-boltzmann200-1000its,846,816,2167.245548629,2127.386586417,30
carcassonne-ucttuned320-vs-ucttuned55-1000its,847,817,2133.661665573,2116.191637305,30
carcassonne-ucttuned485-vs-ucttuned200-1000its,847,817,2266.177413369,2199.054893829,30
carcassonne-uct275-vs-uct440-1000its,848,818,2171.92531891,2115.88232472,30
carcassonne-uct105-vs-uct365-1000its,849,819,2164.081183501,2145.832219559,30
carcassonne-uct160-vs-uct390-1000its,849,819,2169.658631093,2135.297734947,30
carcassonne-boltzmann235-vs-boltzmann50-1000its,851,821,2165.018031004,2133.524624093,30
carcassonne-uct265-vs-uct395-1000its,851,821,2167.636897052,2081.159332241,30
carcassonne-ucttuned410-vs-ucttuned480-1000its,851,821,2255.388126565,2190.562026367,30
carcassonne-ucttuned455-vs-ucttuned350-1000its,851,821,2283.405422159,2218.590319882,30
carcassonne-boltzmann360-vs-boltzmann400-1000its,852,822,2254.101079239,2223.813817958,30
carcassonne-uct155-vs-uct370-1000its,852,822,2238.974016978,2170.634267969,30
carcassonne-uct70-vs-uct345-1000its,853,823,2138.370522438,2126.294543578,30
carcassonne-boltzmann240-vs-boltzmann205-1000its,854,824,2157.854515041,2084.787865687,30
carcassonne-boltzmann465-vs-boltzmann390-1000its,854,824,2125.550911546,2074.00069313,30
carcassonne-ucttuned350-vs-ucttuned205-1000its,854,824,2271.684716752,2242.595169765,30
carcassonne-ucttuned385-vs-ucttuned430-1000its,854,824,2205.640508489,2150.331445483,30
carcassonne-uct445-vs-uct25-1000its,855,825,2227.209415835,2184.496106097,30
carcassonne-ucttuned120-vs-ucttuned270-1000its,858,828,2201.044186149,2143.144174537,30
carcassonne-boltzmann90-vs-boltzmann365-1000its,859,829,2218.359060688,2185.689988369,30
carcassonne-ucttuned125-vs-ucttuned230-1000its,860,830,2206.225088621,2145.346666629,30
carcassonne-ucttuned330-vs-ucttuned135-1000its,861,831,2242.747255393,2231.255793045,30
carcassonne-ucttuned420-vs-ucttuned10-1000its,861,831,2174.041237689,2139.679560217,30
carcassonne-uct485-vs-uct230-1000its,862,832,2181.395680066,2138.189850761,30
carcassonne-ucttuned40-vs-ucttuned415-1000its,863,833,2214.183928853,2165.918322731,30
carcassonne-boltzmann295-vs-boltzmann225-1000its,865,835,2235.005627424,2183.016066226,30
carcassonne-boltzmann445-vs-boltzmann440-1000its,865,835,2144.819324482,2107.85108993,30
carcassonne-ucttuned185-vs-ucttuned235-1000its,865,835,2177.056515527,2132.068528975,30
carcassonne-ucttuned45-vs-ucttuned95-1000its,870,840,2224.128853253,2196.796163025,30
carcassonne-boltzmann190-vs-boltzmann455-1000its,871,841,2184.362197393,2163.958558579,30
carcassonne-ucttuned485-vs-ucttuned80-1000its,871,841,2227.40231679,2156.237433379,30
carcassonne-ucttuned345-vs-ucttuned75-1000its,874,844,2268.612157975,2241.508724919,30
carcassonne-boltzmann185-vs-boltzmann160-1000its,875,845,2229.567490597,2125.138981875,30
carcassonne-boltzmann485-vs-boltzmann90-1000its,875,845,2240.889710141,2236.017583296,30
carcassonne-uct395-vs-uct80-1000its,876,846,2246.394286844,2183.139737443,30
carcassonne-boltzmann55-vs-boltzmann215-1000its,883,853,2252.033127689,2246.061287447,30
carcassonne-boltzmann285-vs-boltzmann185-1000its,884,854,2227.191106129,2141.547278066,30
carcassonne-uct355-vs-uct470-1000its,884,854,2187.604713265,2123.772094445,30
carcassonne-ucttuned120-vs-ucttuned175-1000its,885,855,2167.319110943,2121.201448844,30
carcassonne-uct380-vs-uct45-1000its,891,861,2229.205763028,2177.982131981,30
carcassonne-boltzmann70-vs-boltzmann85-1000its,893,863,2185.895870321,2144.884239791,30
carcassonne-uct150-vs-uct430-1000its,893,863,2252.696139424,2190.899759169,30
carcassonne-ucttuned170-vs-ucttuned460-1000its,894,864,2246.608678884,2156.661363077,30
carcassonne-ucttuned70-vs-ucttuned90-1000its,897,867,2161.591034701,2131.563176576,30
carcassonne-boltzmann465-vs-boltzmann230-1000its,908,878,2202.192034356,2137.367607228,30
carcassonne-uct315-vs-uct440-1000its,909,879,2163.035301826,2131.726736613,30
carcassonne-ucttuned385-vs-ucttuned255-1000its,912,882,2197.601555713,2152.51124913,30
carcassonne-ucttuned90-vs-ucttuned25-1000its,916,886,2225.603704619,2219.197612307,30
carcassonne-boltzmann60-vs-boltzmann140-1000its,921,891,2230.181287958,2183.545897578,30
carcassonne-uct460-vs-uct105-1000its,703,672,2153.554465693,2125.094912715,31
carcassonne-boltzmann340-vs-boltzmann275-1000its,720,689,2142.122452251,2144.530084301,31
carcassonne-uct370-vs-uct135-1000its,749,718,2225.14833455,2166.638585363,31
carcassonne-uct150-vs-uct390-1000its,752,721,2086.55599932,2078.983044393,31
carcassonne-uct150-vs-uct375-1000its,754,723,2158.865702184,2135.543910635,31
carcassonne-uct485-vs-uct105-1000its,756,725,2135.237809674,2106.311621249,31
carcassonne-boltzmann30-vs-boltzmann485-1000its,762,731,2231.424456862,2167.85661291,31
carcassonne-ucttuned425-vs-ucttuned485-1000its,764,733,2201.901759116,2164.954503781,31
carcassonne-boltzmann140-vs-boltzmann100-1000its,766,735,2244.960778269,2118.882373098,31
carcassonne-uct405-vs-uct210-1000its,767,736,2194.874101289,2174.774886381,31
carcassonne-ucttuned305-vs-ucttuned40-1000its,767,736,2198.204010227,2166.652160614,31
carcassonne-ucttuned425-vs-ucttuned245-1000its,768,737,2203.023736127,2178.520645629,31
carcassonne-boltzmann325-vs-boltzmann220-1000its,769,738,2211.253593034,2176.449863417,31
carcassonne-ucttuned260-vs-ucttuned125-1000its,769,738,2197.777394447,2167.827736731,31
carcassonne-boltzmann345-vs-boltzmann480-1000its,774,743,2184.740300813,2138.384548951,31
carcassonne-ucttuned430-vs-ucttuned75-1000its,774,743,2231.991984538,2158.289246601,31
carcassonne-ucttuned200-vs-ucttuned80-1000its,776,745,2186.824599975,2114.412295204,31
carcassonne-boltzmann250-vs-boltzmann410-1000its,777,746,2219.233154647,2170.649117109,31
carcassonne-uct165-vs-uct305-1000its,780,749,2176.695761684,2148.346069298,31
carcassonne-boltzmann260-vs-boltzmann295-1000its,781,750,2177.667525636,2145.19665572,31
carcassonne-ucttuned80-vs-ucttuned245-1000its,781,750,2218.137423201,2176.226145714,31
carcassonne-uct210-vs-uct90-1000its,785,754,2226.268365805,2205.646750659,31
carcassonne-ucttuned340-vs-ucttuned95-1000its,785,754,2116.553345192,2087.747613459,31
carcassonne-ucttuned440-vs-ucttuned235-1000its,785,754,2243.898944248,2234.827607428,31
carcassonne-uct60-vs-uct140-1000its,787,756,2171.596922698,2119.975540333,31
carcassonne-uct170-vs-uct55-1000its,788,757,2168.302430021,2159.000532958,31
carcassonne-uct185-vs-uct120-1000its,788,757,2287.157843069,2211.426856287,31
carcassonne-boltzmann370-vs-boltzmann275-1000its,789,758,2221.502424962,2166.233487467,31
carcassonne-boltzmann370-vs-boltzmann480-1000its,789,758,2203.872090328,2181.769722047,31
carcassonne-boltzmann75-vs-boltzmann405-1000its,789,758,2138.5128555,2128.92927099,31
carcassonne-uct170-vs-uct180-1000its,789,758,2214.751685392,2162.960733082,31
carcassonne-ucttuned70-vs-ucttuned85-1000its,789,758,2173.578028124,2131.887411712,31
carcassonne-ucttuned275-vs-ucttuned60-1000its,791,760,2195.48340476,2182.988710804,31
carcassonne-boltzmann440-vs-boltzmann190-1000its,792,761,2196.47815326,2137.267210716,31
carcassonne-uct105-vs-uct195-1000its,792,761,2174.295252835,2124.584241469,31
carcassonne-ucttuned395-vs-ucttuned260-1000its,792,761,2228.304706365,2235.449421005,31
carcassonne-uct50-vs-uct355-1000its,794,763,2298.071827607,2233.983553033,31
carcassonne-boltzmann290-vs-boltzmann355-1000its,795,764,2185.154947256,2183.270618246,31
carcassonne-boltzmann360-vs-boltzmann350-1000its,795,764,2207.201965518,2169.155760169,31
carcassonne-uct50-vs-uct220-1000its,797,766,2085.046113178,2067.398941839,31
carcassonne-ucttuned340-vs-ucttuned150-1000its,797,766,2191.382921896,2190.131526777,31
carcassonne-boltzmann325-vs-boltzmann495-1000its,798,767,2118.29285887,2127.329288879,31
carcassonne-boltzmann480-vs-boltzmann335-1000its,798,767,2206.930583379,2142.643658357,31
carcassonne-uct250-vs-uct60-1000its,798,767,2232.73742939,2186.858479711,31
carcassonne-uct225-vs-uct420-1000its,799,768,2174.605868321,2121.809427479,31
carcassonne-ucttuned325-vs-ucttuned145-1000its,799,768,2180.921559187,2163.149796114,31
carcassonne-boltzmann5-vs-boltzmann310-1000its,800,769,2194.387997503,2147.890872361,31
carcassonne-uct430-vs-uct250-1000its,801,770,2167.133348597,2093.02129084,31
carcassonne-boltzmann195-vs-boltzmann265-1000its,803,772,2148.613972423,2159.891376474,31
carcassonne-boltzmann205-vs-boltzmann195-1000its,803,772,2267.991578174,2190.267851825,31
carcassonne-boltzmann240-vs-boltzmann105-1000its,804,773,2228.151648913,2211.370909026,31
carcassonne-boltzmann185-vs-boltzmann395-1000its,805,774,2191.56773919,2149.836070583,31
carcassonne-ucttuned245-vs-ucttuned375-1000its,805,774,2211.719151476,2159.150752415,31
carcassonne-ucttuned390-vs-ucttuned435-1000its,805,774,2210.40873508,2172.101492595,31
carcassonne-ucttuned480-vs-ucttuned185-1000its,809,778,2213.737542631,2175.293814229,31
carcassonne-boltzmann390-vs-boltzmann130-1000its,811,780,2217.979484654,2144.542973031,31
carcassonne-uct170-vs-uct350-1000its,811,780,2217.217883649,2185.405450067,31
carcassonne-uct70-vs-uct170-1000its,811,780,2184.004508713,2143.388416907,31
carcassonne-ucttuned190-vs-ucttuned320-1000its,811,780,2169.350218797,2171.111698271,31
carcassonne-ucttuned300-vs-ucttuned215-1000its,813,782,2243.440814744,2178.168987099,31
carcassonne-boltzmann430-vs-boltzmann435-1000its,814,783,2204.0330251,2157.895386347,31
carcassonne-ucttuned230-vs-ucttuned365-1000its,814,783,2209.96088061,2171.646197019,31
carcassonne-boltzmann145-vs-boltzmann315-1000its,815,784,2186.707123468,2118.772760236,31
carcassonne-ucttuned300-vs-ucttuned230-1000its,817,786,2239.92198584,2174.225599931,31
carcassonne-boltzmann115-vs-boltzmann150-1000its,818,787,2116.637988816,2052.570294973,31
carcassonne-uct70-vs-uct400-1000its,818,787,2234.901104251,2196.579511843,31
carcassonne-ucttuned125-vs-ucttuned110-1000its,818,787,2183.776433033,2119.0551688,31
carcassonne-uct135-vs-uct150-1000its,819,788,2077.070556139,2071.905691342,31
carcassonne-uct185-vs-uct495-1000its,819,788,2187.129387693,2143.137408785,31
carcassonne-ucttuned355-vs-ucttuned315-1000its,819,788,2237.785873256,2185.374407788,31
carcassonne-boltzmann455-vs-boltzmann425-1000its,821,790,2222.622972551,2164.080783062,31
carcassonne-ucttuned145-vs-ucttuned225-1000its,821,790,2185.339242872,2153.295410923,31
carcassonne-uct285-vs-uct25-1000its,822,791,2163.820113121,2079.543964137,31
carcassonne-uct230-vs-uct120-1000its,823,792,2263.926800434,2167.049664216,31
carcassonne-ucttuned220-vs-ucttuned50-1000its,823,792,2156.86254253,2151.718734123,31
carcassonne-boltzmann50-vs-boltzmann320-1000its,825,794,2166.367858267,2121.219444779,31
carcassonne-ucttuned155-vs-ucttuned25-1000its,825,794,2195.517376653,2156.392993972,31
carcassonne-ucttuned340-vs-ucttuned35-1000its,826,795,2168.923755429,2121.575107808,31
carcassonne-boltzmann160-vs-boltzmann295-1000its,827,796,2155.565444979,2116.273985736,31
carcassonne-uct220-vs-uct280-1000its,827,796,2129.536607895,2094.961411775,31
carcassonne-ucttuned25-vs-ucttuned10-1000its,827,796,2133.895548675,2076.262789442,31
carcassonne-ucttuned340-vs-ucttuned70-1000its,827,796,2255.688067876,2229.047136824,31
carcassonne-uct110-vs-uct140-1000its,828,797,2186.197995679,2155.899767464,31
carcassonne-uct410-vs-uct440-1000its,828,797,2232.1857467,2186.275165059,31
carcassonne-uct470-vs-uct230-1000its,828,797,2174.062331476,2111.286749163,31
carcassonne-ucttuned30-vs-ucttuned475-1000its,828,797,2146.235553807,2125.826616281,31
carcassonne-uct340-vs-uct460-1000its,829,798,2152.578456553,2116.617965395,31
carcassonne-uct85-vs-uct290-1000its,830,799,2206.768913069,2121.52193878,31
carcassonne-boltzmann310-vs-boltzmann430-1000its,831,800,2223.844000175,2151.924717337,31
carcassonne-ucttuned355-vs-ucttuned390-1000its,831,800,2190.923822729,2179.347261608,31
carcassonne-boltzmann10-vs-boltzmann480-1000its,832,801,2216.724147708,2176.496973304,31
carcassonne-boltzmann490-vs-boltzmann85-1000its,832,801,2204.278390743,2139.86069181,31
carcassonne-uct255-vs-uct170-1000its,834,803,2179.611040628,2114.443823985,31
carcassonne-uct190-vs-uct355-1000its,836,805,2221.675017216,2192.709416831,31
carcassonne-ucttuned270-vs-ucttuned315-1000its,836,805,2158.66331383,2117.265001689,31
carcassonne-boltzmann210-vs-boltzmann20-1000its,837,806,2147.29037171,2129.350503637,31
carcassonne-ucttuned145-vs-ucttuned155-1000its,839,808,2146.481326586,2102.605443081,31
carcassonne-ucttuned230-vs-ucttuned265-1000its,839,808,2180.957059526,2146.158122008,31
carcassonne-boltzmann145-vs-boltzmann50-1000its,840,809,2216.556529975,2184.041969239,31
carcassonne-boltzmann475-vs-boltzmann200-1000its,842,811,2135.616543695,2093.018947389,31
carcassonne-boltzmann90-vs-boltzmann150-1000its,842,811,2232.003604311,2173.861695967,31
carcassonne-ucttuned160-vs-ucttuned135-1000its,843,812,2193.855569115,2172.986022413,31
carcassonne-ucttuned340-vs-ucttuned210-1000its,843,812,2212.98660232,2106.318854584,31
carcassonne-ucttuned495-vs-ucttuned375-1000its,843,812,2248.210689198,2225.230815457,31
carcassonne-boltzmann15-vs-boltzmann210-1000its,845,814,2194.413505788,2138.270723929,31
carcassonne-boltzmann315-vs-boltzmann470-1000its,845,814,2196.526274336,2163.797355906,31
carcassonne-boltzmann125-vs-boltzmann90-1000its,847,816,2251.058476035,2204.996805431,31
carcassonne-uct460-vs-uct65-1000its,847,816,2143.313274345,2101.344985744,31
carcassonne-uct285-vs-uct80-1000its,848,817,2184.604869107,2117.392334659,31
carcassonne-ucttuned360-vs-ucttuned390-1000its,848,817,2152.108478651,2117.938342746,31
carcassonne-boltzmann5-vs-boltzmann175-1000its,850,819,2260.017679684,2222.690740257,31
carcassonne-uct10-vs-uct380-1000its,850,819,2190.115450788,2164.574119916,31
carcassonne-ucttuned310-vs-ucttuned355-1000its,851,820,2210.929088681,2144.660899714,31
carcassonne-ucttuned345-vs-ucttuned375-1000its,854,823,2249.610131971,2144.463161803,31
carcassonne-uct285-vs-uct155-1000its,856,825,2261.436104166,2215.976904414,31
carcassonne-ucttuned415-vs-ucttuned125-1000its,858,827,2146.13916595,2137.311181932,31
carcassonne-boltzmann315-vs-boltzmann300-1000its,859,828,2181.734640945,2149.929027559,31
carcassonne-boltzmann365-vs-boltzmann380-1000its,861,830,2147.569322444,2120.638739424,31
carcassonne-uct410-vs-uct395-1000its,862,831,2181.439586883,2140.073529629,31
carcassonne-ucttuned480-vs-ucttuned370-1000its,862,831,2235.143678401,2226.085954169,31
carcassonne-ucttuned5-vs-ucttuned440-1000its,864,833,2212.194204595,2150.971433064,31
carcassonne-uct350-vs-uct320-1000its,865,834,2234.293345023,2173.70609211,31
carcassonne-ucttuned160-vs-ucttuned330-1000its,867,836,2136.946502171,2095.587747609,31
carcassonne-uct15-vs-uct470-1000its,868,837,2188.398552895,2111.178723641,31
carcassonne-uct465-vs-uct225-1000its,868,837,2201.845071177,2138.337239839,31
carcassonne-ucttuned440-vs-ucttuned485-1000its,868,837,2247.580654468,2207.571495956,31
carcassonne-uct130-vs-uct450-1000its,869,838,2197.822340136,2152.038400907,31
carcassonne-boltzmann210-vs-boltzmann25-1000its,870,839,2198.744150252,2168.728883475,31
carcassonne-ucttuned180-vs-ucttuned280-1000its,870,839,2172.5058493,2139.163374586,31
carcassonne-ucttuned450-vs-ucttuned175-1000its,870,839,2159.748204864,2110.271937944,31
carcassonne-ucttuned25-vs-ucttuned315-1000its,871,840,2265.316979796,2245.323534509,31
carcassonne-uct475-vs-uct460-1000its,872,841,2193.436561468,2155.134385695,31
carcassonne-boltzmann5-vs-boltzmann355-1000its,874,843,2138.559008467,2117.435848161,31
carcassonne-uct420-vs-uct90-1000its,875,844,2273.009502572,2198.458339522,31
carcassonne-ucttuned220-vs-ucttuned365-1000its,875,844,2246.098879732,2195.762306311,31
carcassonne-ucttuned495-vs-ucttuned170-1000its,877,846,2199.921419071,2163.041176289,31
carcassonne-ucttuned5-vs-ucttuned90-1000its,878,847,2266.698583673,2174.9558239,31
carcassonne-uct20-vs-uct115-1000its,880,849,2292.009431285,2198.994483558,31
carcassonne-uct45-vs-uct325-1000its,880,849,2254.269284515,2196.455390334,31
carcassonne-boltzmann405-vs-boltzmann480-1000its,882,851,2240.933016267,2168.499266882,31
carcassonne-ucttuned5-vs-ucttuned120-1000its,884,853,2220.463045452,2181.612248155,31
carcassonne-uct235-vs-uct360-1000its,889,858,2231.011141045,2172.615519509,31
carcassonne-ucttuned365-vs-ucttuned455-1000its,890,859,2180.157609629,2142.5099922,31
carcassonne-ucttuned5-vs-ucttuned115-1000its,890,859,2159.248401648,2041.763920895,31
carcassonne-boltzmann445-vs-boltzmann235-1000its,891,860,2170.621945997,2176.706222473,31
carcassonne-ucttuned270-vs-ucttuned395-1000its,893,862,2256.160528978,2175.502650533,31
carcassonne-uct285-vs-uct455-1000its,898,867,2160.558821017,2039.050032558,31
carcassonne-ucttuned80-vs-ucttuned60-1000its,900,869,2282.7876328,2165.93500401,31
carcassonne-ucttuned105-vs-ucttuned135-1000its,901,870,2211.573333593,2173.684155239,31
carcassonne-boltzmann415-vs-boltzmann5-1000its,908,877,2132.728584984,2115.708642345,31
carcassonne-uct110-vs-uct330-1000its,916,885,2136.118415511,2075.022661451,31
carcassonne-ucttuned410-vs-ucttuned430-1000its,923,892,2225.176936308,2195.902572657,31
carcassonne-boltzmann480-vs-boltzmann60-1000its,927,896,2279.823246472,2216.338514068,31
carcassonne-uct420-vs-uct495-1000its,929,898,2195.745244696,2146.133879326,31
carcassonne-boltzmann335-vs-boltzmann205-1000its,979,948,2176.957192543,2126.47503227,31
carcassonne-ucttuned135-vs-ucttuned490-1000its,735,703,2186.107187135,2134.133335594,32
carcassonne-uct230-vs-uct350-1000its,741,709,2255.008970929,2218.964199545,32
carcassonne-boltzmann315-vs-boltzmann30-1000its,745,713,2202.076076215,2131.895599823,32
carcassonne-uct325-vs-uct70-1000its,748,716,2203.534550621,2177.068205276,32
carcassonne-boltzmann315-vs-boltzmann415-1000its,750,718,2180.662929717,2100.077538456,32
carcassonne-boltzmann220-vs-boltzmann495-1000its,754,722,2226.698612176,2088.778521185,32
carcassonne-boltzmann95-vs-boltzmann190-1000its,756,724,2121.323914602,2111.092250626,32
carcassonne-uct350-vs-uct60-1000its,757,725,2161.630579408,2136.775124213,32
carcassonne-boltzmann200-vs-boltzmann360-1000its,760,728,2199.67339775,2166.310409685,32
carcassonne-ucttuned335-vs-ucttuned130-1000its,761,729,2160.262856804,2147.682962743,32
carcassonne-ucttuned355-vs-ucttuned280-1000its,761,729,2238.61897027,2189.163918317,32
carcassonne-uct290-vs-uct475-1000its,767,735,2228.071516518,2195.455735202,32
carcassonne-boltzmann255-vs-boltzmann435-1000its,768,736,2179.60463359,2096.256111675,32
carcassonne-ucttuned445-vs-ucttuned125-1000its,771,739,2173.779163869,2155.481899088,32
carcassonne-boltzmann20-vs-boltzmann170-1000its,773,741,2108.532356717,2111.852616998,32
carcassonne-uct390-vs-uct300-1000its,774,742,2208.392437028,2164.948041921,32
carcassonne-uct345-vs-uct400-1000its,775,743,2180.127497061,2074.591514478,32
carcassonne-uct110-vs-uct270-1000its,779,747,2280.198646831,2263.10001599,32
carcassonne-boltzmann185-vs-boltzmann65-1000its,781,749,2194.243219709,2144.347824394,32
carcassonne-ucttuned355-vs-ucttuned195-1000its,781,749,2209.268278422,2140.249808356,32
carcassonne-boltzmann120-vs-boltzmann165-1000its,782,750,2191.345528975,2086.949790711,32
carcassonne-uct360-vs-uct495-1000its,784,752,2158.226442478,2144.731614642,32
carcassonne-uct80-vs-uct120-1000its,784,752,2232.448040741,2210.813989136,32
carcassonne-ucttuned300-vs-ucttuned330-1000its,785,753,2217.732955135,2210.909351959,32
carcassonne-uct105-vs-uct265-1000its,787,755,2224.280522878,2191.956981724,32
carcassonne-ucttuned220-vs-ucttuned370-1000its,788,756,2210.875830864,2173.252897954,32
carcassonne-uct335-vs-uct375-1000its,789,757,2192.722342756,2105.079148909,32
carcassonne-uct455-vs-uct215-1000its,789,757,2253.41908583,2195.841278464,32
carcassonne-ucttuned470-vs-ucttuned250-1000its,789,757,2156.675438273,2151.649080756,32
carcassonne-boltzmann230-vs-boltzmann460-1000its,790,758,2159.951865155,2134.6665847,32
carcassonne-boltzmann480-vs-boltzmann125-1000its,790,758,2098.349706314,2079.371438182,32
carcassonne-boltzmann80-vs-boltzmann190-1000its,790,758,2211.930527617,2132.139274892,32
carcassonne-uct355-vs-uct55-1000its,790,758,2182.651182732,2181.167219427,32
carcassonne-uct60-vs-uct130-1000its,792,760,2117.308861672,2098.992637665,32
carcassonne-ucttuned455-vs-ucttuned130-1000its,793,761,2182.153461267,2132.453170513,32
carcassonne-boltzmann335-vs-boltzmann255-1000its,795,763,2209.931149357,2203.893721825,32
carcassonne-boltzmann80-vs-boltzmann220-1000its,795,763,2218.22048316,2172.606693262,32
carcassonne-ucttuned40-vs-ucttuned50-1000its,795,763,2143.49112168,2114.500158516,32
carcassonne-ucttuned430-vs-ucttuned155-1000its,796,764,2199.859180611,2173.8129668,32
carcassonne-ucttuned195-vs-ucttuned400-1000its,798,766,2163.917585053,2124.365479351,32
carcassonne-ucttuned240-vs-ucttuned370-1000its,798,766,2159.198687402,2084.726632862,32
carcassonne-boltzmann105-vs-boltzmann440-1000its,799,767,2239.90272012,2192.717443319,32
carcassonne-ucttuned190-vs-ucttuned455-1000its,799,767,2238.108309432,2175.252949416,32
carcassonne-uct320-vs-uct410-1000its,800,768,2210.568860168,2143.436427644,32
carcassonne-uct380-vs-uct290-1000its,800,768,2328.524620617,2215.973550474,32
carcassonne-ucttuned110-vs-ucttuned240-1000its,801,769,2240.490857961,2210.051285427,32
carcassonne-boltzmann445-vs-boltzmann385-1000its,802,770,2155.75129396,2096.265337015,32
carcassonne-ucttuned395-vs-ucttuned365-1000its,802,770,2181.799962996,2155.406179475,32
carcassonne-uct450-vs-uct455-1000its,803,771,2174.331205394,2130.780113263,32
carcassonne-ucttuned200-vs-ucttuned105-1000its,803,771,2146.940837473,2139.522323871,32
carcassonne-boltzmann305-vs-boltzmann435-1000its,805,773,2230.876263659,2151.289466201,32
carcassonne-uct190-vs-uct235-1000its,805,773,2225.682040726,2192.783631367,32
carcassonne-boltzmann145-vs-boltzmann355-1000its,806,774,2199.301217112,2118.712640196,32
carcassonne-boltzmann165-vs-boltzmann105-1000its,806,774,2224.755001483,2179.502641813,32
carcassonne-boltzmann320-vs-boltzmann380-1000its,806,774,2122.123747246,2105.007450611,32
carcassonne-boltzmann460-vs-boltzmann430-1000its,806,774,2227.726348706,2152.973895817,32
carcassonne-boltzmann495-vs-boltzmann490-1000its,807,775,2141.911084123,2135.989612798,32
carcassonne-ucttuned395-vs-ucttuned385-1000its,807,775,2302.923186954,2206.219137769,32
carcassonne-boltzmann15-vs-boltzmann305-1000its,809,777,2193.282111906,2114.459802437,32
carcassonne-uct285-vs-uct20-1000its,809,777,2252.293243944,2241.90105234,32
carcassonne-uct340-vs-uct345-1000its,809,777,2175.246686092,2127.555736648,32
carcassonne-ucttuned115-vs-ucttuned25-1000its,809,777,2280.012121476,2225.018409844,32
carcassonne-boltzmann40-vs-boltzmann30-1000its,811,779,2183.880677138,2139.40765271,32
carcassonne-ucttuned165-vs-ucttuned230-1000its,811,779,2212.055340103,2170.928472126,32
carcassonne-boltzmann165-vs-boltzmann495-1000its,812,780,2227.972699443,2205.807007798,32
carcassonne-uct405-vs-uct30-1000its,815,783,2238.740953176,2204.843554523,32
carcassonne-uct310-vs-uct30-1000its,816,784,2175.340345146,2135.982961957,32
carcassonne-uct340-vs-uct10-1000its,816,784,2179.39766395,2108.196392495,32
carcassonne-boltzmann340-vs-boltzmann200-1000its,817,785,2230.764641007,2163.007175894,32
carcassonne-boltzmann370-vs-boltzmann130-1000its,817,785,2156.884421621,2145.12133938,32
carcassonne-uct295-vs-uct455-1000its,817,785,2195.565707484,2176.473846005,32
carcassonne-ucttuned315-vs-ucttuned355-1000its,817,785,2204.898577918,2175.514671666,32
carcassonne-ucttuned40-vs-ucttuned250-1000its,817,785,2228.904900843,2241.014033497,32
carcassonne-boltzmann85-vs-boltzmann340-1000its,818,786,2241.518827659,2143.520896084,32
carcassonne-uct365-vs-uct400-1000its,819,787,2148.795833739,2137.480551055,32
carcassonne-boltzmann450-vs-boltzmann85-1000its,820,788,2209.526916318,2184.331020191,32
carcassonne-uct45-vs-uct260-1000its,820,788,2223.59300488,2180.186420282,32
carcassonne-uct480-vs-uct35-1000its,821,789,2179.974335226,2113.122066573,32
carcassonne-ucttuned315-vs-ucttuned25-1000its,821,789,2128.972375263,2121.768009389,32
carcassonne-ucttuned320-vs-ucttuned465-1000its,822,790,2258.415732115,2222.425643618,32
carcassonne-boltzmann225-vs-boltzmann65-1000its,823,791,2226.011243893,2183.842920568,32
carcassonne-boltzmann130-vs-boltzmann275-1000its,826,794,2281.965342334,2225.010576584,32
carcassonne-uct70-vs-uct205-1000its,826,794,2163.600279454,2108.368518628,32
carcassonne-uct355-vs-uct420-1000its,827,795,2244.694204763,2182.123877463,32
carcassonne-ucttuned410-vs-ucttuned160-1000its,827,795,2216.182015414,2133.669489094,32
carcassonne-uct380-vs-uct260-1000its,828,796,2194.754570797,2168.225284493,32
carcassonne-uct85-vs-uct435-1000its,828,796,2187.747240286,2144.63358861,32
carcassonne-boltzmann175-vs-boltzmann315-1000its,829,797,2169.018205258,2138.666025935,32
carcassonne-boltzmann425-vs-boltzmann480-1000its,829,797,2261.262951777,2296.917339087,32
carcassonne-boltzmann315-vs-boltzmann255-1000its,830,798,2178.286197857,2138.994770294,32
carcassonne-boltzmann180-vs-boltzmann20-1000its,831,799,2297.194507831,2243.97042827,32
carcassonne-uct360-vs-uct350-1000its,832,800,2195.291205157,2197.28162568,32
carcassonne-ucttuned180-vs-ucttuned45-1000its,833,801,2157.686248902,2126.245241776,32
carcassonne-uct35-vs-uct375-1000its,835,803,2188.044597932,2122.922319152,32
carcassonne-boltzmann5-vs-boltzmann275-1000its,836,804,2137.803590963,2132.817324375,32
carcassonne-ucttuned235-vs-ucttuned30-1000its,836,804,2225.694515127,2171.72569385,32
carcassonne-boltzmann250-vs-boltzmann460-1000its,837,805,2226.058539794,2180.875114027,32
carcassonne-boltzmann425-vs-boltzmann75-1000its,837,805,2201.190576863,2164.599329479,32
carcassonne-ucttuned90-vs-ucttuned325-1000its,837,805,2213.6081434,2130.31199383,32
carcassonne-uct365-vs-uct170-1000its,838,806,2167.2807954,2141.802239295,32
carcassonne-ucttuned65-vs-ucttuned35-1000its,838,806,2296.977498169,2281.778824412,32
carcassonne-uct445-vs-uct30-1000its,839,807,2261.933779202,2208.652157711,32
carcassonne-uct460-vs-uct40-1000its,839,807,2219.437480247,2153.911418239,32
carcassonne-ucttuned360-vs-ucttuned415-1000its,839,807,2240.697920563,2231.227828661,32
carcassonne-boltzmann495-vs-boltzmann45-1000its,840,808,2139.186644588,2109.743886458,32
carcassonne-ucttuned265-vs-ucttuned200-1000its,841,809,2201.29373481,2179.550040005,32
carcassonne-boltzmann35-vs-boltzmann495-1000its,843,811,2171.701558662,2100.782676214,32
carcassonne-uct130-vs-uct65-1000its,844,812,2169.749524788,2156.063771058,32
carcassonne-ucttuned100-vs-ucttuned250-1000its,844,812,2199.705007546,2150.446311018,32
carcassonne-boltzmann155-vs-boltzmann455-1000its,845,813,2250.282001589,2190.238332167,32
carcassonne-boltzmann220-vs-boltzmann255-1000its,845,813,2236.250121538,2164.524879423,32
carcassonne-boltzmann125-vs-boltzmann35-1000its,847,815,2320.550939176,2250.293134518,32
carcassonne-ucttuned165-vs-ucttuned160-1000its,847,815,2173.487846088,2126.738783049,32
carcassonne-boltzmann450-vs-boltzmann380-1000its,849,817,2177.314884742,2124.177084713,32
carcassonne-uct205-vs-uct210-1000its,849,817,2236.052900978,2188.902916129,32
carcassonne-uct330-vs-uct40-1000its,849,817,2194.700906959,2149.95763056,32
carcassonne-boltzmann445-vs-boltzmann485-1000its,850,818,2192.979829971,2179.821659482,32
carcassonne-uct405-vs-uct90-1000its,851,819,2177.642149126,2164.407232611,32
carcassonne-uct270-vs-uct395-1000its,852,820,2133.607694283,2133.968229867,32
carcassonne-ucttuned90-vs-ucttuned440-1000its,852,820,2142.915368346,2133.883630693,32
carcassonne-boltzmann345-vs-boltzmann210-1000its,853,821,2137.029518337,2105.637848619,32
carcassonne-ucttuned495-vs-ucttuned90-1000its,853,821,2180.120599037,2159.942335306,32
carcassonne-uct380-vs-uct455-1000its,855,823,2215.749998465,2184.083342196,32
carcassonne-uct415-vs-uct250-1000its,855,823,2176.977870128,2138.972836964,32
carcassonne-uct25-vs-uct330-1000its,856,824,2170.726327064,2115.391534378,32
carcassonne-uct275-vs-uct340-1000its,856,824,2188.536870458,2135.195821681,32
carcassonne-ucttuned45-vs-ucttuned135-1000its,856,824,2158.543701561,2124.494992507,32
carcassonne-boltzmann430-vs-boltzmann465-1000its,864,832,2178.773945902,2158.444711659,32
carcassonne-boltzmann230-vs-boltzmann440-1000its,865,833,2180.016504388,2126.531065164,32
carcassonne-ucttuned165-vs-ucttuned365-1000its,865,833,2225.948894052,2154.156973944,32
carcassonne-ucttuned415-vs-ucttuned320-1000its,867,835,2275.811890436,2233.964347695,32
carcassonne-boltzmann430-vs-boltzmann280-1000its,869,837,2248.386705912,2222.80368484,32
carcassonne-boltzmann465-vs-boltzmann85-1000its,870,838,2249.091819159,2199.600508127,32
carcassonne-boltzmann420-vs-boltzmann460-1000its,874,842,2121.274312617,2070.655751772,32
carcassonne-uct455-vs-uct115-1000its,876,844,2214.957182698,2156.275829447,32
carcassonne-ucttuned55-vs-ucttuned15-1000its,876,844,2179.312415976,2152.188535098,32
carcassonne-uct335-vs-uct400-1000its,877,845,2170.848018349,2161.490780995,32
carcassonne-boltzmann335-vs-boltzmann95-1000its,882,850,2216.573570922,2167.504328824,32
carcassonne-ucttuned400-vs-ucttuned305-1000its,885,853,2245.800095919,2179.063811557,32
carcassonne-ucttuned330-vs-ucttuned465-1000its,891,859,2221.200341879,2136.563089898,32
carcassonne-ucttuned15-vs-ucttuned250-1000its,903,871,2266.495409334,2198.383379032,32
carcassonne-boltzmann55-vs-boltzmann135-1000its,904,872,2239.742273552,2174.168798991,32
carcassonne-boltzmann200-vs-boltzmann480-1000its,920,888,2135.11829564,2114.966671651,32
carcassonne-uct40-vs-uct160-1000its,921,889,2140.792848874,2101.010358302,32
carcassonne-uct185-vs-uct190-1000its,929,897,2187.345836412,2179.98209661,32
carcassonne-boltzmann325-vs-boltzmann315-1000its,940,908,2190.530667675,2184.288479353,32
carcassonne-boltzmann315-vs-boltzmann425-1000its,555,522,1779.687642965,1705.82567,33
carcassonne-boltzmann205-vs-boltzmann170-1000its,721,688,2234.601229787,2170.495061032,33
carcassonne-uct205-vs-uct80-1000its,725,692,2211.710163452,2140.118837289,33
carcassonne-boltzmann290-vs-boltzmann145-1000its,738,705,2192.936417876,2157.921054997,33
carcassonne-uct270-vs-uct170-1000its,747,714,2182.733761849,2124.171142423,33
carcassonne-uct165-vs-uct370-1000its,750,717,2156.820487978,2131.064057,33
carcassonne-boltzmann80-vs-boltzmann370-1000its,751,718,2198.380754927,2112.680834514,33
carcassonne-ucttuned420-vs-ucttuned455-1000its,752,719,2156.134607224,2100.479110693,33
carcassonne-boltzmann280-vs-boltzmann210-1000its,755,722,2225.656853208,2217.003628455,33
carcassonne-boltzmann30-vs-boltzmann415-1000its,755,722,2244.82394905,2207.674368107,33
carcassonne-ucttuned420-vs-ucttuned245-1000its,756,723,2209.328311252,2145.396526053,33
carcassonne-boltzmann425-vs-boltzmann345-1000its,758,725,2191.894640634,2107.563139127,33
carcassonne-boltzmann215-vs-boltzmann65-1000its,761,728,2175.501646808,2148.136311496,33
carcassonne-boltzmann105-vs-boltzmann200-1000its,766,733,2156.938453626,2144.477729707,33
carcassonne-boltzmann430-vs-boltzmann245-1000its,766,733,2188.573437058,2089.446949341,33
carcassonne-uct5-vs-uct90-1000its,771,738,2226.941670715,2187.267319505,33
carcassonne-uct250-vs-uct290-1000its,773,740,2134.85982238,2104.811455919,33
carcassonne-uct175-vs-uct435-1000its,776,743,2271.545355314,2229.149589909,33
carcassonne-boltzmann245-vs-boltzmann450-1000its,777,744,2228.693263996,2213.336568716,33
carcassonne-uct215-vs-uct65-1000its,777,744,2180.227672934,2175.802392094,33
carcassonne-uct430-vs-uct45-1000its,777,744,2232.572476715,2162.444345695,33
carcassonne-uct355-vs-uct230-1000its,780,747,2228.731160113,2150.833105458,33
carcassonne-uct365-vs-uct475-1000its,780,747,2189.023247953,2138.631112578,33
carcassonne-boltzmann285-vs-boltzmann215-1000its,783,750,2157.101226035,2112.478360625,33
carcassonne-uct195-vs-uct450-1000its,785,752,2169.802501465,2088.39159272,33
carcassonne-ucttuned335-vs-ucttuned275-1000its,786,753,2188.99203551,2101.622158068,33
carcassonne-ucttuned340-vs-ucttuned215-1000its,789,756,2206.226273983,2153.694242418,33
carcassonne-ucttuned320-vs-ucttuned160-1000its,791,758,2227.753791812,2170.635662242,33
carcassonne-boltzmann360-vs-boltzmann470-1000its,796,763,2132.638075825,2128.05507178,33
carcassonne-uct70-vs-uct45-1000its,798,765,2226.159352643,2126.718254545,33
carcassonne-boltzmann165-vs-boltzmann260-1000its,799,766,2172.86766464,2136.07271099,33
carcassonne-boltzmann215-vs-boltzmann245-1000its,799,766,2208.654128466,2163.597618637,33
carcassonne-boltzmann220-vs-boltzmann235-1000its,799,766,2185.898242884,2142.136965049,33
carcassonne-boltzmann275-vs-boltzmann25-1000its,799,766,2203.77111652,2173.982624716,33
carcassonne-ucttuned385-vs-ucttuned175-1000its,800,767,2287.311683358,2192.108187468,33
carcassonne-ucttuned190-vs-ucttuned410-1000its,801,768,2159.428280235,2131.658642291,33
carcassonne-uct345-vs-uct405-1000its,802,769,2123.210526184,2120.793550556,33
carcassonne-ucttuned390-vs-ucttuned415-1000its,802,769,2212.253773056,2232.569782879,33
carcassonne-boltzmann75-vs-boltzmann225-1000its,803,770,2164.926419476,2144.640923692,33
carcassonne-ucttuned390-vs-ucttuned395-1000its,803,770,2215.090135581,2185.004537076,33
carcassonne-ucttuned65-vs-ucttuned90-1000its,803,770,2249.408289873,2148.020945499,33
carcassonne-uct410-vs-uct355-1000its,805,772,2193.383784598,2157.744655356,33
carcassonne-boltzmann240-vs-boltzmann465-1000its,808,775,2220.502459034,2176.776606059,33
carcassonne-boltzmann110-vs-boltzmann455-1000its,809,776,2226.84781826,2169.980716835,33
carcassonne-uct160-vs-uct185-1000its,809,776,2160.109363965,2136.277221002,33
carcassonne-uct330-vs-uct265-1000its,809,776,2164.756610472,2109.690812178,33
carcassonne-uct80-vs-uct425-1000its,810,777,2129.263974643,2103.060648952,33
carcassonne-boltzmann110-vs-boltzmann285-1000its,811,778,2205.72773093,2121.765603966,33
carcassonne-uct85-vs-uct95-1000its,812,779,2234.614139166,2144.160580328,33
carcassonne-boltzmann145-vs-boltzmann420-1000its,813,780,2214.503598904,2165.467531617,33
carcassonne-boltzmann340-vs-boltzmann225-1000its,813,780,2255.586819292,2214.294015835,33
carcassonne-boltzmann455-vs-boltzmann35-1000its,813,780,2173.123100134,2108.672223325,33
carcassonne-uct310-vs-uct140-1000its,813,780,2248.205846267,2174.698077499,33
carcassonne-uct390-vs-uct90-1000its,813,780,2217.556493003,2179.350995774,33
carcassonne-uct85-vs-uct425-1000its,813,780,2244.446894122,2227.336821049,33
carcassonne-uct400-vs-uct125-1000its,814,781,2155.539796471,2113.700889159,33
carcassonne-ucttuned280-vs-ucttuned75-1000its,814,781,2199.621375021,2197.924521021,33
carcassonne-ucttuned345-vs-ucttuned495-1000its,814,781,2141.023352757,2139.586944372,33
carcassonne-uct90-vs-uct155-1000its,815,782,2197.574939168,2185.711392282,33
carcassonne-ucttuned415-vs-ucttuned80-1000its,815,782,2187.264044886,2154.164566782,33
carcassonne-uct105-vs-uct40-1000its,816,783,2241.265661175,2208.943851717,33
carcassonne-ucttuned25-vs-ucttuned385-1000its,817,784,2186.716278838,2126.248547846,33
carcassonne-uct175-vs-uct200-1000its,818,785,2246.610750601,2222.577846461,33
carcassonne-uct30-vs-uct320-1000its,818,785,2236.048595249,2165.663409098,33
carcassonne-ucttuned180-vs-ucttuned450-1000its,818,785,2240.309588498,2163.98954416,33
carcassonne-uct490-vs-uct75-1000its,819,786,2156.292809545,2076.864493631,33
carcassonne-uct370-vs-uct275-1000its,821,788,2216.354377391,2149.686866708,33
carcassonne-uct420-vs-uct370-1000its,822,789,2145.93453515,2124.138890752,33
carcassonne-ucttuned190-vs-ucttuned345-1000its,823,790,2130.765253146,2137.898634227,33
carcassonne-ucttuned355-vs-ucttuned440-1000its,827,794,2143.670932723,2139.029540986,33
carcassonne-ucttuned410-vs-ucttuned420-1000its,827,794,2167.365595525,2157.171467793,33
carcassonne-boltzmann285-vs-boltzmann345-1000its,828,795,2170.965474971,2142.54359056,33
carcassonne-uct10-vs-uct295-1000its,828,795,2209.775878136,2204.348807776,33
carcassonne-uct425-vs-uct140-1000its,828,795,2270.21006608,2243.435460287,33
carcassonne-boltzmann415-vs-boltzmann165-1000its,829,796,2203.354927368,2128.406716981,33
carcassonne-boltzmann365-vs-boltzmann190-1000its,831,798,2176.19034933,2124.742751749,33
carcassonne-ucttuned405-vs-ucttuned150-1000its,831,798,2234.875894887,2220.713620116,33
carcassonne-boltzmann205-vs-boltzmann25-1000its,832,799,2205.674575402,2175.462215008,33
carcassonne-uct130-vs-uct380-1000its,832,799,2146.71205928,2097.819090562,33
carcassonne-uct350-vs-uct155-1000its,832,799,2196.212942074,2165.247181412,33
carcassonne-ucttuned265-vs-ucttuned375-1000its,832,799,2144.134547115,2142.549677059,33
carcassonne-uct115-vs-uct60-1000its,833,800,2232.986739159,2192.639611899,33
carcassonne-ucttuned110-vs-ucttuned215-1000its,833,800,2179.438172595,2131.037311602,33
carcassonne-boltzmann135-vs-boltzmann90-1000its,834,801,2163.213077773,2177.107903292,33
carcassonne-uct175-vs-uct420-1000its,836,803,2159.774682217,2113.836609034,33
carcassonne-uct280-vs-uct85-1000its,836,803,2190.925536711,2138.380876917,33
carcassonne-ucttuned280-vs-ucttuned495-1000its,836,803,2283.768753569,2205.301495812,33
carcassonne-uct30-vs-uct355-1000its,839,806,2236.56103119,2171.867030594,33
carcassonne-uct340-vs-uct490-1000its,840,807,2217.795714819,2161.054003039,33
carcassonne-ucttuned205-vs-ucttuned40-1000its,840,807,2154.618399366,2113.383828071,33
carcassonne-ucttuned45-vs-ucttuned20-1000its,841,808,2179.25028156,2141.464808872,33
carcassonne-boltzmann145-vs-boltzmann220-1000its,842,809,2166.033973019,2097.316871285,33
carcassonne-uct225-vs-uct175-1000its,842,809,2263.465942513,2231.440390949,33
carcassonne-ucttuned140-vs-ucttuned460-1000its,842,809,2118.877916218,2121.391071355,33
carcassonne-boltzmann90-vs-boltzmann470-1000its,844,811,2234.802453842,2165.395768179,33
carcassonne-uct150-vs-uct235-1000its,844,811,2170.832743034,2170.205528866,33
carcassonne-ucttuned305-vs-ucttuned265-1000its,844,811,2137.647615395,2063.636691689,33
carcassonne-boltzmann15-vs-boltzmann495-1000its,848,815,2169.457645597,2136.922158144,33
carcassonne-ucttuned255-vs-ucttuned200-1000its,848,815,2274.784322247,2220.044367352,33
carcassonne-ucttuned340-vs-ucttuned295-1000its,850,817,2210.168240125,2141.641474959,33
carcassonne-uct170-vs-uct345-1000its,854,821,2179.980321401,2154.596436418,33
carcassonne-uct300-vs-uct225-1000its,854,821,2178.297948919,2101.02120807,33
carcassonne-boltzmann175-vs-boltzmann115-1000its,856,823,2157.602544959,2120.093686732,33
carcassonne-ucttuned165-vs-ucttuned360-1000its,856,823,2215.980568449,2145.101170725,33
carcassonne-uct405-vs-uct255-1000its,857,824,2213.078492611,2143.863913452,33
carcassonne-boltzmann30-vs-boltzmann365-1000its,858,825,2231.972444073,2213.870740008,33
carcassonne-ucttuned380-vs-ucttuned425-1000its,858,825,2177.251957483,2135.100111222,33
carcassonne-ucttuned235-vs-ucttuned305-1000its,859,826,2232.487240491,2177.521905394,33
carcassonne-ucttuned480-vs-ucttuned400-1000its,860,827,2162.327022504,2129.466289461,33
carcassonne-uct455-vs-uct280-1000its,863,830,2184.736452715,2103.210173946,33
carcassonne-ucttuned275-vs-ucttuned90-1000its,864,831,2172.389153378,2147.777284609,33
carcassonne-boltzmann405-vs-boltzmann30-1000its,865,832,2183.671219802,2155.755709615,33
carcassonne-uct125-vs-uct465-1000its,865,832,2237.223817321,2176.793472857,33
carcassonne-ucttuned25-vs-ucttuned45-1000its,865,832,2232.689342955,2181.409438009,33
carcassonne-uct210-vs-uct450-1000its,869,836,2304.150475936,2195.70134876,33
carcassonne-uct125-vs-uct175-1000its,870,837,2247.531817061,2170.871923467,33
carcassonne-boltzmann205-vs-boltzmann425-1000its,871,838,2225.264395815,2190.100634761,33
carcassonne-ucttuned395-vs-ucttuned405-1000its,871,838,2230.408429816,2184.099378786,33
carcassonne-ucttuned410-vs-ucttuned295-1000its,872,839,2180.832720799,2104.816889305,33
carcassonne-uct80-vs-uct300-1000its,873,840,2138.529203905,2089.030129887,33
carcassonne-ucttuned305-vs-ucttuned190-1000its,873,840,2314.345454813,2217.39416581,33
carcassonne-ucttuned235-vs-ucttuned65-1000its,874,841,2130.427025522,2118.777100053,33
carcassonne-ucttuned240-vs-ucttuned355-1000its,874,841,2204.603560936,2130.108644484,33
carcassonne-uct45-vs-uct75-1000its,875,842,2250.842746129,2209.740059439,33
carcassonne-ucttuned135-vs-ucttuned265-1000its,878,845,2263.390768845,2207.680836208,33
carcassonne-ucttuned165-vs-ucttuned145-1000its,880,847,2147.713505709,2140.679046418,33
carcassonne-ucttuned20-vs-ucttuned340-1000its,880,847,2227.316905958,2198.650899757,33
carcassonne-uct255-vs-uct375-1000its,884,851,2236.284353113,2182.509320687,33
carcassonne-uct15-vs-uct50-1000its,885,852,2188.08268985,2135.378156535,33
carcassonne-ucttuned490-vs-ucttuned40-1000its,888,855,2192.05711235,2137.985224403,33
carcassonne-boltzmann145-vs-boltzmann150-1000its,890,857,2249.062197439,2206.048877863,33
carcassonne-uct175-vs-uct20-1000its,892,859,2225.935598645,2172.914692824,33
carcassonne-uct215-vs-uct45-1000its,894,861,2176.894604715,2139.407073152,33
carcassonne-uct315-vs-uct335-1000its,896,863,2226.184500092,2222.169059566,33
carcassonne-uct470-vs-uct200-1000its,901,868,2124.057829262,2100.01310626,33
carcassonne-ucttuned205-vs-ucttuned355-1000its,902,869,2184.025689243,2099.566215616,33
carcassonne-ucttuned25-vs-ucttuned355-1000its,902,869,2239.412146687,2204.208032112,33
carcassonne-uct175-vs-uct210-1000its,907,874,2182.122292769,2129.255160771,33
carcassonne-uct290-vs-uct10-1000its,918,885,2153.100378491,2141.238112383,33
carcassonne-uct435-vs-uct275-1000its,726,692,2157.228944096,2081.66792091,34
carcassonne-uct325-vs-uct195-1000its,734,700,2215.265307559,2180.077254169,34
carcassonne-boltzmann255-vs-boltzmann280-1000its,741,707,2130.520363371,2101.582631908,34
carcassonne-ucttuned415-vs-ucttuned255-1000its,742,708,2190.143853371,2124.656499278,34
carcassonne-ucttuned105-vs-ucttuned405-1000its,758,724,2204.333492976,2133.797360713,34
carcassonne-boltzmann285-vs-boltzmann20-1000its,759,725,2171.388295459,2140.010771345,34
carcassonne-boltzmann205-vs-boltzmann180-1000its,760,726,2130.54176965,2099.959348655,34
carcassonne-boltzmann335-vs-boltzmann225-1000its,761,727,2174.305947707,2108.917503536,34
carcassonne-boltzmann100-vs-boltzmann145-1000its,764,730,2160.903999219,2078.897460273,34
carcassonne-ucttuned125-vs-ucttuned445-1000its,767,733,2213.228975504,2148.380999363,34
carcassonne-uct325-vs-uct440-1000its,768,734,2174.692691264,2122.332260669,34
carcassonne-boltzmann355-vs-boltzmann380-1000its,772,738,2195.234983286,2155.679204726,34
carcassonne-boltzmann480-vs-boltzmann165-1000its,772,738,2201.187723467,2167.01049688,34
carcassonne-boltzmann65-vs-boltzmann335-1000its,774,740,2212.072366313,2149.166603156,34
carcassonne-boltzmann180-vs-boltzmann410-1000its,776,742,2207.336437269,2152.813144742,34
carcassonne-boltzmann460-vs-boltzmann440-1000its,778,744,2198.990303356,2151.477236372,34
carcassonne-ucttuned195-vs-ucttuned155-1000its,778,744,2229.994327304,2183.654998059,34
carcassonne-uct5-vs-uct85-1000its,780,746,2207.694684137,2137.444091013,34
carcassonne-uct280-vs-uct15-1000its,781,747,2206.888033094,2197.536026882,34
carcassonne-boltzmann15-vs-boltzmann280-1000its,783,749,2210.792852457,2165.328230327,34
carcassonne-uct200-vs-uct420-1000its,783,749,2235.990557342,2141.383805368,34
carcassonne-uct90-vs-uct470-1000its,784,750,2226.62840375,2184.823147753,34
carcassonne-ucttuned210-vs-ucttuned300-1000its,784,750,2234.558104108,2126.185030572,34
carcassonne-boltzmann100-vs-boltzmann395-1000its,786,752,2203.832130046,2154.919109369,34
carcassonne-boltzmann170-vs-boltzmann115-1000its,787,753,2185.236438051,2159.799546931,34
carcassonne-ucttuned235-vs-ucttuned395-1000its,787,753,2127.709044541,2073.376904732,34
carcassonne-uct210-vs-uct250-1000its,788,754,2202.174838109,2134.547623464,34
carcassonne-uct60-vs-uct95-1000its,789,755,2208.099483511,2191.931992557,34
carcassonne-boltzmann75-vs-boltzmann35-1000its,790,756,2199.521135132,2126.004079331,34
carcassonne-boltzmann225-vs-boltzmann320-1000its,791,757,2243.374216092,2183.893916088,34
carcassonne-uct495-vs-uct405-1000its,792,758,2248.403330393,2237.483543491,34
carcassonne-ucttuned285-vs-ucttuned165-1000its,792,758,2194.365474706,2094.816262259,34
carcassonne-uct295-vs-uct130-1000its,793,759,2209.093230461,2172.151957962,34
carcassonne-boltzmann305-vs-boltzmann265-1000its,795,761,2178.289772237,2162.293132253,34
carcassonne-boltzmann455-vs-boltzmann415-1000its,796,762,2267.701206332,2124.311089676,34
carcassonne-uct225-vs-uct325-1000its,797,763,2180.205561868,2148.846009758,34
carcassonne-ucttuned335-vs-ucttuned350-1000its,797,763,2167.952619578,2103.550817631,34
carcassonne-boltzmann170-vs-boltzmann215-1000its,798,764,2237.901289392,2167.478899758,34
carcassonne-uct175-vs-uct405-1000its,800,766,2159.918718505,2103.800739876,34
carcassonne-ucttuned115-vs-ucttuned255-1000its,803,769,2234.869520606,2148.097663844,34
carcassonne-uct225-vs-uct320-1000its,805,771,2215.148425577,2151.879669782,34
carcassonne-boltzmann65-vs-boltzmann130-1000its,807,773,2180.153443139,2144.170897359,34
carcassonne-ucttuned140-vs-ucttuned225-1000its,807,773,2139.040068365,2055.012816497,34
carcassonne-boltzmann245-vs-boltzmann55-1000its,808,774,2185.50544919,2088.024759853,34
carcassonne-boltzmann225-vs-boltzmann465-1000its,811,777,2235.553004291,2148.459916917,34
carcassonne-ucttuned175-vs-ucttuned125-1000its,811,777,2199.117517244,2193.729316586,34
carcassonne-uct220-vs-uct185-1000its,812,778,2200.196165742,2102.834902349,34
carcassonne-ucttuned250-vs-ucttuned90-1000its,812,778,2206.12293379,2100.926272895,34
carcassonne-ucttuned255-vs-ucttuned415-1000its,812,778,2199.190989155,2175.114716743,34
carcassonne-ucttuned405-vs-ucttuned250-1000its,812,778,2262.453341655,2186.722356919,34
carcassonne-ucttuned400-vs-ucttuned30-1000its,813,779,2168.999807122,2128.23025875,34
carcassonne-uct225-vs-uct245-1000its,814,780,2204.836417721,2178.348338228,34
carcassonne-uct490-vs-uct105-1000its,814,780,2191.167054678,2124.047461201,34
carcassonne-uct10-vs-uct325-1000its,815,781,2214.501191273,2186.184330841,34
carcassonne-uct425-vs-uct495-1000its,815,781,2194.42934849,2174.425155535,34
carcassonne-boltzmann200-vs-boltzmann490-1000its,816,782,2235.408926546,2189.484989015,34
carcassonne-uct145-vs-uct120-1000its,816,782,2225.400883697,2192.034732067,34
carcassonne-ucttuned285-vs-ucttuned60-1000its,817,783,2167.591944401,2182.923733415,34
carcassonne-ucttuned320-vs-ucttuned315-1000its,817,783,2215.023918467,2165.013259732,34
carcassonne-boltzmann375-vs-boltzmann80-1000its,818,784,2247.833292718,2161.150594395,34
carcassonne-boltzmann5-vs-boltzmann475-1000its,818,784,2240.172284958,2200.204068562,34
carcassonne-ucttuned240-vs-ucttuned480-1000its,818,784,2129.986785549,2079.52999268,34
carcassonne-ucttuned380-vs-ucttuned90-1000its,820,786,2331.877952181,2304.820033283,34
carcassonne-boltzmann65-vs-boltzmann140-1000its,822,788,2218.336648945,2126.192172276,34
carcassonne-boltzmann85-vs-boltzmann315-1000its,822,788,2207.471341288,2154.761650952,34
carcassonne-ucttuned210-vs-ucttuned400-1000its,822,788,2181.126040321,2217.609266954,34
carcassonne-ucttuned425-vs-ucttuned165-1000its,826,792,2130.76770656,2099.719334856,34
carcassonne-boltzmann155-vs-boltzmann380-1000its,828,794,2286.303172473,2225.773589559,34
carcassonne-boltzmann475-vs-boltzmann255-1000its,828,794,2302.888492613,2223.264093341,34
carcassonne-uct105-vs-uct350-1000its,828,794,2305.376322318,2170.573550979,34
carcassonne-ucttuned340-vs-ucttuned300-1000its,828,794,2178.257514362,2133.903540703,34
carcassonne-ucttuned350-vs-ucttuned380-1000its,828,794,2202.806762276,2131.556629476,34
carcassonne-ucttuned415-vs-ucttuned160-1000its,828,794,2240.912354154,2239.370143032,34
carcassonne-boltzmann215-vs-boltzmann25-1000its,829,795,2148.269832565,2087.958584084,34
carcassonne-uct125-vs-uct85-1000its,829,795,2255.745898372,2173.049863804,34
carcassonne-uct265-vs-uct365-1000its,829,795,2175.439307845,2113.770703053,34
carcassonne-uct30-vs-uct420-1000its,832,798,2177.077019231,2102.205294874,34
carcassonne-ucttuned5-vs-ucttuned135-1000its,832,798,2163.085401077,2138.647609038,34
carcassonne-boltzmann155-vs-boltzmann325-1000its,833,799,2249.154220625,2213.834759222,34
carcassonne-boltzmann60-vs-boltzmann345-1000its,833,799,2161.353318943,2104.341254679,34
carcassonne-uct330-vs-uct195-1000its,833,799,2255.531871192,2217.242638818,34
carcassonne-boltzmann445-vs-boltzmann180-1000its,834,800,2178.518568308,2176.105985437,34
carcassonne-ucttuned130-vs-ucttuned185-1000its,834,800,2162.994178453,2120.803811956,34
carcassonne-ucttuned285-vs-ucttuned410-1000its,834,800,2206.116545145,2184.902521854,34
carcassonne-boltzmann250-vs-boltzmann100-1000its,835,801,2119.311635745,2060.660202532,34
carcassonne-uct365-vs-uct240-1000its,835,801,2165.929822956,2119.182062726,34
carcassonne-ucttuned250-vs-ucttuned200-1000its,836,802,2221.452794491,2161.565260008,34
carcassonne-ucttuned10-vs-ucttuned430-1000its,837,803,2203.60927806,2145.971857275,34
carcassonne-uct190-vs-uct455-1000its,838,804,2193.253830811,2200.599048783,34
carcassonne-boltzmann50-vs-boltzmann80-1000its,840,806,2171.506082492,2162.689985656,34
carcassonne-ucttuned320-vs-ucttuned420-1000its,840,806,2184.957374973,2136.956950099,34
carcassonne-uct180-vs-uct265-1000its,842,808,2182.224914041,2096.938913341,34
carcassonne-boltzmann435-vs-boltzmann85-1000its,843,809,2229.367579222,2184.014753233,34
carcassonne-ucttuned145-vs-ucttuned460-1000its,843,809,2128.427047257,2118.861280492,34
carcassonne-uct225-vs-uct215-1000its,844,810,2217.063483931,2166.672473835,34
carcassonne-uct55-vs-uct305-1000its,844,810,2193.780540972,2129.591209402,34
carcassonne-ucttuned20-vs-ucttuned270-1000its,844,810,2260.766393399,2210.499534178,34
carcassonne-ucttuned485-vs-ucttuned25-1000its,844,810,2217.754843298,2162.991935296,34
carcassonne-boltzmann95-vs-boltzmann360-1000its,845,811,2152.814990517,2115.63439151,34
carcassonne-uct335-vs-uct30-1000its,846,812,2288.646955837,2243.330993519,34
carcassonne-uct70-vs-uct315-1000its,846,812,2126.175043392,2078.402581215,34
carcassonne-uct460-vs-uct55-1000its,848,814,2222.921119761,2218.552645848,34
carcassonne-ucttuned415-vs-ucttuned20-1000its,848,814,2199.470368034,2159.238230433,34
carcassonne-boltzmann75-vs-boltzmann120-1000its,850,816,2165.269445939,2145.255850192,34
carcassonne-boltzmann130-vs-boltzmann385-1000its,851,817,2180.480888663,2147.830184186,34
carcassonne-uct360-vs-uct205-1000its,852,818,2137.282245213,2074.480671508,34
carcassonne-uct90-vs-uct85-1000its,852,818,2135.258374674,2105.78648969,34
carcassonne-boltzmann365-vs-boltzmann5-1000its,853,819,2190.677817656,2128.740225701,34
carcassonne-ucttuned265-vs-ucttuned385-1000its,853,819,2132.303180364,2111.83021012,34
carcassonne-boltzmann20-vs-boltzmann220-1000its,854,820,2233.540278421,2181.003895846,34
carcassonne-ucttuned370-vs-ucttuned470-1000its,854,820,2258.995319434,2231.160703127,34
carcassonne-boltzmann480-vs-boltzmann95-1000its,855,821,2223.554608532,2147.5217566,34
carcassonne-boltzmann190-vs-boltzmann140-1000its,857,823,2189.452169676,2121.622561112,34
carcassonne-boltzmann445-vs-boltzmann10-1000its,859,825,2174.094429448,2199.612190659,34
carcassonne-uct255-vs-uct315-1000its,859,825,2128.254347858,2093.2392791,34
carcassonne-ucttuned285-vs-ucttuned235-1000its,859,825,2204.757970646,2151.385134884,34
carcassonne-boltzmann245-vs-boltzmann130-1000its,860,826,2158.945232353,2132.857077485,34
carcassonne-uct440-vs-uct25-1000its,860,826,2231.766894911,2165.305905257,34
carcassonne-ucttuned65-vs-ucttuned130-1000its,860,826,2303.263216566,2276.154244456,34
carcassonne-boltzmann460-vs-boltzmann415-1000its,861,827,2172.92735886,2146.321434619,34
carcassonne-uct285-vs-uct160-1000its,862,828,2208.608750553,2130.725305461,34
carcassonne-ucttuned205-vs-ucttuned85-1000its,864,830,2174.676378967,2143.632133841,34
carcassonne-boltzmann135-vs-boltzmann350-1000its,865,831,2245.607920972,2190.563778393,34
carcassonne-boltzmann220-vs-boltzmann115-1000its,874,840,2089.467597839,2091.995620718,34
carcassonne-boltzmann330-vs-boltzmann315-1000its,875,841,2217.812983906,2137.749633946,34
carcassonne-ucttuned410-vs-ucttuned445-1000its,875,841,2236.668061914,2147.930795766,34
carcassonne-uct165-vs-uct75-1000its,876,842,2180.941647868,2101.011991135,34
carcassonne-ucttuned75-vs-ucttuned335-1000its,877,843,2183.457703167,2167.809255744,34
carcassonne-ucttuned30-vs-ucttuned455-1000its,878,844,2177.112678686,2093.236509608,34
carcassonne-boltzmann5-vs-boltzmann360-1000its,879,845,2259.534724674,2184.664768936,34
carcassonne-uct335-vs-uct210-1000its,882,848,2249.950936715,2193.000164824,34
carcassonne-uct35-vs-uct165-1000its,884,850,2156.333346788,2139.617001027,34
carcassonne-ucttuned95-vs-ucttuned190-1000its,884,850,2199.061767844,2170.394960926,34
carcassonne-uct160-vs-uct95-1000its,885,851,2150.638450402,2134.263874956,34
carcassonne-ucttuned380-vs-ucttuned275-1000its,886,852,2221.999254889,2167.597284238,34
carcassonne-boltzmann150-vs-boltzmann320-1000its,887,853,2173.479394479,2137.420662499,34
carcassonne-uct50-vs-uct365-1000its,887,853,2171.804291816,2188.312867983,34
carcassonne-uct475-vs-uct195-1000its,889,855,2204.197241739,2148.694931957,34
carcassonne-ucttuned315-vs-ucttuned30-1000its,893,859,2233.22494198,2206.785565394,34
carcassonne-ucttuned330-vs-ucttuned115-1000its,896,862,2245.002076209,2203.578909926,34
carcassonne-uct315-vs-uct265-1000its,897,863,2179.282073386,2175.428629922,34
carcassonne-uct120-vs-uct415-1000its,900,866,2230.920725517,2196.858877063,34
carcassonne-uct425-vs-uct285-1000its,906,872,2183.010800435,2119.06347113,34
carcassonne-ucttuned335-vs-ucttuned315-1000its,906,872,2170.960589922,2170.363088095,34
carcassonne-ucttuned420-vs-ucttuned45-1000its,907,873,2235.77307565,2194.337076328,34
carcassonne-uct280-vs-uct325-1000its,909,875,2263.073297223,2230.366081372,34
carcassonne-boltzmann495-vs-boltzmann480-1000its,911,877,2166.211733341,2096.594692119,34
carcassonne-uct30-vs-uct215-1000its,914,880,2181.624916952,2120.974122794,34
carcassonne-boltzmann60-vs-boltzmann145-1000its,919,885,2158.80547125,2103.516727444,34
carcassonne-boltzmann25-vs-boltzmann60-1000its,930,896,2190.096647743,2183.769713227,34
carcassonne-ucttuned280-vs-ucttuned25-1000its,931,897,2225.846797218,2218.974238967,34
carcassonne-boltzmann140-vs-boltzmann35-1000its,737,702,2160.148095464,2093.182791129,35
carcassonne-boltzmann400-vs-boltzmann285-1000its,743,708,2263.212396286,2219.807854896,35
carcassonne-boltzmann75-vs-boltzmann310-1000its,745,710,2216.106474092,2167.873709948,35
carcassonne-uct235-vs-uct95-1000its,752,717,2154.884101328,2112.97546073,35
carcassonne-boltzmann10-vs-boltzmann230-1000its,757,722,2152.627941598,2096.908929143,35
carcassonne-uct200-vs-uct140-1000its,759,724,2190.604961979,2096.77261653,35
carcassonne-boltzmann120-vs-boltzmann220-1000its,762,727,2185.813068733,2152.139957672,35
carcassonne-ucttuned220-vs-ucttuned270-1000its,762,727,2228.668565224,2150.045379648,35
carcassonne-ucttuned495-vs-ucttuned70-1000its,762,727,2212.612741626,2151.898607648,35
carcassonne-uct495-vs-uct380-1000its,765,730,2224.752215503,2195.864990373,35
carcassonne-boltzmann190-vs-boltzmann25-1000its,767,732,2201.199710873,2165.138055515,35
carcassonne-boltzmann355-vs-boltzmann480-1000its,770,735,2153.654453528,2103.812131315,35
carcassonne-boltzmann280-vs-boltzmann295-1000its,772,737,2238.785551999,2201.950577572,35
carcassonne-ucttuned25-vs-ucttuned495-1000its,772,737,2226.088596005,2180.492710377,35
carcassonne-boltzmann95-vs-boltzmann15-1000its,773,738,2163.875128429,2154.706354588,35
carcassonne-boltzmann385-vs-boltzmann235-1000its,774,739,2171.214329553,2154.66614625,35
carcassonne-boltzmann275-vs-boltzmann405-1000its,783,748,2206.251122319,2159.828157832,35
carcassonne-ucttuned315-vs-ucttuned115-1000its,783,748,2260.300960833,2211.866764561,35
carcassonne-ucttuned140-vs-ucttuned485-1000its,785,750,2165.692167406,2130.112152567,35
carcassonne-boltzmann450-vs-boltzmann90-1000its,786,751,2148.84086478,2144.557315359,35
carcassonne-boltzmann110-vs-boltzmann280-1000its,788,753,2173.949043854,2113.348186473,35
carcassonne-boltzmann135-vs-boltzmann415-1000its,788,753,2195.052353084,2170.090433636,35
carcassonne-ucttuned430-vs-ucttuned230-1000its,788,753,2172.853577522,2141.218792813,35
carcassonne-ucttuned75-vs-ucttuned460-1000its,790,755,2208.901346576,2174.227429242,35
carcassonne-uct365-vs-uct300-1000its,792,757,2171.985366176,2169.927193398,35
carcassonne-uct290-vs-uct150-1000its,794,759,2220.262503597,2179.28637133,35
carcassonne-uct120-vs-uct70-1000its,798,763,2143.062900224,2150.682058809,35
carcassonne-uct75-vs-uct315-1000its,803,768,2285.66364791,2220.462316739,35
carcassonne-ucttuned180-vs-ucttuned380-1000its,803,768,2162.084501247,2168.515783252,35
carcassonne-uct45-vs-uct335-1000its,804,769,2193.31790072,2141.823021758,35
carcassonne-boltzmann235-vs-boltzmann355-1000its,807,772,2254.395844574,2237.701479442,35
carcassonne-boltzmann385-vs-boltzmann440-1000its,807,772,2147.099028891,2086.220750497,35
carcassonne-ucttuned195-vs-ucttuned310-1000its,808,773,2179.385136265,2183.271323821,35
carcassonne-boltzmann100-vs-boltzmann225-1000its,809,774,2278.800959757,2219.699926675,35
carcassonne-uct150-vs-uct240-1000its,809,774,2206.450558923,2158.825400543,35
carcassonne-ucttuned170-vs-ucttuned375-1000its,809,774,2160.558354447,2136.588324529,35
carcassonne-ucttuned265-vs-ucttuned410-1000its,809,774,2218.742330376,2199.287737984,35
carcassonne-boltzmann235-vs-boltzmann100-1000its,810,775,2185.451530506,2111.927456144,35
carcassonne-boltzmann235-vs-boltzmann300-1000its,811,776,2180.223345836,2104.82343847,35
carcassonne-boltzmann390-vs-boltzmann370-1000its,811,776,2229.617031858,2138.701951336,35
carcassonne-boltzmann280-vs-boltzmann180-1000its,812,777,2252.827786467,2203.934258659,35
carcassonne-uct285-vs-uct430-1000its,812,777,2233.924175846,2132.24595332,35
carcassonne-ucttuned255-vs-ucttuned170-1000its,812,777,2232.685088818,2195.573617711,35
carcassonne-ucttuned85-vs-ucttuned130-1000its,812,777,2282.295444709,2225.88814461,35
carcassonne-boltzmann95-vs-boltzmann365-1000its,813,778,2264.968275876,2216.415185374,35
carcassonne-boltzmann235-vs-boltzmann150-1000its,814,779,2220.892702642,2187.698732267,35
carcassonne-boltzmann430-vs-boltzmann10-1000its,814,779,2129.601748805,2103.442429574,35
carcassonne-boltzmann470-vs-boltzmann225-1000its,816,781,2136.09721193,2107.415088723,35
carcassonne-uct95-vs-uct155-1000its,816,781,2176.308930725,2140.539046116,35
carcassonne-ucttuned250-vs-ucttuned265-1000its,816,781,2180.546383926,2139.167031039,35
carcassonne-ucttuned50-vs-ucttuned160-1000its,816,781,2190.967597545,2175.183101867,35
carcassonne-boltzmann360-vs-boltzmann290-1000its,817,782,2180.360029122,2162.693972463,35
carcassonne-boltzmann425-vs-boltzmann360-1000its,817,782,2209.297407028,2146.509950199,35
carcassonne-boltzmann55-vs-boltzmann315-1000its,817,782,2211.836859625,2132.177918912,35
carcassonne-uct85-vs-uct220-1000its,817,782,2286.229410541,2232.270560462,35
carcassonne-boltzmann185-vs-boltzmann440-1000its,818,783,2163.815297218,2130.332757381,35
carcassonne-uct280-vs-uct495-1000its,818,783,2213.087105694,2137.229514823,35
carcassonne-uct295-vs-uct480-1000its,818,783,2187.871464067,2142.878475894,35
carcassonne-uct480-vs-uct130-1000its,818,783,2183.553044787,2107.428716286,35
carcassonne-uct410-vs-uct15-1000its,819,784,2197.096866492,2154.00840293,35
carcassonne-boltzmann60-vs-boltzmann420-1000its,821,786,2252.087004338,2193.559656984,35
carcassonne-uct410-vs-uct45-1000its,821,786,2235.4537538,2152.383685298,35
carcassonne-boltzmann155-vs-boltzmann370-1000its,823,788,2226.485626048,2184.215226039,35
carcassonne-uct40-vs-uct420-1000its,824,789,2220.288632605,2172.165771203,35
carcassonne-ucttuned15-vs-ucttuned160-1000its,825,790,2274.244116258,2219.449111903,35
carcassonne-ucttuned135-vs-ucttuned350-1000its,826,791,2178.93130841,2161.338893008,35
carcassonne-ucttuned465-vs-ucttuned240-1000its,826,791,2146.621871677,2127.511251819,35
carcassonne-boltzmann380-vs-boltzmann60-1000its,827,792,2214.252077169,2202.936646743,35
carcassonne-uct495-vs-uct345-1000its,827,792,2145.784071209,2106.809096566,35
carcassonne-ucttuned180-vs-ucttuned365-1000its,827,792,2113.02299334,2080.806200754,35
carcassonne-ucttuned205-vs-ucttuned370-1000its,827,792,2182.009817407,2119.728244971,35
carcassonne-ucttuned400-vs-ucttuned435-1000its,827,792,2180.423591976,2181.551540995,35
carcassonne-uct45-vs-uct185-1000its,828,793,2247.578026662,2252.030438016,35
carcassonne-ucttuned100-vs-ucttuned170-1000its,828,793,2143.970823226,2086.255489053,35
carcassonne-ucttuned235-vs-ucttuned90-1000its,828,793,2229.243404358,2205.018561595,35
carcassonne-uct200-vs-uct225-1000its,829,794,2181.806195227,2156.914487875,35
carcassonne-ucttuned295-vs-ucttuned360-1000its,829,794,2169.778410066,2175.677553739,35
carcassonne-ucttuned245-vs-ucttuned220-1000its,830,795,2150.354026104,2127.709456567,35
carcassonne-boltzmann160-vs-boltzmann70-1000its,831,796,2174.225599128,2149.254518496,35
carcassonne-uct65-vs-uct300-1000its,831,796,2178.673724042,2125.056853157,35
carcassonne-boltzmann280-vs-boltzmann200-1000its,832,797,2272.47914428,2207.860302938,35
carcassonne-uct135-vs-uct395-1000its,832,797,2188.903101567,2167.226420563,35
carcassonne-ucttuned5-vs-ucttuned375-1000its,832,797,2240.961478361,2168.421919458,35
carcassonne-uct115-vs-uct250-1000its,833,798,2184.358343162,2167.711931452,35
carcassonne-uct175-vs-uct155-1000its,834,799,2142.372934632,2110.027624096,35
carcassonne-uct30-vs-uct485-1000its,834,799,2229.987906353,2204.96565544,35
carcassonne-boltzmann210-vs-boltzmann350-1000its,835,800,2160.656406231,2100.850146952,35
carcassonne-boltzmann455-vs-boltzmann160-1000its,835,800,2140.616989227,2119.155711164,35
carcassonne-ucttuned145-vs-ucttuned375-1000its,835,800,2209.603680105,2124.218065266,35
carcassonne-ucttuned80-vs-ucttuned420-1000its,835,800,2143.977470835,2087.419002051,35
carcassonne-ucttuned285-vs-ucttuned40-1000its,836,801,2161.074231401,2132.926999105,35
carcassonne-boltzmann420-vs-boltzmann20-1000its,838,803,2184.04774242,2150.142093857,35
carcassonne-uct360-vs-uct345-1000its,838,803,2199.300964955,2198.057811336,35
carcassonne-ucttuned285-vs-ucttuned470-1000its,838,803,2119.809496452,2074.827349616,35
carcassonne-ucttuned165-vs-ucttuned290-1000its,839,804,2177.761070667,2118.746949253,35
carcassonne-boltzmann275-vs-boltzmann75-1000its,841,806,2202.652023809,2135.261234931,35
carcassonne-boltzmann35-vs-boltzmann325-1000its,841,806,2195.480838989,2182.762457095,35
carcassonne-ucttuned350-vs-ucttuned245-1000its,841,806,2284.393050727,2245.65297016,35
carcassonne-uct335-vs-uct45-1000its,843,808,2229.310539003,2199.241780354,35
carcassonne-ucttuned140-vs-ucttuned310-1000its,843,808,2168.92951452,2107.256265171,35
carcassonne-ucttuned55-vs-ucttuned480-1000its,843,808,2150.44552487,2142.91706808,35
carcassonne-ucttuned440-vs-ucttuned110-1000its,845,810,2223.076437745,2136.071074861,35
carcassonne-boltzmann120-vs-boltzmann340-1000its,846,811,2224.896090174,2181.749111602,35
carcassonne-uct220-vs-uct130-1000its,846,811,2275.198343176,2247.003785861,35
carcassonne-uct95-vs-uct220-1000its,846,811,2233.639557695,2162.844055673,35
carcassonne-ucttuned140-vs-ucttuned475-1000its,847,812,2235.352933388,2180.544951775,35
carcassonne-uct35-vs-uct265-1000its,848,813,2192.337801065,2182.055812696,35
carcassonne-ucttuned475-vs-ucttuned25-1000its,849,814,2231.528416004,2183.922406438,35
carcassonne-boltzmann10-vs-boltzmann290-1000its,850,815,2181.209488564,2099.063776277,35
carcassonne-ucttuned150-vs-ucttuned315-1000its,850,815,2211.234488208,2190.656987792,35
carcassonne-boltzmann230-vs-boltzmann285-1000its,851,816,2180.112975722,2123.111913139,35
carcassonne-uct25-vs-uct470-1000its,851,816,2238.23214104,2186.69452367,35
carcassonne-boltzmann120-vs-boltzmann410-1000its,854,819,2205.721812448,2181.021451376,35
carcassonne-ucttuned115-vs-ucttuned315-1000its,856,821,2124.602163211,2049.207895497,35
carcassonne-ucttuned210-vs-ucttuned280-1000its,856,821,2236.828604931,2156.834939297,35
carcassonne-ucttuned135-vs-ucttuned355-1000its,857,822,2176.616006853,2162.556183949,35
carcassonne-uct210-vs-uct315-1000its,858,823,2228.76788919,2210.633188833,35
carcassonne-ucttuned125-vs-ucttuned410-1000its,858,823,2132.873915455,2105.858020615,35
carcassonne-uct340-vs-uct80-1000its,859,824,2213.715894949,2159.452622277,35
carcassonne-boltzmann260-vs-boltzmann285-1000its,861,826,2254.958955107,2182.415313435,35
carcassonne-boltzmann410-vs-boltzmann390-1000its,861,826,2233.259153776,2202.175080551,35
carcassonne-boltzmann40-vs-boltzmann240-1000its,866,831,2174.643782317,2134.358016033,35
carcassonne-boltzmann50-vs-boltzmann405-1000its,868,833,2184.690583526,2135.507843034,35
carcassonne-uct355-vs-uct95-1000its,868,833,2156.130984393,2134.043843078,35
carcassonne-ucttuned300-vs-ucttuned345-1000its,868,833,2220.287875513,2158.553820589,35
carcassonne-uct470-vs-uct400-1000its,870,835,2166.326292158,2096.610266219,35
carcassonne-uct435-vs-uct85-1000its,872,837,2247.183365461,2196.218262196,35
carcassonne-uct70-vs-uct270-1000its,872,837,2227.613243886,2156.199781424,35
carcassonne-uct115-vs-uct85-1000its,874,839,2155.485233038,2124.661451883,35
carcassonne-ucttuned420-vs-ucttuned160-1000its,874,839,2177.37361463,2157.960832613,35
carcassonne-uct30-vs-uct400-1000its,877,842,2186.515831936,2132.518517468,35
carcassonne-uct300-vs-uct470-1000its,877,842,2128.640100621,2119.391099858,35
carcassonne-uct370-vs-uct280-1000its,877,842,2149.09524215,2114.157988271,35
carcassonne-uct445-vs-uct430-1000its,877,842,2274.726737153,2243.299114365,35
carcassonne-ucttuned285-vs-ucttuned320-1000its,878,843,2212.650515432,2149.303734088,35
carcassonne-uct190-vs-uct410-1000its,880,845,2174.762653719,2149.91545649,35
carcassonne-boltzmann10-vs-boltzmann45-1000its,881,846,2188.907144709,2159.046675511,35
carcassonne-uct475-vs-uct285-1000its,883,848,2164.573832801,2174.857548623,35
carcassonne-uct55-vs-uct185-1000its,883,848,2229.889681844,2204.803070617,35
carcassonne-uct110-vs-uct340-1000its,885,850,2211.697367123,2205.175176753,35
carcassonne-uct440-vs-uct345-1000its,887,852,2219.708501374,2167.801216865,35
carcassonne-uct60-vs-uct255-1000its,889,854,2185.088385052,2156.19770676,35
carcassonne-boltzmann485-vs-boltzmann210-1000its,890,855,2108.842752303,2078.215678264,35
carcassonne-uct185-vs-uct490-1000its,891,856,2179.190407886,2153.667466997,35
carcassonne-uct225-vs-uct240-1000its,891,856,2238.026801472,2159.081959625,35
carcassonne-uct35-vs-uct5-1000its,892,857,2152.251683573,2134.972912673,35
carcassonne-ucttuned135-vs-ucttuned380-1000its,900,865,2134.86086449,2115.822628552,35
carcassonne-ucttuned270-vs-ucttuned420-1000its,906,871,2164.219136478,2067.686454976,35
carcassonne-uct430-vs-uct440-1000its,907,872,2218.779209377,2200.186825754,35
carcassonne-uct470-vs-uct245-1000its,909,874,2132.779621586,2098.734562227,35
carcassonne-ucttuned125-vs-ucttuned30-1000its,909,874,2179.520412883,2140.553458496,35
carcassonne-ucttuned220-vs-ucttuned20-1000its,923,888,2206.45756176,2180.236389056,35
carcassonne-uct230-vs-uct90-1000its,925,890,2130.591319135,2088.537857562,35
carcassonne-uct35-vs-uct385-1000its,926,891,2223.187906534,2182.336506504,35
carcassonne-ucttuned250-vs-ucttuned175-1000its,936,901,2173.676702867,2134.137554843,35
carcassonne-boltzmann175-vs-boltzmann45-1000its,593,557,1769.470879825,1718.355539289,36
carcassonne-boltzmann255-vs-boltzmann495-1000its,725,689,2222.42451922,2180.435853846,36
carcassonne-uct45-vs-uct220-1000its,750,714,2178.505360579,2101.254724559,36
carcassonne-boltzmann35-vs-boltzmann305-1000its,761,725,2159.533708498,2109.195828651,36
carcassonne-uct145-vs-uct340-1000its,764,728,2154.819231079,2125.211999053,36
carcassonne-uct15-vs-uct245-1000its,764,728,2257.862910053,2220.316539092,36
carcassonne-boltzmann30-vs-boltzmann25-1000its,767,731,2215.356019222,2192.674053923,36
carcassonne-uct150-vs-uct405-1000its,769,733,2188.311743162,2178.980887729,36
carcassonne-uct130-vs-uct410-1000its,776,740,2199.713879189,2175.786093065,36
carcassonne-boltzmann295-vs-boltzmann400-1000its,778,742,2184.60979666,2126.264427659,36
carcassonne-boltzmann395-vs-boltzmann270-1000its,778,742,2097.676079575,2060.462578566,36
carcassonne-boltzmann45-vs-boltzmann340-1000its,780,744,2203.597092559,2166.970093935,36
carcassonne-boltzmann235-vs-boltzmann455-1000its,782,746,2255.938670426,2202.390614062,36
carcassonne-boltzmann330-vs-boltzmann495-1000its,782,746,2210.744434869,2131.359575487,36
carcassonne-ucttuned290-vs-ucttuned300-1000its,783,747,2124.545936979,2082.108405732,36
carcassonne-uct105-vs-uct355-1000its,784,748,2168.927170501,2144.314556077,36
carcassonne-uct350-vs-uct300-1000its,785,749,2197.763137762,2187.195963968,36
carcassonne-boltzmann220-vs-boltzmann370-1000its,787,751,2165.069456727,2108.115985861,36
carcassonne-boltzmann200-vs-boltzmann275-1000its,788,752,2203.941289772,2185.646969512,36
carcassonne-boltzmann20-vs-boltzmann150-1000its,789,753,2207.446605385,2199.644149814,36
carcassonne-uct30-vs-uct175-1000its,789,753,2205.911747717,2134.685714315,36
carcassonne-ucttuned55-vs-ucttuned355-1000its,789,753,2147.900980258,2099.860825791,36
carcassonne-ucttuned75-vs-ucttuned60-1000its,790,754,2113.022700885,2149.366373061,36
carcassonne-boltzmann375-vs-boltzmann360-1000its,791,755,2138.011628863,2108.381410934,36
carcassonne-ucttuned380-vs-ucttuned320-1000its,792,756,2237.911227902,2219.714243057,36
carcassonne-ucttuned430-vs-ucttuned45-1000its,792,756,2175.240875241,2161.727829108,36
carcassonne-boltzmann490-vs-boltzmann360-1000its,796,760,2190.781095693,2180.548475602,36
carcassonne-boltzmann25-vs-boltzmann270-1000its,798,762,2225.408408535,2193.319744812,36
carcassonne-uct475-vs-uct370-1000its,798,762,2167.914546397,2154.445190474,36
carcassonne-boltzmann475-vs-boltzmann445-1000its,800,764,2189.7607975,2122.639804428,36
carcassonne-boltzmann10-vs-boltzmann270-1000its,801,765,2154.629385573,2131.157541087,36
carcassonne-boltzmann300-vs-boltzmann380-1000its,801,765,2243.270821238,2201.468048231,36
carcassonne-boltzmann345-vs-boltzmann290-1000its,801,765,2328.727880009,2273.023093169,36
carcassonne-boltzmann90-vs-boltzmann180-1000its,802,766,2241.382504965,2198.433202484,36
carcassonne-ucttuned140-vs-ucttuned440-1000its,802,766,2195.989477259,2162.762852512,36
carcassonne-uct135-vs-uct130-1000its,804,768,2189.378004694,2109.694950712,36
carcassonne-boltzmann460-vs-boltzmann80-1000its,805,769,2227.867294729,2194.835656351,36
carcassonne-boltzmann495-vs-boltzmann375-1000its,806,770,2249.448558196,2204.516476796,36
carcassonne-uct185-vs-uct290-1000its,806,770,2224.833653057,2181.104273975,36
carcassonne-uct270-vs-uct35-1000its,806,770,2222.76719734,2220.854308057,36
carcassonne-boltzmann70-vs-boltzmann425-1000its,807,771,2189.671550064,2142.871995152,36
carcassonne-ucttuned390-vs-ucttuned320-1000its,808,772,2214.295367208,2181.613661983,36
carcassonne-boltzmann215-vs-boltzmann465-1000its,810,774,2245.918823151,2174.853652683,36
carcassonne-boltzmann310-vs-boltzmann200-1000its,812,776,2216.375254587,2154.201293821,36
carcassonne-uct360-vs-uct335-1000its,812,776,2169.087289747,2154.655221666,36
carcassonne-boltzmann210-vs-boltzmann260-1000its,813,777,2202.477280821,2158.6737874,36
carcassonne-ucttuned400-vs-ucttuned90-1000its,813,777,2178.685304767,2127.228983919,36
carcassonne-boltzmann365-vs-boltzmann490-1000its,814,778,2146.396400916,2122.284683891,36
carcassonne-ucttuned230-vs-ucttuned110-1000its,814,778,2178.355538611,2128.20115763,36
carcassonne-boltzmann370-vs-boltzmann410-1000its,815,779,2169.307091351,2116.164954484,36
carcassonne-uct380-vs-uct115-1000its,816,780,2216.987590805,2179.403697646,36
carcassonne-boltzmann265-vs-boltzmann80-1000its,819,783,2166.88727524,2145.655316529,36
carcassonne-ucttuned445-vs-ucttuned65-1000its,819,783,2140.882389489,2124.277235611,36
carcassonne-boltzmann270-vs-boltzmann90-1000its,820,784,2223.30639557,2189.807052767,36
carcassonne-uct490-vs-uct155-1000its,820,784,2100.580405372,2055.985207503,36
carcassonne-uct395-vs-uct370-1000its,821,785,2290.189705398,2223.835809362,36
carcassonne-boltzmann145-vs-boltzmann40-1000its,823,787,2244.228762649,2179.428102424,36
carcassonne-boltzmann435-vs-boltzmann60-1000its,823,787,2225.508205722,2192.843568293,36
carcassonne-boltzmann455-vs-boltzmann380-1000its,823,787,2200.344700602,2133.447401956,36
carcassonne-uct250-vs-uct100-1000its,823,787,2155.127340697,2135.056558579,36
carcassonne-uct165-vs-uct120-1000its,825,789,2130.01651436,2095.870499312,36
carcassonne-uct360-vs-uct375-1000its,825,789,2113.444142371,2112.443840882,36
carcassonne-uct435-vs-uct365-1000its,826,790,2205.214152043,2169.509890526,36
carcassonne-ucttuned90-vs-ucttuned260-1000its,827,791,2138.604016268,2073.615733423,36
carcassonne-boltzmann390-vs-boltzmann405-1000its,828,792,2193.643689158,2169.063828161,36
carcassonne-ucttuned430-vs-ucttuned125-1000its,828,792,2195.138423837,2131.27337055,36
carcassonne-ucttuned460-vs-ucttuned215-1000its,828,792,2203.648965732,2190.290364749,36
carcassonne-uct90-vs-uct255-1000its,830,794,2205.646839961,2184.96983906,36
carcassonne-ucttuned60-vs-ucttuned10-1000its,831,795,2206.569373136,2138.190494054,36
carcassonne-boltzmann480-vs-boltzmann355-1000its,832,796,2166.972017013,2127.818615182,36
carcassonne-boltzmann60-vs-boltzmann290-1000its,833,797,2126.78593696,2109.177703698,36
carcassonne-uct100-vs-uct350-1000its,833,797,2145.980612261,2129.420999062,36
carcassonne-ucttuned450-vs-ucttuned50-1000its,834,798,2220.052417202,2187.196682373,36
carcassonne-boltzmann10-vs-boltzmann405-1000its,836,800,2213.379790874,2146.116733873,36
carcassonne-boltzmann180-vs-boltzmann265-1000its,836,800,2221.621430581,2180.240069244,36
carcassonne-uct100-vs-uct125-1000its,836,800,2154.033491643,2091.930631283,36
carcassonne-boltzmann100-vs-boltzmann50-1000its,838,802,2175.149704543,2145.230762387,36
carcassonne-uct95-vs-uct295-1000its,838,802,2181.266773791,2155.053336704,36
carcassonne-ucttuned430-vs-ucttuned5-1000its,839,803,2242.178917841,2222.013178534,36
carcassonne-uct155-vs-uct425-1000its,840,804,2250.68474176,2130.544752585,36
carcassonne-uct285-vs-uct295-1000its,842,806,2203.144572711,2160.939898822,36
carcassonne-uct235-vs-uct150-1000its,843,807,2219.400671439,2106.71537067,36
carcassonne-uct400-vs-uct475-1000its,843,807,2186.374022293,2152.933566192,36
carcassonne-uct175-vs-uct120-1000its,844,808,2190.203314502,2123.737485568,36
carcassonne-boltzmann195-vs-boltzmann95-1000its,846,810,2222.124187392,2188.223279783,36
carcassonne-boltzmann320-vs-boltzmann350-1000its,846,810,2185.445541612,2187.513760138,36
carcassonne-uct205-vs-uct430-1000its,846,810,2227.415786301,2176.483365222,36
carcassonne-uct345-vs-uct320-1000its,846,810,2210.209137034,2139.774850394,36
carcassonne-uct420-vs-uct75-1000its,846,810,2192.236738152,2130.393409396,36
carcassonne-uct65-vs-uct310-1000its,846,810,2175.860810666,2175.850325257,36
carcassonne-uct230-vs-uct360-1000its,848,812,2138.858827737,2127.074231209,36
carcassonne-ucttuned490-vs-ucttuned105-1000its,848,812,2203.971106877,2135.742538834,36
carcassonne-boltzmann215-vs-boltzmann350-1000its,850,814,2205.094035194,2181.360133419,36
carcassonne-boltzmann340-vs-boltzmann345-1000its,850,814,2234.187349794,2170.074741223,36
carcassonne-ucttuned270-vs-ucttuned155-1000its,850,814,2188.05903319,2147.452295575,36
carcassonne-boltzmann135-vs-boltzmann170-1000its,851,815,2181.486645012,2130.945024448,36
carcassonne-uct485-vs-uct55-1000its,851,815,2170.704556746,2156.382977534,36
carcassonne-ucttuned245-vs-ucttuned270-1000its,851,815,2153.659685039,2097.317490422,36
carcassonne-boltzmann145-vs-boltzmann70-1000its,852,816,2195.670043827,2218.095227217,36
carcassonne-ucttuned55-vs-ucttuned330-1000its,852,816,2263.343323287,2217.658300572,36
carcassonne-ucttuned65-vs-ucttuned380-1000its,852,816,2240.056630475,2231.519032893,36
carcassonne-ucttuned65-vs-ucttuned75-1000its,852,816,2177.261456383,2130.390506074,36
carcassonne-uct490-vs-uct420-1000its,853,817,2226.573833258,2222.809530528,36
carcassonne-boltzmann395-vs-boltzmann425-1000its,854,818,2239.005504924,2191.850688789,36
carcassonne-boltzmann430-vs-boltzmann160-1000its,854,818,2284.743383785,2212.783939936,36
carcassonne-ucttuned230-vs-ucttuned435-1000its,854,818,2195.486704818,2153.973483195,36
carcassonne-boltzmann320-vs-boltzmann480-1000its,858,822,2166.30624281,2136.993323766,36
carcassonne-boltzmann380-vs-boltzmann395-1000its,858,822,2226.928114122,2142.752643769,36
carcassonne-boltzmann275-vs-boltzmann445-1000its,861,825,2161.539780296,2151.681838462,36
carcassonne-ucttuned340-vs-ucttuned100-1000its,861,825,2163.753829153,2167.89839219,36
carcassonne-ucttuned295-vs-ucttuned420-1000its,862,826,2217.721099217,2200.522700637,36
carcassonne-ucttuned50-vs-ucttuned490-1000its,863,827,2184.041931922,2153.727219079,36
carcassonne-ucttuned480-vs-ucttuned300-1000its,869,833,2193.93576146,2160.964489774,36
carcassonne-boltzmann430-vs-boltzmann25-1000its,870,834,2240.173728463,2175.550167129,36
carcassonne-boltzmann365-vs-boltzmann10-1000its,871,835,2212.429295067,2153.896354046,36
carcassonne-ucttuned70-vs-ucttuned485-1000its,872,836,2252.052593886,2197.175909285,36
carcassonne-uct420-vs-uct375-1000its,875,839,2156.018824831,2115.299707133,36
carcassonne-boltzmann5-vs-boltzmann10-1000its,876,840,2144.020492721,2121.776250806,36
carcassonne-uct210-vs-uct385-1000its,877,841,2173.91183705,2127.838351677,36
carcassonne-uct185-vs-uct125-1000its,880,844,2171.257512609,2125.942088465,36
carcassonne-uct455-vs-uct200-1000its,880,844,2286.018404506,2247.222349302,36
carcassonne-uct130-vs-uct140-1000its,881,845,2208.01350245,2153.025269434,36
carcassonne-boltzmann420-vs-boltzmann245-1000its,882,846,2156.801796632,2073.886380223,36
carcassonne-boltzmann70-vs-boltzmann495-1000its,884,848,2165.887016301,2081.055244586,36
carcassonne-ucttuned415-vs-ucttuned200-1000its,885,849,2240.318284672,2236.993986571,36
carcassonne-uct355-vs-uct85-1000its,886,850,2142.556681407,2089.492507125,36
carcassonne-boltzmann270-vs-boltzmann150-1000its,890,854,2215.429803946,2126.241273398,36
carcassonne-uct485-vs-uct315-1000its,890,854,2206.759236273,2116.033154062,36
carcassonne-uct405-vs-uct410-1000its,891,855,2204.130298795,2183.249432759,36
carcassonne-uct65-vs-uct260-1000its,891,855,2144.926307859,2072.579991788,36
carcassonne-uct200-vs-uct295-1000its,895,859,2221.303085169,2150.338049147,36
carcassonne-ucttuned145-vs-ucttuned455-1000its,915,879,2232.038045613,2163.531584894,36
carcassonne-ucttuned10-vs-ucttuned480-1000its,916,880,2176.036370792,2131.959519217,36
carcassonne-uct430-vs-uct5-1000its,920,884,2127.569628514,2077.598399744,36
carcassonne-uct10-vs-uct200-1000its,927,891,2144.982626438,2120.035872533,36
carcassonne-uct355-vs-uct5-1000its,934,898,2278.289842485,2242.891840885,36
carcassonne-uct50-vs-uct340-1000its,950,914,2251.02021455,2164.938551224,36
carcassonne-uct270-vs-uct375-1000its,618,581,1748.436981585,1728.350231583,37
carcassonne-boltzmann315-vs-boltzmann90-1000its,742,705,2264.092336842,2203.384064841,37
carcassonne-boltzmann85-vs-boltzmann80-1000its,746,709,2144.703337327,2138.936249005,37
carcassonne-boltzmann295-vs-boltzmann70-1000its,748,711,2156.802802624,2100.679669153,37
carcassonne-ucttuned420-vs-ucttuned255-1000its,750,713,2256.813779449,2208.684423303,37
carcassonne-uct180-vs-uct270-1000its,753,716,2209.470608873,2135.189080221,37
carcassonne-boltzmann450-vs-boltzmann330-1000its,754,717,2181.077628694,2149.706076138,37
carcassonne-uct85-vs-uct455-1000its,754,717,2170.146590008,2137.792888138,37
carcassonne-ucttuned360-vs-ucttuned330-1000its,782,745,2219.71712116,2155.080048153,37
carcassonne-ucttuned140-vs-ucttuned375-1000its,783,746,2223.882420348,2195.218053622,37
carcassonne-boltzmann110-vs-boltzmann440-1000its,787,750,2255.554616952,2192.929813014,37
carcassonne-boltzmann65-vs-boltzmann380-1000its,788,751,2208.816938135,2151.714596324,37
carcassonne-boltzmann15-vs-boltzmann405-1000its,791,754,2177.387123741,2166.234900435,37
carcassonne-boltzmann280-vs-boltzmann270-1000its,792,755,2208.458457955,2199.414330873,37
carcassonne-uct440-vs-uct20-1000its,792,755,2127.434324962,2106.743971703,37
carcassonne-ucttuned285-vs-ucttuned45-1000its,792,755,2199.534684903,2150.32979068,37
carcassonne-boltzmann125-vs-boltzmann65-1000its,793,756,2168.02201211,2152.534218529,37
carcassonne-boltzmann430-vs-boltzmann135-1000its,793,756,2157.50105603,2111.199733251,37
carcassonne-uct435-vs-uct160-1000its,793,756,2197.113341616,2203.23458991,37
carcassonne-uct450-vs-uct70-1000its,794,757,2215.522824793,2188.331644661,37
carcassonne-ucttuned40-vs-ucttuned295-1000its,794,757,2256.03580439,2265.234529136,37
carcassonne-boltzmann430-vs-boltzmann295-1000its,795,758,2237.55210465,2191.494418071,37
carcassonne-uct290-vs-uct170-1000its,795,758,2238.383391744,2190.592130855,37
carcassonne-boltzmann245-vs-boltzmann410-1000its,796,759,2204.418867361,2140.199786099,37
carcassonne-uct195-vs-uct90-1000its,796,759,2196.753746489,2181.802766754,37
carcassonne-ucttuned365-vs-ucttuned90-1000its,796,759,2208.639811705,2172.825996479,37
carcassonne-boltzmann60-vs-boltzmann385-1000its,797,760,2167.278704282,2144.6247139,37
carcassonne-uct310-vs-uct300-1000its,798,761,2237.911046397,2217.16483468,37
carcassonne-ucttuned110-vs-ucttuned75-1000its,798,761,2256.827150895,2193.819002956,37
carcassonne-ucttuned65-vs-ucttuned305-1000its,799,762,2198.98915877,2189.736491481,37
carcassonne-ucttuned225-vs-ucttuned295-1000its,800,763,2231.05832982,2205.838490739,37
carcassonne-boltzmann420-vs-boltzmann475-1000its,801,764,2232.703018914,2161.574466448,37
carcassonne-uct245-vs-uct420-1000its,803,766,2170.346316374,2116.90678141,37
carcassonne-boltzmann150-vs-boltzmann305-1000its,806,769,2226.832331218,2165.289348943,37
carcassonne-uct255-vs-uct20-1000its,806,769,2207.472577312,2162.707589088,37
carcassonne-ucttuned285-vs-ucttuned440-1000its,806,769,2229.990341743,2163.323416726,37
carcassonne-uct230-vs-uct460-1000its,807,770,2181.47400765,2106.628584889,37
carcassonne-boltzmann345-vs-boltzmann240-1000its,808,771,2175.298570498,2094.896523031,37
carcassonne-uct265-vs-uct180-1000its,808,771,2210.071106789,2131.854000807,37
carcassonne-uct35-vs-uct170-1000its,808,771,2199.277353655,2154.53351324,37
carcassonne-uct480-vs-uct275-1000its,808,771,2199.292325461,2126.907967394,37
carcassonne-uct110-vs-uct10-1000its,811,774,2227.801422187,2228.303366089,37
carcassonne-uct300-vs-uct405-1000its,811,774,2206.37961343,2127.391211989,37
carcassonne-ucttuned160-vs-ucttuned340-1000its,811,774,2214.181527397,2196.440123819,37
carcassonne-boltzmann65-vs-boltzmann35-1000its,812,775,2216.106047196,2195.40407484,37
carcassonne-uct75-vs-uct490-1000its,813,776,2231.633485104,2142.71291562,37
carcassonne-uct75-vs-uct205-1000its,814,777,2262.063238613,2170.485877368,37
carcassonne-boltzmann10-vs-boltzmann95-1000its,815,778,2232.017979763,2229.588207372,37
carcassonne-boltzmann320-vs-boltzmann475-1000its,815,778,2155.42630216,2134.330102611,37
carcassonne-boltzmann85-vs-boltzmann120-1000its,815,778,2248.651614103,2187.214202577,37
carcassonne-uct70-vs-uct85-1000its,816,779,2155.904867814,2061.858570333,37
carcassonne-uct420-vs-uct15-1000its,817,780,2235.628845659,2154.615332618,37
carcassonne-uct435-vs-uct250-1000its,817,780,2227.57291358,2147.257430582,37
carcassonne-ucttuned115-vs-ucttuned495-1000its,817,780,2184.62316631,2155.791609812,37
carcassonne-uct40-vs-uct55-1000its,819,782,2185.02255225,2137.920983775,37
carcassonne-ucttuned195-vs-ucttuned40-1000its,820,783,2146.799631167,2139.98302475,37
carcassonne-boltzmann10-vs-boltzmann305-1000its,821,784,2232.191768288,2212.735042836,37
carcassonne-boltzmann425-vs-boltzmann35-1000its,821,784,2092.421450642,2016.661187059,37
carcassonne-uct130-vs-uct420-1000its,821,784,2171.759476476,2111.41304912,37
carcassonne-uct145-vs-uct315-1000its,821,784,2233.355808437,2152.708326142,37
carcassonne-uct5-vs-uct130-1000its,821,784,2237.115203266,2218.662308781,37
carcassonne-boltzmann50-vs-boltzmann430-1000its,822,785,2187.63341283,2150.211580867,37
carcassonne-ucttuned160-vs-ucttuned385-1000its,822,785,2229.313474946,2158.827982177,37
carcassonne-uct135-vs-uct120-1000its,823,786,2270.36184741,2250.890376048,37
carcassonne-uct300-vs-uct380-1000its,824,787,2231.157204576,2209.165890136,37
carcassonne-ucttuned380-vs-ucttuned70-1000its,824,787,2140.594808558,2129.795911113,37
carcassonne-uct80-vs-uct410-1000its,826,789,2195.262546705,2174.998902697,37
carcassonne-boltzmann135-vs-boltzmann175-1000its,827,790,2171.823101306,2101.443585013,37
carcassonne-boltzmann465-vs-boltzmann35-1000its,827,790,2257.038045919,2236.742459725,37
carcassonne-ucttuned295-vs-ucttuned160-1000its,827,790,2187.979787628,2161.832026959,37
carcassonne-boltzmann310-vs-boltzmann280-1000its,828,791,2122.691803582,2059.004990259,37
carcassonne-ucttuned405-vs-ucttuned40-1000its,828,791,2279.587650613,2235.119162111,37
carcassonne-boltzmann20-vs-boltzmann465-1000its,830,793,2154.210078348,2065.531129275,37
carcassonne-ucttuned95-vs-ucttuned255-1000its,830,793,2191.345791186,2128.018319909,37
carcassonne-boltzmann495-vs-boltzmann335-1000its,831,794,2140.289530928,2111.505354294,37
carcassonne-boltzmann475-vs-boltzmann105-1000its,832,795,2138.746733712,2077.20673447,37
carcassonne-uct5-vs-uct325-1000its,832,795,2205.729391576,2132.268461202,37
carcassonne-uct185-vs-uct350-1000its,833,796,2201.900055635,2182.591349329,37
carcassonne-uct285-vs-uct490-1000its,833,796,2274.149402213,2228.896264512,37
carcassonne-boltzmann475-vs-boltzmann455-1000its,834,797,2200.587920935,2131.775105505,37
carcassonne-ucttuned175-vs-ucttuned225-1000its,834,797,2233.06277564,2155.014774109,37
carcassonne-ucttuned35-vs-ucttuned20-1000its,835,798,2175.336988712,2112.639885789,37
carcassonne-uct45-vs-uct120-1000its,836,799,2181.849555121,2125.972313836,37
carcassonne-uct495-vs-uct470-1000its,836,799,2250.486698065,2201.585745221,37
carcassonne-boltzmann400-vs-boltzmann175-1000its,839,802,2187.498884237,2143.715217993,37
carcassonne-uct270-vs-uct425-1000its,839,802,2266.822575001,2232.491543054,37
carcassonne-uct295-vs-uct385-1000its,839,802,2266.13906589,2230.293043052,37
carcassonne-ucttuned125-vs-ucttuned460-1000its,839,802,2277.753826204,2240.580632049,37
carcassonne-uct365-vs-uct205-1000its,841,804,2241.884895941,2232.695585229,37
carcassonne-ucttuned265-vs-ucttuned380-1000its,842,805,2268.532081114,2199.499312797,37
carcassonne-boltzmann475-vs-boltzmann390-1000its,843,806,2184.352547926,2103.656694397,37
carcassonne-ucttuned245-vs-ucttuned5-1000its,843,806,2251.961456523,2214.840182207,37
carcassonne-boltzmann370-vs-boltzmann430-1000its,845,808,2161.23876615,2111.138988314,37
carcassonne-uct110-vs-uct230-1000its,845,808,2242.34287308,2163.180190079,37
carcassonne-ucttuned245-vs-ucttuned155-1000its,845,808,2230.280407373,2208.563900963,37
carcassonne-uct295-vs-uct355-1000its,846,809,2164.98595009,2107.91007688,37
carcassonne-ucttuned65-vs-ucttuned210-1000its,847,810,2211.338641388,2146.72348758,37
carcassonne-boltzmann230-vs-boltzmann495-1000its,848,811,2164.602645422,2142.053727649,37
carcassonne-uct190-vs-uct490-1000its,849,812,2181.414458366,2164.007798625,37
carcassonne-uct355-vs-uct105-1000its,850,813,2161.952986446,2105.52546591,37
carcassonne-ucttuned200-vs-ucttuned270-1000its,850,813,2198.716231263,2159.111180603,37
carcassonne-ucttuned205-vs-ucttuned180-1000its,850,813,2232.472239764,2164.11040239,37
carcassonne-uct135-vs-uct365-1000its,852,815,2211.383013472,2224.672544932,37
carcassonne-ucttuned195-vs-ucttuned450-1000its,852,815,2250.443632489,2152.119746585,37
carcassonne-uct470-vs-uct60-1000its,853,816,2243.124687466,2219.497770766,37
carcassonne-boltzmann170-vs-boltzmann380-1000its,854,817,2191.192363482,2164.656728231,37
carcassonne-ucttuned30-vs-ucttuned225-1000its,858,821,2234.854719315,2165.973847257,37
carcassonne-ucttuned55-vs-ucttuned25-1000its,858,821,2281.603170385,2229.743914617,37
carcassonne-boltzmann460-vs-boltzmann155-1000its,859,822,2209.931033781,2179.62824444,37
carcassonne-boltzmann255-vs-boltzmann245-1000its,862,825,2193.429110868,2149.810702853,37
carcassonne-boltzmann355-vs-boltzmann205-1000its,862,825,2153.17780597,2098.198329847,37
carcassonne-ucttuned375-vs-ucttuned470-1000its,862,825,2202.985491429,2142.415551257,37
carcassonne-uct85-vs-uct310-1000its,867,830,2235.230652459,2165.484999473,37
carcassonne-ucttuned165-vs-ucttuned305-1000its,867,830,2150.310186016,2082.505413229,37
carcassonne-uct95-vs-uct205-1000its,868,831,2212.626302871,2154.10930778,37
carcassonne-uct270-vs-uct95-1000its,870,833,2159.781539305,2140.101068293,37
carcassonne-ucttuned220-vs-ucttuned235-1000its,871,834,2186.540516655,2199.909353918,37
carcassonne-ucttuned75-vs-ucttuned275-1000its,872,835,2155.600157678,2117.993187812,37
carcassonne-ucttuned195-vs-ucttuned235-1000its,873,836,2191.668106811,2125.601058771,37
carcassonne-uct280-vs-uct20-1000its,876,839,2194.212541025,2173.50954289,37
carcassonne-uct285-vs-uct390-1000its,876,839,2244.194157505,2160.108868835,37
carcassonne-uct405-vs-uct155-1000its,876,839,2180.989853995,2139.265196737,37
carcassonne-ucttuned195-vs-ucttuned290-1000its,877,840,2201.780430109,2127.951035439,37
carcassonne-uct190-vs-uct360-1000its,879,842,2140.677293704,2104.974359085,37
carcassonne-ucttuned420-vs-ucttuned95-1000its,879,842,2279.029643942,2210.226150216,37
carcassonne-ucttuned270-vs-ucttuned365-1000its,882,845,2160.742974336,2129.455739429,37
carcassonne-boltzmann175-vs-boltzmann390-1000its,883,846,2206.746286212,2145.440163828,37
carcassonne-boltzmann410-vs-boltzmann210-1000its,883,846,2127.745788859,2096.592623148,37
carcassonne-uct280-vs-uct430-1000its,883,846,2219.348761303,2192.411574126,37
carcassonne-boltzmann440-vs-boltzmann360-1000its,884,847,2236.442549535,2246.606169597,37
carcassonne-ucttuned60-vs-ucttuned335-1000its,886,849,2242.780326593,2191.951700135,37
carcassonne-ucttuned15-vs-ucttuned45-1000its,890,853,2166.641433983,2132.850216878,37
carcassonne-ucttuned80-vs-ucttuned335-1000its,890,853,2223.929187914,2121.599968334,37
carcassonne-ucttuned160-vs-ucttuned230-1000its,893,856,2274.896106652,2218.515593981,37
carcassonne-ucttuned485-vs-ucttuned130-1000its,894,857,2162.358837839,2108.903018546,37
carcassonne-uct180-vs-uct290-1000its,895,858,2176.911713325,2172.403718435,37
carcassonne-uct20-vs-uct145-1000its,897,860,2225.958450208,2139.525167567,37
carcassonne-ucttuned345-vs-ucttuned45-1000its,899,862,2188.012679466,2145.769760016,37
carcassonne-ucttuned395-vs-ucttuned415-1000its,899,862,2187.334152335,2174.176497488,37
carcassonne-boltzmann450-vs-boltzmann190-1000its,901,864,2202.801032894,2146.169580505,37
carcassonne-ucttuned480-vs-ucttuned405-1000its,905,868,2226.08033342,2182.053388251,37
carcassonne-uct465-vs-uct285-1000its,911,874,2184.780645854,2138.380921015,37
carcassonne-uct380-vs-uct450-1000its,914,877,2226.275362549,2144.161228402,37
carcassonne-boltzmann365-vs-boltzmann85-1000its,915,878,2160.849284715,2101.540093329,37
carcassonne-boltzmann390-vs-boltzmann475-1000its,920,883,2230.341995004,2194.217054411,37
carcassonne-boltzmann345-vs-boltzmann310-1000its,923,886,2231.603224332,2197.734154805,37
carcassonne-boltzmann425-vs-boltzmann275-1000its,951,914,2203.68439959,2184.314348263,37
carcassonne-uct35-vs-uct445-1000its,691,653,1767.281674823,1724.548742948,38
carcassonne-boltzmann380-vs-boltzmann325-1000its,747,709,2220.134313996,2234.849218549,38
carcassonne-boltzmann45-vs-boltzmann145-1000its,751,713,2181.24422703,2133.200681343,38
carcassonne-ucttuned185-vs-ucttuned440-1000its,752,714,2175.677710416,2160.773260806,38
carcassonne-ucttuned390-vs-ucttuned370-1000its,760,722,2171.210285757,2117.002294155,38
carcassonne-boltzmann325-vs-boltzmann400-1000its,763,725,2186.105759856,2185.271095915,38
carcassonne-boltzmann120-vs-boltzmann275-1000its,766,728,2172.03476116,2170.672910056,38
carcassonne-boltzmann80-vs-boltzmann205-1000its,768,730,2245.748372157,2187.008034802,38
carcassonne-boltzmann265-vs-boltzmann450-1000its,778,740,2237.786648323,2190.32955727,38
carcassonne-ucttuned390-vs-ucttuned335-1000its,778,740,2251.061149328,2203.959638574,38
carcassonne-uct485-vs-uct460-1000its,781,743,2188.633482096,2155.829142596,38
carcassonne-ucttuned170-vs-ucttuned385-1000its,781,743,2131.399321155,2116.934121899,38
carcassonne-boltzmann100-vs-boltzmann340-1000its,788,750,2239.894147923,2177.623053893,38
carcassonne-ucttuned445-vs-ucttuned200-1000its,788,750,2156.991984818,2098.619277713,38
carcassonne-boltzmann355-vs-boltzmann245-1000its,789,751,2193.578865195,2199.838606916,38
carcassonne-uct145-vs-uct170-1000its,789,751,2217.766306645,2184.356953408,38
carcassonne-ucttuned450-vs-ucttuned380-1000its,789,751,2185.89626054,2156.451772663,38
carcassonne-ucttuned260-vs-ucttuned105-1000its,791,753,2175.618468789,2150.462273443,38
carcassonne-boltzmann460-vs-boltzmann380-1000its,793,755,2178.227683003,2172.927851995,38
carcassonne-uct240-vs-uct285-1000its,795,757,2200.621123582,2154.969349928,38
carcassonne-ucttuned215-vs-ucttuned275-1000its,797,759,2132.989524804,2115.599234385,38
carcassonne-boltzmann125-vs-boltzmann180-1000its,799,761,2172.909381674,2137.065990931,38
carcassonne-boltzmann200-vs-boltzmann405-1000its,799,761,2287.372747219,2246.404661653,38
carcassonne-boltzmann80-vs-boltzmann45-1000its,799,761,2232.03240418,2194.566121045,38
carcassonne-uct180-vs-uct315-1000its,800,762,2187.577151861,2161.755864158,38
carcassonne-uct185-vs-uct240-1000its,801,763,2232.272897328,2164.476106409,38
carcassonne-ucttuned345-vs-ucttuned425-1000its,801,763,2176.051255623,2180.028105605,38
carcassonne-uct405-vs-uct325-1000its,802,764,2195.179438646,2196.955408563,38
carcassonne-uct90-vs-uct480-1000its,802,764,2186.509002797,2136.796105554,38
carcassonne-uct435-vs-uct105-1000its,804,766,2225.98816729,2166.434687371,38
carcassonne-boltzmann235-vs-boltzmann415-1000its,805,767,2214.16819465,2207.584209728,38
carcassonne-ucttuned110-vs-ucttuned375-1000its,805,767,2203.220425281,2133.182415287,38
carcassonne-boltzmann375-vs-boltzmann95-1000its,807,769,2195.720904938,2123.353467054,38
carcassonne-boltzmann20-vs-boltzmann210-1000its,808,770,2192.75160791,2168.374656008,38
carcassonne-boltzmann200-vs-boltzmann350-1000its,808,770,2159.206623907,2124.768439841,38
carcassonne-uct355-vs-uct35-1000its,809,771,2227.15562153,2167.427048985,38
carcassonne-boltzmann130-vs-boltzmann290-1000its,810,772,2146.231523259,2082.125632367,38
carcassonne-boltzmann485-vs-boltzmann185-1000its,811,773,2142.909204343,2097.308207104,38
carcassonne-ucttuned235-vs-ucttuned350-1000its,811,773,2185.005228117,2139.28922075,38
carcassonne-boltzmann490-vs-boltzmann270-1000its,813,775,2251.697838505,2187.334890213,38
carcassonne-uct370-vs-uct105-1000its,813,775,2296.588395462,2220.639658433,38
carcassonne-boltzmann325-vs-boltzmann45-1000its,814,776,2280.268549215,2197.164659249,38
carcassonne-ucttuned55-vs-ucttuned105-1000its,814,776,2195.477828274,2121.047967741,38
carcassonne-ucttuned90-vs-ucttuned165-1000its,815,777,2196.633372149,2128.881082129,38
carcassonne-boltzmann495-vs-boltzmann5-1000its,816,778,2173.027126326,2140.427961387,38
carcassonne-uct405-vs-uct460-1000its,816,778,2269.174939505,2221.304933518,38
carcassonne-uct70-vs-uct235-1000its,817,779,2198.172754777,2173.908736569,38
carcassonne-ucttuned115-vs-ucttuned155-1000its,817,779,2309.594208339,2226.329118878,38
carcassonne-boltzmann370-vs-boltzmann385-1000its,818,780,2178.238307874,2113.795300089,38
carcassonne-ucttuned45-vs-ucttuned415-1000its,818,780,2209.936480304,2171.861369328,38
carcassonne-ucttuned485-vs-ucttuned405-1000its,818,780,2112.323570779,2058.075234739,38
carcassonne-ucttuned270-vs-ucttuned490-1000its,819,781,2143.997809619,2110.156880992,38
carcassonne-ucttuned40-vs-ucttuned405-1000its,820,782,2151.571772817,2133.391551893,38
carcassonne-uct460-vs-uct470-1000its,821,783,2269.324984844,2202.216544024,38
carcassonne-ucttuned185-vs-ucttuned320-1000its,821,783,2237.850432756,2183.328261921,38
carcassonne-ucttuned355-vs-ucttuned270-1000its,821,783,2253.889828269,2142.992706381,38
carcassonne-boltzmann110-vs-boltzmann50-1000its,822,784,2162.426886541,2139.998176273,38
carcassonne-uct240-vs-uct50-1000its,822,784,2218.238355433,2152.888565533,38
carcassonne-ucttuned205-vs-ucttuned490-1000its,825,787,2166.720247109,2135.778417412,38
carcassonne-uct185-vs-uct105-1000its,826,788,2229.965634028,2189.070961127,38
carcassonne-boltzmann480-vs-boltzmann190-1000its,827,789,2316.468628999,2226.039375904,38
carcassonne-ucttuned10-vs-ucttuned450-1000its,828,790,2220.139196581,2159.45118383,38
carcassonne-ucttuned195-vs-ucttuned410-1000its,829,791,2283.962679271,2259.880351642,38
carcassonne-boltzmann45-vs-boltzmann370-1000its,833,795,2228.923475964,2195.860256889,38
carcassonne-boltzmann5-vs-boltzmann135-1000its,833,795,2247.545444523,2208.724926308,38
carcassonne-uct110-vs-uct115-1000its,833,795,2141.839302465,2096.84252331,38
carcassonne-boltzmann375-vs-boltzmann260-1000its,836,798,2183.17015586,2137.865286638,38
carcassonne-boltzmann315-vs-boltzmann365-1000its,837,799,2183.053975399,2107.30410449,38
carcassonne-boltzmann385-vs-boltzmann5-1000its,839,801,2250.754080629,2197.26637574,38
carcassonne-uct20-vs-uct170-1000its,839,801,2204.724362062,2143.531361883,38
carcassonne-uct415-vs-uct305-1000its,840,802,2168.329232034,2178.413458401,38
carcassonne-boltzmann285-vs-boltzmann80-1000its,841,803,2196.147935283,2141.744816008,38
carcassonne-boltzmann485-vs-boltzmann470-1000its,841,803,2221.575818019,2178.066081292,38
carcassonne-ucttuned385-vs-ucttuned100-1000its,841,803,2216.012534939,2173.905397921,38
carcassonne-ucttuned5-vs-ucttuned130-1000its,842,804,2173.28214204,2145.347013599,38
carcassonne-uct395-vs-uct95-1000its,843,805,2140.828237652,2108.246360804,38
carcassonne-uct445-vs-uct195-1000its,843,805,2242.179249855,2186.809615732,38
carcassonne-uct25-vs-uct105-1000its,844,806,2192.316982779,2156.109333945,38
carcassonne-ucttuned255-vs-ucttuned430-1000its,844,806,2188.44262367,2189.781142486,38
carcassonne-boltzmann355-vs-boltzmann255-1000its,845,807,2282.317030285,2266.22590614,38
carcassonne-ucttuned240-vs-ucttuned410-1000its,846,808,2251.90166123,2200.270786457,38
carcassonne-ucttuned495-vs-ucttuned490-1000its,850,812,2186.113320779,2132.36039007,38
carcassonne-uct75-vs-uct410-1000its,851,813,2181.140701859,2172.488823124,38
carcassonne-uct340-vs-uct325-1000its,852,814,2247.977413454,2174.809031876,38
carcassonne-uct35-vs-uct255-1000its,853,815,2143.998580919,2117.648504506,38
carcassonne-uct75-vs-uct215-1000its,853,815,2200.91628918,2209.377114945,38
carcassonne-ucttuned315-vs-ucttuned495-1000its,853,815,2163.64438055,2118.167129232,38
carcassonne-uct165-vs-uct185-1000its,854,816,2159.266183836,2143.37605358,38
carcassonne-boltzmann465-vs-boltzmann350-1000its,856,818,2191.303950288,2173.103470677,38
carcassonne-uct340-vs-uct145-1000its,856,818,2167.644385767,2118.504572462,38
carcassonne-ucttuned25-vs-ucttuned310-1000its,857,819,2164.961518957,2111.05684324,38
carcassonne-boltzmann10-vs-boltzmann205-1000its,858,820,2224.907542426,2172.293962636,38
carcassonne-ucttuned310-vs-ucttuned15-1000its,858,820,2181.560864008,2138.568197672,38
carcassonne-ucttuned455-vs-ucttuned15-1000its,860,822,2223.373750631,2157.913335785,38
carcassonne-boltzmann100-vs-boltzmann115-1000its,862,824,2230.046890692,2215.296396966,38
carcassonne-uct205-vs-uct220-1000its,862,824,2177.054122982,2167.283316447,38
carcassonne-uct390-vs-uct200-1000its,864,826,2236.355879491,2213.185471513,38
carcassonne-uct485-vs-uct410-1000its,864,826,2185.936672665,2150.657550702,38
carcassonne-uct165-vs-uct130-1000its,866,828,2231.450770167,2190.957770357,38
carcassonne-ucttuned310-vs-ucttuned460-1000its,869,831,2120.137882235,2144.891039168,38
carcassonne-ucttuned20-vs-ucttuned260-1000its,870,832,2188.727081823,2165.567678131,38
carcassonne-boltzmann360-vs-boltzmann50-1000its,871,833,2143.980099723,2105.542748495,38
carcassonne-ucttuned285-vs-ucttuned265-1000its,871,833,2159.60028621,2131.270770436,38
carcassonne-boltzmann35-vs-boltzmann80-1000its,873,835,2184.921226307,2171.730700116,38
carcassonne-uct140-vs-uct150-1000its,875,837,2145.213558054,2113.388575302,38
carcassonne-uct395-vs-uct25-1000its,876,838,2191.142053975,2131.06572195,38
carcassonne-uct225-vs-uct360-1000its,879,841,2174.354414796,2126.874883654,38
carcassonne-uct415-vs-uct470-1000its,880,842,2265.90174901,2210.591801444,38
carcassonne-ucttuned45-vs-ucttuned160-1000its,884,846,2226.537454962,2167.935839786,38
carcassonne-ucttuned485-vs-ucttuned310-1000its,884,846,2182.879729834,2107.145927867,38
carcassonne-uct55-vs-uct10-1000its,887,849,2209.382575702,2214.93923885,38
carcassonne-boltzmann420-vs-boltzmann300-1000its,890,852,2155.39419959,2167.986968578,38
carcassonne-uct480-vs-uct460-1000its,890,852,2210.315892914,2145.897835006,38
carcassonne-boltzmann25-vs-boltzmann265-1000its,893,855,2217.573608828,2161.097565791,38
carcassonne-uct490-vs-uct255-1000its,897,859,2252.745345945,2167.358260447,38
carcassonne-boltzmann60-vs-boltzmann170-1000its,899,861,2210.417919985,2157.569672348,38
carcassonne-boltzmann295-vs-boltzmann270-1000its,903,865,2289.606363382,2201.445525616,38
carcassonne-uct155-vs-uct350-1000its,908,870,2180.103705681,2150.151789597,38
carcassonne-boltzmann45-vs-boltzmann350-1000its,913,875,2235.108340372,2167.031366567,38
carcassonne-uct385-vs-uct420-1000its,917,879,2148.535732207,2129.26527673,38
carcassonne-uct240-vs-uct320-1000its,918,880,2251.077656532,2166.797319641,38
carcassonne-boltzmann470-vs-boltzmann410-1000its,920,882,2204.83805626,2180.915805641,38
carcassonne-uct185-vs-uct10-1000its,935,897,2259.125834761,2214.650261439,38
carcassonne-ucttuned150-vs-ucttuned300-1000its,937,899,2176.313417217,2121.483432214,38
carcassonne-boltzmann325-vs-boltzmann175-1000its,958,920,2271.947173644,2196.053756003,38
carcassonne-boltzmann225-vs-boltzmann400-1000its,718,679,2140.790553447,2084.231164265,39
carcassonne-uct125-vs-uct490-1000its,739,700,2210.789547949,2175.15527562,39
carcassonne-boltzmann50-vs-boltzmann435-1000its,753,714,2238.982185982,2184.197372966,39
carcassonne-uct360-vs-uct435-1000its,754,715,2241.387107069,2167.867693292,39
carcassonne-uct270-vs-uct210-1000its,759,720,2252.251596634,2209.775701105,39
carcassonne-boltzmann45-vs-boltzmann345-1000its,764,725,2164.350049032,2128.421524725,39
carcassonne-boltzmann360-vs-boltzmann335-1000its,768,729,2193.226422961,2102.247684857,39
carcassonne-boltzmann150-vs-boltzmann230-1000its,769,730,2164.497300794,2097.351521352,39
carcassonne-ucttuned190-vs-ucttuned355-1000its,771,732,2179.948266681,2111.703027769,39
carcassonne-boltzmann20-vs-boltzmann380-1000its,773,734,2170.959245388,2085.793153546,39
carcassonne-ucttuned50-vs-ucttuned120-1000its,773,734,2224.334354097,2172.625614025,39
carcassonne-boltzmann235-vs-boltzmann115-1000its,777,738,2163.706029797,2117.687800546,39
carcassonne-boltzmann175-vs-boltzmann375-1000its,778,739,2155.760978447,2140.983105154,39
carcassonne-ucttuned345-vs-ucttuned30-1000its,778,739,2188.357792461,2155.564765545,39
carcassonne-uct445-vs-uct190-1000its,779,740,2237.236806562,2177.901952335,39
carcassonne-ucttuned260-vs-ucttuned450-1000its,780,741,2191.524464212,2121.889364652,39
carcassonne-boltzmann390-vs-boltzmann340-1000its,782,743,2155.643670354,2148.559917545,39
carcassonne-boltzmann55-vs-boltzmann200-1000its,784,745,2183.277910619,2152.89345763,39
carcassonne-uct45-vs-uct55-1000its,785,746,2170.065398542,2135.962574019,39
carcassonne-ucttuned330-vs-ucttuned335-1000its,789,750,2209.155965288,2145.869753319,39
carcassonne-uct35-vs-uct195-1000its,790,751,2263.371412969,2212.908243461,39
carcassonne-boltzmann215-vs-boltzmann270-1000its,792,753,2190.896659797,2103.117735579,39
carcassonne-uct395-vs-uct155-1000its,793,754,2167.31911808,2160.894535832,39
carcassonne-boltzmann305-vs-boltzmann50-1000its,795,756,2197.388449601,2192.869906867,39
carcassonne-uct360-vs-uct385-1000its,795,756,2143.317674788,2107.893136847,39
carcassonne-uct385-vs-uct270-1000its,795,756,2173.109577984,2029.8772836,39
carcassonne-ucttuned460-vs-ucttuned85-1000its,799,760,2204.152715735,2174.349088699,39
carcassonne-ucttuned220-vs-ucttuned345-1000its,801,762,2184.553440074,2177.2227681,39
carcassonne-uct400-vs-uct50-1000its,803,764,2170.227042887,2123.714691416,39
carcassonne-ucttuned80-vs-ucttuned165-1000its,803,764,2206.532451974,2135.421764867,39
carcassonne-uct175-vs-uct320-1000its,804,765,2199.259534198,2151.723283628,39
carcassonne-ucttuned30-vs-ucttuned60-1000its,804,765,2323.004205268,2252.252839299,39
carcassonne-ucttuned390-vs-ucttuned285-1000its,804,765,2143.529807631,2096.679528858,39
carcassonne-boltzmann360-vs-boltzmann270-1000its,805,766,2217.062218816,2164.720841536,39
carcassonne-uct470-vs-uct80-1000its,806,767,2277.869267066,2200.413337882,39
carcassonne-boltzmann215-vs-boltzmann355-1000its,808,769,2184.809889357,2128.042504424,39
carcassonne-boltzmann365-vs-boltzmann270-1000its,808,769,2097.360716271,2080.337906,39
carcassonne-boltzmann240-vs-boltzmann485-1000its,809,770,2208.792114589,2134.935712969,39
carcassonne-boltzmann55-vs-boltzmann90-1000its,809,770,2170.230174162,2121.910637346,39
carcassonne-uct130-vs-uct100-1000its,809,770,2173.799426397,2168.973148933,39
carcassonne-uct30-vs-uct85-1000its,809,770,2165.229354955,2168.185170211,39
carcassonne-uct435-vs-uct130-1000its,812,773,2205.333915148,2155.597529404,39
carcassonne-boltzmann170-vs-boltzmann240-1000its,814,775,2228.602503353,2164.925993982,39
carcassonne-boltzmann185-vs-boltzmann490-1000its,815,776,2227.037380085,2136.272376158,39
carcassonne-uct290-vs-uct445-1000its,815,776,2190.419873304,2132.384335656,39
carcassonne-uct330-vs-uct125-1000its,815,776,2132.20423289,2067.258530174,39
carcassonne-ucttuned330-vs-ucttuned110-1000its,815,776,2210.077956884,2180.254170322,39
carcassonne-boltzmann350-vs-boltzmann225-1000its,816,777,2159.75097304,2145.258447086,39
carcassonne-boltzmann255-vs-boltzmann410-1000its,817,778,2231.267844989,2186.605330765,39
carcassonne-boltzmann90-vs-boltzmann390-1000its,818,779,2154.717821997,2161.549957359,39
carcassonne-boltzmann300-vs-boltzmann415-1000its,819,780,2191.297323163,2144.993138816,39
carcassonne-uct155-vs-uct105-1000its,819,780,2174.043178485,2096.516025868,39
carcassonne-boltzmann210-vs-boltzmann105-1000its,820,781,2173.032060971,2139.353973831,39
carcassonne-uct265-vs-uct450-1000its,820,781,2285.932032941,2231.219257324,39
carcassonne-boltzmann330-vs-boltzmann95-1000its,821,782,2216.01179191,2152.956594568,39
carcassonne-boltzmann130-vs-boltzmann195-1000its,822,783,2131.69534936,2096.608601335,39
carcassonne-boltzmann435-vs-boltzmann370-1000its,822,783,2264.040842508,2178.688505376,39
carcassonne-ucttuned170-vs-ucttuned100-1000its,822,783,2189.318551674,2181.335873399,39
carcassonne-boltzmann285-vs-boltzmann415-1000its,823,784,2221.738533823,2160.120353972,39
carcassonne-uct375-vs-uct195-1000its,823,784,2280.738460555,2194.631981853,39
carcassonne-boltzmann225-vs-boltzmann355-1000its,829,790,2175.829565407,2094.952519158,39
carcassonne-boltzmann35-vs-boltzmann405-1000its,830,791,2210.482426498,2164.073519105,39
carcassonne-ucttuned55-vs-ucttuned370-1000its,830,791,2135.232554692,2078.292428459,39
carcassonne-boltzmann255-vs-boltzmann290-1000its,834,795,2153.018757884,2122.432791341,39
carcassonne-uct300-vs-uct400-1000its,834,795,2180.665550192,2114.799874886,39
carcassonne-ucttuned300-vs-ucttuned80-1000its,834,795,2218.600869593,2167.753054055,39
carcassonne-boltzmann395-vs-boltzmann120-1000its,835,796,2231.415675608,2218.577441005,39
carcassonne-uct415-vs-uct390-1000its,836,797,2181.10189919,2150.834570938,39
carcassonne-ucttuned365-vs-ucttuned280-1000its,836,797,2188.79252194,2136.830147856,39
carcassonne-boltzmann205-vs-boltzmann115-1000its,837,798,2274.474621062,2256.602642464,39
carcassonne-uct340-vs-uct85-1000its,837,798,2194.120646191,2199.822738393,39
carcassonne-uct275-vs-uct360-1000its,838,799,2233.931993512,2204.60722719,39
carcassonne-boltzmann340-vs-boltzmann405-1000its,840,801,2225.920353869,2162.852315381,39
carcassonne-boltzmann100-vs-boltzmann495-1000its,842,803,2214.348509844,2185.351585428,39
carcassonne-boltzmann175-vs-boltzmann145-1000its,842,803,2238.477458504,2165.967783949,39
carcassonne-boltzmann5-vs-boltzmann435-1000its,842,803,2213.397376697,2157.002841338,39
carcassonne-uct215-vs-uct150-1000its,843,804,2182.276680422,2194.208930346,39
carcassonne-ucttuned200-vs-ucttuned395-1000its,844,805,2161.665569446,2124.647538024,39
carcassonne-uct160-vs-uct290-1000its,845,806,2294.717998968,2252.356622915,39
carcassonne-uct325-vs-uct130-1000its,845,806,2255.314431638,2192.450324641,39
carcassonne-ucttuned235-vs-ucttuned345-1000its,847,808,2195.147141592,2129.433812986,39
carcassonne-ucttuned20-vs-ucttuned290-1000its,848,809,2199.326881315,2129.718923077,39
carcassonne-ucttuned80-vs-ucttuned215-1000its,848,809,2211.125115549,2165.141725825,39
carcassonne-boltzmann325-vs-boltzmann235-1000its,849,810,2231.625920535,2147.587570359,39
carcassonne-boltzmann145-vs-boltzmann15-1000its,850,811,2162.159428375,2109.46803469,39
carcassonne-uct210-vs-uct255-1000its,850,811,2251.002916039,2230.392365936,39
carcassonne-uct435-vs-uct465-1000its,852,813,2269.611293322,2237.253375734,39
carcassonne-ucttuned150-vs-ucttuned235-1000its,852,813,2144.824712333,2137.942078825,39
carcassonne-boltzmann385-vs-boltzmann365-1000its,855,816,2270.705220838,2246.113327212,39
carcassonne-uct20-vs-uct35-1000its,856,817,2153.937746982,2141.620525355,39
carcassonne-ucttuned115-vs-ucttuned295-1000its,856,817,2205.046824162,2132.013440035,39
carcassonne-uct125-vs-uct495-1000its,857,818,2305.539494573,2257.281414155,39
carcassonne-ucttuned50-vs-ucttuned390-1000its,857,818,2234.791936534,2126.058873657,39
carcassonne-uct190-vs-uct165-1000its,858,819,2221.241247139,2147.402086799,39
carcassonne-ucttuned70-vs-ucttuned235-1000its,858,819,2174.791003067,2165.002029171,39
carcassonne-uct25-vs-uct265-1000its,859,820,2149.536380036,2097.394160892,39
carcassonne-uct30-vs-uct395-1000its,859,820,2182.502056288,2082.982344955,39
carcassonne-boltzmann370-vs-boltzmann360-1000its,861,822,2152.757230101,2116.97487887,39
carcassonne-boltzmann485-vs-boltzmann275-1000its,863,824,2165.855556809,2115.384535297,39
carcassonne-ucttuned45-vs-ucttuned220-1000its,863,824,2275.402264362,2204.105098616,39
carcassonne-ucttuned165-vs-ucttuned125-1000its,864,825,2177.262636075,2134.620137842,39
carcassonne-boltzmann305-vs-boltzmann115-1000its,867,828,2250.183481574,2179.583303593,39
carcassonne-uct60-vs-uct275-1000its,867,828,2145.757358354,2104.940969656,39
carcassonne-ucttuned15-vs-ucttuned295-1000its,867,828,2215.592524969,2161.727435184,39
carcassonne-ucttuned155-vs-ucttuned485-1000its,867,828,2162.969928117,2121.876677797,39
carcassonne-uct295-vs-uct345-1000its,869,830,2183.328154944,2161.70285865,39
carcassonne-boltzmann260-vs-boltzmann25-1000its,870,831,2225.241127263,2196.078333984,39
carcassonne-ucttuned210-vs-ucttuned305-1000its,870,831,2201.767960563,2144.908235079,39
carcassonne-boltzmann110-vs-boltzmann225-1000its,872,833,2223.019977079,2197.959602776,39
carcassonne-boltzmann235-vs-boltzmann240-1000its,872,833,2148.933912,2082.290925142,39
carcassonne-boltzmann275-vs-boltzmann480-1000its,872,833,2202.150044719,2144.851728213,39
carcassonne-uct60-vs-uct110-1000its,872,833,2172.10988269,2168.324566529,39
carcassonne-ucttuned240-vs-ucttuned460-1000its,872,833,2150.265541478,2106.863749184,39
carcassonne-uct145-vs-uct150-1000its,876,837,2205.692384205,2149.167839876,39
carcassonne-uct360-vs-uct240-1000its,876,837,2244.070796355,2192.690136629,39
carcassonne-uct385-vs-uct105-1000its,877,838,2177.681805338,2117.465114726,39
carcassonne-uct480-vs-uct280-1000its,877,838,2173.336135529,2144.567951468,39
carcassonne-ucttuned20-vs-ucttuned310-1000its,879,840,2210.242535211,2137.057287752,39
carcassonne-ucttuned350-vs-ucttuned275-1000its,879,840,2277.096016706,2272.182117019,39
carcassonne-ucttuned435-vs-ucttuned50-1000its,881,842,2128.899613175,2102.71087829,39
carcassonne-ucttuned150-vs-ucttuned135-1000its,883,844,2264.603000494,2184.1809653,39
carcassonne-boltzmann185-vs-boltzmann155-1000its,886,847,2213.386604895,2213.799294602,39
carcassonne-uct165-vs-uct115-1000its,891,852,2313.491399553,2243.208663519,39
carcassonne-ucttuned25-vs-ucttuned85-1000its,891,852,2182.949452582,2149.906492162,39
carcassonne-ucttuned160-vs-ucttuned290-1000its,895,856,2208.598289929,2164.153438653,39
carcassonne-ucttuned180-vs-ucttuned405-1000its,895,856,2113.568650738,2047.867584286,39
carcassonne-boltzmann310-vs-boltzmann90-1000its,896,857,2255.647402189,2222.410892849,39
carcassonne-uct470-vs-uct235-1000its,897,858,2200.704758828,2179.518326562,39
carcassonne-boltzmann90-vs-boltzmann305-1000its,898,859,2251.452220075,2177.220984172,39
carcassonne-uct120-vs-uct160-1000its,902,863,2199.966334391,2140.706191464,39
carcassonne-uct385-vs-uct220-1000its,902,863,2189.224438372,2104.452637226,39
carcassonne-uct85-vs-uct475-1000its,905,866,2163.200823797,2127.566615837,39
carcassonne-ucttuned220-vs-ucttuned110-1000its,907,868,2175.177605114,2158.620764013,39
carcassonne-uct495-vs-uct445-1000its,910,871,2169.821918393,2095.277253787,39
carcassonne-uct285-vs-uct45-1000its,912,873,2254.342806758,2234.597580464,39
carcassonne-uct35-vs-uct10-1000its,930,891,2239.730280736,2194.006267143,39
carcassonne-uct135-vs-uct290-1000its,948,909,2208.42775865,2196.124435809,39
carcassonne-uct295-vs-uct125-1000its,743,703,2171.260750653,2159.897353012,40
carcassonne-uct155-vs-uct390-1000its,755,715,2229.094257912,2165.434513962,40
carcassonne-boltzmann195-vs-boltzmann235-1000its,760,720,2154.846287233,2186.65356282,40
carcassonne-ucttuned325-vs-ucttuned15-1000its,760,720,2191.944481206,2141.751956962,40
carcassonne-boltzmann185-vs-boltzmann195-1000its,761,721,2201.319938134,2119.150409629,40
carcassonne-uct30-vs-uct440-1000its,765,725,2238.772868472,2171.616123015,40
carcassonne-uct460-vs-uct260-1000its,767,727,2185.197808518,2136.127558547,40
carcassonne-boltzmann295-vs-boltzmann395-1000its,769,729,2256.697018646,2167.204618526,40
carcassonne-boltzmann30-vs-boltzmann165-1000its,771,731,2114.314594776,2086.510425802,40
carcassonne-boltzmann315-vs-boltzmann360-1000its,776,736,2184.107057771,2183.463349122,40
carcassonne-boltzmann305-vs-boltzmann285-1000its,777,737,2220.851251292,2143.378401463,40
carcassonne-ucttuned75-vs-ucttuned220-1000its,780,740,2126.199422841,2094.852667477,40
carcassonne-boltzmann200-vs-boltzmann40-1000its,783,743,2228.947607056,2219.804833006,40
carcassonne-boltzmann340-vs-boltzmann360-1000its,784,744,2158.086728453,2083.51610209,40
carcassonne-uct485-vs-uct440-1000its,786,746,2255.019607795,2248.950361461,40
carcassonne-uct320-vs-uct490-1000its,788,748,2228.232901872,2134.258819813,40
carcassonne-ucttuned200-vs-ucttuned50-1000its,789,749,2202.573783438,2141.389613004,40
carcassonne-boltzmann220-vs-boltzmann10-1000its,790,750,2185.649877036,2198.565642451,40
carcassonne-boltzmann65-vs-boltzmann115-1000its,793,753,2249.802231193,2141.767351496,40
carcassonne-uct175-vs-uct165-1000its,794,754,2142.709090828,2113.413999842,40
carcassonne-uct205-vs-uct475-1000its,794,754,2159.098636666,2159.110181349,40
carcassonne-uct90-vs-uct440-1000its,795,755,2140.858290236,2097.349078669,40
carcassonne-uct10-vs-uct185-1000its,796,756,2155.600543237,2078.359136937,40
carcassonne-boltzmann30-vs-boltzmann175-1000its,797,757,2280.686679042,2220.73789991,40
carcassonne-boltzmann445-vs-boltzmann200-1000its,797,757,2195.90919962,2148.310663441,40
carcassonne-uct65-vs-uct325-1000its,797,757,2211.47468941,2191.409822093,40
carcassonne-boltzmann205-vs-boltzmann285-1000its,801,761,2130.128943457,2113.386922087,40
carcassonne-boltzmann210-vs-boltzmann265-1000its,801,761,2180.972720448,2182.579004356,40
carcassonne-uct45-vs-uct395-1000its,801,761,2156.647127708,2097.596251248,40
carcassonne-boltzmann175-vs-boltzmann80-1000its,802,762,2225.918022454,2143.119241087,40
carcassonne-ucttuned495-vs-ucttuned155-1000its,803,763,2156.517836948,2108.889568783,40
carcassonne-uct355-vs-uct340-1000its,804,764,2202.637530001,2125.887754385,40
carcassonne-boltzmann350-vs-boltzmann65-1000its,806,766,2193.491114187,2130.76409319,40
carcassonne-boltzmann465-vs-boltzmann240-1000its,806,766,2232.600686207,2169.830254589,40
carcassonne-uct355-vs-uct155-1000its,806,766,2137.137072123,2104.611648518,40
carcassonne-ucttuned405-vs-ucttuned170-1000its,806,766,2222.77314961,2197.816969363,40
carcassonne-boltzmann350-vs-boltzmann295-1000its,809,769,2262.255459665,2227.231472281,40
carcassonne-uct310-vs-uct125-1000its,809,769,2160.181485532,2105.893439268,40
carcassonne-boltzmann125-vs-boltzmann240-1000its,811,771,2257.787587415,2176.459896888,40
carcassonne-boltzmann80-vs-boltzmann465-1000its,812,772,2207.017241997,2181.433117314,40
carcassonne-uct445-vs-uct235-1000its,813,773,2256.43415791,2180.278003316,40
carcassonne-uct340-vs-uct455-1000its,816,776,2196.438791708,2158.072342394,40
carcassonne-ucttuned265-vs-ucttuned120-1000its,816,776,2307.331949873,2244.242407268,40
carcassonne-ucttuned405-vs-ucttuned390-1000its,816,776,2210.661488902,2134.882061497,40
carcassonne-uct70-vs-uct260-1000its,817,777,2164.936685521,2153.602674161,40
carcassonne-boltzmann70-vs-boltzmann240-1000its,818,778,2195.349619183,2151.772424157,40
carcassonne-uct385-vs-uct185-1000its,818,778,2191.292707058,2173.867511977,40
carcassonne-boltzmann115-vs-boltzmann240-1000its,819,779,2196.909165712,2165.907813168,40
carcassonne-ucttuned475-vs-ucttuned60-1000its,821,781,2294.48980865,2269.492118839,40
carcassonne-uct320-vs-uct205-1000its,822,782,2253.596348769,2226.40589506,40
carcassonne-boltzmann105-vs-boltzmann490-1000its,824,784,2216.013928327,2179.831461084,40
carcassonne-boltzmann175-vs-boltzmann345-1000its,824,784,2289.931896231,2255.344733314,40
carcassonne-uct240-vs-uct30-1000its,824,784,2165.697508636,2148.654029514,40
carcassonne-uct350-vs-uct110-1000its,824,784,2163.979120768,2130.579549087,40
carcassonne-boltzmann180-vs-boltzmann345-1000its,826,786,2209.821834773,2136.896203894,40
carcassonne-boltzmann285-vs-boltzmann240-1000its,826,786,2203.715460329,2173.129925245,40
carcassonne-boltzmann280-vs-boltzmann165-1000its,828,788,2212.073144139,2152.541779772,40
carcassonne-ucttuned490-vs-ucttuned310-1000its,828,788,2159.421648677,2142.15775417,40
carcassonne-boltzmann30-vs-boltzmann195-1000its,830,790,2197.144702732,2152.060094736,40
carcassonne-uct225-vs-uct40-1000its,830,790,2244.05805021,2210.422435368,40
carcassonne-ucttuned75-vs-ucttuned280-1000its,830,790,2221.067185968,2229.062139217,40
carcassonne-boltzmann305-vs-boltzmann165-1000its,831,791,2262.993014932,2228.314001383,40
carcassonne-ucttuned445-vs-ucttuned255-1000its,831,791,2176.912130519,2095.048347424,40
carcassonne-boltzmann465-vs-boltzmann345-1000its,832,792,2158.481188222,2100.5530868,40
carcassonne-ucttuned150-vs-ucttuned290-1000its,832,792,2195.387955179,2148.063897054,40
carcassonne-ucttuned205-vs-ucttuned290-1000its,832,792,2275.00434751,2194.294979199,40
carcassonne-uct305-vs-uct285-1000its,833,793,2116.4689314,2072.795060388,40
carcassonne-boltzmann70-vs-boltzmann115-1000its,834,794,2151.810477083,2122.842324289,40
carcassonne-uct135-vs-uct210-1000its,834,794,2267.467910522,2190.355266124,40
carcassonne-uct250-vs-uct235-1000its,834,794,2186.040706057,2099.44729644,40
carcassonne-uct460-vs-uct25-1000its,834,794,2164.867909009,2158.580022429,40
carcassonne-uct175-vs-uct170-1000its,835,795,2240.393775716,2206.761524456,40
carcassonne-uct370-vs-uct365-1000its,835,795,2199.318554562,2133.485213343,40
carcassonne-uct410-vs-uct250-1000its,835,795,2233.703928654,2157.364910515,40
carcassonne-boltzmann175-vs-boltzmann360-1000its,837,797,2316.172405972,2270.059757468,40
carcassonne-uct180-vs-uct380-1000its,838,798,2212.92414556,2174.717280193,40
carcassonne-ucttuned205-vs-ucttuned235-1000its,840,800,2139.860130268,2114.646393565,40
carcassonne-uct25-vs-uct485-1000its,841,801,2158.491110156,2087.578924853,40
carcassonne-uct340-vs-uct215-1000its,841,801,2186.244368157,2161.991615037,40
carcassonne-ucttuned305-vs-ucttuned205-1000its,842,802,2141.617273106,2110.135721727,40
carcassonne-ucttuned60-vs-ucttuned15-1000its,842,802,2200.177718514,2167.509331839,40
carcassonne-boltzmann285-vs-boltzmann250-1000its,844,804,2244.316154461,2206.391903721,40
carcassonne-ucttuned90-vs-ucttuned15-1000its,844,804,2219.353774803,2152.238435034,40
carcassonne-ucttuned95-vs-ucttuned350-1000its,844,804,2150.241923688,2112.322592212,40
carcassonne-boltzmann215-vs-boltzmann15-1000its,845,805,2167.452200319,2094.860420957,40
carcassonne-ucttuned295-vs-ucttuned265-1000its,845,805,2174.512649325,2173.966584133,40
carcassonne-boltzmann170-vs-boltzmann50-1000its,846,806,2153.536909695,2110.236926063,40
carcassonne-boltzmann200-vs-boltzmann255-1000its,846,806,2201.377860316,2147.391474691,40
carcassonne-boltzmann240-vs-boltzmann180-1000its,847,807,2179.594683626,2127.08054392,40
carcassonne-uct260-vs-uct280-1000its,847,807,2267.161723193,2161.514560177,40
carcassonne-uct295-vs-uct435-1000its,847,807,2142.14516667,2113.39744108,40
carcassonne-uct40-vs-uct440-1000its,847,807,2289.727247302,2187.441749752,40
carcassonne-boltzmann185-vs-boltzmann300-1000its,848,808,2286.746149676,2198.117660937,40
carcassonne-uct20-vs-uct425-1000its,848,808,2229.22043765,2182.159543788,40
carcassonne-boltzmann210-vs-boltzmann90-1000its,849,809,2150.260987768,2106.173733118,40
carcassonne-uct400-vs-uct340-1000its,849,809,2183.876747577,2140.235515221,40
carcassonne-ucttuned465-vs-ucttuned410-1000its,850,810,2198.127178442,2129.407840818,40
carcassonne-boltzmann15-vs-boltzmann335-1000its,852,812,2219.740091589,2162.62179972,40
carcassonne-ucttuned425-vs-ucttuned190-1000its,853,813,2171.271264839,2131.143755275,40
carcassonne-boltzmann130-vs-boltzmann430-1000its,855,815,2245.143849869,2234.220431167,40
carcassonne-boltzmann435-vs-boltzmann130-1000its,856,816,2166.588243157,2135.101538522,40
carcassonne-boltzmann445-vs-boltzmann280-1000its,856,816,2195.377056366,2115.39589679,40
carcassonne-boltzmann480-vs-boltzmann70-1000its,856,816,2113.706186195,2089.259760459,40
carcassonne-uct195-vs-uct95-1000its,857,817,2184.586092745,2137.124099009,40
carcassonne-uct45-vs-uct195-1000its,857,817,2236.184564157,2131.379163162,40
carcassonne-ucttuned90-vs-ucttuned80-1000its,859,819,2224.806265321,2221.282293734,40
carcassonne-uct375-vs-uct180-1000its,860,820,2260.557588844,2195.134884114,40
carcassonne-uct235-vs-uct260-1000its,861,821,2188.733084459,2159.779455354,40
carcassonne-uct320-vs-uct265-1000its,861,821,2238.765480358,2248.168052999,40
carcassonne-ucttuned85-vs-ucttuned70-1000its,861,821,2200.107425819,2143.398662958,40
carcassonne-uct110-vs-uct175-1000its,865,825,2183.100925041,2157.721648912,40
carcassonne-uct55-vs-uct360-1000its,866,826,2221.115573619,2190.878189536,40
carcassonne-boltzmann415-vs-boltzmann405-1000its,868,828,2224.989945939,2180.85014173,40
carcassonne-boltzmann10-vs-boltzmann90-1000its,869,829,2201.419536202,2173.429292429,40
carcassonne-ucttuned455-vs-ucttuned75-1000its,869,829,2272.89740237,2248.337685958,40
carcassonne-boltzmann50-vs-boltzmann45-1000its,875,835,2200.131220791,2187.239668282,40
carcassonne-uct315-vs-uct425-1000its,876,836,2257.511746647,2192.374413305,40
carcassonne-ucttuned55-vs-ucttuned220-1000its,876,836,2220.097793151,2175.971535576,40
carcassonne-uct10-vs-uct275-1000its,877,837,2252.015184889,2209.599705975,40
carcassonne-ucttuned40-vs-ucttuned20-1000its,877,837,2149.083837331,2078.207377302,40
carcassonne-boltzmann490-vs-boltzmann140-1000its,878,838,2235.376335285,2216.055047349,40
carcassonne-uct75-vs-uct70-1000its,879,839,2164.051337691,2127.027358539,40
carcassonne-boltzmann55-vs-boltzmann140-1000its,881,841,2203.910744262,2168.434435419,40
carcassonne-ucttuned315-vs-ucttuned285-1000its,883,843,2245.268529307,2202.237985225,40
carcassonne-ucttuned35-vs-ucttuned45-1000its,885,845,2178.835624607,2124.495303495,40
carcassonne-boltzmann195-vs-boltzmann80-1000its,892,852,2214.606095789,2167.955643616,40
carcassonne-ucttuned205-vs-ucttuned140-1000its,892,852,2168.032697346,2111.98321119,40
carcassonne-boltzmann465-vs-boltzmann245-1000its,893,853,2164.073636528,2128.401384393,40
carcassonne-boltzmann95-vs-boltzmann215-1000its,901,861,2134.144892284,2083.601522602,40
carcassonne-uct50-vs-uct10-1000its,901,861,2147.421145609,2131.792408381,40
carcassonne-ucttuned470-vs-ucttuned335-1000its,901,861,2277.114934029,2278.304000735,40
carcassonne-ucttuned445-vs-ucttuned245-1000its,904,864,2227.349157841,2172.766539424,40
carcassonne-uct390-vs-uct345-1000its,908,868,2266.344479332,2185.479133428,40
carcassonne-ucttuned490-vs-ucttuned440-1000its,910,870,2242.237923993,2167.754174889,40
carcassonne-ucttuned90-vs-ucttuned130-1000its,915,875,2203.414724457,2169.542161845,40
carcassonne-boltzmann330-vs-boltzmann485-1000its,917,877,2279.139343853,2176.480179638,40
carcassonne-ucttuned10-vs-ucttuned375-1000its,938,898,2176.614685998,2092.304707012,40
carcassonne-ucttuned90-vs-ucttuned120-1000its,942,902,2255.847678656,2182.174418862,40
carcassonne-ucttuned385-vs-ucttuned375-1000its,588,547,1715.797107281,1682.35235093,41
carcassonne-boltzmann80-vs-boltzmann10-1000its,717,676,2208.246460364,2200.352955039,41
carcassonne-boltzmann30-vs-boltzmann455-1000its,736,695,2173.851452707,2099.397359857,41
carcassonne-boltzmann255-vs-boltzmann475-1000its,738,697,2230.318410401,2140.797119331,41
carcassonne-boltzmann430-vs-boltzmann370-1000its,747,706,2158.927519653,2127.439297597,41
carcassonne-uct300-vs-uct310-1000its,747,706,2221.227847404,2155.575966359,41
carcassonne-boltzmann210-vs-boltzmann240-1000its,750,709,2143.870904768,2150.914742441,41
carcassonne-boltzmann370-vs-boltzmann155-1000its,759,718,2166.238571826,2123.871129094,41
carcassonne-boltzmann55-vs-boltzmann205-1000its,766,725,2213.935403522,2177.860893251,41
carcassonne-boltzmann240-vs-boltzmann325-1000its,767,726,2128.263528653,2095.521643743,41
carcassonne-ucttuned385-vs-ucttuned85-1000its,770,729,2215.971423756,2143.510074688,41
carcassonne-uct60-vs-uct265-1000its,772,731,2154.039605406,2129.533989404,41
carcassonne-ucttuned260-vs-ucttuned335-1000its,773,732,2212.162003939,2163.667286688,41
carcassonne-uct310-vs-uct60-1000its,776,735,2234.934812692,2181.696190882,41
carcassonne-uct375-vs-uct380-1000its,776,735,2320.123928729,2205.48514382,41
carcassonne-ucttuned215-vs-ucttuned65-1000its,777,736,2197.129006185,2165.840776566,41
carcassonne-boltzmann355-vs-boltzmann275-1000its,778,737,2200.85488356,2135.312947756,41
carcassonne-ucttuned245-vs-ucttuned485-1000its,779,738,2115.658055696,2074.279858154,41
carcassonne-boltzmann220-vs-boltzmann425-1000its,780,739,2194.928250368,2112.86894012,41
carcassonne-boltzmann270-vs-boltzmann450-1000its,780,739,2178.87875246,2091.9486574,41
carcassonne-boltzmann400-vs-boltzmann465-1000its,780,739,2230.727878443,2165.645480322,41
carcassonne-uct240-vs-uct135-1000its,780,739,2167.154593233,2137.876420275,41
carcassonne-ucttuned175-vs-ucttuned335-1000its,781,740,2225.546803263,2188.337949196,41
carcassonne-boltzmann360-vs-boltzmann20-1000its,782,741,2131.354354702,2098.007854506,41
carcassonne-boltzmann100-vs-boltzmann390-1000its,784,743,2178.343269637,2118.410915841,41
carcassonne-boltzmann255-vs-boltzmann20-1000its,784,743,2247.246618537,2156.255740534,41
carcassonne-uct285-vs-uct120-1000its,788,747,2209.693023397,2137.71872318,41
carcassonne-ucttuned390-vs-ucttuned60-1000its,788,747,2279.920757531,2208.448529281,41
carcassonne-boltzmann390-vs-boltzmann270-1000its,790,749,2254.729438661,2205.227393604,41
carcassonne-boltzmann235-vs-boltzmann105-1000its,792,751,2368.946812888,2324.415670515,41
carcassonne-uct485-vs-uct250-1000its,792,751,2200.283552937,2155.254933442,41
carcassonne-ucttuned450-vs-ucttuned230-1000its,793,752,2235.560128055,2212.249537188,41
carcassonne-boltzmann150-vs-boltzmann475-1000its,795,754,2200.585526226,2136.363800596,41
carcassonne-boltzmann335-vs-boltzmann140-1000its,795,754,2177.125566186,2100.572157646,41
carcassonne-boltzmann435-vs-boltzmann190-1000its,795,754,2210.44960025,2184.487615793,41
carcassonne-boltzmann400-vs-boltzmann435-1000its,796,755,2234.893770789,2159.649201739,41
carcassonne-uct225-vs-uct125-1000its,796,755,2116.070516034,2074.027029021,41
carcassonne-ucttuned315-vs-ucttuned460-1000its,800,759,2246.133658939,2219.765340436,41
carcassonne-boltzmann80-vs-boltzmann145-1000its,802,761,2198.767150891,2168.046798114,41
carcassonne-ucttuned420-vs-ucttuned110-1000its,805,764,2242.556294467,2168.131450908,41
carcassonne-ucttuned205-vs-ucttuned80-1000its,806,765,2253.932127933,2232.197753487,41
carcassonne-ucttuned445-vs-ucttuned300-1000its,806,765,2235.408722031,2202.10613377,41
carcassonne-ucttuned475-vs-ucttuned480-1000its,808,767,2278.368092055,2277.01803693,41
carcassonne-uct285-vs-uct345-1000its,809,768,2221.114240605,2179.601079555,41
carcassonne-uct90-vs-uct230-1000its,809,768,2209.540341048,2156.444382396,41
carcassonne-ucttuned450-vs-ucttuned400-1000its,809,768,2162.671769188,2133.842426034,41
carcassonne-boltzmann460-vs-boltzmann90-1000its,812,771,2169.139506359,2104.11405966,41
carcassonne-boltzmann345-vs-boltzmann125-1000its,813,772,2252.694455544,2195.263242951,41
carcassonne-uct220-vs-uct440-1000its,813,772,2198.948600373,2164.582985942,41
carcassonne-uct200-vs-uct415-1000its,814,773,2128.980816481,2090.196591326,41
carcassonne-ucttuned430-vs-ucttuned300-1000its,814,773,2145.328588741,2112.526303661,41
carcassonne-boltzmann350-vs-boltzmann285-1000its,816,775,2238.813150503,2170.619989151,41
carcassonne-ucttuned375-vs-ucttuned200-1000its,816,775,2197.566446782,2156.819154776,41
carcassonne-boltzmann90-vs-boltzmann65-1000its,817,776,2270.842257885,2210.779649851,41
carcassonne-ucttuned480-vs-ucttuned260-1000its,817,776,2195.194731635,2143.407800012,41
carcassonne-uct100-vs-uct110-1000its,819,778,2171.968113421,2105.844244865,41
carcassonne-uct105-vs-uct470-1000its,819,778,2227.531326052,2187.419130779,41
carcassonne-uct25-vs-uct160-1000its,819,778,2172.45173711,2138.114414264,41
carcassonne-ucttuned245-vs-ucttuned230-1000its,819,778,2171.724149958,2119.360832599,41
carcassonne-boltzmann75-vs-boltzmann425-1000its,821,780,2256.073311539,2212.943254384,41
carcassonne-uct450-vs-uct270-1000its,821,780,2179.373586667,2137.941324164,41
carcassonne-ucttuned55-vs-ucttuned445-1000its,822,781,2166.214264467,2090.858103034,41
carcassonne-boltzmann470-vs-boltzmann450-1000its,823,782,2186.89057517,2166.578535369,41
carcassonne-boltzmann255-vs-boltzmann340-1000its,824,783,2198.220869115,2214.104996821,41
carcassonne-uct300-vs-uct485-1000its,824,783,2146.230724266,2071.965779617,41
carcassonne-boltzmann295-vs-boltzmann355-1000its,825,784,2190.951333758,2174.99246936,41
carcassonne-uct80-vs-uct475-1000its,826,785,2186.797856327,2150.390714579,41
carcassonne-uct315-vs-uct130-1000its,828,787,2230.204825104,2211.094653179,41
carcassonne-boltzmann395-vs-boltzmann140-1000its,831,790,2175.22913692,2116.772757064,41
carcassonne-ucttuned170-vs-ucttuned205-1000its,831,790,2210.881438849,2157.618114508,41
carcassonne-boltzmann415-vs-boltzmann475-1000its,832,791,2212.028086762,2200.756613628,41
carcassonne-uct410-vs-uct300-1000its,833,792,2151.839080285,2091.578087064,41
carcassonne-ucttuned130-vs-ucttuned420-1000its,833,792,2235.517346485,2191.701760096,41
carcassonne-boltzmann120-vs-boltzmann15-1000its,834,793,2172.439573942,2183.234194766,41
carcassonne-ucttuned480-vs-ucttuned460-1000its,834,793,2206.661555781,2143.528362321,41
carcassonne-boltzmann30-vs-boltzmann230-1000its,835,794,2343.028922318,2306.308970545,41
carcassonne-boltzmann175-vs-boltzmann445-1000its,836,795,2182.403400381,2130.135808887,41
carcassonne-boltzmann45-vs-boltzmann75-1000its,836,795,2162.055316394,2108.743533488,41
carcassonne-uct115-vs-uct450-1000its,836,795,2178.275813013,2117.649498695,41
carcassonne-ucttuned75-vs-ucttuned135-1000its,836,795,2183.429009506,2143.033731349,41
carcassonne-boltzmann490-vs-boltzmann300-1000its,837,796,2252.614725557,2220.053718213,41
carcassonne-ucttuned115-vs-ucttuned90-1000its,837,796,2203.346836709,2179.889041729,41
carcassonne-ucttuned105-vs-ucttuned325-1000its,838,797,2195.801884539,2105.98769825,41
carcassonne-boltzmann10-vs-boltzmann385-1000its,839,798,2222.642485076,2194.517012544,41
carcassonne-ucttuned15-vs-ucttuned475-1000its,839,798,2157.114897047,2057.776168745,41
carcassonne-uct290-vs-uct460-1000its,841,800,2106.358751716,2069.987288199,41
carcassonne-ucttuned25-vs-ucttuned205-1000its,842,801,2186.477859736,2149.833840883,41
carcassonne-boltzmann190-vs-boltzmann365-1000its,843,802,2184.493318778,2173.557330483,41
carcassonne-uct315-vs-uct105-1000its,843,802,2179.615825175,2107.475932898,41
carcassonne-uct325-vs-uct300-1000its,843,802,2216.380785241,2166.185565071,41
carcassonne-uct400-vs-uct445-1000its,843,802,2225.27728123,2211.976953284,41
carcassonne-ucttuned155-vs-ucttuned10-1000its,843,802,2223.778170397,2195.609584903,41
carcassonne-ucttuned460-vs-ucttuned200-1000its,843,802,2168.216518286,2113.419148938,41
carcassonne-boltzmann205-vs-boltzmann125-1000its,845,804,2228.174523576,2142.599516025,41
carcassonne-boltzmann85-vs-boltzmann210-1000its,845,804,2236.745718877,2223.151295861,41
carcassonne-boltzmann485-vs-boltzmann135-1000its,847,806,2180.737731904,2164.264779526,41
carcassonne-boltzmann390-vs-boltzmann480-1000its,849,808,2272.298842311,2231.250686269,41
carcassonne-boltzmann435-vs-boltzmann55-1000its,849,808,2158.718209004,2100.097806555,41
carcassonne-uct140-vs-uct455-1000its,849,808,2272.568200137,2162.808267953,41
carcassonne-uct30-vs-uct20-1000its,849,808,2183.726809298,2157.780087714,41
carcassonne-uct385-vs-uct25-1000its,849,808,2264.710365046,2204.836836909,41
carcassonne-ucttuned120-vs-ucttuned25-1000its,850,809,2165.131577145,2123.423062655,41
carcassonne-ucttuned295-vs-ucttuned95-1000its,850,809,2175.372715527,2168.606990892,41
carcassonne-uct10-vs-uct300-1000its,851,810,2157.78180701,2140.10823271,41
carcassonne-uct460-vs-uct320-1000its,851,810,2089.194438863,2084.560223459,41
carcassonne-boltzmann90-vs-boltzmann220-1000its,852,811,2129.937579393,2067.983280564,41
carcassonne-boltzmann480-vs-boltzmann250-1000its,853,812,2198.642213058,2182.948213211,41
carcassonne-ucttuned490-vs-ucttuned495-1000its,853,812,2182.049204924,2125.890478414,41
carcassonne-boltzmann240-vs-boltzmann360-1000its,854,813,2216.946265522,2179.966848994,41
carcassonne-boltzmann475-vs-boltzmann150-1000its,854,813,2190.119444056,2145.55201139,41
carcassonne-ucttuned360-vs-ucttuned350-1000its,854,813,2263.02156317,2212.7703535,41
carcassonne-boltzmann395-vs-boltzmann405-1000its,855,814,2191.975977389,2175.969725847,41
carcassonne-uct140-vs-uct445-1000its,855,814,2228.984005152,2174.621941056,41
carcassonne-uct460-vs-uct325-1000its,855,814,2115.204730302,2135.819781541,41
carcassonne-ucttuned430-vs-ucttuned165-1000its,856,815,2202.679775438,2142.769650557,41
carcassonne-uct35-vs-uct370-1000its,857,816,2173.83741878,2142.58013212,41
carcassonne-ucttuned200-vs-ucttuned345-1000its,857,816,2279.342884823,2236.629229048,41
carcassonne-ucttuned320-vs-ucttuned145-1000its,857,816,2130.75400728,2077.069221043,41
carcassonne-ucttuned380-vs-ucttuned115-1000its,858,817,2228.10108616,2181.125920725,41
carcassonne-boltzmann425-vs-boltzmann30-1000its,859,818,2205.96776689,2142.707096034,41
carcassonne-boltzmann125-vs-boltzmann380-1000its,860,819,2177.12758171,2150.784024416,41
carcassonne-uct330-vs-uct380-1000its,860,819,2206.898219576,2158.690657633,41
carcassonne-uct370-vs-uct130-1000its,860,819,2305.676629143,2251.389725055,41
carcassonne-ucttuned330-vs-ucttuned280-1000its,860,819,2159.358483087,2124.47674047,41
carcassonne-ucttuned345-vs-ucttuned480-1000its,860,819,2186.295186788,2153.55136693,41
carcassonne-uct490-vs-uct235-1000its,861,820,2263.669393125,2208.6268313,41
carcassonne-ucttuned110-vs-ucttuned130-1000its,861,820,2264.985359805,2219.318715768,41
carcassonne-ucttuned325-vs-ucttuned445-1000its,861,820,2162.284913822,2102.900506184,41
carcassonne-ucttuned380-vs-ucttuned335-1000its,861,820,2190.198842246,2122.073614345,41
carcassonne-ucttuned50-vs-ucttuned215-1000its,861,820,2170.234242054,2128.696845237,41
carcassonne-boltzmann225-vs-boltzmann460-1000its,862,821,2189.080690816,2103.097226209,41
carcassonne-uct215-vs-uct95-1000its,862,821,2187.666479371,2123.072306601,41
carcassonne-uct150-vs-uct195-1000its,863,822,2149.971893955,2131.381961174,41
carcassonne-uct200-vs-uct160-1000its,863,822,2149.005493427,2118.658862059,41
carcassonne-ucttuned80-vs-ucttuned230-1000its,863,822,2254.255826345,2171.20502328,41
carcassonne-boltzmann90-vs-boltzmann400-1000its,864,823,2191.178836631,2160.637485435,41
carcassonne-uct215-vs-uct75-1000its,864,823,2234.948493959,2189.262603335,41
carcassonne-boltzmann25-vs-boltzmann355-1000its,865,824,2161.891892583,2106.095085034,41
carcassonne-boltzmann35-vs-boltzmann50-1000its,865,824,2216.75282412,2166.86842457,41
carcassonne-uct75-vs-uct130-1000its,865,824,2210.504428387,2201.233850796,41
carcassonne-ucttuned415-vs-ucttuned230-1000its,865,824,2195.353314971,2194.422572541,41
carcassonne-ucttuned115-vs-ucttuned230-1000its,866,825,2169.635910062,2185.692191722,41
carcassonne-uct70-vs-uct150-1000its,868,827,2151.177922127,2093.054633427,41
carcassonne-ucttuned330-vs-ucttuned485-1000its,868,827,2235.13751198,2180.608174902,41
carcassonne-boltzmann395-vs-boltzmann35-1000its,869,828,2202.654101397,2185.24574556,41
carcassonne-boltzmann275-vs-boltzmann205-1000its,875,834,2215.110170401,2214.31335637,41
carcassonne-ucttuned280-vs-ucttuned385-1000its,875,834,2200.083447665,2141.510904876,41
carcassonne-boltzmann185-vs-boltzmann350-1000its,879,838,2197.914490018,2153.283782826,41
carcassonne-ucttuned35-vs-ucttuned430-1000its,880,839,2238.133464551,2215.088605059,41
carcassonne-boltzmann140-vs-boltzmann425-1000its,881,840,2154.280851625,2131.134443577,41
carcassonne-ucttuned365-vs-ucttuned245-1000its,881,840,2253.667451158,2169.450969422,41
carcassonne-uct325-vs-uct295-1000its,882,841,2148.752679849,2084.213711941,41
carcassonne-ucttuned430-vs-ucttuned410-1000its,883,842,2249.424880915,2211.462443164,41
carcassonne-uct235-vs-uct325-1000its,884,843,2226.981596371,2155.72824584,41
carcassonne-ucttuned15-vs-ucttuned25-1000its,886,845,2278.723105368,2212.95606332,41
carcassonne-boltzmann235-vs-boltzmann35-1000its,887,846,2155.375236884,2100.361359434,41
carcassonne-ucttuned40-vs-ucttuned360-1000its,890,849,2225.57442826,2162.798181852,41
carcassonne-uct440-vs-uct240-1000its,893,852,2243.085958463,2186.506987556,41
carcassonne-ucttuned375-vs-ucttuned475-1000its,893,852,2196.324093549,2153.380850939,41
carcassonne-ucttuned340-vs-ucttuned290-1000its,894,853,2217.230007634,2168.16931777,41
carcassonne-ucttuned400-vs-ucttuned80-1000its,895,854,2206.140130686,2165.752168353,41
carcassonne-boltzmann245-vs-boltzmann320-1000its,896,855,2192.602595726,2132.79347893,41
carcassonne-boltzmann345-vs-boltzmann375-1000its,897,856,2149.960033402,2097.113644931,41
carcassonne-ucttuned475-vs-ucttuned15-1000its,904,863,2217.387601267,2134.581719264,41
carcassonne-boltzmann235-vs-boltzmann130-1000its,911,870,2220.185407337,2184.161833849,41
carcassonne-ucttuned25-vs-ucttuned75-1000its,919,878,2167.828552052,2127.955178164,41
carcassonne-boltzmann370-vs-boltzmann60-1000its,925,884,2201.413404,2129.258423397,41
carcassonne-ucttuned490-vs-ucttuned355-1000its,931,890,2292.564170696,2255.899670145,41
carcassonne-ucttuned165-vs-ucttuned455-1000its,965,924,2235.599081568,2163.138837901,41
carcassonne-uct465-vs-uct95-1000its,985,944,2246.040856756,2176.918726292,41
carcassonne-ucttuned55-vs-ucttuned115-1000its,728,686,2120.852991736,2084.834578698,42
carcassonne-ucttuned145-vs-ucttuned325-1000its,735,693,2180.77900064,2134.2128022,42
carcassonne-boltzmann265-vs-boltzmann195-1000its,754,712,2205.718325848,2165.032635121,42
carcassonne-boltzmann475-vs-boltzmann275-1000its,759,717,2216.661870927,2175.334687714,42
carcassonne-boltzmann355-vs-boltzmann405-1000its,767,725,2228.944753466,2149.376000858,42
carcassonne-boltzmann135-vs-boltzmann140-1000its,768,726,2184.702813116,2164.481431866,42
carcassonne-boltzmann30-vs-boltzmann495-1000its,769,727,2229.680328523,2179.948747255,42
carcassonne-boltzmann305-vs-boltzmann290-1000its,769,727,2245.183680054,2149.251885291,42
carcassonne-uct230-vs-uct250-1000its,769,727,2238.790350822,2206.71747717,42
carcassonne-boltzmann20-vs-boltzmann250-1000its,773,731,2230.027043505,2158.910842713,42
carcassonne-uct400-vs-uct110-1000its,774,732,2188.695687659,2163.677447952,42
carcassonne-ucttuned115-vs-ucttuned105-1000its,776,734,2149.693530461,2128.643972475,42
carcassonne-uct100-vs-uct70-1000its,777,735,2191.930572987,2153.330927116,42
carcassonne-uct425-vs-uct315-1000its,777,735,2154.983757336,2118.612806068,42
carcassonne-boltzmann145-vs-boltzmann395-1000its,779,737,2167.989842237,2126.854786775,42
carcassonne-boltzmann370-vs-boltzmann420-1000its,780,738,2202.986474643,2201.275807149,42
carcassonne-ucttuned155-vs-ucttuned285-1000its,780,738,2186.34837104,2122.852563229,42
carcassonne-ucttuned495-vs-ucttuned110-1000its,784,742,2153.08769948,2095.178066736,42
carcassonne-uct375-vs-uct185-1000its,785,743,2127.846533265,2108.227910896,42
carcassonne-uct215-vs-uct90-1000its,786,744,2339.870955623,2261.419964966,42
carcassonne-boltzmann430-vs-boltzmann400-1000its,787,745,2159.105556439,2145.203542508,42
carcassonne-ucttuned220-vs-ucttuned60-1000its,787,745,2194.28518896,2135.103248249,42
carcassonne-ucttuned200-vs-ucttuned320-1000its,788,746,2239.45957461,2219.229573786,42
carcassonne-ucttuned205-vs-ucttuned300-1000its,788,746,2238.440111547,2160.831737698,42
carcassonne-boltzmann25-vs-boltzmann45-1000its,793,751,2223.179673852,2124.882672725,42
carcassonne-boltzmann55-vs-boltzmann240-1000its,793,751,2216.432810356,2135.340694423,42
carcassonne-uct465-vs-uct390-1000its,795,753,2184.795261066,2139.915355575,42
carcassonne-boltzmann265-vs-boltzmann470-1000its,796,754,2148.644032017,2121.287416968,42
carcassonne-boltzmann215-vs-boltzmann105-1000its,800,758,2288.378973993,2215.991140646,42
carcassonne-uct90-vs-uct45-1000its,800,758,2191.112827154,2141.434025876,42
carcassonne-ucttuned255-vs-ucttuned130-1000its,800,758,2124.230720157,2117.840880563,42
carcassonne-uct25-vs-uct155-1000its,801,759,2227.48294997,2210.817199134,42
carcassonne-boltzmann70-vs-boltzmann50-1000its,802,760,2240.260756333,2262.450032386,42
carcassonne-boltzmann110-vs-boltzmann135-1000its,803,761,2193.238340769,2184.484619287,42
carcassonne-boltzmann495-vs-boltzmann305-1000its,804,762,2234.776462204,2212.006593877,42
carcassonne-uct255-vs-uct430-1000its,804,762,2235.156952508,2211.516854138,42
carcassonne-boltzmann70-vs-boltzmann480-1000its,805,763,2125.924449974,2109.02364753,42
carcassonne-uct250-vs-uct160-1000its,805,763,2159.983194412,2094.143964864,42
carcassonne-uct435-vs-uct290-1000its,807,765,2236.769965004,2162.310516954,42
carcassonne-ucttuned325-vs-ucttuned125-1000its,807,765,2206.661755735,2186.240825627,42
carcassonne-boltzmann130-vs-boltzmann350-1000its,808,766,2177.776379496,2136.57822277,42
carcassonne-ucttuned225-vs-ucttuned335-1000its,808,766,2235.906426197,2155.423938955,42
carcassonne-ucttuned75-vs-ucttuned230-1000its,809,767,2215.43575335,2176.061964559,42
carcassonne-ucttuned490-vs-ucttuned460-1000its,812,770,2136.08506196,2121.615456919,42
carcassonne-uct80-vs-uct275-1000its,813,771,2224.945406417,2197.882436776,42
carcassonne-ucttuned150-vs-ucttuned215-1000its,814,772,2234.40543523,2199.147494213,42
carcassonne-ucttuned195-vs-ucttuned340-1000its,815,773,2186.21550469,2151.154981186,42
carcassonne-ucttuned450-vs-ucttuned390-1000its,815,773,2163.245725858,2132.086964064,42
carcassonne-uct485-vs-uct355-1000its,818,776,2248.056925987,2197.109969026,42
carcassonne-ucttuned260-vs-ucttuned80-1000its,818,776,2252.721889815,2228.986841831,42
carcassonne-uct370-vs-uct100-1000its,819,777,2260.869973585,2199.208875226,42
carcassonne-ucttuned370-vs-ucttuned280-1000its,820,778,2193.153366859,2134.827558597,42
carcassonne-ucttuned20-vs-ucttuned75-1000its,822,780,2233.65810574,2170.028263322,42
carcassonne-boltzmann255-vs-boltzmann315-1000its,823,781,2257.502623233,2193.567300092,42
carcassonne-ucttuned170-vs-ucttuned465-1000its,823,781,2146.858939229,2138.516539557,42
carcassonne-boltzmann385-vs-boltzmann50-1000its,824,782,2224.674224381,2147.477168254,42
carcassonne-ucttuned285-vs-ucttuned180-1000its,825,783,2187.271372655,2140.087568028,42
carcassonne-ucttuned385-vs-ucttuned135-1000its,825,783,2227.603257512,2187.440624804,42
carcassonne-boltzmann320-vs-boltzmann145-1000its,826,784,2153.722354225,2110.592605841,42
carcassonne-ucttuned235-vs-ucttuned135-1000its,826,784,2228.482229788,2213.296212732,42
carcassonne-ucttuned480-vs-ucttuned155-1000its,828,786,2227.579738247,2151.393440397,42
carcassonne-uct440-vs-uct435-1000its,829,787,2213.94878873,2163.375063635,42
carcassonne-boltzmann10-vs-boltzmann235-1000its,830,788,2330.722061095,2241.972680375,42
carcassonne-boltzmann40-vs-boltzmann185-1000its,831,789,2204.117127578,2099.432787685,42
carcassonne-uct185-vs-uct355-1000its,831,789,2112.687367074,2092.161758431,42
carcassonne-uct300-vs-uct55-1000its,831,789,2189.01003,2183.616145479,42
carcassonne-uct455-vs-uct175-1000its,831,789,2250.853815616,2152.013725027,42
carcassonne-boltzmann245-vs-boltzmann395-1000its,833,791,2187.982700603,2123.903574032,42
carcassonne-boltzmann85-vs-boltzmann345-1000its,835,793,2239.377526108,2182.529426333,42
carcassonne-uct20-vs-uct345-1000its,835,793,2223.478201714,2184.361933932,42
carcassonne-uct20-vs-uct85-1000its,835,793,2157.536924646,2161.952712148,42
carcassonne-ucttuned165-vs-ucttuned460-1000its,835,793,2198.156342141,2147.957849768,42
carcassonne-ucttuned480-vs-ucttuned110-1000its,835,793,2183.081701848,2164.262054259,42
carcassonne-uct370-vs-uct195-1000its,836,794,2226.781883879,2160.475235833,42
carcassonne-ucttuned430-vs-ucttuned190-1000its,836,794,2225.533114078,2133.152133112,42
carcassonne-boltzmann80-vs-boltzmann445-1000its,837,795,2270.693006341,2232.086541076,42
carcassonne-ucttuned185-vs-ucttuned375-1000its,837,795,2154.957916892,2096.840225945,42
carcassonne-boltzmann335-vs-boltzmann240-1000its,838,796,2175.776202657,2139.599525152,42
carcassonne-uct250-vs-uct385-1000its,839,797,2253.04234823,2161.28134783,42
carcassonne-ucttuned460-vs-ucttuned420-1000its,839,797,2258.775700562,2190.393265684,42
carcassonne-boltzmann440-vs-boltzmann445-1000its,840,798,2221.884054542,2163.28827604,42
carcassonne-ucttuned280-vs-ucttuned95-1000its,840,798,2268.986267627,2208.036586055,42
carcassonne-boltzmann175-vs-boltzmann270-1000its,841,799,2228.006520862,2172.798407391,42
carcassonne-boltzmann450-vs-boltzmann195-1000its,842,800,2163.506233964,2125.662127275,42
carcassonne-ucttuned120-vs-ucttuned460-1000its,842,800,2211.431887147,2188.572289895,42
carcassonne-ucttuned270-vs-ucttuned320-1000its,842,800,2212.542058778,2141.835083999,42
carcassonne-uct145-vs-uct165-1000its,843,801,2284.967558972,2246.144546028,42
carcassonne-uct390-vs-uct320-1000its,843,801,2174.53464711,2189.584758227,42
carcassonne-ucttuned40-vs-ucttuned90-1000its,844,802,2210.245626457,2124.711587677,42
carcassonne-uct180-vs-uct135-1000its,846,804,2242.704864673,2255.907276455,42
carcassonne-uct465-vs-uct380-1000its,846,804,2239.101441787,2201.192196216,42
carcassonne-boltzmann415-vs-boltzmann370-1000its,847,805,2155.775877527,2091.644251059,42
carcassonne-boltzmann225-vs-boltzmann385-1000its,848,806,2139.37565583,2131.514555936,42
carcassonne-boltzmann485-vs-boltzmann495-1000its,848,806,2163.13889718,2127.062185149,42
carcassonne-ucttuned90-vs-ucttuned245-1000its,848,806,2172.376569086,2141.629554644,42
carcassonne-ucttuned60-vs-ucttuned320-1000its,850,808,2197.436128608,2145.645351796,42
carcassonne-boltzmann310-vs-boltzmann180-1000its,852,810,2184.749613726,2156.119659106,42
carcassonne-boltzmann375-vs-boltzmann245-1000its,854,812,2178.776807727,2156.488697942,42
carcassonne-ucttuned160-vs-ucttuned85-1000its,854,812,2150.488793001,2109.587652172,42
carcassonne-ucttuned415-vs-ucttuned190-1000its,858,816,2202.505601375,2140.788950205,42
carcassonne-uct270-vs-uct45-1000its,860,818,2184.686918556,2137.274571759,42
carcassonne-boltzmann20-vs-boltzmann40-1000its,861,819,2155.631380436,2133.343466575,42
carcassonne-ucttuned20-vs-ucttuned335-1000its,861,819,2207.608708785,2138.067254192,42
carcassonne-uct185-vs-uct5-1000its,865,823,2229.663541255,2221.478089279,42
carcassonne-uct170-vs-uct485-1000its,866,824,2200.68235212,2162.974645877,42
carcassonne-ucttuned405-vs-ucttuned355-1000its,867,825,2254.630218521,2223.171883549,42
carcassonne-ucttuned320-vs-ucttuned165-1000its,868,826,2169.580331806,2116.356598818,42
carcassonne-uct115-vs-uct385-1000its,871,829,2185.871908138,2166.010740077,42
carcassonne-uct260-vs-uct5-1000its,871,829,2143.564171457,2143.168206128,42
carcassonne-uct385-vs-uct240-1000its,871,829,2235.396910616,2160.446295585,42
carcassonne-ucttuned440-vs-ucttuned135-1000its,871,829,2211.929338437,2154.497362424,42
carcassonne-uct410-vs-uct110-1000its,872,830,2170.214845222,2086.505731683,42
carcassonne-ucttuned265-vs-ucttuned110-1000its,872,830,2220.563854492,2137.386100211,42
carcassonne-uct405-vs-uct415-1000its,874,832,2249.269827117,2201.365573106,42
carcassonne-ucttuned265-vs-ucttuned15-1000its,876,834,2179.34784574,2217.128505105,42
carcassonne-uct335-vs-uct155-1000its,879,837,2247.897415427,2217.381650177,42
carcassonne-ucttuned230-vs-ucttuned280-1000its,879,837,2112.428691526,2093.996406584,42
carcassonne-ucttuned395-vs-ucttuned330-1000its,879,837,2174.973996983,2118.228605603,42
carcassonne-boltzmann205-vs-boltzmann430-1000its,880,838,2192.436354756,2143.732692449,42
carcassonne-boltzmann130-vs-boltzmann480-1000its,881,839,2137.072742807,2072.592381615,42
carcassonne-boltzmann115-vs-boltzmann65-1000its,882,840,2220.218620859,2171.664773938,42
carcassonne-boltzmann15-vs-boltzmann195-1000its,882,840,2153.796085781,2131.65399222,42
carcassonne-boltzmann15-vs-boltzmann365-1000its,884,842,2370.266553205,2287.384817049,42
carcassonne-uct305-vs-uct120-1000its,886,844,2212.467211992,2191.713438286,42
carcassonne-uct25-vs-uct305-1000its,888,846,2211.556102161,2127.41496318,42
carcassonne-ucttuned20-vs-ucttuned170-1000its,888,846,2198.810690215,2157.518734734,42
carcassonne-boltzmann35-vs-boltzmann45-1000its,893,851,2242.07237105,2236.242653455,42
carcassonne-uct425-vs-uct475-1000its,893,851,2228.65620999,2177.518594829,42
carcassonne-uct120-vs-uct115-1000its,895,853,2173.245276618,2139.697633026,42
carcassonne-boltzmann175-vs-boltzmann275-1000its,899,857,2205.488239781,2153.761256846,42
carcassonne-boltzmann245-vs-boltzmann390-1000its,902,860,2258.193745373,2144.272844697,42
carcassonne-ucttuned195-vs-ucttuned265-1000its,902,860,2197.070229331,2128.659413706,42
carcassonne-uct270-vs-uct140-1000its,909,867,2264.720561849,2254.637155241,42
carcassonne-ucttuned375-vs-ucttuned140-1000its,909,867,2250.410768054,2193.297918892,42
carcassonne-uct95-vs-uct345-1000its,914,872,2177.803123115,2129.272913479,42
carcassonne-uct415-vs-uct95-1000its,915,873,2281.048253196,2202.939180569,42
carcassonne-ucttuned220-vs-ucttuned275-1000its,921,879,2209.650906643,2192.569598794,42
carcassonne-uct285-vs-uct145-1000its,922,880,2150.247213854,2118.037234604,42
carcassonne-uct325-vs-uct475-1000its,925,883,2163.454292731,2164.435152463,42
carcassonne-uct125-vs-uct440-1000its,932,890,2191.472879803,2119.872775506,42
carcassonne-uct465-vs-uct300-1000its,982,940,2191.706080381,2125.533242037,42
carcassonne-boltzmann185-vs-boltzmann420-1000its,748,705,2199.685979103,2140.156399833,43
carcassonne-boltzmann210-vs-boltzmann45-1000its,754,711,2201.002646928,2155.750412277,43
carcassonne-boltzmann250-vs-boltzmann195-1000its,754,711,2137.571303431,2137.864886611,43
carcassonne-boltzmann365-vs-boltzmann395-1000its,754,711,2267.27948998,2241.001815188,43
carcassonne-ucttuned245-vs-ucttuned80-1000its,757,714,2169.572232458,2148.933272621,43
carcassonne-ucttuned95-vs-ucttuned125-1000its,760,717,2248.282962684,2200.760706638,43
carcassonne-boltzmann430-vs-boltzmann55-1000its,763,720,2213.40657142,2128.381610475,43
carcassonne-uct140-vs-uct400-1000its,764,721,2222.652333187,2162.347337324,43
carcassonne-boltzmann415-vs-boltzmann480-1000its,766,723,2232.914917252,2178.767685025,43
carcassonne-ucttuned380-vs-ucttuned85-1000its,767,724,2173.562386859,2164.098872366,43
carcassonne-boltzmann185-vs-boltzmann315-1000its,768,725,2203.57273447,2137.238167503,43
carcassonne-boltzmann240-vs-boltzmann75-1000its,768,725,2204.475139395,2141.369177822,43
carcassonne-uct275-vs-uct350-1000its,770,727,2159.625151115,2115.523807044,43
carcassonne-boltzmann445-vs-boltzmann190-1000its,771,728,2186.544262497,2127.860638025,43
carcassonne-uct35-vs-uct460-1000its,776,733,2230.346412736,2169.088585025,43
carcassonne-ucttuned135-vs-ucttuned385-1000its,778,735,2149.600662566,2095.600621759,43
carcassonne-uct485-vs-uct300-1000its,781,738,2178.396991772,2134.694669102,43
carcassonne-ucttuned245-vs-ucttuned260-1000its,783,740,2185.170732607,2154.949092698,43
carcassonne-boltzmann115-vs-boltzmann340-1000its,784,741,2211.849457919,2176.163414546,43
carcassonne-uct10-vs-uct395-1000its,784,741,2133.969354171,2094.358435804,43
carcassonne-uct260-vs-uct100-1000its,785,742,2193.147648198,2133.009637929,43
carcassonne-boltzmann100-vs-boltzmann345-1000its,786,743,2251.793915449,2206.296836053,43
carcassonne-boltzmann305-vs-boltzmann180-1000its,787,744,2223.134774861,2176.399654405,43
carcassonne-boltzmann445-vs-boltzmann260-1000its,787,744,2173.796449527,2154.448420777,43
carcassonne-boltzmann440-vs-boltzmann130-1000its,788,745,2212.865480546,2200.919811304,43
carcassonne-boltzmann375-vs-boltzmann110-1000its,790,747,2196.774278083,2108.738952705,43
carcassonne-ucttuned255-vs-ucttuned85-1000its,791,748,2175.178850176,2151.947784552,43
carcassonne-boltzmann135-vs-boltzmann440-1000its,792,749,2169.686924773,2109.390137011,43
carcassonne-boltzmann145-vs-boltzmann325-1000its,792,749,2181.881096575,2158.926437048,43
carcassonne-boltzmann480-vs-boltzmann440-1000its,792,749,2225.113118225,2181.453216722,43
carcassonne-boltzmann85-vs-boltzmann135-1000its,793,750,2222.723602529,2173.208781905,43
carcassonne-ucttuned105-vs-ucttuned440-1000its,794,751,2218.652326161,2181.049998159,43
carcassonne-boltzmann130-vs-boltzmann170-1000its,797,754,2181.964881763,2157.404280689,43
carcassonne-boltzmann390-vs-boltzmann145-1000its,797,754,2203.518603409,2164.719114763,43
carcassonne-boltzmann230-vs-boltzmann75-1000its,798,755,2152.415890443,2119.750048147,43
carcassonne-boltzmann415-vs-boltzmann410-1000its,800,757,2150.589294849,2108.797774726,43
carcassonne-ucttuned450-vs-ucttuned90-1000its,800,757,2185.348996681,2176.009250744,43
carcassonne-ucttuned270-vs-ucttuned445-1000its,802,759,2219.278585308,2156.539154758,43
carcassonne-boltzmann35-vs-boltzmann300-1000its,803,760,2213.025293895,2180.289561255,43
carcassonne-boltzmann430-vs-boltzmann385-1000its,803,760,2134.597268885,2096.32322327,43
carcassonne-boltzmann420-vs-boltzmann310-1000its,804,761,2122.302626021,2104.398418328,43
carcassonne-uct185-vs-uct15-1000its,804,761,2160.934797441,2113.979747214,43
carcassonne-uct435-vs-uct65-1000its,804,761,2126.555807747,2112.49217363,43
carcassonne-boltzmann360-vs-boltzmann70-1000its,806,763,2152.771660339,2146.142190383,43
carcassonne-uct270-vs-uct85-1000its,806,763,2204.401226481,2200.437710731,43
carcassonne-ucttuned230-vs-ucttuned55-1000its,806,763,2143.742618804,2139.796002834,43
carcassonne-uct310-vs-uct345-1000its,809,766,2221.765444444,2156.6561043,43
carcassonne-uct465-vs-uct330-1000its,809,766,2195.157266387,2125.032562687,43
carcassonne-uct470-vs-uct315-1000its,810,767,2173.560841434,2084.001882426,43
carcassonne-ucttuned195-vs-ucttuned190-1000its,810,767,2226.576461694,2212.609551765,43
carcassonne-ucttuned460-vs-ucttuned225-1000its,810,767,2227.994992784,2168.983975036,43
carcassonne-uct125-vs-uct55-1000its,811,768,2234.704703386,2158.460493601,43
carcassonne-uct165-vs-uct255-1000its,811,768,2186.141749542,2190.96269078,43
carcassonne-ucttuned380-vs-ucttuned300-1000its,812,769,2166.001330389,2113.608196636,43
carcassonne-ucttuned40-vs-ucttuned475-1000its,813,770,2189.824552506,2138.558447279,43
carcassonne-boltzmann75-vs-boltzmann340-1000its,814,771,2155.30866232,2090.511719017,43
carcassonne-boltzmann445-vs-boltzmann210-1000its,815,772,2227.895911108,2176.308590282,43
carcassonne-uct485-vs-uct345-1000its,815,772,2226.846619201,2248.197329308,43
carcassonne-boltzmann185-vs-boltzmann120-1000its,816,773,2183.614647771,2214.707599413,43
carcassonne-ucttuned460-vs-ucttuned480-1000its,816,773,2164.454188875,2128.265793686,43
carcassonne-boltzmann290-vs-boltzmann420-1000its,817,774,2151.62229693,2132.860811808,43
carcassonne-uct365-vs-uct100-1000its,818,775,2230.652770438,2199.030582343,43
carcassonne-ucttuned5-vs-ucttuned55-1000its,819,776,2112.339650189,2070.412682773,43
carcassonne-boltzmann325-vs-boltzmann365-1000its,820,777,2136.458011622,2126.227366247,43
carcassonne-uct195-vs-uct290-1000its,820,777,2249.761928182,2198.874079177,43
carcassonne-ucttuned90-vs-ucttuned110-1000its,821,778,2144.549198823,2071.996186979,43
carcassonne-uct360-vs-uct190-1000its,822,779,2225.075874058,2200.640226564,43
carcassonne-ucttuned490-vs-ucttuned90-1000its,823,780,2189.907450479,2119.230612291,43
carcassonne-uct270-vs-uct50-1000its,824,781,2126.492586863,2097.26581071,43
carcassonne-uct285-vs-uct190-1000its,825,782,2237.823570003,2206.60434745,43
carcassonne-ucttuned285-vs-ucttuned420-1000its,825,782,2235.971496276,2181.541287426,43
carcassonne-boltzmann420-vs-boltzmann400-1000its,826,783,2268.474533108,2278.03092258,43
carcassonne-boltzmann430-vs-boltzmann300-1000its,827,784,2205.789586978,2179.127771558,43
carcassonne-ucttuned405-vs-ucttuned435-1000its,828,785,2282.793023196,2211.351232602,43
carcassonne-boltzmann470-vs-boltzmann335-1000its,830,787,2187.818304202,2128.084571644,43
carcassonne-uct130-vs-uct175-1000its,830,787,2216.714094096,2174.727196751,43
carcassonne-uct435-vs-uct185-1000its,830,787,2198.620031731,2176.986504979,43
carcassonne-uct465-vs-uct210-1000its,830,787,2250.448692906,2177.022460688,43
carcassonne-boltzmann20-vs-boltzmann140-1000its,835,792,2168.890360193,2140.883391212,43
carcassonne-uct295-vs-uct90-1000its,835,792,2182.033207408,2146.067338208,43
carcassonne-uct315-vs-uct300-1000its,835,792,2230.136949415,2172.466963148,43
carcassonne-uct245-vs-uct135-1000its,836,793,2129.903904093,2118.629374748,43
carcassonne-boltzmann145-vs-boltzmann240-1000its,840,797,2287.35224467,2220.247242747,43
carcassonne-uct435-vs-uct45-1000its,840,797,2226.64562927,2174.736318627,43
carcassonne-boltzmann165-vs-boltzmann100-1000its,841,798,2240.036030489,2167.673734212,43
carcassonne-uct445-vs-uct90-1000its,841,798,2157.394520702,2098.18552952,43
carcassonne-boltzmann165-vs-boltzmann485-1000its,842,799,2219.273991764,2119.93250171,43
carcassonne-ucttuned20-vs-ucttuned345-1000its,842,799,2252.952743828,2174.197580784,43
carcassonne-ucttuned205-vs-ucttuned475-1000its,842,799,2255.362693762,2188.485660668,43
carcassonne-uct135-vs-uct115-1000its,844,801,2203.467969407,2139.255312736,43
carcassonne-uct335-vs-uct470-1000its,844,801,2262.736955799,2164.077316735,43
carcassonne-uct340-vs-uct265-1000its,844,801,2290.743784363,2202.928500232,43
carcassonne-uct185-vs-uct245-1000its,846,803,2170.419891804,2134.732202405,43
carcassonne-ucttuned35-vs-ucttuned480-1000its,846,803,2139.312614538,2125.300837144,43
carcassonne-uct295-vs-uct425-1000its,850,807,2220.318315929,2155.911587613,43
carcassonne-uct330-vs-uct350-1000its,851,808,2190.634013094,2159.776431064,43
carcassonne-ucttuned365-vs-ucttuned435-1000its,852,809,2246.701949084,2171.023154536,43
carcassonne-ucttuned90-vs-ucttuned355-1000its,853,810,2162.447080595,2144.851968749,43
carcassonne-boltzmann485-vs-boltzmann65-1000its,854,811,2157.050704995,2130.705505827,43
carcassonne-uct295-vs-uct395-1000its,855,812,2137.762483278,2119.501548287,43
carcassonne-ucttuned305-vs-ucttuned15-1000its,855,812,2099.871355884,2098.804588673,43
carcassonne-ucttuned40-vs-ucttuned285-1000its,856,813,2204.916227626,2187.40494976,43
carcassonne-uct310-vs-uct230-1000its,859,816,2230.686148038,2135.999910774,43
carcassonne-ucttuned5-vs-ucttuned295-1000its,859,816,2287.566511099,2215.58925321,43
carcassonne-boltzmann60-vs-boltzmann305-1000its,860,817,2196.966792167,2176.562824152,43
carcassonne-uct130-vs-uct470-1000its,860,817,2184.727634993,2159.429038628,43
carcassonne-ucttuned330-vs-ucttuned345-1000its,863,820,2236.09279912,2208.333159325,43
carcassonne-ucttuned70-vs-ucttuned165-1000its,863,820,2184.921478958,2162.570435789,43
carcassonne-boltzmann390-vs-boltzmann495-1000its,864,821,2182.412478082,2144.998392098,43
carcassonne-uct355-vs-uct150-1000its,865,822,2242.112703598,2178.069177192,43
carcassonne-ucttuned350-vs-ucttuned255-1000its,868,825,2185.110714616,2181.348303183,43
carcassonne-ucttuned370-vs-ucttuned75-1000its,868,825,2139.98110606,2113.884004464,43
carcassonne-uct285-vs-uct90-1000its,870,827,2177.6353918,2123.823280998,43
carcassonne-ucttuned480-vs-ucttuned75-1000its,870,827,2193.28719568,2159.25016887,43
carcassonne-boltzmann170-vs-boltzmann130-1000its,871,828,2179.133707318,2149.12767857,43
carcassonne-boltzmann260-vs-boltzmann460-1000its,871,828,2206.391118099,2106.342187268,43
carcassonne-ucttuned205-vs-ucttuned130-1000its,871,828,2235.770445521,2134.865872609,43
carcassonne-ucttuned145-vs-ucttuned350-1000its,872,829,2238.290718021,2181.008498997,43
carcassonne-boltzmann405-vs-boltzmann260-1000its,875,832,2241.6339699,2176.238756504,43
carcassonne-boltzmann190-vs-boltzmann250-1000its,878,835,2180.744097354,2132.653967447,43
carcassonne-ucttuned385-vs-ucttuned65-1000its,880,837,2226.395396223,2177.885129444,43
carcassonne-boltzmann490-vs-boltzmann160-1000its,882,839,2226.299555157,2195.107307736,43
carcassonne-uct165-vs-uct275-1000its,882,839,2167.097289492,2105.128519659,43
carcassonne-ucttuned130-vs-ucttuned465-1000its,882,839,2231.034473355,2170.828639361,43
carcassonne-uct35-vs-uct85-1000its,886,843,2291.480758413,2254.704488805,43
carcassonne-boltzmann140-vs-boltzmann15-1000its,890,847,2163.445818816,2116.913318183,43
carcassonne-ucttuned390-vs-ucttuned125-1000its,897,854,2217.724267481,2169.234854715,43
carcassonne-uct115-vs-uct335-1000its,911,868,2192.434585311,2165.430897547,43
carcassonne-uct5-vs-uct25-1000its,922,879,2243.810102623,2211.191825188,43
carcassonne-boltzmann255-vs-boltzmann270-1000its,935,892,2197.911517981,2144.052485598,43
carcassonne-ucttuned305-vs-ucttuned80-1000its,944,901,2188.478776232,2161.566224539,43
carcassonne-uct15-vs-uct480-1000its,741,697,2253.870781851,2188.718370235,44
carcassonne-uct200-vs-uct80-1000its,746,702,2171.455729469,2118.157099472,44
carcassonne-boltzmann320-vs-boltzmann115-1000its,757,713,2204.279215924,2236.300583061,44
carcassonne-uct390-vs-uct415-1000its,767,723,2228.530149598,2164.727097982,44
carcassonne-ucttuned460-vs-ucttuned150-1000its,768,724,2194.534708353,2146.505369497,44
carcassonne-uct225-vs-uct400-1000its,770,726,2240.3374755,2177.288738401,44
carcassonne-boltzmann420-vs-boltzmann235-1000its,775,731,2260.407809723,2249.999014422,44
carcassonne-uct190-vs-uct80-1000its,777,733,2140.705344492,2099.113117591,44
carcassonne-uct490-vs-uct445-1000its,782,738,2248.750776248,2201.226382332,44
carcassonne-boltzmann175-vs-boltzmann480-1000its,783,739,2171.680311184,2139.139686918,44
carcassonne-ucttuned360-vs-ucttuned150-1000its,783,739,2180.364887365,2146.790182787,44
carcassonne-ucttuned460-vs-ucttuned295-1000its,783,739,2208.520196605,2177.995096027,44
carcassonne-boltzmann380-vs-boltzmann490-1000its,785,741,2237.685339616,2203.209394185,44
carcassonne-ucttuned45-vs-ucttuned420-1000its,785,741,2168.355799835,2145.855697136,44
carcassonne-uct110-vs-uct35-1000its,786,742,2144.426360637,2092.600852982,44
carcassonne-boltzmann100-vs-boltzmann355-1000its,787,743,2252.106915748,2200.159878843,44
carcassonne-ucttuned20-vs-ucttuned320-1000its,787,743,2168.45086985,2133.875710974,44
carcassonne-ucttuned125-vs-ucttuned300-1000its,793,749,2134.499799256,2104.662006466,44
carcassonne-ucttuned170-vs-ucttuned165-1000its,793,749,2145.571794,2126.264597266,44
carcassonne-uct140-vs-uct265-1000its,794,750,2227.877402973,2184.913018003,44
carcassonne-uct465-vs-uct435-1000its,797,753,2156.525855547,2164.663931766,44
carcassonne-boltzmann365-vs-boltzmann445-1000its,798,754,2196.119833512,2131.344585103,44
carcassonne-uct210-vs-uct300-1000its,798,754,2157.756195069,2114.358565841,44
carcassonne-boltzmann265-vs-boltzmann410-1000its,799,755,2155.958379181,2082.615114641,44
carcassonne-boltzmann180-vs-boltzmann390-1000its,800,756,2247.428745351,2202.792227035,44
carcassonne-boltzmann45-vs-boltzmann100-1000its,800,756,2160.973430218,2102.864757538,44
carcassonne-boltzmann185-vs-boltzmann410-1000its,802,758,2154.13165844,2120.772238855,44
carcassonne-uct280-vs-uct95-1000its,802,758,2216.004477237,2170.029797678,44
carcassonne-ucttuned50-vs-ucttuned225-1000its,802,758,2260.272925688,2154.889320825,44
carcassonne-uct40-vs-uct335-1000its,803,759,2196.046784559,2139.08667233,44
carcassonne-boltzmann195-vs-boltzmann155-1000its,804,760,2201.690473124,2148.835863716,44
carcassonne-boltzmann420-vs-boltzmann485-1000its,805,761,2298.673961481,2230.035620687,44
carcassonne-ucttuned120-vs-ucttuned405-1000its,805,761,2104.254888072,2053.907069083,44
carcassonne-uct105-vs-uct50-1000its,806,762,2174.180500961,2174.421230065,44
carcassonne-ucttuned335-vs-ucttuned420-1000its,808,764,2233.722037435,2164.158720908,44
carcassonne-ucttuned75-vs-ucttuned200-1000its,809,765,2223.116841331,2193.472000589,44
carcassonne-uct275-vs-uct230-1000its,810,766,2262.811167792,2223.397981597,44
carcassonne-uct310-vs-uct410-1000its,811,767,2174.795401113,2132.599562784,44
carcassonne-boltzmann335-vs-boltzmann395-1000its,812,768,2273.531542429,2197.780617997,44
carcassonne-uct475-vs-uct165-1000its,812,768,2160.58142253,2123.832622814,44
carcassonne-ucttuned195-vs-ucttuned130-1000its,812,768,2193.475021346,2182.379603452,44
carcassonne-uct185-vs-uct475-1000its,813,769,2215.171442533,2183.310257051,44
carcassonne-boltzmann210-vs-boltzmann305-1000its,814,770,2170.650945227,2090.957738248,44
carcassonne-boltzmann130-vs-boltzmann380-1000its,816,772,2177.448440387,2138.519123588,44
carcassonne-ucttuned485-vs-ucttuned55-1000its,816,772,2178.410446443,2125.688694999,44
carcassonne-boltzmann295-vs-boltzmann450-1000its,817,773,2244.89192302,2182.421778284,44
carcassonne-boltzmann90-vs-boltzmann440-1000its,818,774,2150.704260288,2079.786234944,44
carcassonne-uct280-vs-uct210-1000its,818,774,2174.244955852,2121.696680646,44
carcassonne-uct470-vs-uct355-1000its,818,774,2260.327061507,2230.548927042,44
carcassonne-boltzmann20-vs-boltzmann410-1000its,820,776,2310.294502871,2194.617312756,44
carcassonne-uct285-vs-uct365-1000its,820,776,2251.827903651,2220.861409551,44
carcassonne-ucttuned215-vs-ucttuned430-1000its,821,777,2233.536992352,2142.322726829,44
carcassonne-ucttuned455-vs-ucttuned365-1000its,821,777,2166.180928666,2085.382528509,44
carcassonne-boltzmann55-vs-boltzmann225-1000its,822,778,2200.385065199,2155.541675176,44
carcassonne-boltzmann190-vs-boltzmann285-1000its,823,779,2148.543914084,2060.299490801,44
carcassonne-uct115-vs-uct150-1000its,823,779,2232.174918222,2177.087537214,44
carcassonne-ucttuned205-vs-ucttuned455-1000its,823,779,2211.883004463,2192.528752782,44
carcassonne-boltzmann275-vs-boltzmann190-1000its,824,780,2192.19102665,2153.936618137,44
carcassonne-uct270-vs-uct430-1000its,824,780,2218.021757284,2167.537759399,44
carcassonne-uct355-vs-uct45-1000its,824,780,2170.777710688,2111.723307485,44
carcassonne-uct45-vs-uct205-1000its,824,780,2204.949883447,2159.135049587,44
carcassonne-uct20-vs-uct290-1000its,825,781,2162.968652378,2134.771296119,44
carcassonne-ucttuned210-vs-ucttuned455-1000its,825,781,2265.989389777,2254.962982729,44
carcassonne-boltzmann65-vs-boltzmann245-1000its,826,782,2155.011326252,2103.648896217,44
carcassonne-uct455-vs-uct465-1000its,827,783,2218.58094415,2157.273083543,44
carcassonne-boltzmann315-vs-boltzmann160-1000its,828,784,2162.603547757,2119.569983331,44
carcassonne-ucttuned305-vs-ucttuned150-1000its,828,784,2221.031213035,2222.86068722,44
carcassonne-boltzmann455-vs-boltzmann465-1000its,829,785,2185.670095401,2167.121546185,44
carcassonne-ucttuned220-vs-ucttuned465-1000its,829,785,2188.85881682,2121.188609023,44
carcassonne-uct195-vs-uct335-1000its,832,788,2198.073158433,2167.610844139,44
carcassonne-boltzmann370-vs-boltzmann25-1000its,833,789,2265.221955873,2211.792173135,44
carcassonne-uct90-vs-uct125-1000its,833,789,2187.506104027,2176.130643427,44
carcassonne-uct145-vs-uct20-1000its,834,790,2313.037838354,2201.975688417,44
carcassonne-uct255-vs-uct70-1000its,834,790,2136.209334519,2055.951894713,44
carcassonne-ucttuned65-vs-ucttuned155-1000its,835,791,2149.86502472,2112.133856905,44
carcassonne-boltzmann465-vs-boltzmann270-1000its,837,793,2180.25353851,2111.156871364,44
carcassonne-boltzmann30-vs-boltzmann340-1000its,838,794,2213.826347908,2167.782130263,44
carcassonne-ucttuned60-vs-ucttuned380-1000its,838,794,2232.29621971,2182.645597536,44
carcassonne-uct115-vs-uct105-1000its,839,795,2155.636654304,2126.711282403,44
carcassonne-ucttuned410-vs-ucttuned315-1000its,839,795,2137.20517919,2110.772236882,44
carcassonne-uct255-vs-uct435-1000its,841,797,2170.983213375,2141.047978258,44
carcassonne-uct320-vs-uct335-1000its,841,797,2215.568125438,2163.66933957,44
carcassonne-ucttuned215-vs-ucttuned440-1000its,841,797,2230.761197614,2166.722746356,44
carcassonne-boltzmann145-vs-boltzmann105-1000its,842,798,2184.727705416,2147.221055693,44
carcassonne-uct370-vs-uct305-1000its,843,799,2207.993302009,2129.264173884,44
carcassonne-uct115-vs-uct480-1000its,844,800,2214.274456631,2170.165091696,44
carcassonne-uct290-vs-uct250-1000its,844,800,2219.152835962,2161.514910762,44
carcassonne-uct445-vs-uct480-1000its,844,800,2176.605126312,2153.303534289,44
carcassonne-uct150-vs-uct270-1000its,845,801,2219.394274277,2179.083057949,44
carcassonne-uct425-vs-uct325-1000its,845,801,2213.393243101,2162.452478537,44
carcassonne-boltzmann330-vs-boltzmann400-1000its,848,804,2152.520045409,2118.522653599,44
carcassonne-uct405-vs-uct240-1000its,848,804,2178.646943388,2107.792133065,44
carcassonne-ucttuned80-vs-ucttuned275-1000its,848,804,2229.75479453,2129.381700524,44
carcassonne-uct350-vs-uct315-1000its,850,806,2204.033074723,2165.330952397,44
carcassonne-uct480-vs-uct305-1000its,851,807,2178.922548597,2149.098893008,44
carcassonne-ucttuned230-vs-ucttuned140-1000its,851,807,2167.092861826,2098.129990853,44
carcassonne-ucttuned415-vs-ucttuned315-1000its,852,808,2246.771266578,2197.592640071,44
carcassonne-boltzmann175-vs-boltzmann180-1000its,853,809,2269.794362175,2211.819746903,44
carcassonne-ucttuned280-vs-ucttuned210-1000its,853,809,2140.590869525,2085.860465711,44
carcassonne-uct460-vs-uct425-1000its,854,810,2196.483388114,2156.615323514,44
carcassonne-ucttuned170-vs-ucttuned480-1000its,854,810,2231.423854788,2182.066062348,44
carcassonne-boltzmann35-vs-boltzmann175-1000its,856,812,2205.483455669,2161.182329927,44
carcassonne-uct305-vs-uct130-1000its,861,817,2265.438349577,2195.863423654,44
carcassonne-ucttuned455-vs-ucttuned385-1000its,865,821,2173.296690248,2152.305005535,44
carcassonne-ucttuned345-vs-ucttuned385-1000its,867,823,2200.502411519,2137.300168354,44
carcassonne-ucttuned55-vs-ucttuned285-1000its,867,823,2200.73456097,2167.627509727,44
carcassonne-ucttuned175-vs-ucttuned315-1000its,868,824,2214.298481289,2155.506485946,44
carcassonne-boltzmann450-vs-boltzmann75-1000its,869,825,2222.348132703,2172.249067511,44
carcassonne-boltzmann5-vs-boltzmann470-1000its,869,825,2181.636491621,2087.87989406,44
carcassonne-ucttuned320-vs-ucttuned50-1000its,869,825,2212.563567983,2178.137121894,44
carcassonne-ucttuned75-vs-ucttuned20-1000its,870,826,2128.617000313,2072.122352072,44
carcassonne-ucttuned80-vs-ucttuned225-1000its,871,827,2206.261619884,2124.525373047,44
carcassonne-uct455-vs-uct225-1000its,873,829,2173.21753535,2112.240708866,44
carcassonne-ucttuned110-vs-ucttuned335-1000its,874,830,2196.602522032,2099.409114776,44
carcassonne-uct265-vs-uct410-1000its,875,831,2200.467091446,2183.833731828,44
carcassonne-uct265-vs-uct25-1000its,877,833,2135.865872232,2121.927984769,44
carcassonne-uct390-vs-uct145-1000its,879,835,2257.49126183,2240.399489406,44
carcassonne-ucttuned90-vs-ucttuned485-1000its,882,838,2180.820854285,2168.614382801,44
carcassonne-uct320-vs-uct380-1000its,885,841,2183.707056599,2143.101392217,44
carcassonne-ucttuned270-vs-ucttuned480-1000its,885,841,2162.34585586,2141.070587908,44
carcassonne-boltzmann25-vs-boltzmann20-1000its,888,844,2247.179720399,2171.570827884,44
carcassonne-uct100-vs-uct245-1000its,894,850,2184.234591707,2135.893890345,44
carcassonne-ucttuned240-vs-ucttuned55-1000its,895,851,2147.263410762,2102.284747624,44
carcassonne-ucttuned20-vs-ucttuned175-1000its,897,853,2288.633608555,2275.922342377,44
carcassonne-ucttuned195-vs-ucttuned490-1000its,906,862,2224.339653908,2209.191353886,44
carcassonne-uct375-vs-uct245-1000its,922,878,2196.132662252,2123.871945538,44
carcassonne-ucttuned30-vs-ucttuned360-1000its,936,892,2291.360383926,2253.814408884,44
carcassonne-uct345-vs-uct295-1000its,965,921,2212.840313419,2138.575944998,44
carcassonne-boltzmann85-vs-boltzmann405-1000its,759,714,2237.320050922,2179.490259197,45
carcassonne-boltzmann170-vs-boltzmann420-1000its,766,721,2154.674732408,2095.666926148,45
carcassonne-boltzmann295-vs-boltzmann240-1000its,769,724,2199.464871258,2178.685702869,45
carcassonne-ucttuned125-vs-ucttuned465-1000its,771,726,2182.75289506,2133.846791371,45
carcassonne-ucttuned290-vs-ucttuned355-1000its,773,728,2236.543347484,2206.57915591,45
carcassonne-uct390-vs-uct435-1000its,780,735,2245.493468386,2219.043809922,45
carcassonne-ucttuned140-vs-ucttuned185-1000its,781,736,2268.083659005,2249.084204771,45
carcassonne-uct30-vs-uct200-1000its,783,738,2179.076281967,2123.081791049,45
carcassonne-uct435-vs-uct370-1000its,783,738,2217.363490329,2196.447503874,45
carcassonne-boltzmann385-vs-boltzmann390-1000its,785,740,2212.736541726,2148.591547298,45
carcassonne-uct410-vs-uct430-1000its,785,740,2172.029014584,2132.636450202,45
carcassonne-uct155-vs-uct55-1000its,787,742,2182.07129421,2147.393284278,45
carcassonne-uct430-vs-uct215-1000its,787,742,2266.411505756,2195.340625508,45
carcassonne-boltzmann100-vs-boltzmann410-1000its,789,744,2250.927637144,2177.333165033,45
carcassonne-ucttuned80-vs-ucttuned85-1000its,789,744,2120.710740669,2095.169798196,45
carcassonne-boltzmann115-vs-boltzmann205-1000its,791,746,2181.819875823,2163.184442004,45
carcassonne-boltzmann480-vs-boltzmann245-1000its,792,747,2283.073766905,2208.975173282,45
carcassonne-boltzmann485-vs-boltzmann335-1000its,793,748,2275.043260794,2252.162378274,45
carcassonne-boltzmann105-vs-boltzmann190-1000its,795,750,2130.420240662,2113.969106004,45
carcassonne-boltzmann15-vs-boltzmann250-1000its,795,750,2185.697297623,2154.260893763,45
carcassonne-boltzmann45-vs-boltzmann40-1000its,795,750,2169.478558137,2125.027925736,45
carcassonne-boltzmann145-vs-boltzmann290-1000its,797,752,2142.653130844,2104.546606628,45
carcassonne-ucttuned400-vs-ucttuned25-1000its,798,753,2205.224890086,2179.885895589,45
carcassonne-boltzmann385-vs-boltzmann370-1000its,799,754,2216.306476213,2204.125294741,45
carcassonne-boltzmann195-vs-boltzmann410-1000its,800,755,2218.314208785,2195.827425681,45
carcassonne-ucttuned235-vs-ucttuned445-1000its,800,755,2244.835304672,2175.191129895,45
carcassonne-boltzmann435-vs-boltzmann100-1000its,802,757,2172.795513223,2143.301929696,45
carcassonne-boltzmann470-vs-boltzmann320-1000its,802,757,2235.896925115,2170.737041176,45
carcassonne-uct465-vs-uct495-1000its,803,758,2164.372270559,2107.90207629,45
carcassonne-uct245-vs-uct255-1000its,804,759,2282.614896643,2262.609168562,45
carcassonne-boltzmann105-vs-boltzmann415-1000its,805,760,2222.087564778,2167.517479503,45
carcassonne-boltzmann315-vs-boltzmann235-1000its,805,760,2255.424758267,2213.277167963,45
carcassonne-uct495-vs-uct55-1000its,806,761,2097.799851357,2051.715337867,45
carcassonne-ucttuned200-vs-ucttuned130-1000its,806,761,2209.515156798,2172.446024119,45
carcassonne-boltzmann195-vs-boltzmann255-1000its,807,762,2179.249887384,2169.552153966,45
carcassonne-ucttuned70-vs-ucttuned30-1000its,808,763,2208.19105921,2157.137792236,45
carcassonne-ucttuned340-vs-ucttuned440-1000its,809,764,2284.990748152,2208.123027978,45
carcassonne-ucttuned55-vs-ucttuned175-1000its,809,764,2155.888111558,2092.952114078,45
carcassonne-uct90-vs-uct375-1000its,810,765,2187.767277642,2146.236988498,45
carcassonne-boltzmann30-vs-boltzmann70-1000its,812,767,2206.607723457,2122.755185536,45
carcassonne-boltzmann205-vs-boltzmann490-1000its,814,769,2157.244846763,2108.683318478,45
carcassonne-uct420-vs-uct245-1000its,814,769,2172.794566432,2114.771122055,45
carcassonne-ucttuned355-vs-ucttuned55-1000its,814,769,2227.868183675,2165.738881998,45
carcassonne-ucttuned395-vs-ucttuned45-1000its,815,770,2232.844125841,2179.032582894,45
carcassonne-uct70-vs-uct445-1000its,816,771,2199.414287862,2165.048937256,45
carcassonne-ucttuned430-vs-ucttuned50-1000its,816,771,2212.446531431,2181.233330927,45
carcassonne-ucttuned150-vs-ucttuned265-1000its,817,772,2222.894556578,2167.933747042,45
carcassonne-ucttuned170-vs-ucttuned415-1000its,818,773,2147.557976268,2149.396166052,45
carcassonne-uct220-vs-uct405-1000its,825,780,2158.607826236,2154.144457698,45
carcassonne-ucttuned140-vs-ucttuned340-1000its,825,780,2156.59525244,2120.505263624,45
carcassonne-boltzmann425-vs-boltzmann315-1000its,826,781,2225.022259164,2181.342294084,45
carcassonne-boltzmann55-vs-boltzmann280-1000its,828,783,2220.340825642,2171.560921324,45
carcassonne-ucttuned60-vs-ucttuned100-1000its,828,783,2193.701728961,2160.16231942,45
carcassonne-boltzmann465-vs-boltzmann5-1000its,830,785,2168.565685042,2146.844312069,45
carcassonne-uct215-vs-uct145-1000its,830,785,2151.813535894,2136.338669267,45
carcassonne-uct60-vs-uct405-1000its,830,785,2236.579661254,2188.586259967,45
carcassonne-ucttuned215-vs-ucttuned380-1000its,830,785,2297.29442082,2224.496053308,45
carcassonne-boltzmann110-vs-boltzmann470-1000its,832,787,2177.721322192,2115.001493084,45
carcassonne-boltzmann155-vs-boltzmann130-1000its,832,787,2241.201805852,2168.636411963,45
carcassonne-ucttuned155-vs-ucttuned265-1000its,832,787,2195.979591719,2110.57030848,45
carcassonne-uct150-vs-uct370-1000its,833,788,2189.1523017,2118.86968283,45
carcassonne-uct225-vs-uct340-1000its,833,788,2241.714309785,2195.098986268,45
carcassonne-ucttuned165-vs-ucttuned420-1000its,834,789,2219.250179284,2180.517722426,45
carcassonne-ucttuned205-vs-ucttuned325-1000its,834,789,2173.513364768,2131.9396632,45
carcassonne-ucttuned470-vs-ucttuned185-1000its,834,789,2204.642420227,2190.819575905,45
carcassonne-boltzmann395-vs-boltzmann475-1000its,835,790,2166.671747431,2143.592615096,45
carcassonne-boltzmann95-vs-boltzmann120-1000its,836,791,2232.799079953,2185.218235795,45
carcassonne-uct115-vs-uct35-1000its,836,791,2207.404585263,2172.225780736,45
carcassonne-ucttuned385-vs-ucttuned485-1000its,836,791,2196.518818745,2153.697979329,45
carcassonne-boltzmann50-vs-boltzmann350-1000its,837,792,2204.984602718,2194.062972213,45
carcassonne-ucttuned90-vs-ucttuned150-1000its,837,792,2229.092285347,2145.197427985,45
carcassonne-uct425-vs-uct245-1000its,838,793,2211.498630694,2200.256714128,45
carcassonne-ucttuned215-vs-ucttuned250-1000its,838,793,2212.997417209,2172.530220035,45
carcassonne-ucttuned70-vs-ucttuned230-1000its,840,795,2187.176757885,2135.06283916,45
carcassonne-ucttuned370-vs-ucttuned160-1000its,841,796,2131.495453372,2141.503339407,45
carcassonne-uct115-vs-uct305-1000its,845,800,2160.423352538,2111.581245429,45
carcassonne-uct295-vs-uct35-1000its,845,800,2227.419766514,2146.160704459,45
carcassonne-ucttuned135-vs-ucttuned200-1000its,845,800,2154.903151343,2129.330269981,45
carcassonne-ucttuned120-vs-ucttuned390-1000its,846,801,2258.883311591,2170.606143939,45
carcassonne-boltzmann75-vs-boltzmann265-1000its,847,802,2246.846604963,2175.866491024,45
carcassonne-ucttuned110-vs-ucttuned50-1000its,847,802,2174.243435242,2128.440647776,45
carcassonne-ucttuned250-vs-ucttuned245-1000its,847,802,2216.789741798,2148.032178405,45
carcassonne-ucttuned90-vs-ucttuned375-1000its,847,802,2298.471648174,2249.792002264,45
carcassonne-uct285-vs-uct480-1000its,848,803,2182.278425521,2140.156857544,45
carcassonne-boltzmann155-vs-boltzmann20-1000its,849,804,2175.830020037,2131.725538531,45
carcassonne-boltzmann445-vs-boltzmann290-1000its,849,804,2182.845897698,2163.277803577,45
carcassonne-uct245-vs-uct190-1000its,849,804,2231.287430578,2167.604409719,45
carcassonne-uct280-vs-uct260-1000its,849,804,2245.91305056,2193.905575553,45
carcassonne-uct465-vs-uct40-1000its,849,804,2175.395807592,2141.379847449,45
carcassonne-ucttuned180-vs-ucttuned150-1000its,849,804,2229.271984349,2196.286453227,45
carcassonne-boltzmann45-vs-boltzmann225-1000its,850,805,2249.240362141,2213.559409407,45
carcassonne-ucttuned435-vs-ucttuned220-1000its,850,805,2236.030571646,2169.482707667,45
carcassonne-ucttuned475-vs-ucttuned490-1000its,850,805,2189.612723145,2139.764350479,45
carcassonne-boltzmann475-vs-boltzmann45-1000its,852,807,2286.993136951,2234.99311117,45
carcassonne-uct180-vs-uct420-1000its,852,807,2242.914957239,2225.350045155,45
carcassonne-ucttuned425-vs-ucttuned75-1000its,852,807,2215.277793809,2215.423478,45
carcassonne-boltzmann35-vs-boltzmann135-1000its,853,808,2168.563096474,2145.308407363,45
carcassonne-boltzmann400-vs-boltzmann470-1000its,853,808,2228.808864366,2191.666821488,45
carcassonne-uct495-vs-uct150-1000its,854,809,2279.023765276,2231.840345106,45
carcassonne-ucttuned5-vs-ucttuned300-1000its,854,809,2218.358553419,2167.012189862,45
carcassonne-uct35-vs-uct220-1000its,855,810,2211.230041608,2196.575479064,45
carcassonne-boltzmann305-vs-boltzmann60-1000its,856,811,2163.143926797,2125.210132721,45
carcassonne-boltzmann325-vs-boltzmann230-1000its,858,813,2210.964176593,2146.406397015,45
carcassonne-uct175-vs-uct40-1000its,858,813,2200.18896494,2131.918244478,45
carcassonne-uct250-vs-uct320-1000its,860,815,2163.891636664,2134.864941936,45
carcassonne-ucttuned485-vs-ucttuned355-1000its,861,816,2174.56521448,2089.434876743,45
carcassonne-uct35-vs-uct135-1000its,862,817,2194.151751825,2136.329842803,45
carcassonne-ucttuned10-vs-ucttuned260-1000its,865,820,2194.787070117,2128.02284447,45
carcassonne-ucttuned415-vs-ucttuned385-1000its,865,820,2215.279787655,2154.560160544,45
carcassonne-boltzmann420-vs-boltzmann125-1000its,866,821,2163.049740747,2121.007533954,45
carcassonne-ucttuned170-vs-ucttuned255-1000its,867,822,2169.514109266,2137.853893529,45
carcassonne-ucttuned370-vs-ucttuned145-1000its,867,822,2229.875602595,2194.204221077,45
carcassonne-uct450-vs-uct145-1000its,869,824,2213.210675239,2139.668231331,45
carcassonne-uct425-vs-uct320-1000its,870,825,2199.958162515,2170.990355018,45
carcassonne-ucttuned20-vs-ucttuned455-1000its,875,830,2261.736267047,2194.344919779,45
carcassonne-uct170-vs-uct460-1000its,876,831,2255.118780068,2193.720343628,45
carcassonne-boltzmann260-vs-boltzmann40-1000its,877,832,2198.160698636,2145.320603822,45
carcassonne-ucttuned200-vs-ucttuned365-1000its,877,832,2227.183440808,2161.063090406,45
carcassonne-ucttuned230-vs-ucttuned415-1000its,878,833,2148.032525028,2110.168905461,45
carcassonne-ucttuned235-vs-ucttuned120-1000its,878,833,2194.256226759,2130.388076128,45
carcassonne-ucttuned405-vs-ucttuned410-1000its,878,833,2230.791619168,2166.682829513,45
carcassonne-boltzmann35-vs-boltzmann240-1000its,879,834,2267.533009102,2213.053685444,45
carcassonne-boltzmann470-vs-boltzmann80-1000its,883,838,2179.646492852,2146.93966886,45
carcassonne-uct10-vs-uct390-1000its,883,838,2166.474900499,2132.929589606,45
carcassonne-uct415-vs-uct125-1000its,884,839,2241.37444897,2212.400123608,45
carcassonne-uct345-vs-uct160-1000its,885,840,2171.162519342,2154.477480636,45
carcassonne-ucttuned45-vs-ucttuned290-1000its,891,846,2178.579850475,2151.061424072,45
carcassonne-boltzmann485-vs-boltzmann105-1000its,895,850,2244.107245532,2193.511285637,45
carcassonne-ucttuned385-vs-ucttuned145-1000its,897,852,2109.414672557,2093.176065524,45
carcassonne-uct25-vs-uct170-1000its,899,854,2281.352800104,2265.136748887,45
carcassonne-uct115-vs-uct295-1000its,904,859,2217.276181344,2188.127685642,45
carcassonne-ucttuned90-vs-ucttuned20-1000its,910,865,2198.099703051,2177.861516752,45
carcassonne-ucttuned220-vs-ucttuned200-1000its,923,878,2243.157204613,2168.441152247,45
carcassonne-ucttuned290-vs-ucttuned250-1000its,975,930,2251.83479891,2222.882728764,45
carcassonne-boltzmann300-vs-boltzmann360-1000its,748,702,2268.72544489,2206.902330615,46
carcassonne-uct195-vs-uct75-1000its,748,702,2207.733769727,2158.673951148,46
carcassonne-boltzmann280-vs-boltzmann50-1000its,750,704,2149.059232406,2133.069503979,46
carcassonne-boltzmann490-vs-boltzmann180-1000its,751,705,2231.823732268,2193.849138855,46
carcassonne-ucttuned265-vs-ucttuned225-1000its,756,710,2217.76678412,2173.730496384,46
carcassonne-uct65-vs-uct185-1000its,765,719,2140.928274327,2101.24494839,46
carcassonne-ucttuned170-vs-ucttuned315-1000its,778,732,2202.631155738,2153.070442579,46
carcassonne-boltzmann15-vs-boltzmann30-1000its,781,735,2222.716067489,2159.93498314,46
carcassonne-boltzmann480-vs-boltzmann150-1000its,784,738,2138.690023321,2097.465905322,46
carcassonne-uct390-vs-uct160-1000its,785,739,2166.202040526,2152.792873323,46
carcassonne-ucttuned445-vs-ucttuned165-1000its,785,739,2160.965878477,2114.841170003,46
carcassonne-ucttuned440-vs-ucttuned290-1000its,786,740,2187.438763934,2159.795099939,46
carcassonne-uct40-vs-uct490-1000its,787,741,2225.522205544,2208.258813768,46
carcassonne-ucttuned450-vs-ucttuned490-1000its,788,742,2210.902778043,2186.524701885,46
carcassonne-boltzmann220-vs-boltzmann65-1000its,791,745,2249.331067179,2206.899865678,46
carcassonne-ucttuned195-vs-ucttuned75-1000its,793,747,2168.574628866,2154.744284934,46
carcassonne-boltzmann435-vs-boltzmann155-1000its,794,748,2255.733403809,2208.097281209,46
carcassonne-ucttuned400-vs-ucttuned470-1000its,794,748,2217.857080799,2191.716690374,46
carcassonne-boltzmann295-vs-boltzmann120-1000its,795,749,2203.757171233,2166.929330295,46
carcassonne-uct430-vs-uct305-1000its,795,749,2211.602236143,2125.356979205,46
carcassonne-boltzmann10-vs-boltzmann225-1000its,796,750,2175.646205843,2139.532825879,46
carcassonne-boltzmann145-vs-boltzmann25-1000its,796,750,2153.028885483,2081.169509575,46
carcassonne-boltzmann160-vs-boltzmann170-1000its,797,751,2225.070111296,2197.712075963,46
carcassonne-ucttuned170-vs-ucttuned200-1000its,797,751,2228.569798295,2187.095565856,46
carcassonne-boltzmann395-vs-boltzmann135-1000its,798,752,2209.377003286,2170.389812831,46
carcassonne-uct235-vs-uct195-1000its,798,752,2308.345218923,2247.229099943,46
carcassonne-uct375-vs-uct430-1000its,799,753,2171.723728485,2110.700955123,46
carcassonne-boltzmann185-vs-boltzmann145-1000its,800,754,2137.789690553,2143.763873904,46
carcassonne-ucttuned290-vs-ucttuned325-1000its,801,755,2172.861705425,2139.511121955,46
carcassonne-ucttuned400-vs-ucttuned100-1000its,805,759,2230.742707622,2178.284035797,46
carcassonne-boltzmann180-vs-boltzmann220-1000its,806,760,2240.168162711,2165.144916714,46
carcassonne-ucttuned50-vs-ucttuned275-1000its,806,760,2166.752883567,2113.705174117,46
carcassonne-boltzmann485-vs-boltzmann325-1000its,807,761,2198.113886344,2090.006784549,46
carcassonne-ucttuned85-vs-ucttuned225-1000its,807,761,2134.330204099,2116.196895175,46
carcassonne-boltzmann220-vs-boltzmann120-1000its,808,762,2205.03255177,2156.984999806,46
carcassonne-boltzmann220-vs-boltzmann440-1000its,808,762,2197.294023026,2153.011041511,46
carcassonne-uct65-vs-uct435-1000its,808,762,2264.601497738,2244.649604081,46
carcassonne-uct185-vs-uct315-1000its,809,763,2206.731769337,2174.922460622,46
carcassonne-boltzmann430-vs-boltzmann150-1000its,810,764,2178.315668994,2140.607806495,46
carcassonne-uct345-vs-uct135-1000its,811,765,2240.129870808,2220.935204883,46
carcassonne-ucttuned460-vs-ucttuned210-1000its,811,765,2121.07628424,2095.360542799,46
carcassonne-boltzmann220-vs-boltzmann380-1000its,812,766,2158.924947031,2122.752438519,46
carcassonne-uct325-vs-uct415-1000its,812,766,2254.064225293,2242.911565959,46
carcassonne-boltzmann140-vs-boltzmann325-1000its,813,767,2171.479576645,2161.507421941,46
carcassonne-uct190-vs-uct200-1000its,813,767,2102.072056029,2098.998544027,46
carcassonne-uct25-vs-uct355-1000its,813,767,2177.696522738,2088.785555234,46
carcassonne-boltzmann250-vs-boltzmann115-1000its,817,771,2214.249194151,2197.392676906,46
carcassonne-uct45-vs-uct490-1000its,818,772,2170.335667109,2094.315926202,46
carcassonne-ucttuned410-vs-ucttuned425-1000its,818,772,2240.196877633,2124.686915773,46
carcassonne-boltzmann135-vs-boltzmann225-1000its,819,773,2183.154036544,2142.913798533,46
carcassonne-boltzmann145-vs-boltzmann300-1000its,819,773,2189.173613261,2097.446146554,46
carcassonne-uct40-vs-uct495-1000its,820,774,2207.95375529,2167.921287495,46
carcassonne-ucttuned30-vs-ucttuned405-1000its,820,774,2118.4117791,2074.437276662,46
carcassonne-uct255-vs-uct95-1000its,822,776,2170.6612234,2125.868237267,46
carcassonne-uct345-vs-uct440-1000its,822,776,2291.310868977,2239.98810849,46
carcassonne-ucttuned115-vs-ucttuned460-1000its,822,776,2235.789553392,2220.019500887,46
carcassonne-uct300-vs-uct135-1000its,823,777,2206.228480658,2196.859569898,46
carcassonne-ucttuned35-vs-ucttuned330-1000its,823,777,2201.854372671,2189.473656281,46
carcassonne-uct200-vs-uct480-1000its,824,778,2262.102208929,2212.301737787,46
carcassonne-ucttuned240-vs-ucttuned405-1000its,825,779,2232.082497295,2188.877187695,46
carcassonne-uct280-vs-uct30-1000its,827,781,2238.53099025,2170.314720084,46
carcassonne-ucttuned95-vs-ucttuned240-1000its,828,782,2269.822024829,2213.572724236,46
carcassonne-uct25-vs-uct465-1000its,829,783,2166.062714679,2119.937592057,46
carcassonne-ucttuned150-vs-ucttuned295-1000its,829,783,2257.072649146,2191.223805007,46
carcassonne-uct25-vs-uct415-1000its,831,785,2203.45056497,2200.355372639,46
carcassonne-uct350-vs-uct245-1000its,831,785,2165.852226851,2138.082379408,46
carcassonne-boltzmann255-vs-boltzmann190-1000its,832,786,2188.939684714,2109.255123656,46
carcassonne-boltzmann30-vs-boltzmann430-1000its,832,786,2092.491534485,2083.92553821,46
carcassonne-ucttuned130-vs-ucttuned390-1000its,833,787,2216.943484981,2195.961100814,46
carcassonne-ucttuned30-vs-ucttuned440-1000its,833,787,2197.414666404,2173.742385891,46
carcassonne-boltzmann465-vs-boltzmann235-1000its,835,789,2190.529324332,2118.780330973,46
carcassonne-ucttuned260-vs-ucttuned160-1000its,835,789,2223.582896004,2149.447091579,46
carcassonne-ucttuned410-vs-ucttuned140-1000its,835,789,2168.761656887,2189.361786588,46
carcassonne-boltzmann80-vs-boltzmann155-1000its,836,790,2206.3838592,2139.163613182,46
carcassonne-uct60-vs-uct30-1000its,836,790,2174.420258577,2112.347062216,46
carcassonne-uct280-vs-uct395-1000its,837,791,2212.945173525,2181.627355637,46
carcassonne-ucttuned430-vs-ucttuned270-1000its,837,791,2232.401772593,2162.53960438,46
carcassonne-uct220-vs-uct310-1000its,838,792,2209.785980083,2120.733147179,46
carcassonne-uct40-vs-uct330-1000its,838,792,2177.318482867,2183.300371817,46
carcassonne-ucttuned290-vs-ucttuned100-1000its,838,792,2208.984302791,2194.25259455,46
carcassonne-uct270-vs-uct455-1000its,839,793,2191.77429916,2129.534473666,46
carcassonne-ucttuned295-vs-ucttuned115-1000its,839,793,2177.519303173,2162.000894358,46
carcassonne-ucttuned215-vs-ucttuned45-1000its,841,795,2185.764483647,2147.792998409,46
carcassonne-ucttuned70-vs-ucttuned175-1000its,841,795,2135.503769663,2060.38662818,46
carcassonne-ucttuned285-vs-ucttuned70-1000its,842,796,2191.919097087,2154.441024255,46
carcassonne-ucttuned410-vs-ucttuned75-1000its,842,796,2270.690447272,2231.399308384,46
carcassonne-boltzmann255-vs-boltzmann110-1000its,844,798,2277.459137132,2221.272682169,46
carcassonne-boltzmann270-vs-boltzmann350-1000its,844,798,2172.636623836,2103.812668374,46
carcassonne-ucttuned75-vs-ucttuned495-1000its,844,798,2223.459169918,2198.06645966,46
carcassonne-boltzmann120-vs-boltzmann455-1000its,845,799,2192.823331118,2147.787408732,46
carcassonne-ucttuned215-vs-ucttuned360-1000its,846,800,2232.577753548,2211.572359216,46
carcassonne-ucttuned285-vs-ucttuned425-1000its,846,800,2170.227103804,2129.875666248,46
carcassonne-uct400-vs-uct315-1000its,847,801,2249.793733449,2212.754810475,46
carcassonne-ucttuned415-vs-ucttuned395-1000its,848,802,2209.74624849,2162.230806322,46
carcassonne-ucttuned60-vs-ucttuned440-1000its,848,802,2188.614308588,2155.757179239,46
carcassonne-boltzmann400-vs-boltzmann30-1000its,849,803,2222.510824494,2236.436143633,46
carcassonne-ucttuned225-vs-ucttuned290-1000its,849,803,2167.759745671,2165.120843683,46
carcassonne-boltzmann295-vs-boltzmann405-1000its,851,805,2273.382803308,2245.958255696,46
carcassonne-ucttuned445-vs-ucttuned50-1000its,851,805,2270.956117664,2200.411715151,46
carcassonne-boltzmann80-vs-boltzmann355-1000its,852,806,2189.580496704,2131.561414039,46
carcassonne-ucttuned455-vs-ucttuned290-1000its,853,807,2224.197958559,2190.355828172,46
carcassonne-ucttuned470-vs-ucttuned305-1000its,853,807,2198.135610231,2152.037112491,46
carcassonne-ucttuned335-vs-ucttuned265-1000its,854,808,2168.590043859,2142.098060212,46
carcassonne-ucttuned140-vs-ucttuned350-1000its,855,809,2250.749663476,2164.275722922,46
carcassonne-uct395-vs-uct310-1000its,856,810,2162.190101922,2139.159769694,46
carcassonne-boltzmann215-vs-boltzmann250-1000its,857,811,2180.11976665,2148.882489612,46
carcassonne-ucttuned150-vs-ucttuned450-1000its,858,812,2188.441578457,2156.53106457,46
carcassonne-boltzmann375-vs-boltzmann35-1000its,861,815,2139.865090888,2076.204617432,46
carcassonne-boltzmann465-vs-boltzmann425-1000its,861,815,2190.860296877,2168.57182673,46
carcassonne-ucttuned170-vs-ucttuned390-1000its,861,815,2268.297505579,2223.746209913,46
carcassonne-boltzmann495-vs-boltzmann420-1000its,864,818,2206.085743176,2119.816077419,46
carcassonne-ucttuned220-vs-ucttuned435-1000its,865,819,2171.783002456,2120.112267944,46
carcassonne-ucttuned365-vs-ucttuned115-1000its,865,819,2154.842047376,2119.279762154,46
carcassonne-ucttuned360-vs-ucttuned285-1000its,866,820,2203.990202279,2120.76467435,46
carcassonne-uct210-vs-uct345-1000its,868,822,2175.286140013,2141.191291839,46
carcassonne-boltzmann60-vs-boltzmann115-1000its,869,823,2128.69312651,2078.72732672,46
carcassonne-ucttuned110-vs-ucttuned95-1000its,869,823,2226.967665751,2187.718492063,46
carcassonne-uct420-vs-uct280-1000its,870,824,2295.020566343,2216.615190613,46
carcassonne-boltzmann65-vs-boltzmann345-1000its,871,825,2160.860372983,2155.013894549,46
carcassonne-ucttuned35-vs-ucttuned325-1000its,871,825,2179.433795634,2095.537380968,46
carcassonne-uct175-vs-uct125-1000its,872,826,2184.988808594,2125.989783385,46
carcassonne-ucttuned210-vs-ucttuned290-1000its,872,826,2217.64398598,2132.594127474,46
carcassonne-ucttuned10-vs-ucttuned105-1000its,874,828,2195.182099644,2131.239905534,46
carcassonne-ucttuned270-vs-ucttuned415-1000its,874,828,2247.378483066,2202.289397447,46
carcassonne-ucttuned235-vs-ucttuned365-1000its,877,831,2189.388585461,2155.709357312,46
carcassonne-ucttuned240-vs-ucttuned315-1000its,877,831,2183.562167392,2107.456773551,46
carcassonne-ucttuned365-vs-ucttuned210-1000its,878,832,2236.521737351,2163.074692459,46
carcassonne-boltzmann365-vs-boltzmann40-1000its,879,833,2186.435664509,2137.024245134,46
carcassonne-uct50-vs-uct120-1000its,879,833,2268.53441246,2209.942406063,46
carcassonne-boltzmann260-vs-boltzmann200-1000its,880,834,2244.741493059,2192.829891309,46
carcassonne-boltzmann295-vs-boltzmann305-1000its,884,838,2231.154829792,2155.292300292,46
carcassonne-uct355-vs-uct15-1000its,884,838,2196.413194456,2151.291992307,46
carcassonne-boltzmann210-vs-boltzmann65-1000its,885,839,2208.024193468,2161.573082585,46
carcassonne-uct240-vs-uct75-1000its,885,839,2251.468451943,2190.626138729,46
carcassonne-ucttuned405-vs-ucttuned155-1000its,885,839,2116.203037101,2048.9664277,46
carcassonne-boltzmann45-vs-boltzmann335-1000its,888,842,2172.509105073,2113.810130615,46
carcassonne-uct315-vs-uct270-1000its,891,845,2218.238057994,2116.221963197,46
carcassonne-boltzmann340-vs-boltzmann150-1000its,897,851,2185.850398979,2104.646508222,46
carcassonne-ucttuned425-vs-ucttuned185-1000its,898,852,2146.819531429,2115.928011594,46
carcassonne-boltzmann250-vs-boltzmann20-1000its,899,853,2165.550265153,2109.304237074,46
carcassonne-uct385-vs-uct335-1000its,906,860,2180.364416949,2137.98198459,46
carcassonne-uct305-vs-uct475-1000its,915,869,2120.362280532,2125.303766394,46
carcassonne-ucttuned15-vs-ucttuned400-1000its,928,882,2235.145496229,2196.100194181,46
carcassonne-ucttuned350-vs-ucttuned25-1000its,946,900,2185.22872521,2121.360981311,46
carcassonne-boltzmann455-vs-boltzmann145-1000its,732,685,2203.563505744,2152.234661099,47
carcassonne-boltzmann345-vs-boltzmann295-1000its,733,686,2138.422108635,2118.971180588,47
carcassonne-boltzmann360-vs-boltzmann460-1000its,758,711,2264.614983004,2235.606875812,47
carcassonne-boltzmann480-vs-boltzmann325-1000its,764,717,2259.117459857,2225.99048996,47
carcassonne-uct170-vs-uct415-1000its,764,717,2120.553751048,2104.303228025,47
carcassonne-boltzmann115-vs-boltzmann225-1000its,765,718,2168.245354641,2153.498904601,47
carcassonne-boltzmann310-vs-boltzmann340-1000its,765,718,2214.433477382,2125.658217913,47
carcassonne-boltzmann55-vs-boltzmann130-1000its,767,720,2169.37387465,2140.363508374,47
carcassonne-uct110-vs-uct490-1000its,773,726,2252.404027597,2168.710594734,47
carcassonne-uct385-vs-uct280-1000its,773,726,2173.366541388,2140.626555645,47
carcassonne-boltzmann295-vs-boltzmann340-1000its,774,727,2218.708483292,2185.105314384,47
carcassonne-uct380-vs-uct215-1000its,774,727,2228.717490828,2163.947431102,47
carcassonne-ucttuned405-vs-ucttuned115-1000its,774,727,2146.454013309,2066.944826964,47
carcassonne-boltzmann210-vs-boltzmann450-1000its,775,728,2268.787145849,2160.727454533,47
carcassonne-uct135-vs-uct95-1000its,775,728,2260.747182272,2207.163500516,47
carcassonne-ucttuned135-vs-ucttuned245-1000its,777,730,2241.0319544,2191.320134628,47
carcassonne-ucttuned75-vs-ucttuned165-1000its,780,733,2175.019832687,2126.066137794,47
carcassonne-uct280-vs-uct335-1000its,782,735,2188.365549378,2133.853028895,47
carcassonne-boltzmann25-vs-boltzmann465-1000its,785,738,2175.051239018,2164.289361063,47
carcassonne-boltzmann350-vs-boltzmann235-1000its,785,738,2219.199344725,2110.838073809,47
carcassonne-uct470-vs-uct495-1000its,786,739,2275.127083752,2211.291140371,47
carcassonne-uct65-vs-uct60-1000its,787,740,2192.229470062,2170.803495383,47
carcassonne-ucttuned375-vs-ucttuned330-1000its,787,740,2156.606047759,2092.184027995,47
carcassonne-uct300-vs-uct180-1000its,789,742,2197.24443542,2118.557836946,47
carcassonne-uct270-vs-uct330-1000its,796,749,2173.283041762,2128.120065984,47
carcassonne-uct480-vs-uct340-1000its,796,749,2223.466532478,2213.731897392,47
carcassonne-boltzmann200-vs-boltzmann355-1000its,797,750,2196.9763667,2155.083328755,47
carcassonne-uct35-vs-uct345-1000its,798,751,2144.610289832,2145.349330332,47
carcassonne-uct400-vs-uct320-1000its,799,752,2250.231812325,2159.822121371,47
carcassonne-boltzmann235-vs-boltzmann495-1000its,800,753,2212.912401385,2215.811361752,47
carcassonne-ucttuned320-vs-ucttuned295-1000its,800,753,2217.20484261,2153.127614771,47
carcassonne-boltzmann445-vs-boltzmann170-1000its,801,754,2181.054650878,2158.319943298,47
carcassonne-boltzmann35-vs-boltzmann70-1000its,803,756,2217.460521357,2175.50433821,47
carcassonne-ucttuned460-vs-ucttuned325-1000its,806,759,2187.064903658,2144.974403624,47
carcassonne-ucttuned390-vs-ucttuned200-1000its,807,760,2146.827183157,2152.31481975,47
carcassonne-uct195-vs-uct440-1000its,811,764,2125.740042417,2041.781955815,47
carcassonne-boltzmann170-vs-boltzmann75-1000its,812,765,2261.558732856,2261.838500841,47
carcassonne-ucttuned415-vs-ucttuned145-1000its,812,765,2268.481051603,2222.981541187,47
carcassonne-boltzmann230-vs-boltzmann155-1000its,813,766,2255.362406712,2155.029652139,47
carcassonne-uct135-vs-uct285-1000its,815,768,2143.060255701,2078.467809188,47
carcassonne-uct345-vs-uct100-1000its,816,769,2192.228161503,2155.035208802,47
carcassonne-boltzmann105-vs-boltzmann360-1000its,817,770,2239.93460541,2162.405574217,47
carcassonne-uct95-vs-uct145-1000its,817,770,2178.124347363,2124.230763391,47
carcassonne-boltzmann60-vs-boltzmann180-1000its,818,771,2200.219204887,2169.637181017,47
carcassonne-uct35-vs-uct130-1000its,818,771,2267.008877112,2237.538146676,47
carcassonne-uct370-vs-uct375-1000its,818,771,2154.001561667,2101.355035847,47
carcassonne-boltzmann70-vs-boltzmann485-1000its,820,773,2260.032948041,2219.857634091,47
carcassonne-uct205-vs-uct480-1000its,820,773,2172.88627398,2161.50375624,47
carcassonne-uct210-vs-uct165-1000its,820,773,2246.15280146,2227.747636544,47
carcassonne-ucttuned185-vs-ucttuned20-1000its,820,773,2140.795027249,2141.701491833,47
carcassonne-ucttuned245-vs-ucttuned460-1000its,820,773,2122.130174093,2093.521726923,47
carcassonne-boltzmann365-vs-boltzmann400-1000its,821,774,2182.826501573,2134.219109858,47
carcassonne-boltzmann285-vs-boltzmann225-1000its,823,776,2175.566596124,2154.342755881,47
carcassonne-ucttuned235-vs-ucttuned145-1000its,823,776,2134.824545107,2092.801743962,47
carcassonne-ucttuned245-vs-ucttuned310-1000its,823,776,2191.416679208,2156.744292764,47
carcassonne-ucttuned5-vs-ucttuned125-1000its,823,776,2130.013157052,2107.209835674,47
carcassonne-boltzmann40-vs-boltzmann445-1000its,824,777,2152.221187827,2147.806428696,47
carcassonne-ucttuned315-vs-ucttuned350-1000its,826,779,2165.580262865,2127.989966612,47
carcassonne-uct10-vs-uct190-1000its,827,780,2122.982569871,2070.992473798,47
carcassonne-ucttuned260-vs-ucttuned475-1000its,827,780,2153.740473979,2123.278753094,47
carcassonne-boltzmann435-vs-boltzmann230-1000its,829,782,2250.366319474,2169.047370349,47
carcassonne-boltzmann450-vs-boltzmann140-1000its,829,782,2270.890188869,2229.836444777,47
carcassonne-ucttuned70-vs-ucttuned265-1000its,829,782,2178.843012428,2114.671060837,47
carcassonne-ucttuned75-vs-ucttuned305-1000its,829,782,2188.354841269,2183.12481443,47
carcassonne-boltzmann475-vs-boltzmann175-1000its,830,783,2164.749955661,2115.139519781,47
carcassonne-ucttuned150-vs-ucttuned125-1000its,830,783,2181.001903634,2105.114465808,47
carcassonne-boltzmann130-vs-boltzmann75-1000its,832,785,2207.8242687,2196.951405147,47
carcassonne-boltzmann405-vs-boltzmann195-1000its,834,787,2216.720965336,2187.274670094,47
carcassonne-ucttuned120-vs-ucttuned485-1000its,835,788,2206.502954203,2147.075657672,47
carcassonne-ucttuned145-vs-ucttuned250-1000its,835,788,2197.094075171,2176.201051507,47
carcassonne-ucttuned80-vs-ucttuned305-1000its,835,788,2196.138355695,2135.136455191,47
carcassonne-boltzmann45-vs-boltzmann110-1000its,837,790,2110.795711101,2067.780966999,47
carcassonne-ucttuned300-vs-ucttuned85-1000its,837,790,2224.461170704,2153.177929226,47
carcassonne-uct335-vs-uct80-1000its,840,793,2202.990500188,2162.743183749,47
carcassonne-ucttuned10-vs-ucttuned290-1000its,840,793,2162.476759653,2083.834603513,47
carcassonne-ucttuned130-vs-ucttuned150-1000its,840,793,2292.908917582,2194.70734898,47
carcassonne-uct180-vs-uct480-1000its,842,795,2098.631703775,2042.68227277,47
carcassonne-ucttuned105-vs-ucttuned280-1000its,842,795,2250.16239429,2184.221510239,47
carcassonne-uct425-vs-uct440-1000its,844,797,2144.053036512,2130.529154571,47
carcassonne-boltzmann370-vs-boltzmann90-1000its,845,798,2213.074072574,2153.230065542,47
carcassonne-ucttuned120-vs-ucttuned115-1000its,845,798,2188.33014647,2139.626295466,47
carcassonne-boltzmann465-vs-boltzmann340-1000its,846,799,2194.350606767,2116.678282252,47
carcassonne-uct405-vs-uct235-1000its,848,801,2212.066073231,2177.507345814,47
carcassonne-ucttuned310-vs-ucttuned70-1000its,848,801,2192.257382355,2196.017752603,47
carcassonne-ucttuned255-vs-ucttuned100-1000its,849,802,2186.399861545,2187.305087174,47
carcassonne-boltzmann205-vs-boltzmann325-1000its,850,803,2115.173674119,2086.554645458,47
carcassonne-boltzmann490-vs-boltzmann35-1000its,851,804,2180.413631489,2143.36107235,47
carcassonne-ucttuned120-vs-ucttuned200-1000its,851,804,2219.851420964,2204.390081589,47
carcassonne-boltzmann200-vs-boltzmann145-1000its,852,805,2208.088537661,2199.464874752,47
carcassonne-boltzmann305-vs-boltzmann365-1000its,853,806,2205.89911761,2163.242492815,47
carcassonne-boltzmann445-vs-boltzmann175-1000its,854,807,2214.414951187,2188.047344308,47
carcassonne-ucttuned70-vs-ucttuned220-1000its,855,808,2183.189266121,2162.294846829,47
carcassonne-uct400-vs-uct55-1000its,857,810,2269.577566487,2214.626336539,47
carcassonne-uct305-vs-uct175-1000its,858,811,2244.309490914,2193.255866769,47
carcassonne-uct405-vs-uct390-1000its,859,812,2216.223974173,2145.346111918,47
carcassonne-ucttuned345-vs-ucttuned85-1000its,863,816,2131.134683157,2089.756549959,47
carcassonne-ucttuned260-vs-ucttuned155-1000its,866,819,2186.576411655,2149.438784546,47
carcassonne-uct450-vs-uct245-1000its,868,821,2255.844459959,2191.466874423,47
carcassonne-boltzmann390-vs-boltzmann235-1000its,869,822,2187.349933446,2112.706338517,47
carcassonne-uct30-vs-uct230-1000its,870,823,2184.110458451,2162.193408029,47
carcassonne-boltzmann305-vs-boltzmann275-1000its,871,824,2217.777402084,2166.113834566,47
carcassonne-ucttuned110-vs-ucttuned100-1000its,873,826,2205.248147857,2130.742346304,47
carcassonne-boltzmann10-vs-boltzmann490-1000its,874,827,2167.948123396,2144.079741052,47
carcassonne-ucttuned245-vs-ucttuned130-1000its,876,829,2176.318242008,2142.9666456,47
carcassonne-ucttuned190-vs-ucttuned185-1000its,878,831,2158.142379777,2110.044063223,47
carcassonne-ucttuned350-vs-ucttuned360-1000its,878,831,2210.817786425,2178.307051427,47
carcassonne-ucttuned400-vs-ucttuned205-1000its,878,831,2163.381177314,2132.43276882,47
carcassonne-ucttuned20-vs-ucttuned420-1000its,879,832,2196.041596028,2173.991442954,47
carcassonne-uct145-vs-uct230-1000its,883,836,2211.356138638,2129.535350984,47
carcassonne-uct20-vs-uct445-1000its,886,839,2151.413424355,2124.153544238,47
carcassonne-uct90-vs-uct105-1000its,886,839,2255.781291061,2217.348079182,47
carcassonne-ucttuned115-vs-ucttuned65-1000its,887,840,2232.605532287,2145.296129229,47
carcassonne-boltzmann230-vs-boltzmann290-1000its,888,841,2297.934049988,2243.318049905,47
carcassonne-boltzmann420-vs-boltzmann405-1000its,889,842,2298.000302454,2268.72457797,47
carcassonne-ucttuned195-vs-ucttuned275-1000its,895,848,2287.01739871,2209.833644369,47
carcassonne-boltzmann365-vs-boltzmann45-1000its,897,850,2151.604604844,2135.294452276,47
carcassonne-boltzmann45-vs-boltzmann20-1000its,898,851,2165.470804385,2139.861247598,47
carcassonne-ucttuned30-vs-ucttuned425-1000its,898,851,2170.405152035,2131.620629559,47
carcassonne-boltzmann10-vs-boltzmann335-1000its,899,852,2221.480982605,2174.086976676,47
carcassonne-boltzmann130-vs-boltzmann210-1000its,902,855,2144.926278043,2082.938686686,47
carcassonne-uct85-vs-uct130-1000its,909,862,2238.286523291,2194.399804887,47
carcassonne-ucttuned265-vs-ucttuned90-1000its,910,863,2172.284305217,2118.246344018,47
carcassonne-uct415-vs-uct410-1000its,914,867,2204.416864359,2153.976377873,47
carcassonne-ucttuned45-vs-ucttuned275-1000its,922,875,2213.281075891,2195.408687974,47
carcassonne-ucttuned395-vs-ucttuned250-1000its,925,878,2227.40397375,2188.2378114,47
carcassonne-ucttuned95-vs-ucttuned110-1000its,938,891,2200.751424026,2150.523290433,47
carcassonne-uct50-vs-uct275-1000its,944,897,2233.147838982,2203.496965569,47
carcassonne-ucttuned35-vs-ucttuned145-1000its,583,535,1751.880222001,1718.768906918,48
carcassonne-uct360-vs-uct285-1000its,744,696,2189.956346593,2090.192111332,48
carcassonne-boltzmann350-vs-boltzmann150-1000its,751,703,2254.834135089,2169.443276115,48
carcassonne-uct235-vs-uct330-1000its,756,708,2197.767128793,2146.251419504,48
carcassonne-ucttuned240-vs-ucttuned285-1000its,764,716,2148.654600729,2076.596408628,48
carcassonne-uct385-vs-uct450-1000its,765,717,2133.741260313,2178.829969954,48
carcassonne-boltzmann415-vs-boltzmann435-1000its,773,725,2165.127975848,2101.15965661,48
carcassonne-ucttuned180-vs-ucttuned75-1000its,776,728,2234.286350713,2181.384510104,48
carcassonne-boltzmann490-vs-boltzmann40-1000its,780,732,2268.094456384,2148.92775501,48
carcassonne-boltzmann480-vs-boltzmann465-1000its,783,735,2183.650429759,2095.926112627,48
carcassonne-ucttuned445-vs-ucttuned215-1000its,783,735,2239.144832883,2179.5296976,48
carcassonne-boltzmann105-vs-boltzmann250-1000its,785,737,2195.841424168,2174.431803939,48
carcassonne-boltzmann325-vs-boltzmann70-1000its,785,737,2152.219233961,2107.241645511,48
carcassonne-uct445-vs-uct340-1000its,785,737,2181.256191324,2172.027938693,48
carcassonne-ucttuned115-vs-ucttuned240-1000its,785,737,2196.502852295,2185.915945886,48
carcassonne-boltzmann210-vs-boltzmann35-1000its,787,739,2257.411263907,2206.46789916,48
carcassonne-uct80-vs-uct215-1000its,787,739,2201.688269165,2140.556693541,48
carcassonne-boltzmann280-vs-boltzmann300-1000its,789,741,2129.688577127,2116.416503466,48
carcassonne-uct85-vs-uct125-1000its,789,741,2285.965432754,2243.672770919,48
carcassonne-boltzmann480-vs-boltzmann310-1000its,791,743,2143.724232352,2109.448037744,48
carcassonne-ucttuned485-vs-ucttuned335-1000its,791,743,2172.919413512,2145.951989249,48
carcassonne-uct480-vs-uct155-1000its,792,744,2210.272309137,2181.80106189,48
carcassonne-boltzmann260-vs-boltzmann115-1000its,794,746,2153.791525179,2173.558351673,48
carcassonne-ucttuned490-vs-ucttuned180-1000its,794,746,2188.239508857,2154.813757916,48
carcassonne-boltzmann365-vs-boltzmann460-1000its,795,747,2189.600851847,2139.721086859,48
carcassonne-ucttuned30-vs-ucttuned450-1000its,795,747,2240.477814007,2184.603698877,48
carcassonne-boltzmann245-vs-boltzmann465-1000its,796,748,2164.807413296,2093.153142994,48
carcassonne-boltzmann110-vs-boltzmann345-1000its,797,749,2279.038765589,2218.682514688,48
carcassonne-boltzmann80-vs-boltzmann490-1000its,798,750,2226.744744784,2155.464564901,48
carcassonne-uct95-vs-uct490-1000its,798,750,2196.896805996,2122.323287524,48
carcassonne-ucttuned420-vs-ucttuned55-1000its,798,750,2169.825773066,2172.195482601,48
carcassonne-uct420-vs-uct275-1000its,799,751,2161.421075803,2159.780138086,48
carcassonne-ucttuned305-vs-ucttuned365-1000its,799,751,2147.947851905,2101.820914798,48
carcassonne-ucttuned440-vs-ucttuned355-1000its,800,752,2166.956233092,2185.828448117,48
carcassonne-boltzmann15-vs-boltzmann100-1000its,801,753,2243.88741041,2193.994242092,48
carcassonne-boltzmann200-vs-boltzmann165-1000its,801,753,2270.20795108,2229.710611718,48
carcassonne-boltzmann445-vs-boltzmann435-1000its,801,753,2200.140174469,2175.656590542,48
carcassonne-ucttuned120-vs-ucttuned110-1000its,801,753,2228.215915689,2192.901990843,48
carcassonne-uct395-vs-uct330-1000its,802,754,2192.02309911,2169.00248227,48
carcassonne-ucttuned250-vs-ucttuned35-1000its,805,757,2224.677194371,2182.759637347,48
carcassonne-ucttuned450-vs-ucttuned460-1000its,805,757,2196.618376914,2167.026616138,48
carcassonne-boltzmann300-vs-boltzmann180-1000its,806,758,2172.026070058,2155.101945344,48
carcassonne-boltzmann380-vs-boltzmann15-1000its,806,758,2279.056766565,2215.03992224,48
carcassonne-boltzmann205-vs-boltzmann405-1000its,807,759,2250.758914932,2238.095525318,48
carcassonne-boltzmann485-vs-boltzmann460-1000its,810,762,2156.42830128,2099.3014401,48
carcassonne-ucttuned330-vs-ucttuned225-1000its,813,765,2238.450308121,2202.154221126,48
carcassonne-ucttuned305-vs-ucttuned145-1000its,814,766,2236.451283079,2161.250716715,48
carcassonne-uct455-vs-uct55-1000its,816,768,2131.792391419,2102.483001969,48
carcassonne-uct50-vs-uct320-1000its,816,768,2171.862938084,2095.003574052,48
carcassonne-boltzmann20-vs-boltzmann450-1000its,817,769,2303.98547345,2243.431745331,48
carcassonne-uct70-vs-uct240-1000its,817,769,2178.938038746,2100.306205146,48
carcassonne-boltzmann485-vs-boltzmann245-1000its,818,770,2208.029062131,2084.825425115,48
carcassonne-ucttuned175-vs-ucttuned115-1000its,818,770,2144.256602089,2115.369659988,48
carcassonne-ucttuned40-vs-ucttuned485-1000its,819,771,2156.877841961,2134.269313671,48
carcassonne-boltzmann360-vs-boltzmann415-1000its,820,772,2217.042167509,2146.901165825,48
carcassonne-ucttuned280-vs-ucttuned480-1000its,820,772,2173.74411813,2118.92823872,48
carcassonne-uct100-vs-uct25-1000its,822,774,2112.399899853,2086.880743447,48
carcassonne-boltzmann460-vs-boltzmann435-1000its,823,775,2220.778846171,2133.886969764,48
carcassonne-boltzmann50-vs-boltzmann295-1000its,823,775,2134.915702522,2073.920080642,48
carcassonne-uct155-vs-uct460-1000its,823,775,2144.825013774,2107.457099152,48
carcassonne-ucttuned255-vs-ucttuned320-1000its,823,775,2141.339446509,2102.385063088,48
carcassonne-uct480-vs-uct370-1000its,824,776,2171.829262101,2125.694248972,48
carcassonne-boltzmann430-vs-boltzmann85-1000its,825,777,2162.885103465,2148.036102103,48
carcassonne-boltzmann155-vs-boltzmann410-1000its,826,778,2214.511471753,2190.447981748,48
carcassonne-ucttuned475-vs-ucttuned390-1000its,826,778,2158.771779209,2105.878721949,48
carcassonne-boltzmann85-vs-boltzmann300-1000its,827,779,2249.710109697,2175.205497055,48
carcassonne-boltzmann355-vs-boltzmann60-1000its,828,780,2251.76651461,2200.398814266,48
carcassonne-uct260-vs-uct110-1000its,828,780,2192.637138209,2158.237582151,48
carcassonne-uct490-vs-uct65-1000its,828,780,2093.687189723,2078.090344923,48
carcassonne-ucttuned260-vs-ucttuned225-1000its,828,780,2151.894877779,2121.466802287,48
carcassonne-boltzmann140-vs-boltzmann335-1000its,829,781,2285.368487395,2285.196851652,48
carcassonne-uct195-vs-uct355-1000its,829,781,2165.775036282,2073.05017537,48
carcassonne-ucttuned255-vs-ucttuned265-1000its,829,781,2168.412565631,2124.965427765,48
carcassonne-boltzmann320-vs-boltzmann275-1000its,830,782,2165.412719299,2162.055211714,48
carcassonne-ucttuned450-vs-ucttuned45-1000its,830,782,2277.687266446,2187.310753308,48
carcassonne-uct215-vs-uct290-1000its,832,784,2238.053485717,2179.537938426,48
carcassonne-uct320-vs-uct165-1000its,833,785,2287.365906585,2205.182417028,48
carcassonne-ucttuned65-vs-ucttuned175-1000its,833,785,2263.39923921,2172.4798746,48
carcassonne-uct135-vs-uct110-1000its,834,786,2202.348045429,2186.644822093,48
carcassonne-uct160-vs-uct485-1000its,834,786,2180.903830657,2157.352786545,48
carcassonne-uct340-vs-uct285-1000its,834,786,2226.261572439,2180.193773273,48
carcassonne-ucttuned260-vs-ucttuned145-1000its,834,786,2262.179482639,2171.313807205,48
carcassonne-boltzmann335-vs-boltzmann100-1000its,835,787,2187.496480336,2154.045889105,48
carcassonne-uct485-vs-uct190-1000its,835,787,2220.07256866,2144.393829488,48
carcassonne-boltzmann420-vs-boltzmann445-1000its,837,789,2207.843546803,2164.965785736,48
carcassonne-boltzmann425-vs-boltzmann305-1000its,837,789,2188.140143106,2104.949512847,48
carcassonne-uct360-vs-uct250-1000its,837,789,2238.683301799,2198.700957424,48
carcassonne-uct65-vs-uct105-1000its,839,791,2188.290116441,2198.280560861,48
carcassonne-ucttuned340-vs-ucttuned395-1000its,839,791,2159.541492065,2116.971955107,48
carcassonne-ucttuned45-vs-ucttuned495-1000its,839,791,2172.181797411,2165.185949314,48
carcassonne-ucttuned465-vs-ucttuned80-1000its,839,791,2176.852176065,2156.773280166,48
carcassonne-boltzmann325-vs-boltzmann215-1000its,840,792,2264.989322526,2184.863052718,48
carcassonne-ucttuned465-vs-ucttuned95-1000its,840,792,2145.136673049,2145.678965355,48
carcassonne-ucttuned235-vs-ucttuned375-1000its,841,793,2176.562195605,2118.869943741,48
carcassonne-ucttuned345-vs-ucttuned415-1000its,841,793,2180.929286102,2127.177248684,48
carcassonne-boltzmann395-vs-boltzmann125-1000its,843,795,2150.413416332,2121.5199237,48
carcassonne-boltzmann80-vs-boltzmann15-1000its,843,795,2202.946853278,2148.157698238,48
carcassonne-ucttuned145-vs-ucttuned220-1000its,843,795,2181.67420793,2106.626438124,48
carcassonne-uct295-vs-uct110-1000its,844,796,2213.56015082,2177.374465294,48
carcassonne-ucttuned50-vs-ucttuned200-1000its,845,797,2206.657893967,2154.639091199,48
carcassonne-uct285-vs-uct245-1000its,847,799,2258.860886396,2179.435897097,48
carcassonne-uct480-vs-uct255-1000its,847,799,2314.840410772,2216.624266511,48
carcassonne-ucttuned50-vs-ucttuned445-1000its,847,799,2193.455719996,2163.402717613,48
carcassonne-uct285-vs-uct60-1000its,848,800,2198.236478313,2174.662576063,48
carcassonne-uct405-vs-uct400-1000its,848,800,2206.963027942,2146.293856773,48
carcassonne-ucttuned170-vs-ucttuned95-1000its,848,800,2247.149812542,2210.336591425,48
carcassonne-uct485-vs-uct135-1000its,849,801,2226.615894324,2200.597973729,48
carcassonne-ucttuned175-vs-ucttuned420-1000its,849,801,2190.244445798,2146.884228846,48
carcassonne-ucttuned310-vs-ucttuned195-1000its,849,801,2175.400304738,2083.273308263,48
carcassonne-ucttuned5-vs-ucttuned100-1000its,850,802,2255.356712459,2172.261480892,48
carcassonne-uct435-vs-uct495-1000its,851,803,2243.166598729,2229.016197024,48
carcassonne-uct320-vs-uct175-1000its,854,806,2251.021058658,2191.614573469,48
carcassonne-ucttuned220-vs-ucttuned355-1000its,854,806,2240.130220917,2183.412100481,48
carcassonne-ucttuned400-vs-ucttuned380-1000its,857,809,2210.589694713,2134.998674948,48
carcassonne-boltzmann330-vs-boltzmann375-1000its,858,810,2139.732144386,2079.337197937,48
carcassonne-ucttuned105-vs-ucttuned80-1000its,858,810,2136.539975883,2109.241402507,48
carcassonne-ucttuned115-vs-ucttuned225-1000its,858,810,2171.14432991,2132.852979999,48
carcassonne-ucttuned105-vs-ucttuned140-1000its,861,813,2205.931097515,2156.775332597,48
carcassonne-uct15-vs-uct290-1000its,862,814,2228.968443449,2158.686485578,48
carcassonne-ucttuned165-vs-ucttuned270-1000its,863,815,2287.81493773,2232.704609606,48
carcassonne-ucttuned410-vs-ucttuned270-1000its,863,815,2239.259242832,2146.010697366,48
carcassonne-boltzmann165-vs-boltzmann310-1000its,864,816,2197.059702505,2142.249580652,48
carcassonne-boltzmann145-vs-boltzmann270-1000its,865,817,2293.076048432,2220.93715921,48
carcassonne-boltzmann420-vs-boltzmann435-1000its,865,817,2213.566174412,2219.599606539,48
carcassonne-boltzmann465-vs-boltzmann40-1000its,867,819,2233.096839735,2182.612111903,48
carcassonne-ucttuned275-vs-ucttuned190-1000its,868,820,2207.759799311,2193.219472006,48
carcassonne-ucttuned40-vs-ucttuned105-1000its,869,821,2172.268742406,2161.257885712,48
carcassonne-uct135-vs-uct370-1000its,870,822,2164.512523533,2129.560509652,48
carcassonne-ucttuned455-vs-ucttuned480-1000its,870,822,2207.923949272,2156.615247903,48
carcassonne-boltzmann65-vs-boltzmann240-1000its,871,823,2138.237706386,2081.281918968,48
carcassonne-uct465-vs-uct55-1000its,872,824,2234.80917017,2227.296732878,48
carcassonne-ucttuned10-vs-ucttuned255-1000its,874,826,2162.177073136,2068.512486199,48
carcassonne-ucttuned270-vs-ucttuned290-1000its,874,826,2207.60801603,2161.848369905,48
carcassonne-boltzmann265-vs-boltzmann285-1000its,875,827,2218.352849639,2208.847871455,48
carcassonne-uct85-vs-uct80-1000its,878,830,2225.824886781,2202.922581407,48
carcassonne-boltzmann225-vs-boltzmann425-1000its,880,832,2189.397116468,2143.924494449,48
carcassonne-ucttuned125-vs-ucttuned170-1000its,880,832,2155.524538605,2102.755482973,48
carcassonne-ucttuned265-vs-ucttuned240-1000its,881,833,2193.901671826,2162.354911933,48
carcassonne-uct290-vs-uct285-1000its,882,834,2223.820736697,2133.680980877,48
carcassonne-uct300-vs-uct5-1000its,882,834,2214.701916777,2124.389261143,48
carcassonne-uct5-vs-uct150-1000its,882,834,2301.213624599,2253.929196814,48
carcassonne-boltzmann20-vs-boltzmann200-1000its,887,839,2277.487282007,2199.168315208,48
carcassonne-boltzmann390-vs-boltzmann45-1000its,887,839,2211.040489004,2173.201263125,48
carcassonne-ucttuned45-vs-ucttuned55-1000its,889,841,2193.147003982,2109.591694486,48
carcassonne-uct100-vs-uct400-1000its,890,842,2163.879550196,2138.346218606,48
carcassonne-uct140-vs-uct410-1000its,890,842,2171.634387291,2095.632206155,48
carcassonne-ucttuned215-vs-ucttuned70-1000its,890,842,2199.913231946,2150.585119094,48
carcassonne-ucttuned295-vs-ucttuned190-1000its,890,842,2212.231003571,2222.483517712,48
carcassonne-ucttuned435-vs-ucttuned85-1000its,892,844,2135.47864255,2115.011333054,48
carcassonne-ucttuned105-vs-ucttuned395-1000its,893,845,2185.59392623,2162.544611367,48
carcassonne-uct315-vs-uct320-1000its,894,846,2175.584114686,2134.52575336,48
carcassonne-uct20-vs-uct5-1000its,896,848,2168.212019939,2212.660640778,48
carcassonne-ucttuned420-vs-ucttuned370-1000its,898,850,2251.178662882,2201.662751304,48
carcassonne-ucttuned135-vs-ucttuned230-1000its,900,852,2191.509378969,2088.81106364,48
carcassonne-uct215-vs-uct370-1000its,907,859,2291.720852338,2216.510561994,48
carcassonne-uct65-vs-uct375-1000its,912,864,2175.815191723,2086.703266648,48
carcassonne-ucttuned30-vs-ucttuned10-1000its,919,871,2131.242357336,2070.117152753,48
carcassonne-ucttuned165-vs-ucttuned170-1000its,931,883,2247.226322951,2219.603404383,48
carcassonne-ucttuned10-vs-ucttuned350-1000its,934,886,2203.030735751,2140.225940821,48
carcassonne-boltzmann95-vs-boltzmann200-1000its,727,678,2217.136041697,2102.391854702,49
carcassonne-boltzmann380-vs-boltzmann335-1000its,751,702,2181.947808175,2156.107592344,49
carcassonne-ucttuned410-vs-ucttuned70-1000its,751,702,2226.607802785,2201.714851481,49
carcassonne-ucttuned260-vs-ucttuned95-1000its,752,703,2138.900210208,2102.419925391,49
carcassonne-ucttuned75-vs-ucttuned465-1000its,755,706,2235.010388299,2176.086490135,49
carcassonne-boltzmann15-vs-boltzmann200-1000its,760,711,2209.48772228,2155.30798219,49
carcassonne-boltzmann170-vs-boltzmann265-1000its,761,712,2241.469388652,2228.679626272,49
carcassonne-boltzmann75-vs-boltzmann105-1000its,766,717,2208.977323515,2149.005610522,49
carcassonne-boltzmann205-vs-boltzmann305-1000its,768,719,2189.674902492,2185.11539592,49
carcassonne-boltzmann340-vs-boltzmann480-1000its,774,725,2190.156101104,2137.261430375,49
carcassonne-boltzmann130-vs-boltzmann225-1000its,777,728,2253.50989486,2165.263443074,49
carcassonne-boltzmann80-vs-boltzmann470-1000its,781,732,2124.409466622,2056.656320803,49
carcassonne-boltzmann180-vs-boltzmann185-1000its,782,733,2181.801228221,2121.333974382,49
carcassonne-ucttuned105-vs-ucttuned320-1000its,786,737,2149.628188584,2128.832430135,49
carcassonne-boltzmann205-vs-boltzmann440-1000its,788,739,2206.330986936,2116.826693845,49
carcassonne-ucttuned55-vs-ucttuned475-1000its,788,739,2193.628842016,2143.37693866,49
carcassonne-uct435-vs-uct90-1000its,789,740,2240.779470029,2164.236707934,49
carcassonne-uct495-vs-uct130-1000its,789,740,2260.622441934,2170.46426975,49
carcassonne-boltzmann30-vs-boltzmann190-1000its,790,741,2246.191691113,2187.546596747,49
carcassonne-boltzmann380-vs-boltzmann415-1000its,792,743,2229.230349696,2185.46573818,49
carcassonne-uct335-vs-uct430-1000its,792,743,2187.341814231,2136.534033919,49
carcassonne-boltzmann35-vs-boltzmann210-1000its,794,745,2184.154794267,2176.32408349,49
carcassonne-uct355-vs-uct130-1000its,795,746,2226.070811864,2157.165568995,49
carcassonne-ucttuned210-vs-ucttuned225-1000its,795,746,2261.323990138,2163.398741376,49
carcassonne-boltzmann155-vs-boltzmann305-1000its,796,747,2161.516881035,2098.148959554,49
carcassonne-boltzmann470-vs-boltzmann330-1000its,796,747,2150.868301698,2114.913628105,49
carcassonne-ucttuned360-vs-ucttuned325-1000its,796,747,2188.6459531,2163.77538951,49
carcassonne-boltzmann260-vs-boltzmann245-1000its,797,748,2154.378627263,2122.354266737,49
carcassonne-uct60-vs-uct230-1000its,799,750,2177.952895568,2120.562526416,49
carcassonne-boltzmann50-vs-boltzmann175-1000its,800,751,2150.061675414,2115.708010048,49
carcassonne-boltzmann155-vs-boltzmann35-1000its,801,752,2255.531961705,2231.366991702,49
carcassonne-boltzmann375-vs-boltzmann265-1000its,802,753,2234.004011198,2154.056130536,49
carcassonne-uct125-vs-uct60-1000its,802,753,2245.371734265,2245.624011569,49
carcassonne-ucttuned190-vs-ucttuned265-1000its,802,753,2259.293029287,2171.526241514,49
carcassonne-uct35-vs-uct450-1000its,803,754,2128.336743131,2091.001418465,49
carcassonne-ucttuned415-vs-ucttuned305-1000its,806,757,2342.630019426,2282.6453581,49
carcassonne-boltzmann270-vs-boltzmann320-1000its,807,758,2212.593391945,2169.667234431,49
carcassonne-uct355-vs-uct300-1000its,808,759,2156.522162336,2096.766661155,49
carcassonne-boltzmann305-vs-boltzmann150-1000its,809,760,2156.732023586,2097.335630117,49
carcassonne-uct25-vs-uct460-1000its,809,760,2179.186569847,2179.753385419,49
carcassonne-boltzmann80-vs-boltzmann85-1000its,812,763,2212.225822742,2153.475142389,49
carcassonne-uct80-vs-uct125-1000its,815,766,2172.655879597,2132.39641005,49
carcassonne-boltzmann220-vs-boltzmann415-1000its,816,767,2230.238279444,2162.553486464,49
carcassonne-uct425-vs-uct135-1000its,818,769,2177.325816461,2157.389842989,49
carcassonne-ucttuned195-vs-ucttuned320-1000its,818,769,2178.396906982,2147.070477305,49
carcassonne-ucttuned300-vs-ucttuned280-1000its,819,770,2286.893907247,2234.145564209,49
carcassonne-ucttuned35-vs-ucttuned210-1000its,819,770,2203.355518637,2119.198904449,49
carcassonne-uct70-vs-uct325-1000its,820,771,2231.138164155,2143.461057339,49
carcassonne-boltzmann110-vs-boltzmann180-1000its,823,774,2200.408905623,2172.889638674,49
carcassonne-boltzmann30-vs-boltzmann370-1000its,823,774,2126.661425039,2096.845328425,49
carcassonne-uct205-vs-uct215-1000its,823,774,2197.097792934,2172.696044435,49
carcassonne-boltzmann25-vs-boltzmann285-1000its,824,775,2217.713169031,2150.304907672,49
carcassonne-boltzmann45-vs-boltzmann480-1000its,824,775,2242.583402831,2186.671929606,49
carcassonne-ucttuned260-vs-ucttuned270-1000its,826,777,2081.898125777,2035.943947242,49
carcassonne-ucttuned430-vs-ucttuned110-1000its,829,780,2160.989569659,2122.730993097,49
carcassonne-boltzmann190-vs-boltzmann180-1000its,830,781,2145.711560077,2045.838816619,49
carcassonne-uct325-vs-uct215-1000its,830,781,2155.32835878,2156.312563828,49
carcassonne-uct385-vs-uct480-1000its,830,781,2236.534729191,2158.183244661,49
carcassonne-uct395-vs-uct100-1000its,830,781,2177.087218462,2144.514922834,49
carcassonne-uct350-vs-uct230-1000its,831,782,2237.581537017,2188.934403323,49
carcassonne-ucttuned365-vs-ucttuned275-1000its,831,782,2210.00391002,2191.209553865,49
carcassonne-boltzmann175-vs-boltzmann165-1000its,833,784,2141.20376126,2080.905751177,49
carcassonne-uct465-vs-uct145-1000its,833,784,2185.653934047,2079.810330564,49
carcassonne-ucttuned140-vs-ucttuned195-1000its,833,784,2185.109011233,2151.129080286,49
carcassonne-boltzmann40-vs-boltzmann85-1000its,835,786,2146.17370106,2120.115921109,49
carcassonne-uct10-vs-uct305-1000its,835,786,2229.85451113,2166.167992268,49
carcassonne-ucttuned430-vs-ucttuned90-1000its,835,786,2302.464404867,2238.452774431,49
carcassonne-boltzmann55-vs-boltzmann405-1000its,837,788,2171.247475507,2141.048455018,49
carcassonne-uct235-vs-uct170-1000its,837,788,2267.191897061,2216.352461658,49
carcassonne-uct495-vs-uct485-1000its,837,788,2113.515819665,2110.949412851,49
carcassonne-ucttuned60-vs-ucttuned170-1000its,838,789,2248.093154056,2186.45940884,49
carcassonne-boltzmann205-vs-boltzmann395-1000its,839,790,2254.45528244,2228.425264709,49
carcassonne-uct30-vs-uct120-1000its,839,790,2174.262266833,2167.339346221,49
carcassonne-boltzmann305-vs-boltzmann485-1000its,840,791,2195.53178599,2151.569438462,49
carcassonne-boltzmann90-vs-boltzmann170-1000its,842,793,2229.633499965,2139.91770037,49
carcassonne-uct255-vs-uct380-1000its,843,794,2220.163694588,2198.244452071,49
carcassonne-uct245-vs-uct200-1000its,844,795,2103.302117851,2080.026378785,49
carcassonne-ucttuned320-vs-ucttuned455-1000its,844,795,2254.845009285,2212.165895008,49
carcassonne-boltzmann25-vs-boltzmann190-1000its,845,796,2215.104223923,2182.460305234,49
carcassonne-ucttuned50-vs-ucttuned425-1000its,845,796,2290.123000678,2212.624338543,49
carcassonne-boltzmann20-vs-boltzmann495-1000its,848,799,2171.128549984,2146.898673408,49
carcassonne-boltzmann245-vs-boltzmann225-1000its,848,799,2162.87184872,2128.168571975,49
carcassonne-uct280-vs-uct195-1000its,848,799,2282.560742014,2260.910413443,49
carcassonne-boltzmann20-vs-boltzmann115-1000its,849,800,2132.716520234,2116.205305487,49
carcassonne-boltzmann265-vs-boltzmann145-1000its,849,800,2178.427518542,2166.448799143,49
carcassonne-boltzmann300-vs-boltzmann210-1000its,849,800,2160.554860788,2095.581586518,49
carcassonne-uct40-vs-uct360-1000its,851,802,2127.289948348,2110.936501715,49
carcassonne-uct40-vs-uct380-1000its,851,802,2236.05203842,2186.936907706,49
carcassonne-ucttuned265-vs-ucttuned250-1000its,852,803,2211.351474266,2120.709090973,49
carcassonne-boltzmann190-vs-boltzmann220-1000its,853,804,2192.20542141,2116.553740963,49
carcassonne-uct410-vs-uct455-1000its,853,804,2254.479227761,2188.134114857,49
carcassonne-boltzmann225-vs-boltzmann140-1000its,854,805,2147.702127504,2125.095403737,49
carcassonne-uct90-vs-uct135-1000its,854,805,2243.652702295,2205.88689068,49
carcassonne-uct90-vs-uct180-1000its,855,806,2217.105766813,2185.876159479,49
carcassonne-boltzmann190-vs-boltzmann265-1000its,856,807,2174.688422443,2131.081751031,49
carcassonne-uct195-vs-uct50-1000its,856,807,2218.646452544,2174.537652422,49
carcassonne-ucttuned250-vs-ucttuned300-1000its,856,807,2260.217602324,2220.702972601,49
carcassonne-boltzmann215-vs-boltzmann460-1000its,857,808,2173.534083785,2139.738074311,49
carcassonne-uct45-vs-uct210-1000its,857,808,2206.418973624,2147.677985247,49
carcassonne-ucttuned25-vs-ucttuned430-1000its,857,808,2240.719924446,2153.643080775,49
carcassonne-boltzmann5-vs-boltzmann290-1000its,858,809,2227.608956775,2209.958456843,49
carcassonne-uct350-vs-uct280-1000its,858,809,2191.858533392,2125.035820904,49
carcassonne-uct330-vs-uct270-1000its,859,810,2196.921853334,2130.164747408,49
carcassonne-uct105-vs-uct155-1000its,860,811,2190.019433643,2151.255776182,49
carcassonne-ucttuned305-vs-ucttuned355-1000its,860,811,2225.698082133,2122.820154428,49
carcassonne-uct345-vs-uct175-1000its,862,813,2182.223058419,2129.76332014,49
carcassonne-ucttuned25-vs-ucttuned265-1000its,863,814,2194.588314051,2210.84370145,49
carcassonne-boltzmann70-vs-boltzmann465-1000its,865,816,2158.791258756,2102.259545811,49
carcassonne-uct145-vs-uct420-1000its,865,816,2174.398292764,2118.061767385,49
carcassonne-ucttuned345-vs-ucttuned170-1000its,865,816,2140.53688981,2094.443124971,49
carcassonne-boltzmann20-vs-boltzmann105-1000its,866,817,2152.743365981,2098.131181606,49
carcassonne-boltzmann305-vs-boltzmann475-1000its,867,818,2203.736395403,2154.364729032,49
carcassonne-uct185-vs-uct280-1000its,868,819,2211.87725861,2191.771055806,49
carcassonne-uct190-vs-uct65-1000its,868,819,2183.878615808,2119.081021903,49
carcassonne-ucttuned10-vs-ucttuned155-1000its,869,820,2178.971701268,2155.977005487,49
carcassonne-boltzmann440-vs-boltzmann215-1000its,872,823,2144.449446009,2068.426211134,49
carcassonne-ucttuned320-vs-ucttuned125-1000its,872,823,2148.514878353,2163.137997609,49
carcassonne-ucttuned160-vs-ucttuned420-1000its,873,824,2174.672960173,2158.035331565,49
carcassonne-uct150-vs-uct175-1000its,874,825,2196.864075983,2175.40269202,49
carcassonne-uct435-vs-uct285-1000its,874,825,2184.289000508,2142.102778944,49
carcassonne-ucttuned270-vs-ucttuned40-1000its,875,826,2204.655513007,2184.256969092,49
carcassonne-ucttuned15-vs-ucttuned240-1000its,876,827,2162.825298286,2130.474707799,49
carcassonne-uct375-vs-uct475-1000its,877,828,2165.498496097,2088.978526794,49
carcassonne-ucttuned175-vs-ucttuned120-1000its,880,831,2167.842954816,2127.972036913,49
carcassonne-uct325-vs-uct330-1000its,882,833,2214.781341945,2175.969262855,49
carcassonne-uct460-vs-uct330-1000its,884,835,2165.579273148,2084.871861388,49
carcassonne-ucttuned215-vs-ucttuned425-1000its,890,841,2159.783234115,2125.417579314,49
carcassonne-uct40-vs-uct35-1000its,891,842,2247.490648095,2212.20579721,49
carcassonne-ucttuned435-vs-ucttuned165-1000its,891,842,2252.435013065,2163.327842729,49
carcassonne-ucttuned200-vs-ucttuned370-1000its,892,843,2242.131726677,2223.101055036,49
carcassonne-ucttuned40-vs-ucttuned205-1000its,897,848,2179.492129913,2142.979113709,49
carcassonne-boltzmann270-vs-boltzmann310-1000its,901,852,2228.047365862,2186.975143036,49
carcassonne-boltzmann275-vs-boltzmann300-1000its,903,854,2258.751747928,2260.034691631,49
carcassonne-uct50-vs-uct200-1000its,903,854,2255.721199039,2212.812145229,49
carcassonne-boltzmann260-vs-boltzmann440-1000its,908,859,2184.654466325,2135.100116206,49
carcassonne-uct220-vs-uct300-1000its,911,862,2216.230273186,2149.861048268,49
carcassonne-boltzmann35-vs-boltzmann185-1000its,923,874,2142.017104497,2168.632716497,49
carcassonne-ucttuned15-vs-ucttuned210-1000its,933,884,2176.819878137,2088.48402017,49
carcassonne-boltzmann455-vs-boltzmann475-1000its,716,666,1724.539430123,1669.977999949,50
carcassonne-boltzmann90-vs-boltzmann175-1000its,723,673,2216.647303454,2217.215727957,50
carcassonne-ucttuned190-vs-ucttuned140-1000its,753,703,2192.750861535,2153.924314143,50
carcassonne-uct380-vs-uct225-1000its,760,710,2247.529132116,2136.479777508,50
carcassonne-ucttuned285-vs-ucttuned310-1000its,760,710,2182.37815684,2096.480188523,50
carcassonne-boltzmann275-vs-boltzmann470-1000its,781,731,2239.618623354,2149.462413849,50
carcassonne-uct260-vs-uct460-1000its,781,731,2156.163334719,2115.667637114,50
carcassonne-boltzmann160-vs-boltzmann415-1000its,784,734,2152.454997725,2090.980183494,50
carcassonne-uct265-vs-uct360-1000its,786,736,2185.691084069,2120.724227954,50
carcassonne-ucttuned85-vs-ucttuned395-1000its,788,738,2194.708043398,2166.828673375,50
carcassonne-ucttuned140-vs-ucttuned200-1000its,790,740,2297.247126745,2259.710937133,50
carcassonne-ucttuned455-vs-ucttuned405-1000its,791,741,2146.469923149,2117.262779636,50
carcassonne-ucttuned190-vs-ucttuned310-1000its,793,743,2169.782551789,2144.49232881,50
carcassonne-ucttuned30-vs-ucttuned480-1000its,793,743,2191.508985956,2166.222972532,50
carcassonne-uct275-vs-uct445-1000its,800,750,2202.119459385,2198.724871997,50
carcassonne-ucttuned350-vs-ucttuned185-1000its,803,753,2182.112787626,2108.031768266,50
carcassonne-uct100-vs-uct435-1000its,804,754,2138.196531356,2114.516449778,50
carcassonne-ucttuned255-vs-ucttuned435-1000its,804,754,2199.639145591,2150.617726705,50
carcassonne-ucttuned365-vs-ucttuned165-1000its,805,755,2220.244987019,2127.845041762,50
carcassonne-ucttuned240-vs-ucttuned220-1000its,806,756,2177.408172424,2130.458307432,50
carcassonne-ucttuned320-vs-ucttuned90-1000its,807,757,2217.046187705,2198.851170356,50
carcassonne-ucttuned35-vs-ucttuned255-1000its,807,757,2189.526159384,2146.000740916,50
carcassonne-ucttuned350-vs-ucttuned45-1000its,807,757,2181.050872683,2135.874303158,50
carcassonne-ucttuned465-vs-ucttuned65-1000its,807,757,2239.789642364,2234.425580607,50
carcassonne-ucttuned475-vs-ucttuned250-1000its,809,759,2165.835545065,2107.405489938,50
carcassonne-boltzmann105-vs-boltzmann25-1000its,811,761,2203.505621043,2191.830547118,50
carcassonne-boltzmann275-vs-boltzmann255-1000its,811,761,2184.807015688,2151.901089205,50
carcassonne-boltzmann230-vs-boltzmann295-1000its,812,762,2235.089504531,2174.521001913,50
carcassonne-boltzmann275-vs-boltzmann305-1000its,812,762,2178.624859044,2135.016811098,50
carcassonne-boltzmann415-vs-boltzmann30-1000its,813,763,2205.380647385,2157.375584899,50
carcassonne-boltzmann55-vs-boltzmann440-1000its,813,763,2256.623636923,2202.670792227,50
carcassonne-uct355-vs-uct370-1000its,813,763,2176.512593924,2098.809176635,50
carcassonne-ucttuned430-vs-ucttuned280-1000its,813,763,2189.651114122,2101.180704729,50
carcassonne-uct410-vs-uct450-1000its,815,765,2156.796682503,2129.044412999,50
carcassonne-ucttuned220-vs-ucttuned405-1000its,817,767,2226.868871726,2195.671745199,50
carcassonne-ucttuned475-vs-ucttuned335-1000its,819,769,2210.927577289,2186.771052258,50
carcassonne-uct245-vs-uct380-1000its,821,771,2234.716125111,2227.850094601,50
carcassonne-uct360-vs-uct485-1000its,822,772,2268.345784144,2277.697676671,50
carcassonne-uct75-vs-uct45-1000its,822,772,2217.411736386,2126.932374952,50
carcassonne-uct140-vs-uct370-1000its,823,773,2165.117744055,2108.829861594,50
carcassonne-ucttuned225-vs-ucttuned375-1000its,823,773,2303.772498494,2288.457721409,50
carcassonne-ucttuned175-vs-ucttuned285-1000its,824,774,2269.444546319,2222.607018036,50
carcassonne-ucttuned45-vs-ucttuned145-1000its,825,775,2176.10028136,2127.4991751,50
carcassonne-boltzmann380-vs-boltzmann75-1000its,826,776,2169.77335522,2133.704577673,50
carcassonne-ucttuned390-vs-ucttuned315-1000its,827,777,2147.537576152,2082.544721395,50
carcassonne-ucttuned440-vs-ucttuned375-1000its,828,778,2206.973231622,2202.972527183,50
carcassonne-boltzmann55-vs-boltzmann425-1000its,829,779,2253.560209939,2191.117731774,50
carcassonne-boltzmann145-vs-boltzmann255-1000its,832,782,2251.587170497,2210.999194774,50
carcassonne-ucttuned430-vs-ucttuned415-1000its,832,782,2183.892797128,2126.890409283,50
carcassonne-ucttuned235-vs-ucttuned335-1000its,833,783,2218.044140617,2167.708566212,50
carcassonne-ucttuned155-vs-ucttuned255-1000its,834,784,2220.204506767,2183.587903634,50
carcassonne-boltzmann355-vs-boltzmann320-1000its,836,786,2229.097643395,2194.912877841,50
carcassonne-uct155-vs-uct30-1000its,836,786,2147.63354282,2079.753539265,50
carcassonne-uct85-vs-uct365-1000its,836,786,2206.556494447,2140.332069868,50
carcassonne-uct280-vs-uct160-1000its,837,787,2128.059378335,2109.599313126,50
carcassonne-ucttuned225-vs-ucttuned270-1000its,837,787,2248.21668416,2216.020968513,50
carcassonne-ucttuned245-vs-ucttuned75-1000its,837,787,2167.050571952,2141.744733708,50
carcassonne-boltzmann225-vs-boltzmann60-1000its,838,788,2266.955927922,2227.006795192,50
carcassonne-uct240-vs-uct170-1000its,839,789,2259.679634212,2206.967898323,50
carcassonne-uct425-vs-uct415-1000its,839,789,2267.925908888,2207.080614206,50
carcassonne-boltzmann30-vs-boltzmann85-1000its,840,790,2242.4007046,2208.789144357,50
carcassonne-ucttuned420-vs-ucttuned310-1000its,841,791,2225.498530676,2132.191246062,50
carcassonne-uct405-vs-uct45-1000its,843,793,2156.383364868,2133.822258182,50
carcassonne-uct70-vs-uct255-1000its,843,793,2154.815522048,2135.828238288,50
carcassonne-boltzmann60-vs-boltzmann250-1000its,844,794,2178.523122168,2131.515301365,50
carcassonne-uct170-vs-uct125-1000its,844,794,2178.754406938,2131.77502189,50
carcassonne-uct220-vs-uct155-1000its,844,794,2146.544294926,2116.672853895,50
carcassonne-ucttuned390-vs-ucttuned45-1000its,845,795,2171.375559593,2144.348003224,50
carcassonne-boltzmann205-vs-boltzmann55-1000its,846,796,2112.111749286,2070.932815678,50
carcassonne-ucttuned225-vs-ucttuned385-1000its,847,797,2195.301889922,2179.074892999,50
carcassonne-ucttuned290-vs-ucttuned165-1000its,848,798,2213.234130965,2159.366707965,50
carcassonne-uct385-vs-uct75-1000its,849,799,2137.414701256,2132.009375409,50
carcassonne-ucttuned35-vs-ucttuned450-1000its,849,799,2111.617476693,2053.022191003,50
carcassonne-ucttuned480-vs-ucttuned255-1000its,849,799,2160.699768383,2172.565432383,50
carcassonne-boltzmann295-vs-boltzmann50-1000its,850,800,2196.516606688,2139.409023298,50
carcassonne-uct245-vs-uct160-1000its,850,800,2224.102429471,2173.656004213,50
carcassonne-ucttuned15-vs-ucttuned355-1000its,850,800,2196.689378127,2148.698382845,50
carcassonne-ucttuned25-vs-ucttuned295-1000its,852,802,2255.570574424,2195.558573032,50
carcassonne-boltzmann320-vs-boltzmann325-1000its,856,806,2155.185108151,2136.893110441,50
carcassonne-ucttuned40-vs-ucttuned240-1000its,856,806,2147.967815062,2070.131629736,50
carcassonne-ucttuned365-vs-ucttuned40-1000its,857,807,2157.258759309,2127.450304154,50
carcassonne-boltzmann380-vs-boltzmann230-1000its,858,808,2185.645439728,2159.735860131,50
carcassonne-uct35-vs-uct315-1000its,858,808,2172.312401285,2156.128497436,50
carcassonne-ucttuned475-vs-ucttuned105-1000its,858,808,2225.789905682,2190.911040653,50
carcassonne-boltzmann260-vs-boltzmann165-1000its,860,810,2185.097830909,2110.327289857,50
carcassonne-boltzmann270-vs-boltzmann50-1000its,861,811,2184.584478265,2188.698654834,50
carcassonne-uct270-vs-uct340-1000its,861,811,2204.983304935,2147.186172346,50
carcassonne-ucttuned70-vs-ucttuned290-1000its,863,813,2198.1421586,2148.083899477,50
carcassonne-boltzmann400-vs-boltzmann105-1000its,864,814,2156.013417834,2139.417321431,50
carcassonne-boltzmann175-vs-boltzmann170-1000its,865,815,2259.223448281,2144.005342577,50
carcassonne-uct185-vs-uct480-1000its,865,815,2190.156165805,2111.960373284,50
carcassonne-uct250-vs-uct460-1000its,865,815,2211.294953134,2158.753966653,50
carcassonne-boltzmann230-vs-boltzmann485-1000its,869,819,2142.231198734,2102.219677386,50
carcassonne-uct370-vs-uct440-1000its,870,820,2190.962246292,2188.687520642,50
carcassonne-ucttuned155-vs-ucttuned325-1000its,870,820,2186.48870615,2137.487886599,50
carcassonne-ucttuned470-vs-ucttuned15-1000its,870,820,2246.949318705,2197.570318911,50
carcassonne-ucttuned235-vs-ucttuned55-1000its,876,826,2218.743196572,2149.705204917,50
carcassonne-boltzmann80-vs-boltzmann325-1000its,879,829,2210.749258176,2182.459540814,50
carcassonne-ucttuned340-vs-ucttuned155-1000its,879,829,2236.46387064,2210.015572692,50
carcassonne-ucttuned35-vs-ucttuned230-1000its,880,830,2236.314295924,2219.070642652,50
carcassonne-ucttuned140-vs-ucttuned415-1000its,881,831,2240.56547494,2185.900974067,50
carcassonne-ucttuned250-vs-ucttuned415-1000its,882,832,2192.194814324,2101.111938897,50
carcassonne-ucttuned480-vs-ucttuned90-1000its,882,832,2159.879387525,2127.297683603,50
carcassonne-uct50-vs-uct470-1000its,883,833,2229.90523676,2184.736543059,50
carcassonne-uct25-vs-uct495-1000its,888,838,2196.071740621,2157.530566226,50
carcassonne-boltzmann65-vs-boltzmann125-1000its,890,840,2191.092382638,2178.677435195,50
carcassonne-uct385-vs-uct315-1000its,890,840,2196.28497376,2128.051986703,50
carcassonne-boltzmann175-vs-boltzmann230-1000its,892,842,2223.939440144,2201.778089962,50
carcassonne-uct410-vs-uct95-1000its,893,843,2149.300155306,2142.719117918,50
carcassonne-uct350-vs-uct485-1000its,895,845,2191.127225814,2154.781404652,50
carcassonne-uct275-vs-uct410-1000its,897,847,2245.43955387,2174.707557692,50
carcassonne-uct90-vs-uct70-1000its,898,848,2170.433303921,2138.883688757,50
carcassonne-boltzmann365-vs-boltzmann265-1000its,902,852,2186.636979539,2157.165143012,50
carcassonne-boltzmann395-vs-boltzmann115-1000its,902,852,2232.223666175,2197.599431428,50
carcassonne-boltzmann370-vs-boltzmann425-1000its,907,857,2193.280250874,2122.282203482,50
carcassonne-uct10-vs-uct270-1000its,912,862,2291.959786514,2205.837289809,50
carcassonne-boltzmann135-vs-boltzmann275-1000its,913,863,2182.388519403,2163.108804693,50
carcassonne-ucttuned195-vs-ucttuned315-1000its,913,863,2175.571801518,2134.458055595,50
carcassonne-uct495-vs-uct365-1000its,934,884,2246.14324,2206.106538886,50
carcassonne-uct30-vs-uct390-1000its,996,946,2170.650964358,2113.761057119,50
carcassonne-boltzmann65-vs-boltzmann445-1000its,728,677,2238.2855081,2217.087802488,51
carcassonne-ucttuned400-vs-ucttuned350-1000its,748,697,2170.637907115,2129.165587788,51
carcassonne-uct195-vs-uct390-1000its,755,704,2178.345552421,2178.090004463,51
carcassonne-boltzmann255-vs-boltzmann395-1000its,764,713,2258.507134051,2220.601892195,51
carcassonne-ucttuned80-vs-ucttuned400-1000its,770,719,2107.498048084,2101.954672945,51
carcassonne-boltzmann185-vs-boltzmann265-1000its,776,725,2162.236265659,2119.05719225,51
carcassonne-boltzmann420-vs-boltzmann95-1000its,779,728,2171.380356589,2072.735855017,51
carcassonne-boltzmann95-vs-boltzmann480-1000its,783,732,2214.722740535,2185.110159716,51
carcassonne-boltzmann495-vs-boltzmann445-1000its,788,737,2153.866061368,2064.800000761,51
carcassonne-ucttuned125-vs-ucttuned405-1000its,791,740,2217.443619387,2158.606732982,51
carcassonne-ucttuned140-vs-ucttuned495-1000its,793,742,2192.708017292,2096.162261721,51
carcassonne-ucttuned365-vs-ucttuned235-1000its,794,743,2249.1273706,2229.851762207,51
carcassonne-boltzmann265-vs-boltzmann390-1000its,796,745,2241.887696467,2209.984223214,51
carcassonne-boltzmann410-vs-boltzmann15-1000its,796,745,2220.058456746,2154.796300123,51
carcassonne-boltzmann90-vs-boltzmann200-1000its,796,745,2305.66514913,2230.321080741,51
carcassonne-ucttuned410-vs-ucttuned110-1000its,798,747,2157.336888055,2106.523527279,51
carcassonne-boltzmann485-vs-boltzmann410-1000its,800,749,2153.210092881,2108.067045392,51
carcassonne-ucttuned225-vs-ucttuned315-1000its,800,749,2150.987762982,2130.081230061,51
carcassonne-boltzmann290-vs-boltzmann370-1000its,802,751,2240.909917358,2234.955183972,51
carcassonne-uct355-vs-uct490-1000its,803,752,2226.608319527,2199.546740642,51
carcassonne-ucttuned440-vs-ucttuned255-1000its,803,752,2199.740322918,2173.303555787,51
carcassonne-boltzmann475-vs-boltzmann280-1000its,806,755,2225.523637305,2144.505489772,51
carcassonne-boltzmann490-vs-boltzmann340-1000its,807,756,2172.328360506,2098.094884609,51
carcassonne-boltzmann360-vs-boltzmann365-1000its,811,760,2228.711610199,2136.980074624,51
carcassonne-uct300-vs-uct120-1000its,811,760,2200.973221864,2171.232924362,51
carcassonne-uct415-vs-uct440-1000its,811,760,2216.496061958,2176.122043312,51
carcassonne-ucttuned360-vs-ucttuned170-1000its,813,762,2158.373328632,2108.409657634,51
carcassonne-uct305-vs-uct115-1000its,814,763,2184.84159048,2149.352786178,51
carcassonne-boltzmann430-vs-boltzmann275-1000its,816,765,2203.374701173,2163.352518082,51
carcassonne-boltzmann170-vs-boltzmann475-1000its,817,766,2176.252020784,2104.570980622,51
carcassonne-boltzmann430-vs-boltzmann45-1000its,817,766,2143.449324317,2181.107043993,51
carcassonne-boltzmann455-vs-boltzmann270-1000its,817,766,2150.718424885,2085.912454018,51
carcassonne-uct325-vs-uct385-1000its,818,767,2187.959408411,2153.443498111,51
carcassonne-boltzmann200-vs-boltzmann190-1000its,819,768,2215.086286716,2191.293860123,51
carcassonne-ucttuned265-vs-ucttuned180-1000its,819,768,2158.693602301,2092.042781894,51
carcassonne-boltzmann65-vs-boltzmann420-1000its,820,769,2191.6555493,2198.419950325,51
carcassonne-ucttuned175-vs-ucttuned235-1000its,821,770,2183.221483379,2114.1593848,51
carcassonne-ucttuned85-vs-ucttuned195-1000its,821,770,2238.087199979,2216.086348728,51
carcassonne-ucttuned145-vs-ucttuned130-1000its,822,771,2252.539673657,2222.481953088,51
carcassonne-uct195-vs-uct245-1000its,823,772,2227.765745478,2188.325842238,51
carcassonne-ucttuned150-vs-ucttuned35-1000its,826,775,2216.044263944,2120.409613525,51
carcassonne-boltzmann210-vs-boltzmann410-1000its,828,777,2278.954849051,2232.405101132,51
carcassonne-boltzmann60-vs-boltzmann430-1000its,828,777,2157.458005981,2166.297542777,51
carcassonne-ucttuned100-vs-ucttuned460-1000its,829,778,2131.023524997,2113.946953676,51
carcassonne-ucttuned305-vs-ucttuned345-1000its,829,778,2219.553984633,2220.560068674,51
carcassonne-uct115-vs-uct170-1000its,832,781,2178.363722079,2133.056362312,51
carcassonne-uct105-vs-uct85-1000its,834,783,2213.406731249,2184.641755004,51
carcassonne-ucttuned245-vs-ucttuned235-1000its,834,783,2176.474183112,2118.150144022,51
carcassonne-ucttuned50-vs-ucttuned430-1000its,835,784,2186.522204404,2146.95395954,51
carcassonne-ucttuned15-vs-ucttuned455-1000its,836,785,2180.536326152,2165.417683774,51
carcassonne-uct425-vs-uct170-1000its,837,786,2165.187700769,2105.537114911,51
carcassonne-uct250-vs-uct440-1000its,838,787,2224.003461304,2173.932795593,51
carcassonne-ucttuned495-vs-ucttuned200-1000its,838,787,2263.198699288,2173.303703259,51
carcassonne-boltzmann140-vs-boltzmann180-1000its,839,788,2221.349090838,2174.630010847,51
carcassonne-boltzmann360-vs-boltzmann295-1000its,839,788,2121.92073642,2087.175717377,51
carcassonne-uct265-vs-uct385-1000its,839,788,2174.664391984,2122.359540276,51
carcassonne-ucttuned190-vs-ucttuned15-1000its,839,788,2189.508733031,2123.679837204,51
carcassonne-uct55-vs-uct490-1000its,841,790,2210.511642905,2179.700642305,51
carcassonne-ucttuned130-vs-ucttuned55-1000its,841,790,2193.107435364,2163.118601381,51
carcassonne-uct210-vs-uct50-1000its,842,791,2183.444941105,2120.225803901,51
carcassonne-uct375-vs-uct65-1000its,842,791,2159.166476077,2138.23906368,51
carcassonne-boltzmann420-vs-boltzmann135-1000its,843,792,2232.987467288,2128.641418578,51
carcassonne-boltzmann270-vs-boltzmann385-1000its,844,793,2260.682113425,2182.633465937,51
carcassonne-uct65-vs-uct495-1000its,844,793,2166.180870761,2120.133915863,51
carcassonne-boltzmann175-vs-boltzmann120-1000its,846,795,2149.561347177,2110.366098739,51
carcassonne-uct485-vs-uct290-1000its,846,795,2231.649028766,2175.99009213,51
carcassonne-uct390-vs-uct380-1000its,847,796,2200.534023771,2131.562657211,51
carcassonne-uct455-vs-uct205-1000its,847,796,2139.276251698,2093.26838136,51
carcassonne-uct340-vs-uct185-1000its,848,797,2180.195883049,2139.666075381,51
carcassonne-uct105-vs-uct285-1000its,849,798,2158.879851195,2077.770524122,51
carcassonne-uct15-vs-uct155-1000its,850,799,2263.509477603,2165.717622671,51
carcassonne-uct70-vs-uct490-1000its,850,799,2252.794765227,2164.689710717,51
carcassonne-ucttuned280-vs-ucttuned275-1000its,850,799,2146.623616975,2110.809079619,51
carcassonne-boltzmann285-vs-boltzmann165-1000its,851,800,2214.189879799,2169.147917619,51
carcassonne-uct430-vs-uct195-1000its,852,801,2260.494317271,2171.592977615,51
carcassonne-ucttuned295-vs-ucttuned185-1000its,852,801,2164.130718239,2133.459959488,51
carcassonne-uct190-vs-uct445-1000its,853,802,2196.241129991,2126.186386358,51
carcassonne-ucttuned430-vs-ucttuned485-1000its,853,802,2182.754167696,2132.05281285,51
carcassonne-ucttuned15-vs-ucttuned255-1000its,854,803,2175.494152892,2137.30327438,51
carcassonne-boltzmann315-vs-boltzmann75-1000its,855,804,2226.69355486,2248.506943686,51
carcassonne-ucttuned85-vs-ucttuned380-1000its,855,804,2233.717115534,2168.231046037,51
carcassonne-ucttuned250-vs-ucttuned425-1000its,857,806,2249.175169888,2175.612065777,51
carcassonne-ucttuned125-vs-ucttuned440-1000its,858,807,2231.624046334,2186.917800405,51
carcassonne-uct405-vs-uct65-1000its,859,808,2182.044072456,2114.455871611,51
carcassonne-ucttuned245-vs-ucttuned135-1000its,859,808,2180.357860807,2120.078428239,51
carcassonne-ucttuned260-vs-ucttuned55-1000its,859,808,2213.3585984,2206.162140545,51
carcassonne-boltzmann105-vs-boltzmann225-1000its,860,809,2220.711272909,2158.208008498,51
carcassonne-boltzmann265-vs-boltzmann370-1000its,861,810,2202.704324271,2175.725597024,51
carcassonne-boltzmann495-vs-boltzmann55-1000its,861,810,2181.561739433,2149.24371148,51
carcassonne-uct140-vs-uct235-1000its,863,812,2194.010644082,2151.014462493,51
carcassonne-ucttuned30-vs-ucttuned310-1000its,864,813,2259.842539676,2201.441162032,51
carcassonne-ucttuned480-vs-ucttuned465-1000its,864,813,2193.103649568,2101.984706513,51
carcassonne-uct450-vs-uct210-1000its,870,819,2191.488585989,2130.612779047,51
carcassonne-uct270-vs-uct460-1000its,872,821,2187.943678581,2125.254117212,51
carcassonne-boltzmann215-vs-boltzmann75-1000its,874,823,2164.504426192,2137.840845458,51
carcassonne-boltzmann425-vs-boltzmann160-1000its,874,823,2242.373785584,2210.412773423,51
carcassonne-boltzmann490-vs-boltzmann175-1000its,875,824,2153.91738418,2079.394786041,51
carcassonne-uct485-vs-uct480-1000its,875,824,2211.476797064,2183.502613596,51
carcassonne-boltzmann95-vs-boltzmann155-1000its,877,826,2179.445010849,2123.646918618,51
carcassonne-ucttuned245-vs-ucttuned410-1000its,877,826,2249.779024873,2204.832932296,51
carcassonne-boltzmann245-vs-boltzmann255-1000its,879,828,2206.705813265,2163.659889262,51
carcassonne-boltzmann255-vs-boltzmann175-1000its,879,828,2262.726822876,2172.225785973,51
carcassonne-uct455-vs-uct265-1000its,880,829,2151.364928988,2118.204269827,51
carcassonne-uct230-vs-uct190-1000its,881,830,2194.739174499,2122.662290868,51
carcassonne-ucttuned370-vs-ucttuned395-1000its,882,831,2109.634232257,2059.781528936,51
carcassonne-uct25-vs-uct285-1000its,883,832,2208.359437825,2165.764504605,51
carcassonne-uct440-vs-uct135-1000its,884,833,2178.890343008,2187.565005159,51
carcassonne-uct175-vs-uct410-1000its,885,834,2252.927163605,2203.332353045,51
carcassonne-ucttuned450-vs-ucttuned280-1000its,886,835,2183.600743367,2128.807780469,51
carcassonne-boltzmann455-vs-boltzmann5-1000its,892,841,2199.311293135,2139.114623302,51
carcassonne-ucttuned290-vs-ucttuned35-1000its,892,841,2118.516643459,2104.789776818,51
carcassonne-boltzmann5-vs-boltzmann115-1000its,894,843,2208.798330702,2168.493326624,51
carcassonne-uct200-vs-uct265-1000its,894,843,2167.465295581,2099.213517223,51
carcassonne-uct385-vs-uct425-1000its,894,843,2175.696720658,2147.026160223,51
carcassonne-uct105-vs-uct130-1000its,899,848,2130.536030729,2130.083710422,51
carcassonne-ucttuned495-vs-ucttuned300-1000its,900,849,2226.835489479,2142.946760224,51
carcassonne-boltzmann240-vs-boltzmann65-1000its,901,850,2184.068221811,2195.175565449,51
carcassonne-boltzmann25-vs-boltzmann115-1000its,906,855,2182.99940903,2143.822955362,51
carcassonne-ucttuned140-vs-ucttuned155-1000its,908,857,2279.202572644,2229.056350505,51
carcassonne-uct370-vs-uct95-1000its,913,862,2277.806348972,2235.47967201,51
carcassonne-boltzmann375-vs-boltzmann285-1000its,914,863,2263.064536473,2208.423850738,51
carcassonne-ucttuned65-vs-ucttuned60-1000its,915,864,2174.990048564,2088.553886428,51
carcassonne-ucttuned20-vs-ucttuned90-1000its,916,865,2286.645291058,2190.663349676,51
carcassonne-boltzmann475-vs-boltzmann235-1000its,933,882,2180.701576071,2131.323571718,51
carcassonne-ucttuned225-vs-ucttuned485-1000its,973,922,2145.542879085,2074.604353376,51
carcassonne-boltzmann115-vs-boltzmann490-1000its,705,653,2171.025503041,2105.653716147,52
carcassonne-uct450-vs-uct125-1000its,745,693,2217.055686237,2156.271589746,52
carcassonne-boltzmann30-vs-boltzmann150-1000its,750,698,2188.90971172,2184.178368979,52
carcassonne-boltzmann225-vs-boltzmann325-1000its,754,702,2213.466564726,2159.360783017,52
carcassonne-boltzmann230-vs-boltzmann365-1000its,755,703,2172.109590942,2141.632449886,52
carcassonne-boltzmann475-vs-boltzmann405-1000its,755,703,2182.527316332,2114.678903238,52
carcassonne-boltzmann385-vs-boltzmann495-1000its,760,708,2248.256604281,2216.7506127,52
carcassonne-ucttuned415-vs-ucttuned440-1000its,761,709,2239.563273113,2125.082961654,52
carcassonne-uct440-vs-uct85-1000its,763,711,2212.247830972,2151.645273986,52
carcassonne-ucttuned360-vs-ucttuned385-1000its,766,714,2252.073488661,2206.336222538,52
carcassonne-ucttuned45-vs-ucttuned410-1000its,766,714,2140.795053413,2101.748910895,52
carcassonne-boltzmann320-vs-boltzmann245-1000its,767,715,2175.776980598,2117.932705379,52
carcassonne-ucttuned255-vs-ucttuned490-1000its,767,715,2148.313876071,2125.688916198,52
carcassonne-ucttuned300-vs-ucttuned190-1000its,772,720,2152.311465103,2096.024245572,52
carcassonne-ucttuned310-vs-ucttuned315-1000its,777,725,2218.652883903,2171.567121722,52
carcassonne-boltzmann465-vs-boltzmann370-1000its,778,726,2208.437263052,2195.24045251,52
carcassonne-boltzmann310-vs-boltzmann355-1000its,782,730,2197.040443479,2203.791840726,52
carcassonne-boltzmann445-vs-boltzmann90-1000its,782,730,2169.610414892,2097.394026216,52
carcassonne-uct345-vs-uct395-1000its,783,731,2179.405903511,2149.101718053,52
carcassonne-boltzmann180-vs-boltzmann375-1000its,784,732,2284.747464832,2245.409836444,52
carcassonne-boltzmann410-vs-boltzmann320-1000its,784,732,2193.691056032,2148.339775923,52
carcassonne-boltzmann105-vs-boltzmann450-1000its,789,737,2240.767950014,2180.384916173,52
carcassonne-ucttuned400-vs-ucttuned245-1000its,793,741,2141.789128132,2111.911979469,52
carcassonne-boltzmann445-vs-boltzmann65-1000its,797,745,2205.703040707,2175.1998843,52
carcassonne-ucttuned45-vs-ucttuned240-1000its,802,750,2167.24017527,2150.201821501,52
carcassonne-boltzmann460-vs-boltzmann255-1000its,804,752,2166.278634524,2138.703817202,52
carcassonne-boltzmann95-vs-boltzmann315-1000its,806,754,2134.78977875,2111.214652711,52
carcassonne-ucttuned120-vs-ucttuned295-1000its,806,754,2270.432118483,2194.28618173,52
carcassonne-boltzmann340-vs-boltzmann155-1000its,807,755,2279.326898622,2227.96296021,52
carcassonne-uct35-vs-uct465-1000its,807,755,2242.543921956,2145.701246747,52
carcassonne-ucttuned35-vs-ucttuned85-1000its,807,755,2163.305455644,2113.183015348,52
carcassonne-boltzmann295-vs-boltzmann85-1000its,808,756,2119.379925424,2106.677492446,52
carcassonne-boltzmann65-vs-boltzmann300-1000its,808,756,2212.827952563,2156.768838551,52
carcassonne-ucttuned480-vs-ucttuned85-1000its,808,756,2151.546142858,2139.992244686,52
carcassonne-uct225-vs-uct330-1000its,809,757,2183.030591532,2109.565282231,52
carcassonne-uct425-vs-uct380-1000its,809,757,2183.459968103,2196.965596312,52
carcassonne-boltzmann355-vs-boltzmann85-1000its,811,759,2254.768113832,2186.172796554,52
carcassonne-boltzmann435-vs-boltzmann295-1000its,811,759,2162.292007139,2098.921788319,52
carcassonne-boltzmann105-vs-boltzmann495-1000its,815,763,2210.741590934,2106.926078975,52
carcassonne-boltzmann170-vs-boltzmann235-1000its,815,763,2180.458260913,2099.656894197,52
carcassonne-uct420-vs-uct345-1000its,815,763,2161.049691766,2139.479937788,52
carcassonne-ucttuned185-vs-ucttuned490-1000its,815,763,2130.063354919,2119.645605968,52
carcassonne-uct235-vs-uct110-1000its,816,764,2200.155745178,2160.909065474,52
carcassonne-boltzmann180-vs-boltzmann440-1000its,818,766,2222.838378037,2172.526517778,52
carcassonne-boltzmann185-vs-boltzmann465-1000its,819,767,2239.584086333,2180.066445309,52
carcassonne-boltzmann280-vs-boltzmann135-1000its,820,768,2236.698375109,2204.917979112,52
carcassonne-ucttuned180-vs-ucttuned240-1000its,820,768,2123.60383337,2127.242189065,52
carcassonne-ucttuned90-vs-ucttuned85-1000its,821,769,2269.09214017,2228.253242701,52
carcassonne-uct160-vs-uct335-1000its,822,770,2190.525413495,2184.119753898,52
carcassonne-uct205-vs-uct460-1000its,822,770,2273.786158899,2212.18913923,52
carcassonne-ucttuned410-vs-ucttuned135-1000its,823,771,2181.573455824,2124.348856403,52
carcassonne-boltzmann370-vs-boltzmann340-1000its,825,773,2219.428126496,2161.96433006,52
carcassonne-uct355-vs-uct80-1000its,825,773,2165.783937672,2122.570309584,52
carcassonne-ucttuned470-vs-ucttuned135-1000its,825,773,2227.021544184,2149.369744827,52
carcassonne-boltzmann450-vs-boltzmann210-1000its,827,775,2182.984063593,2179.256526856,52
carcassonne-uct110-vs-uct325-1000its,827,775,2136.456155637,2104.315948351,52
carcassonne-ucttuned335-vs-ucttuned455-1000its,827,775,2135.756522103,2138.089792861,52
carcassonne-boltzmann340-vs-boltzmann330-1000its,828,776,2167.761189191,2134.538931431,52
carcassonne-uct95-vs-uct240-1000its,829,777,2246.436486016,2189.068847745,52
carcassonne-boltzmann490-vs-boltzmann95-1000its,831,779,2188.2674949,2151.609130849,52
carcassonne-uct235-vs-uct175-1000its,831,779,2213.711142641,2160.703477839,52
carcassonne-uct440-vs-uct250-1000its,831,779,2255.882894118,2255.422634048,52
carcassonne-boltzmann220-vs-boltzmann480-1000its,832,780,2206.214676752,2150.788940126,52
carcassonne-boltzmann80-vs-boltzmann210-1000its,832,780,2191.391973061,2161.32184521,52
carcassonne-boltzmann195-vs-boltzmann150-1000its,833,781,2116.513291258,2087.162888436,52
carcassonne-boltzmann20-vs-boltzmann100-1000its,833,781,2182.884374492,2127.209861293,52
carcassonne-uct485-vs-uct310-1000its,834,782,2231.889602531,2130.656538809,52
carcassonne-ucttuned60-vs-ucttuned5-1000its,834,782,2150.960921874,2099.618844275,52
carcassonne-boltzmann465-vs-boltzmann285-1000its,837,785,2205.435042163,2163.343721573,52
carcassonne-uct255-vs-uct400-1000its,837,785,2143.484088696,2109.372582559,52
carcassonne-ucttuned350-vs-ucttuned220-1000its,838,786,2189.442735297,2150.481480305,52
carcassonne-uct225-vs-uct485-1000its,839,787,2196.298307484,2143.201195378,52
carcassonne-ucttuned490-vs-ucttuned190-1000its,839,787,2168.010360213,2134.33963967,52
carcassonne-uct430-vs-uct155-1000its,842,790,2157.305654439,2145.413794048,52
carcassonne-uct265-vs-uct220-1000its,844,792,2223.318402245,2171.760387607,52
carcassonne-uct95-vs-uct315-1000its,844,792,2211.365318927,2159.842857847,52
carcassonne-boltzmann100-vs-boltzmann265-1000its,845,793,2235.634033406,2155.894856355,52
carcassonne-boltzmann325-vs-boltzmann445-1000its,845,793,2189.882646099,2137.015591171,52
carcassonne-ucttuned125-vs-ucttuned105-1000its,845,793,2198.536935871,2161.027617742,52
carcassonne-ucttuned215-vs-ucttuned410-1000its,845,793,2173.014659962,2157.928246914,52
carcassonne-ucttuned335-vs-ucttuned90-1000its,845,793,2193.419191796,2172.328193984,52
carcassonne-uct460-vs-uct405-1000its,846,794,2204.692593725,2151.551515112,52
carcassonne-uct490-vs-uct425-1000its,846,794,2168.592996258,2143.08010863,52
carcassonne-boltzmann350-vs-boltzmann55-1000its,847,795,2160.342402082,2110.385639818,52
carcassonne-boltzmann460-vs-boltzmann50-1000its,847,795,2156.153078642,2086.010305138,52
carcassonne-boltzmann5-vs-boltzmann155-1000its,847,795,2251.502888621,2174.790034146,52
carcassonne-uct175-vs-uct80-1000its,847,795,2197.418771351,2131.357790263,52
carcassonne-boltzmann445-vs-boltzmann15-1000its,848,796,2178.565415358,2160.427567153,52
carcassonne-ucttuned280-vs-ucttuned30-1000its,849,797,2142.323292184,2087.414223851,52
carcassonne-boltzmann220-vs-boltzmann240-1000its,850,798,2196.109343895,2112.86507557,52
carcassonne-uct375-vs-uct240-1000its,851,799,2207.515605553,2115.660463153,52
carcassonne-boltzmann220-vs-boltzmann350-1000its,852,800,2155.128403622,2109.278137697,52
carcassonne-ucttuned80-vs-ucttuned285-1000its,852,800,2143.385258853,2091.160046291,52
carcassonne-boltzmann345-vs-boltzmann195-1000its,853,801,2183.399209523,2166.679760214,52
carcassonne-uct385-vs-uct55-1000its,854,802,2154.060244797,2100.629000904,52
carcassonne-ucttuned110-vs-ucttuned310-1000its,856,804,2181.985953039,2106.511259738,52
carcassonne-ucttuned165-vs-ucttuned480-1000its,856,804,2174.378803367,2156.117957805,52
carcassonne-ucttuned145-vs-ucttuned255-1000its,858,806,2147.040766692,2121.457983391,52
carcassonne-uct200-vs-uct355-1000its,859,807,2134.374805696,2081.394333874,52
carcassonne-ucttuned340-vs-ucttuned205-1000its,860,808,2238.585672622,2176.022083284,52
carcassonne-uct315-vs-uct395-1000its,861,809,2203.14991662,2139.613206001,52
carcassonne-ucttuned495-vs-ucttuned80-1000its,862,810,2168.388326553,2158.614996897,52
carcassonne-boltzmann95-vs-boltzmann460-1000its,863,811,2164.380746595,2142.706732425,52
carcassonne-uct440-vs-uct380-1000its,863,811,2191.179407308,2175.354083864,52
carcassonne-ucttuned120-vs-ucttuned100-1000its,863,811,2155.215830778,2122.175833827,52
carcassonne-ucttuned35-vs-ucttuned460-1000its,863,811,2261.691309411,2242.147636381,52
carcassonne-boltzmann245-vs-boltzmann315-1000its,864,812,2264.886722977,2248.084915726,52
carcassonne-boltzmann455-vs-boltzmann305-1000its,864,812,2280.43265781,2182.872389531,52
carcassonne-ucttuned30-vs-ucttuned220-1000its,864,812,2162.315355905,2151.959923385,52
carcassonne-boltzmann455-vs-boltzmann220-1000its,868,816,2177.008896826,2117.948144903,52
carcassonne-boltzmann160-vs-boltzmann35-1000its,869,817,2218.271149087,2157.839729335,52
carcassonne-uct305-vs-uct480-1000its,872,820,2194.471489152,2123.712691987,52
carcassonne-ucttuned10-vs-ucttuned125-1000its,873,821,2201.774426685,2129.00589703,52
carcassonne-boltzmann25-vs-boltzmann280-1000its,874,822,2243.477273078,2177.351960015,52
carcassonne-boltzmann475-vs-boltzmann55-1000its,874,822,2177.038699287,2161.013639829,52
carcassonne-uct80-vs-uct45-1000its,874,822,2268.790404641,2207.242465873,52
carcassonne-ucttuned310-vs-ucttuned215-1000its,878,826,2315.180993822,2243.654218168,52
carcassonne-ucttuned10-vs-ucttuned280-1000its,880,828,2339.271264423,2271.810944472,52
carcassonne-boltzmann470-vs-boltzmann190-1000its,881,829,2241.833504201,2150.148186316,52
carcassonne-uct425-vs-uct375-1000its,883,831,2152.999191905,2120.049769855,52
carcassonne-boltzmann380-vs-boltzmann400-1000its,884,832,2187.613233657,2128.041874522,52
carcassonne-uct115-vs-uct55-1000its,885,833,2126.583329203,2076.988415741,52
carcassonne-ucttuned45-vs-ucttuned475-1000its,885,833,2178.338819963,2140.474625228,52
carcassonne-ucttuned40-vs-ucttuned145-1000its,886,834,2163.584831978,2161.834712277,52
carcassonne-uct455-vs-uct345-1000its,889,837,2188.371582517,2119.263275151,52
carcassonne-ucttuned150-vs-ucttuned465-1000its,892,840,2147.438576455,2119.627891529,52
carcassonne-boltzmann40-vs-boltzmann25-1000its,893,841,2170.600135686,2177.874479167,52
carcassonne-boltzmann205-vs-boltzmann5-1000its,894,842,2220.337909635,2179.717137426,52
carcassonne-uct430-vs-uct175-1000its,906,854,2213.121917175,2121.432821027,52
carcassonne-ucttuned235-vs-ucttuned230-1000its,908,856,2239.081275154,2148.960568258,52
carcassonne-ucttuned445-vs-ucttuned175-1000its,909,857,2260.089976609,2240.299141132,52
carcassonne-ucttuned15-vs-ucttuned335-1000its,912,860,2181.698212553,2103.181849714,52
carcassonne-ucttuned215-vs-ucttuned465-1000its,930,878,2151.068265172,2137.086240944,52
carcassonne-boltzmann330-vs-boltzmann235-1000its,735,682,2198.214490325,2160.729667595,53
carcassonne-boltzmann480-vs-boltzmann180-1000its,748,695,2137.368927484,2094.790486739,53
carcassonne-boltzmann355-vs-boltzmann310-1000its,750,697,2186.591822743,2124.135164392,53
carcassonne-boltzmann140-vs-boltzmann280-1000its,752,699,2279.809151475,2205.955958805,53
carcassonne-ucttuned200-vs-ucttuned125-1000its,753,700,2179.153211399,2161.75514493,53
carcassonne-boltzmann425-vs-boltzmann20-1000its,756,703,2216.361356727,2165.077232919,53
carcassonne-boltzmann415-vs-boltzmann15-1000its,759,706,2253.244407532,2235.187136435,53
carcassonne-ucttuned445-vs-ucttuned325-1000its,760,707,2190.576806989,2156.882762895,53
carcassonne-boltzmann475-vs-boltzmann60-1000its,771,718,2194.595329279,2140.319336877,53
carcassonne-boltzmann110-vs-boltzmann230-1000its,777,724,2193.107695652,2093.482819072,53
carcassonne-boltzmann445-vs-boltzmann195-1000its,778,725,2264.449459053,2179.98746683,53
carcassonne-boltzmann205-vs-boltzmann220-1000its,779,726,2236.750556566,2191.995014364,53
carcassonne-uct100-vs-uct170-1000its,779,726,2182.723315463,2143.207977624,53
carcassonne-boltzmann255-vs-boltzmann100-1000its,780,727,2215.030405262,2163.242377208,53
carcassonne-boltzmann405-vs-boltzmann495-1000its,780,727,2188.983754927,2153.056901213,53
carcassonne-boltzmann190-vs-boltzmann205-1000its,783,730,2221.213543905,2187.233561508,53
carcassonne-boltzmann380-vs-boltzmann290-1000its,787,734,2196.641547105,2202.286688188,53
carcassonne-boltzmann25-vs-boltzmann365-1000its,789,736,2200.74726701,2124.091654412,53
carcassonne-boltzmann320-vs-boltzmann285-1000its,789,736,2147.99151571,2108.512619188,53
carcassonne-uct220-vs-uct270-1000its,791,738,2129.749177618,2113.056818826,53
carcassonne-uct310-vs-uct455-1000its,793,740,2256.317645394,2206.534320981,53
carcassonne-uct150-vs-uct95-1000its,794,741,2185.113742177,2150.100966892,53
carcassonne-uct485-vs-uct140-1000its,797,744,2147.846495026,2173.328779881,53
carcassonne-boltzmann315-vs-boltzmann115-1000its,799,746,2233.799897528,2238.881117226,53
carcassonne-boltzmann370-vs-boltzmann65-1000its,800,747,2180.86554316,2100.096116976,53
carcassonne-uct200-vs-uct175-1000its,801,748,2144.42423215,2058.883847996,53
carcassonne-ucttuned320-vs-ucttuned380-1000its,801,748,2190.102900342,2183.213227379,53
carcassonne-uct320-vs-uct200-1000its,802,749,2182.690893564,2135.784007759,53
carcassonne-uct345-vs-uct240-1000its,802,749,2176.235959018,2129.650553093,53
carcassonne-ucttuned170-vs-ucttuned485-1000its,802,749,2199.79109971,2119.871628233,53
carcassonne-uct365-vs-uct450-1000its,804,751,2166.922252567,2115.09694665,53
carcassonne-ucttuned445-vs-ucttuned480-1000its,806,753,2199.703478995,2177.985697421,53
carcassonne-boltzmann385-vs-boltzmann60-1000its,807,754,2178.630577297,2141.633408859,53
carcassonne-ucttuned45-vs-ucttuned425-1000its,807,754,2188.770138596,2123.120396425,53
carcassonne-uct425-vs-uct370-1000its,808,755,2186.811471016,2167.493642907,53
carcassonne-uct435-vs-uct70-1000its,808,755,2116.541453163,2122.680678263,53
carcassonne-boltzmann285-vs-boltzmann150-1000its,810,757,2224.147503078,2174.088726127,53
carcassonne-ucttuned190-vs-ucttuned180-1000its,810,757,2130.76464153,2103.826742921,53
carcassonne-uct10-vs-uct375-1000its,812,759,2208.516224905,2147.135164103,53
carcassonne-boltzmann220-vs-boltzmann405-1000its,813,760,2203.774372015,2134.954986967,53
carcassonne-boltzmann50-vs-boltzmann360-1000its,814,761,2184.709769479,2178.320757911,53
carcassonne-uct20-vs-uct430-1000its,814,761,2188.546115204,2140.654516012,53
carcassonne-ucttuned135-vs-ucttuned35-1000its,815,762,2175.465744319,2144.949282843,53
carcassonne-ucttuned335-vs-ucttuned310-1000its,818,765,2199.74343486,2150.321831642,53
carcassonne-boltzmann110-vs-boltzmann370-1000its,819,766,2262.031199413,2282.692383768,53
carcassonne-boltzmann245-vs-boltzmann135-1000its,819,766,2176.050739098,2138.050614919,53
carcassonne-boltzmann285-vs-boltzmann445-1000its,819,766,2166.291539914,2127.670698882,53
carcassonne-uct145-vs-uct350-1000its,820,767,2164.158559964,2127.871240566,53
carcassonne-boltzmann200-vs-boltzmann20-1000its,821,768,2200.856685372,2145.896927854,53
carcassonne-ucttuned260-vs-ucttuned325-1000its,821,768,2234.157897133,2149.433660822,53
carcassonne-uct400-vs-uct70-1000its,822,769,2227.863211758,2156.703498744,53
carcassonne-boltzmann235-vs-boltzmann220-1000its,823,770,2181.663453346,2133.707477056,53
carcassonne-boltzmann420-vs-boltzmann190-1000its,823,770,2147.46686999,2132.339449746,53
carcassonne-ucttuned180-vs-ucttuned285-1000its,823,770,2125.454929685,2093.042597626,53
carcassonne-uct410-vs-uct445-1000its,824,771,2172.777398642,2144.900423201,53
carcassonne-ucttuned240-vs-ucttuned185-1000its,824,771,2171.881937603,2133.046597276,53
carcassonne-uct75-vs-uct460-1000its,826,773,2201.526985828,2150.151844365,53
carcassonne-boltzmann310-vs-boltzmann305-1000its,828,775,2258.918255725,2225.687890269,53
carcassonne-uct115-vs-uct40-1000its,829,776,2179.724720551,2193.81857958,53
carcassonne-boltzmann120-vs-boltzmann285-1000its,832,779,2241.742957024,2223.668849662,53
carcassonne-boltzmann220-vs-boltzmann230-1000its,832,779,2212.206276567,2186.078113927,53
carcassonne-ucttuned295-vs-ucttuned490-1000its,833,780,2203.24819688,2204.262149341,53
carcassonne-uct50-vs-uct35-1000its,834,781,2149.884396268,2105.655391909,53
carcassonne-ucttuned265-vs-ucttuned320-1000its,834,781,2273.511481389,2208.900625345,53
carcassonne-boltzmann25-vs-boltzmann155-1000its,836,783,2166.130709688,2102.142550207,53
carcassonne-boltzmann380-vs-boltzmann365-1000its,836,783,2225.004852884,2201.410300766,53
carcassonne-boltzmann5-vs-boltzmann430-1000its,836,783,2189.443194237,2129.374936431,53
carcassonne-uct265-vs-uct260-1000its,836,783,2202.967686151,2143.969078949,53
carcassonne-uct460-vs-uct115-1000its,836,783,2149.662988414,2089.607778183,53
carcassonne-boltzmann120-vs-boltzmann225-1000its,838,785,2202.153370691,2137.657783313,53
carcassonne-ucttuned285-vs-ucttuned150-1000its,839,786,2204.293726096,2184.180231484,53
carcassonne-ucttuned5-vs-ucttuned15-1000its,840,787,2195.588621781,2168.511204724,53
carcassonne-boltzmann200-vs-boltzmann175-1000its,842,789,2167.212675398,2153.45214392,53
carcassonne-ucttuned330-vs-ucttuned425-1000its,842,789,2165.406442666,2170.705761107,53
carcassonne-uct115-vs-uct445-1000its,843,790,2244.590328543,2266.915317124,53
carcassonne-ucttuned20-vs-ucttuned410-1000its,843,790,2180.628368802,2117.961462979,53
carcassonne-uct435-vs-uct60-1000its,844,791,2215.978081893,2146.819820707,53
carcassonne-uct60-vs-uct295-1000its,844,791,2141.722807489,2111.290727538,53
carcassonne-uct25-vs-uct95-1000its,846,793,2182.101957443,2121.563556982,53
carcassonne-uct40-vs-uct270-1000its,847,794,2308.501490735,2271.42139716,53
carcassonne-boltzmann240-vs-boltzmann120-1000its,848,795,2159.77610758,2116.759642515,53
carcassonne-uct185-vs-uct70-1000its,848,795,2129.571208324,2117.846831805,53
carcassonne-boltzmann155-vs-boltzmann475-1000its,849,796,2230.471191871,2206.823802693,53
carcassonne-uct405-vs-uct115-1000its,849,796,2214.915588871,2179.556054773,53
carcassonne-ucttuned75-vs-ucttuned260-1000its,849,796,2199.787557112,2195.258762825,53
carcassonne-ucttuned165-vs-ucttuned235-1000its,851,798,2274.433277336,2236.154671099,53
carcassonne-boltzmann365-vs-boltzmann285-1000its,852,799,2161.541856694,2097.967714081,53
carcassonne-uct435-vs-uct135-1000its,852,799,2190.267534975,2143.914124107,53
carcassonne-uct150-vs-uct135-1000its,853,800,2166.068653346,2092.682827244,53
carcassonne-uct350-vs-uct330-1000its,854,801,2175.032955869,2112.233770375,53
carcassonne-uct175-vs-uct280-1000its,855,802,2231.849657198,2174.708157852,53
carcassonne-uct325-vs-uct205-1000its,855,802,2212.891598176,2166.608044712,53
carcassonne-uct280-vs-uct115-1000its,856,803,2236.73815489,2186.926871731,53
carcassonne-uct10-vs-uct490-1000its,858,805,2245.335283317,2206.761858637,53
carcassonne-ucttuned445-vs-ucttuned185-1000its,859,806,2180.783519636,2169.275824048,53
carcassonne-ucttuned60-vs-ucttuned185-1000its,860,807,2204.808823694,2143.223065378,53
carcassonne-uct220-vs-uct50-1000its,861,808,2154.778438064,2083.550124374,53
carcassonne-boltzmann195-vs-boltzmann180-1000its,862,809,2181.729190643,2152.062172524,53
carcassonne-boltzmann390-vs-boltzmann50-1000its,862,809,2141.841133915,2104.190628947,53
carcassonne-uct380-vs-uct10-1000its,862,809,2222.213842162,2161.356937687,53
carcassonne-ucttuned35-vs-ucttuned140-1000its,862,809,2184.049902591,2156.739860705,53
carcassonne-ucttuned375-vs-ucttuned225-1000its,864,811,2237.629260639,2213.738661138,53
carcassonne-uct310-vs-uct235-1000its,865,812,2207.580907268,2147.841628321,53
carcassonne-boltzmann240-vs-boltzmann270-1000its,866,813,2228.914897737,2190.087413205,53
carcassonne-uct90-vs-uct445-1000its,866,813,2148.474063466,2140.219270948,53
carcassonne-ucttuned175-vs-ucttuned85-1000its,866,813,2117.948768178,2094.625804805,53
carcassonne-ucttuned440-vs-ucttuned195-1000its,866,813,2186.666608557,2126.862445971,53
carcassonne-uct390-vs-uct205-1000its,869,816,2169.334192237,2154.053025377,53
carcassonne-ucttuned160-vs-ucttuned305-1000its,869,816,2188.114393904,2129.502177554,53
carcassonne-ucttuned450-vs-ucttuned355-1000its,870,817,2291.051013776,2268.066805998,53
carcassonne-boltzmann315-vs-boltzmann45-1000its,871,818,2169.809852946,2143.107500776,53
carcassonne-uct85-vs-uct330-1000its,872,819,2127.730798341,2143.586813451,53
carcassonne-uct170-vs-uct405-1000its,873,820,2201.973965921,2124.471914189,53
carcassonne-boltzmann435-vs-boltzmann450-1000its,874,821,2145.341560066,2143.349110882,53
carcassonne-boltzmann140-vs-boltzmann160-1000its,875,822,2273.063122539,2235.106671557,53
carcassonne-uct15-vs-uct70-1000its,875,822,2251.560541951,2183.736936813,53
carcassonne-uct60-vs-uct320-1000its,875,822,2254.404628784,2198.400395391,53
carcassonne-uct310-vs-uct380-1000its,876,823,2333.874729185,2291.295777013,53
carcassonne-uct380-vs-uct370-1000its,876,823,2181.204352543,2168.22811751,53
carcassonne-ucttuned400-vs-ucttuned260-1000its,876,823,2194.452314,2160.950464011,53
carcassonne-uct315-vs-uct255-1000its,877,824,2244.625764345,2200.676844356,53
carcassonne-boltzmann5-vs-boltzmann205-1000its,878,825,2154.439130941,2158.391099687,53
carcassonne-ucttuned400-vs-ucttuned335-1000its,878,825,2172.125600224,2128.482331356,53
carcassonne-ucttuned95-vs-ucttuned315-1000its,880,827,2207.541727533,2145.47434314,53
carcassonne-ucttuned140-vs-ucttuned345-1000its,887,834,2247.345073166,2175.851561411,53
carcassonne-ucttuned30-vs-ucttuned235-1000its,887,834,2163.840663324,2111.269088911,53
carcassonne-ucttuned390-vs-ucttuned360-1000its,890,837,2237.447992513,2206.731437968,53
carcassonne-uct280-vs-uct140-1000its,891,838,2281.618984898,2206.139624381,53
carcassonne-uct170-vs-uct65-1000its,893,840,2264.683445039,2211.734172607,53
carcassonne-ucttuned385-vs-ucttuned470-1000its,894,841,2270.109086505,2242.920604742,53
carcassonne-uct400-vs-uct490-1000its,897,844,2215.919047432,2211.966186395,53
carcassonne-ucttuned85-vs-ucttuned440-1000its,899,846,2143.72701032,2101.301245286,53
carcassonne-ucttuned80-vs-ucttuned110-1000its,904,851,2272.744014059,2243.118137251,53
carcassonne-ucttuned90-vs-ucttuned35-1000its,905,852,2181.050334785,2140.01575142,53
carcassonne-uct225-vs-uct80-1000its,906,853,2191.168246369,2123.916744383,53
carcassonne-ucttuned460-vs-ucttuned70-1000its,906,853,2174.164753881,2106.935988085,53
carcassonne-boltzmann275-vs-boltzmann365-1000its,908,855,2233.147687887,2152.470277875,53
carcassonne-boltzmann445-vs-boltzmann30-1000its,908,855,2171.296579663,2133.14563465,53
carcassonne-uct190-vs-uct480-1000its,908,855,2168.567246257,2133.619108522,53
carcassonne-uct20-vs-uct125-1000its,909,856,2242.565203954,2219.85631518,53
carcassonne-ucttuned155-vs-ucttuned80-1000its,910,857,2218.687916143,2127.561478599,53
carcassonne-boltzmann25-vs-boltzmann395-1000its,915,862,2193.565895053,2124.312332041,53
carcassonne-ucttuned5-vs-ucttuned305-1000its,917,864,2235.887323246,2178.212889203,53
carcassonne-uct20-vs-uct255-1000its,919,866,2229.291783542,2195.460017873,53
carcassonne-uct395-vs-uct170-1000its,925,872,2215.673659656,2159.7151402,53
carcassonne-uct180-vs-uct495-1000its,927,874,2148.109621066,2099.248908088,53
carcassonne-boltzmann285-vs-boltzmann380-1000its,931,878,2234.707169357,2226.478356693,53
carcassonne-boltzmann190-vs-boltzmann185-1000its,936,883,2211.69860599,2167.328509898,53
carcassonne-uct335-vs-uct395-1000its,939,886,2166.776404563,2152.105056504,53
carcassonne-uct345-vs-uct350-1000its,940,887,2290.046752146,2249.721512047,53
carcassonne-boltzmann200-vs-boltzmann85-1000its,941,888,2221.773811842,2167.795107858,53
carcassonne-ucttuned280-vs-ucttuned290-1000its,950,897,2250.521125443,2181.918772533,53
carcassonne-uct495-vs-uct260-1000its,614,560,1799.931321635,1715.878982498,54
carcassonne-uct320-vs-uct65-1000its,677,623,1793.619713429,1755.716779309,54
carcassonne-boltzmann260-vs-boltzmann280-1000its,757,703,2220.908088622,2168.304355688,54
carcassonne-ucttuned435-vs-ucttuned95-1000its,765,711,2139.761773431,2099.395855822,54
carcassonne-boltzmann35-vs-boltzmann375-1000its,767,713,2220.207277992,2149.923274329,54
carcassonne-boltzmann15-vs-boltzmann315-1000its,770,716,2128.911917462,2095.689844794,54
carcassonne-boltzmann80-vs-boltzmann150-1000its,772,718,2223.572029785,2162.682178821,54
carcassonne-boltzmann255-vs-boltzmann130-1000its,773,719,2154.613619981,2126.026790842,54
carcassonne-boltzmann50-vs-boltzmann35-1000its,776,722,2313.770568453,2248.587091058,54
carcassonne-uct95-vs-uct70-1000its,776,722,2157.986781489,2056.705342639,54
carcassonne-uct145-vs-uct15-1000its,779,725,2231.229809043,2229.376013439,54
carcassonne-boltzmann255-vs-boltzmann250-1000its,782,728,2173.652635262,2140.347490999,54
carcassonne-ucttuned365-vs-ucttuned465-1000its,785,731,2245.030617829,2226.747843943,54
carcassonne-uct225-vs-uct450-1000its,786,732,2208.212143894,2170.167795818,54
carcassonne-ucttuned445-vs-ucttuned135-1000its,791,737,2181.838671152,2193.563274788,54
carcassonne-boltzmann360-vs-boltzmann420-1000its,792,738,2264.787701574,2196.823970221,54
carcassonne-uct120-vs-uct235-1000its,794,740,2273.151683814,2184.197584515,54
carcassonne-ucttuned480-vs-ucttuned50-1000its,796,742,2198.925903795,2167.281471015,54
carcassonne-ucttuned80-vs-ucttuned485-1000its,798,744,2228.78705733,2174.783003064,54
carcassonne-uct450-vs-uct470-1000its,800,746,2177.471166416,2083.422478381,54
carcassonne-ucttuned250-vs-ucttuned235-1000its,801,747,2153.88934176,2121.881217616,54
carcassonne-boltzmann40-vs-boltzmann300-1000its,803,749,2226.198119248,2152.917903032,54
carcassonne-boltzmann110-vs-boltzmann460-1000its,804,750,2236.38910297,2168.301634287,54
carcassonne-uct395-vs-uct355-1000its,804,750,2243.063706551,2168.136554752,54
carcassonne-boltzmann305-vs-boltzmann380-1000its,806,752,2124.223227254,2064.561119886,54
carcassonne-uct275-vs-uct225-1000its,806,752,2227.292867966,2180.10126426,54
carcassonne-ucttuned220-vs-ucttuned380-1000its,807,753,2227.699216204,2199.052670932,54
carcassonne-uct325-vs-uct115-1000its,808,754,2215.620138072,2170.926452606,54
carcassonne-boltzmann265-vs-boltzmann225-1000its,810,756,2226.989459762,2171.895523055,54
carcassonne-ucttuned60-vs-ucttuned395-1000its,811,757,2170.682294692,2147.650750452,54
carcassonne-ucttuned85-vs-ucttuned495-1000its,811,757,2187.155005784,2144.225193577,54
carcassonne-ucttuned70-vs-ucttuned240-1000its,812,758,2173.472094763,2126.887794076,54
carcassonne-ucttuned455-vs-ucttuned100-1000its,815,761,2244.08296914,2197.799837344,54
carcassonne-boltzmann340-vs-boltzmann260-1000its,816,762,2150.669623469,2083.965888186,54
carcassonne-ucttuned205-vs-ucttuned90-1000its,817,763,2125.080879806,2113.84456197,54
carcassonne-uct170-vs-uct110-1000its,818,764,2128.239809041,2133.186301398,54
carcassonne-uct220-vs-uct45-1000its,818,764,2203.669163796,2137.477640894,54
carcassonne-uct270-vs-uct30-1000its,820,766,2231.731531403,2208.102012913,54
carcassonne-boltzmann460-vs-boltzmann210-1000its,821,767,2210.204175706,2119.608001755,54
carcassonne-ucttuned310-vs-ucttuned110-1000its,821,767,2214.542420384,2178.947793812,54
carcassonne-boltzmann375-vs-boltzmann455-1000its,822,768,2234.12498672,2152.861934383,54
carcassonne-boltzmann115-vs-boltzmann185-1000its,823,769,2203.12132274,2183.318898231,54
carcassonne-uct190-vs-uct25-1000its,823,769,2241.773352501,2196.567847319,54
carcassonne-uct35-vs-uct140-1000its,823,769,2117.235413092,2100.543824439,54
carcassonne-uct370-vs-uct235-1000its,823,769,2132.613652951,2128.200088456,54
carcassonne-uct125-vs-uct485-1000its,825,771,2197.704433499,2158.848497886,54
carcassonne-boltzmann180-vs-boltzmann215-1000its,827,773,2234.471241597,2219.089317009,54
carcassonne-boltzmann370-vs-boltzmann280-1000its,828,774,2163.177072754,2105.07477851,54
carcassonne-boltzmann40-vs-boltzmann255-1000its,830,776,2224.471293,2227.320638803,54
carcassonne-boltzmann165-vs-boltzmann315-1000its,831,777,2285.34261842,2263.734745668,54
carcassonne-ucttuned375-vs-ucttuned415-1000its,831,777,2183.780349969,2090.048442933,54
carcassonne-boltzmann145-vs-boltzmann445-1000its,832,778,2239.16385086,2120.666985197,54
carcassonne-boltzmann385-vs-boltzmann200-1000its,832,778,2192.309503697,2167.607554364,54
carcassonne-boltzmann490-vs-boltzmann315-1000its,832,778,2279.33848353,2208.048769469,54
carcassonne-uct210-vs-uct65-1000its,832,778,2232.892477272,2175.778683553,54
carcassonne-ucttuned310-vs-ucttuned470-1000its,832,778,2194.70078739,2131.812316755,54
carcassonne-ucttuned150-vs-ucttuned110-1000its,833,779,2182.953876385,2130.132616319,54
carcassonne-ucttuned85-vs-ucttuned165-1000its,833,779,2221.225641808,2162.346814504,54
carcassonne-uct290-vs-uct175-1000its,835,781,2194.974348312,2178.101173726,54
carcassonne-ucttuned385-vs-ucttuned310-1000its,835,781,2282.011222338,2207.159237054,54
carcassonne-ucttuned435-vs-ucttuned360-1000its,835,781,2211.768523062,2174.552338803,54
carcassonne-boltzmann45-vs-boltzmann300-1000its,836,782,2225.116557717,2163.475503699,54
carcassonne-uct195-vs-uct285-1000its,836,782,2142.93085162,2076.901206282,54
carcassonne-ucttuned10-vs-ucttuned160-1000its,837,783,2208.499226612,2175.161852951,54
carcassonne-uct175-vs-uct465-1000its,838,784,2177.978801299,2124.497299109,54
carcassonne-ucttuned135-vs-ucttuned415-1000its,838,784,2107.733797832,2038.539803256,54
carcassonne-ucttuned450-vs-ucttuned445-1000its,838,784,2174.719235581,2094.053804759,54
carcassonne-boltzmann410-vs-boltzmann240-1000its,840,786,2151.32902835,2141.741722114,54
carcassonne-boltzmann365-vs-boltzmann140-1000its,842,788,2295.138822737,2260.455761618,54
carcassonne-boltzmann190-vs-boltzmann480-1000its,843,789,2186.403113294,2144.803629113,54
carcassonne-uct175-vs-uct495-1000its,843,789,2167.751465013,2141.320788447,54
carcassonne-ucttuned210-vs-ucttuned445-1000its,843,789,2188.957084938,2107.546199784,54
carcassonne-boltzmann350-vs-boltzmann100-1000its,844,790,2170.766110613,2095.615308003,54
carcassonne-boltzmann390-vs-boltzmann285-1000its,844,790,2277.331046311,2227.341080995,54
carcassonne-ucttuned345-vs-ucttuned410-1000its,844,790,2232.058800507,2181.574793924,54
carcassonne-boltzmann130-vs-boltzmann245-1000its,845,791,2234.508684309,2256.023851441,54
carcassonne-ucttuned115-vs-ucttuned320-1000its,845,791,2198.983040638,2161.696266942,54
carcassonne-boltzmann305-vs-boltzmann345-1000its,846,792,2316.717472783,2280.112337911,54
carcassonne-ucttuned450-vs-ucttuned30-1000its,846,792,2199.350525687,2116.698816033,54
carcassonne-ucttuned430-vs-ucttuned365-1000its,847,793,2172.829960226,2126.484652871,54
carcassonne-ucttuned325-vs-ucttuned465-1000its,848,794,2240.562508114,2159.674869152,54
carcassonne-uct490-vs-uct200-1000its,849,795,2259.723658866,2167.84587099,54
carcassonne-ucttuned65-vs-ucttuned285-1000its,849,795,2145.720003071,2116.975875408,54
carcassonne-uct100-vs-uct370-1000its,851,797,2224.295533344,2186.345857117,54
carcassonne-boltzmann455-vs-boltzmann200-1000its,852,798,2256.898314393,2221.124441496,54
carcassonne-ucttuned455-vs-ucttuned150-1000its,852,798,2158.621057224,2130.710081113,54
carcassonne-ucttuned480-vs-ucttuned355-1000its,853,799,2200.892039567,2170.523060391,54
carcassonne-uct490-vs-uct165-1000its,854,800,2264.81491202,2249.717642717,54
carcassonne-uct480-vs-uct200-1000its,855,801,2231.473940766,2171.332082969,54
carcassonne-ucttuned175-vs-ucttuned460-1000its,855,801,2175.329415193,2141.739262238,54
carcassonne-ucttuned340-vs-ucttuned470-1000its,855,801,2203.320995458,2147.755997241,54
carcassonne-boltzmann295-vs-boltzmann110-1000its,857,803,2093.409024818,2091.907126269,54
carcassonne-boltzmann265-vs-boltzmann320-1000its,859,805,2207.774936709,2140.380966942,54
carcassonne-boltzmann440-vs-boltzmann325-1000its,859,805,2162.672768267,2131.90293687,54
carcassonne-ucttuned150-vs-ucttuned140-1000its,859,805,2247.816293177,2228.539225692,54
carcassonne-boltzmann385-vs-boltzmann465-1000its,860,806,2177.464538426,2138.855489929,54
carcassonne-ucttuned450-vs-ucttuned255-1000its,860,806,2189.940523607,2156.830979384,54
carcassonne-ucttuned465-vs-ucttuned345-1000its,860,806,2177.478719673,2141.155674889,54
carcassonne-uct25-vs-uct380-1000its,863,809,2205.547927256,2164.860491877,54
carcassonne-uct450-vs-uct260-1000its,863,809,2259.436216987,2211.815204718,54
carcassonne-ucttuned15-vs-ucttuned350-1000its,864,810,2192.524018932,2163.709076039,54
carcassonne-ucttuned495-vs-ucttuned175-1000its,866,812,2252.975754706,2181.07398611,54
carcassonne-ucttuned365-vs-ucttuned140-1000its,867,813,2195.727407789,2169.053227121,54
carcassonne-uct270-vs-uct360-1000its,868,814,2193.478181367,2088.111602747,54
carcassonne-ucttuned230-vs-ucttuned220-1000its,868,814,2159.109116674,2092.056803783,54
carcassonne-boltzmann5-vs-boltzmann480-1000its,869,815,2224.422175948,2185.263789813,54
carcassonne-uct465-vs-uct85-1000its,869,815,2203.110463853,2169.86108574,54
carcassonne-boltzmann390-vs-boltzmann440-1000its,870,816,2189.446999765,2134.544013895,54
carcassonne-ucttuned215-vs-ucttuned415-1000its,873,819,2237.279916329,2194.848286942,54
carcassonne-ucttuned215-vs-ucttuned60-1000its,873,819,2194.894756831,2161.651722381,54
carcassonne-boltzmann170-vs-boltzmann350-1000its,875,821,2209.126480107,2158.059134518,54
carcassonne-uct155-vs-uct395-1000its,875,821,2189.914030924,2124.390787236,54
carcassonne-uct10-vs-uct290-1000its,876,822,2190.096515318,2110.552114608,54
carcassonne-uct5-vs-uct430-1000its,876,822,2287.323186354,2229.029056818,54
carcassonne-uct110-vs-uct105-1000its,877,823,2150.747270071,2101.792495481,54
carcassonne-uct305-vs-uct280-1000its,877,823,2178.789626674,2127.730623787,54
carcassonne-uct410-vs-uct230-1000its,878,824,2170.412895339,2133.931611771,54
carcassonne-ucttuned190-vs-ucttuned290-1000its,881,827,2108.249382188,2111.177909935,54
carcassonne-ucttuned80-vs-ucttuned350-1000its,884,830,2224.833973919,2191.423698101,54
carcassonne-ucttuned10-vs-ucttuned40-1000its,889,835,2178.210576143,2178.087547789,54
carcassonne-boltzmann130-vs-boltzmann5-1000its,892,838,2226.032127626,2159.213790069,54
carcassonne-uct470-vs-uct310-1000its,893,839,2196.28140538,2209.384262008,54
carcassonne-uct215-vs-uct295-1000its,901,847,2293.326269782,2255.562588505,54
carcassonne-boltzmann475-vs-boltzmann65-1000its,905,851,2181.892695721,2102.044953028,54
carcassonne-boltzmann480-vs-boltzmann395-1000its,905,851,2161.443965085,2142.699757541,54
carcassonne-boltzmann5-vs-boltzmann280-1000its,905,851,2234.142868588,2201.095928297,54
carcassonne-uct125-vs-uct190-1000its,905,851,2189.007549673,2123.06007576,54
carcassonne-uct140-vs-uct285-1000its,905,851,2169.386174606,2145.560823899,54
carcassonne-ucttuned195-vs-ucttuned175-1000its,908,854,2254.821287947,2199.860592575,54
carcassonne-uct175-vs-uct385-1000its,912,858,2156.473736813,2074.854666239,54
carcassonne-uct310-vs-uct55-1000its,920,866,2215.931648717,2173.207778639,54
carcassonne-ucttuned410-vs-ucttuned185-1000its,922,868,2194.8051828,2141.716438386,54
carcassonne-ucttuned455-vs-ucttuned310-1000its,926,872,2206.894969653,2145.193820716,54
carcassonne-uct210-vs-uct245-1000its,932,878,2184.866573545,2115.547429463,54
carcassonne-ucttuned310-vs-ucttuned75-1000its,1021,967,2238.9798101,2186.062928039,54
carcassonne-ucttuned345-vs-ucttuned10-1000its,1024,970,2167.109384573,2136.649474921,54
carcassonne-boltzmann410-vs-boltzmann220-1000its,722,667,2135.593904666,2108.506523913,55
carcassonne-boltzmann85-vs-boltzmann305-1000its,736,681,2230.534781757,2181.394394256,55
carcassonne-boltzmann335-vs-boltzmann190-1000its,763,708,2225.217130501,2160.610430928,55
carcassonne-boltzmann270-vs-boltzmann10-1000its,767,712,2241.241026487,2212.2941949,55
carcassonne-boltzmann140-vs-boltzmann305-1000its,770,715,2131.4079295,2073.939682123,55
carcassonne-boltzmann295-vs-boltzmann460-1000its,771,716,2157.127231889,2122.83539345,55
carcassonne-boltzmann410-vs-boltzmann300-1000its,771,716,2192.429073375,2156.723160339,55
carcassonne-ucttuned495-vs-ucttuned475-1000its,772,717,2184.675100362,2103.470779617,55
carcassonne-boltzmann170-vs-boltzmann325-1000its,774,719,2151.219572638,2147.10691989,55
carcassonne-uct230-vs-uct420-1000its,780,725,2179.753578194,2111.048599857,55
carcassonne-boltzmann370-vs-boltzmann120-1000its,782,727,2186.601312126,2201.716702427,55
carcassonne-ucttuned465-vs-ucttuned270-1000its,784,729,2186.085691902,2104.130077066,55
carcassonne-uct50-vs-uct115-1000its,785,730,2214.54806182,2180.00729162,55
carcassonne-ucttuned105-vs-ucttuned245-1000its,785,730,2169.40715016,2129.407236775,55
carcassonne-uct180-vs-uct30-1000its,786,731,2263.0481068,2214.567290994,55
carcassonne-ucttuned140-vs-ucttuned205-1000its,789,734,2209.573354859,2149.006536165,55
carcassonne-ucttuned275-vs-ucttuned415-1000its,789,734,2224.806531954,2154.667892663,55
carcassonne-uct65-vs-uct90-1000its,790,735,2166.046429766,2150.61695942,55
carcassonne-uct70-vs-uct130-1000its,791,736,2244.346238651,2215.976799441,55
carcassonne-boltzmann240-vs-boltzmann60-1000its,793,738,2263.655566462,2158.34235928,55
carcassonne-boltzmann65-vs-boltzmann405-1000its,793,738,2261.651597142,2178.298031097,55
carcassonne-boltzmann185-vs-boltzmann60-1000its,794,739,2269.616929017,2227.906953622,55
carcassonne-boltzmann55-vs-boltzmann385-1000its,794,739,2252.87639631,2185.172812572,55
carcassonne-uct35-vs-uct260-1000its,795,740,2231.816721527,2166.129606772,55
carcassonne-boltzmann290-vs-boltzmann120-1000its,798,743,2149.42715223,2110.959860459,55
carcassonne-boltzmann95-vs-boltzmann100-1000its,798,743,2137.956032766,2116.43487678,55
carcassonne-boltzmann410-vs-boltzmann495-1000its,800,745,2174.481564502,2140.828175626,55
carcassonne-boltzmann410-vs-boltzmann290-1000its,802,747,2140.385974462,2098.006910274,55
carcassonne-uct470-vs-uct345-1000its,802,747,2214.105300233,2150.801671296,55
carcassonne-boltzmann160-vs-boltzmann375-1000its,803,748,2214.99395405,2162.104421958,55
carcassonne-ucttuned100-vs-ucttuned200-1000its,803,748,2161.457650024,2119.618325201,55
carcassonne-boltzmann125-vs-boltzmann460-1000its,804,749,2131.327759099,2101.281235064,55
carcassonne-ucttuned270-vs-ucttuned240-1000its,806,751,2129.52282153,2086.248326595,55
carcassonne-boltzmann365-vs-boltzmann315-1000its,807,752,2220.168084951,2186.249636429,55
carcassonne-uct495-vs-uct440-1000its,808,753,2208.09657638,2138.789252523,55
carcassonne-boltzmann115-vs-boltzmann35-1000its,812,757,2209.2806412,2166.901794502,55
carcassonne-uct225-vs-uct260-1000its,812,757,2220.598510947,2169.837679333,55
carcassonne-boltzmann175-vs-boltzmann485-1000its,813,758,2262.24624806,2207.972244392,55
carcassonne-ucttuned340-vs-ucttuned190-1000its,813,758,2215.489679435,2134.461709052,55
carcassonne-ucttuned185-vs-ucttuned65-1000its,815,760,2166.683119574,2131.861947319,55
carcassonne-ucttuned295-vs-ucttuned270-1000its,816,761,2124.930834375,2092.722933925,55
carcassonne-ucttuned240-vs-ucttuned190-1000its,817,762,2157.00206662,2078.957810415,55
carcassonne-boltzmann490-vs-boltzmann15-1000its,818,763,2156.710113393,2147.280819697,55
carcassonne-ucttuned165-vs-ucttuned100-1000its,818,763,2278.659252804,2212.028571262,55
carcassonne-ucttuned190-vs-ucttuned440-1000its,819,764,2224.453012441,2180.419260094,55
carcassonne-ucttuned95-vs-ucttuned365-1000its,819,764,2179.699712333,2108.551966366,55
carcassonne-boltzmann75-vs-boltzmann145-1000its,821,766,2186.483357501,2111.029678011,55
carcassonne-uct365-vs-uct15-1000its,821,766,2157.657294319,2104.245521273,55
carcassonne-uct310-vs-uct470-1000its,822,767,2230.568105609,2209.789917477,55
carcassonne-boltzmann330-vs-boltzmann345-1000its,823,768,2162.083950579,2139.665945767,55
carcassonne-boltzmann465-vs-boltzmann205-1000its,826,771,2238.287807704,2176.891692446,55
carcassonne-uct20-vs-uct75-1000its,826,771,2273.125040404,2190.855513724,55
carcassonne-ucttuned310-vs-ucttuned295-1000its,826,771,2255.708531429,2159.435912424,55
carcassonne-ucttuned460-vs-ucttuned305-1000its,827,772,2162.050644413,2128.10962301,55
carcassonne-uct170-vs-uct70-1000its,828,773,2234.178074057,2189.780640821,55
carcassonne-uct65-vs-uct270-1000its,828,773,2259.500131275,2227.705475241,55
carcassonne-boltzmann205-vs-boltzmann400-1000its,830,775,2176.332068325,2151.132259493,55
carcassonne-uct215-vs-uct410-1000its,830,775,2171.920252965,2131.270300466,55
carcassonne-boltzmann80-vs-boltzmann485-1000its,831,776,2190.894717445,2154.797449989,55
carcassonne-uct315-vs-uct405-1000its,832,777,2141.628924789,2089.427122597,55
carcassonne-boltzmann245-vs-boltzmann50-1000its,834,779,2139.052721057,2064.924203384,55
carcassonne-uct100-vs-uct90-1000its,834,779,2190.565732324,2106.542936014,55
carcassonne-uct80-vs-uct445-1000its,834,779,2130.435633098,2095.266359537,55
carcassonne-ucttuned405-vs-ucttuned300-1000its,834,779,2225.341213555,2169.489842156,55
carcassonne-uct395-vs-uct75-1000its,835,780,2165.413226306,2167.582465827,55
carcassonne-uct70-vs-uct155-1000its,835,780,2170.994657949,2101.251654996,55
carcassonne-ucttuned135-vs-ucttuned165-1000its,835,780,2122.39266555,2092.767101487,55
carcassonne-ucttuned185-vs-ucttuned315-1000its,835,780,2163.525613992,2140.357971212,55
carcassonne-ucttuned480-vs-ucttuned230-1000its,835,780,2129.609112119,2108.346113385,55
carcassonne-boltzmann340-vs-boltzmann195-1000its,836,781,2233.746157292,2178.205014014,55
carcassonne-ucttuned165-vs-ucttuned175-1000its,836,781,2194.477308874,2148.904368537,55
carcassonne-boltzmann155-vs-boltzmann95-1000its,837,782,2247.440686179,2181.718210842,55
carcassonne-boltzmann180-vs-boltzmann110-1000its,838,783,2226.856233203,2133.444945217,55
carcassonne-boltzmann265-vs-boltzmann475-1000its,839,784,2167.464472471,2088.097830728,55
carcassonne-boltzmann445-vs-boltzmann350-1000its,839,784,2227.091849791,2176.764395391,55
carcassonne-uct160-vs-uct315-1000its,839,784,2155.513308872,2104.817249839,55
carcassonne-uct95-vs-uct465-1000its,839,784,2215.893341038,2161.675394915,55
carcassonne-boltzmann50-vs-boltzmann180-1000its,840,785,2227.703344768,2175.849040399,55
carcassonne-uct235-vs-uct395-1000its,840,785,2256.878698835,2173.028373977,55
carcassonne-uct395-vs-uct450-1000its,840,785,2231.421256257,2168.016343329,55
carcassonne-uct435-vs-uct270-1000its,840,785,2185.611230208,2133.270102898,55
carcassonne-uct185-vs-uct305-1000its,841,786,2197.894478765,2147.540422459,55
carcassonne-ucttuned140-vs-ucttuned320-1000its,841,786,2231.893787325,2198.486428539,55
carcassonne-boltzmann180-vs-boltzmann195-1000its,842,787,2223.811756411,2170.589594438,55
carcassonne-uct305-vs-uct70-1000its,843,788,2182.364582824,2134.444819666,55
carcassonne-uct410-vs-uct340-1000its,843,788,2172.892322003,2140.046386585,55
carcassonne-ucttuned260-vs-ucttuned65-1000its,843,788,2195.037019941,2154.033171353,55
carcassonne-uct370-vs-uct245-1000its,846,791,2232.883318478,2229.820497966,55
carcassonne-ucttuned115-vs-ucttuned325-1000its,848,793,2200.630754016,2111.378794282,55
carcassonne-ucttuned180-vs-ucttuned175-1000its,848,793,2166.573872131,2105.527210291,55
carcassonne-ucttuned315-vs-ucttuned55-1000its,848,793,2226.76078685,2173.534702593,55
carcassonne-uct355-vs-uct265-1000its,849,794,2237.37155971,2136.919247587,55
carcassonne-ucttuned100-vs-ucttuned425-1000its,849,794,2169.157359071,2099.486459362,55
carcassonne-ucttuned285-vs-ucttuned95-1000its,849,794,2186.905347765,2202.491101918,55
carcassonne-ucttuned75-vs-ucttuned375-1000its,849,794,2238.179342385,2203.371042678,55
carcassonne-uct345-vs-uct490-1000its,851,796,2207.202266776,2147.75591339,55
carcassonne-boltzmann165-vs-boltzmann5-1000its,852,797,2178.140539694,2130.24139845,55
carcassonne-boltzmann60-vs-boltzmann235-1000its,852,797,2220.306113123,2144.679565437,55
carcassonne-uct10-vs-uct425-1000its,852,797,2237.107873045,2165.784254314,55
carcassonne-ucttuned375-vs-ucttuned295-1000its,854,799,2156.010943343,2147.052784662,55
carcassonne-uct150-vs-uct75-1000its,855,800,2205.246786203,2193.16596836,55
carcassonne-uct415-vs-uct450-1000its,858,803,2193.800204503,2116.257531805,55
carcassonne-uct430-vs-uct135-1000its,859,804,2209.425483111,2173.222569535,55
carcassonne-ucttuned365-vs-ucttuned300-1000its,859,804,2203.404248707,2139.258504491,55
carcassonne-boltzmann40-vs-boltzmann80-1000its,860,805,2266.205171636,2213.160537268,55
carcassonne-ucttuned340-vs-ucttuned120-1000its,860,805,2199.236591282,2145.078971457,55
carcassonne-boltzmann485-vs-boltzmann475-1000its,861,806,2260.839604857,2164.760980636,55
carcassonne-uct125-vs-uct290-1000its,864,809,2159.759731813,2159.944656354,55
carcassonne-ucttuned235-vs-ucttuned60-1000its,864,809,2209.810984488,2180.955053807,55
carcassonne-ucttuned370-vs-ucttuned330-1000its,864,809,2193.239433761,2173.356066475,55
carcassonne-uct120-vs-uct410-1000its,865,810,2151.491408398,2137.84969086,55
carcassonne-uct410-vs-uct290-1000its,866,811,2149.066260915,2109.170023943,55
carcassonne-ucttuned15-vs-ucttuned285-1000its,866,811,2234.012194728,2200.667121609,55
carcassonne-ucttuned430-vs-ucttuned200-1000its,867,812,2187.195139097,2115.801208507,55
carcassonne-boltzmann330-vs-boltzmann355-1000its,868,813,2224.008445785,2122.207517918,55
carcassonne-ucttuned155-vs-ucttuned95-1000its,869,814,2163.038626995,2128.70629414,55
carcassonne-ucttuned70-vs-ucttuned75-1000its,869,814,2240.593219644,2213.825773019,55
carcassonne-boltzmann45-vs-boltzmann285-1000its,871,816,2155.094938207,2110.897212982,55
carcassonne-boltzmann495-vs-boltzmann385-1000its,872,817,2169.367145939,2123.891042591,55
carcassonne-ucttuned465-vs-ucttuned255-1000its,874,819,2196.998176901,2197.80733613,55
carcassonne-ucttuned320-vs-ucttuned70-1000its,875,820,2236.5696326,2216.007090441,55
carcassonne-uct495-vs-uct25-1000its,878,823,2257.75414485,2226.166089726,55
carcassonne-boltzmann205-vs-boltzmann390-1000its,879,824,2224.97790936,2149.04222288,55
carcassonne-boltzmann150-vs-boltzmann205-1000its,882,827,2140.44355797,2079.404967932,55
carcassonne-ucttuned175-vs-ucttuned260-1000its,884,829,2221.206969225,2174.017432435,55
carcassonne-ucttuned355-vs-ucttuned215-1000its,885,830,2178.606570875,2152.387002604,55
carcassonne-uct40-vs-uct70-1000its,886,831,2202.344996882,2179.457076392,55
carcassonne-ucttuned20-vs-ucttuned465-1000its,894,839,2205.380112959,2154.482192983,55
carcassonne-uct375-vs-uct360-1000its,899,844,2253.401272478,2187.56019411,55
carcassonne-boltzmann190-vs-boltzmann490-1000its,901,846,2235.356301258,2189.234185655,55
carcassonne-uct480-vs-uct90-1000its,901,846,2132.249621505,2070.839168603,55
carcassonne-ucttuned65-vs-ucttuned50-1000its,905,850,2195.345588958,2206.363301463,55
carcassonne-ucttuned145-vs-ucttuned480-1000its,906,851,2145.582329752,2099.241336047,55
carcassonne-boltzmann120-vs-boltzmann150-1000its,909,854,2126.952899371,2126.353622254,55
carcassonne-uct10-vs-uct460-1000its,916,861,2232.00064994,2188.141401092,55
carcassonne-uct340-vs-uct375-1000its,924,869,2253.076789354,2187.28137062,55
carcassonne-boltzmann40-vs-boltzmann105-1000its,931,876,2236.488971956,2200.441891531,55
carcassonne-boltzmann105-vs-boltzmann295-1000its,939,884,2159.219603616,2117.428117324,55
carcassonne-boltzmann330-vs-boltzmann125-1000its,648,592,1717.090481633,1719.932916255,56
carcassonne-uct425-vs-uct75-1000its,690,634,1757.658945124,1730.382418898,56
carcassonne-uct245-vs-uct210-1000its,692,636,1776.445210085,1719.038689875,56
carcassonne-boltzmann300-vs-boltzmann70-1000its,736,680,2134.386330879,2059.925357427,56
carcassonne-ucttuned335-vs-ucttuned440-1000its,770,714,2168.809228712,2130.800915316,56
carcassonne-boltzmann195-vs-boltzmann290-1000its,774,718,2178.43975292,2146.752679717,56
carcassonne-uct215-vs-uct200-1000its,775,719,2162.230228653,2109.032769412,56
carcassonne-boltzmann290-vs-boltzmann340-1000its,778,722,2190.278434249,2178.055981154,56
carcassonne-boltzmann260-vs-boltzmann330-1000its,787,731,2171.167763632,2119.496006312,56
carcassonne-ucttuned465-vs-ucttuned395-1000its,787,731,2160.630049928,2135.848510316,56
carcassonne-boltzmann375-vs-boltzmann175-1000its,789,733,2223.804844528,2210.124192043,56
carcassonne-ucttuned385-vs-ucttuned460-1000its,791,735,2189.370453996,2177.734735975,56
carcassonne-uct440-vs-uct45-1000its,792,736,2181.368586359,2176.900069361,56
carcassonne-ucttuned270-vs-ucttuned355-1000its,792,736,2236.144412796,2228.335979708,56
carcassonne-uct495-vs-uct190-1000its,795,739,2156.540797499,2110.286019623,56
carcassonne-uct145-vs-uct430-1000its,796,740,2113.672657223,2055.30235516,56
carcassonne-uct275-vs-uct100-1000its,801,745,2226.515140242,2195.158718147,56
carcassonne-ucttuned380-vs-ucttuned285-1000its,801,745,2209.768516643,2175.995639763,56
carcassonne-boltzmann130-vs-boltzmann215-1000its,803,747,2178.43442068,2142.179182926,56
carcassonne-boltzmann375-vs-boltzmann290-1000its,803,747,2179.030662012,2171.121088003,56
carcassonne-uct280-vs-uct350-1000its,803,747,2208.24377914,2150.591651817,56
carcassonne-ucttuned360-vs-ucttuned50-1000its,803,747,2233.116366513,2184.310103169,56
carcassonne-boltzmann360-vs-boltzmann45-1000its,804,748,2238.260391177,2214.324767442,56
carcassonne-boltzmann370-vs-boltzmann210-1000its,808,752,2163.867516233,2103.576497989,56
carcassonne-boltzmann415-vs-boltzmann35-1000its,808,752,2208.694507283,2200.970875952,56
carcassonne-ucttuned290-vs-ucttuned365-1000its,808,752,2202.701872068,2146.08905955,56
carcassonne-boltzmann105-vs-boltzmann70-1000its,812,756,2218.329108917,2172.005440288,56
carcassonne-ucttuned210-vs-ucttuned435-1000its,812,756,2205.99854362,2163.225800244,56
carcassonne-boltzmann265-vs-boltzmann315-1000its,813,757,2188.914235633,2171.468082674,56
carcassonne-uct185-vs-uct405-1000its,813,757,2253.944217053,2240.955096337,56
carcassonne-ucttuned125-vs-ucttuned250-1000its,813,757,2190.526262076,2148.474845144,56
carcassonne-ucttuned455-vs-ucttuned450-1000its,817,761,2185.462416323,2132.241257847,56
carcassonne-ucttuned50-vs-ucttuned360-1000its,817,761,2239.567564208,2147.166847987,56
carcassonne-uct485-vs-uct265-1000its,820,764,2144.559579084,2149.333221848,56
carcassonne-boltzmann250-vs-boltzmann430-1000its,822,766,2237.99009075,2203.646163442,56
carcassonne-uct75-vs-uct475-1000its,822,766,2229.445195776,2207.928438726,56
carcassonne-ucttuned85-vs-ucttuned375-1000its,822,766,2310.903670085,2245.79541904,56
carcassonne-boltzmann290-vs-boltzmann105-1000its,823,767,2173.008266056,2115.455816412,56
carcassonne-ucttuned465-vs-ucttuned175-1000its,823,767,2144.209729525,2178.239408273,56
carcassonne-uct100-vs-uct205-1000its,824,768,2297.816374321,2239.782225337,56
carcassonne-ucttuned300-vs-ucttuned65-1000its,824,768,2180.135388107,2124.009009643,56
carcassonne-boltzmann160-vs-boltzmann100-1000its,825,769,2173.704353984,2130.092049882,56
carcassonne-boltzmann295-vs-boltzmann235-1000its,825,769,2149.658644187,2102.066801735,56
carcassonne-boltzmann30-vs-boltzmann105-1000its,825,769,2207.426649784,2168.15014492,56
carcassonne-boltzmann385-vs-boltzmann310-1000its,825,769,2125.960478761,2119.249166002,56
carcassonne-ucttuned300-vs-ucttuned465-1000its,827,771,2246.905539068,2177.615955839,56
carcassonne-uct95-vs-uct25-1000its,829,773,2162.640626397,2140.250144025,56
carcassonne-uct100-vs-uct420-1000its,830,774,2320.427869393,2225.858079126,56
carcassonne-ucttuned40-vs-ucttuned420-1000its,832,776,2213.665490001,2149.238114931,56
carcassonne-ucttuned425-vs-ucttuned415-1000its,833,777,2220.591662453,2158.970636699,56
carcassonne-ucttuned270-vs-ucttuned425-1000its,834,778,2245.766024387,2204.356447653,56
carcassonne-ucttuned50-vs-ucttuned405-1000its,834,778,2166.338782642,2133.720137749,56
carcassonne-ucttuned25-vs-ucttuned350-1000its,835,779,2180.854505835,2102.018932793,56
carcassonne-boltzmann365-vs-boltzmann245-1000its,836,780,2147.55855443,2110.032808884,56
carcassonne-uct340-vs-uct330-1000its,836,780,2184.913642585,2124.016667827,56
carcassonne-uct420-vs-uct190-1000its,836,780,2168.320197442,2147.898740715,56
carcassonne-uct210-vs-uct20-1000its,837,781,2137.071294792,2117.443142207,56
carcassonne-uct55-vs-uct145-1000its,838,782,2169.959570146,2132.043191922,56
carcassonne-boltzmann325-vs-boltzmann210-1000its,839,783,2230.635692602,2215.03442045,56
carcassonne-boltzmann155-vs-boltzmann310-1000its,842,786,2111.906884036,2048.06132259,56
carcassonne-boltzmann195-vs-boltzmann300-1000its,842,786,2226.617611871,2145.845554796,56
carcassonne-uct345-vs-uct165-1000its,842,786,2178.306359058,2068.572661649,56
carcassonne-boltzmann175-vs-boltzmann405-1000its,844,788,2134.664371716,2120.908519651,56
carcassonne-boltzmann430-vs-boltzmann80-1000its,844,788,2192.706758983,2118.06183713,56
carcassonne-uct195-vs-uct490-1000its,844,788,2262.986973109,2212.826224025,56
carcassonne-ucttuned320-vs-ucttuned400-1000its,846,790,2265.499541678,2254.769834667,56
carcassonne-boltzmann5-vs-boltzmann165-1000its,847,791,2184.934675887,2134.183575432,56
carcassonne-uct305-vs-uct410-1000its,848,792,2202.026372224,2134.810888488,56
carcassonne-ucttuned115-vs-ucttuned395-1000its,848,792,2274.874272378,2193.052249716,56
carcassonne-ucttuned230-vs-ucttuned350-1000its,848,792,2205.200953612,2180.603092214,56
carcassonne-uct80-vs-uct390-1000its,849,793,2129.775919312,2101.575648487,56
carcassonne-boltzmann325-vs-boltzmann160-1000its,851,795,2268.07590417,2177.923695425,56
carcassonne-uct15-vs-uct325-1000its,851,795,2274.983027275,2181.059652506,56
carcassonne-ucttuned170-vs-ucttuned285-1000its,851,795,2184.426548424,2152.902795423,56
carcassonne-boltzmann250-vs-boltzmann160-1000its,852,796,2160.144714272,2123.961466871,56
carcassonne-uct390-vs-uct85-1000its,852,796,2244.560403911,2178.680854204,56
carcassonne-uct225-vs-uct170-1000its,853,797,2202.918479725,2135.063656466,56
carcassonne-ucttuned290-vs-ucttuned460-1000its,853,797,2273.861742401,2196.545137418,56
carcassonne-ucttuned325-vs-ucttuned50-1000its,854,798,2253.138120002,2272.92667095,56
carcassonne-ucttuned390-vs-ucttuned295-1000its,854,798,2160.020260398,2128.414646353,56
carcassonne-uct250-vs-uct345-1000its,856,800,2239.542484799,2191.116910478,56
carcassonne-boltzmann235-vs-boltzmann265-1000its,857,801,2168.189888762,2146.766096452,56
carcassonne-uct225-vs-uct90-1000its,857,801,2155.853888774,2107.835786939,56
carcassonne-uct365-vs-uct85-1000its,857,801,2205.132149758,2160.608802883,56
carcassonne-ucttuned355-vs-ucttuned420-1000its,858,802,2226.450580709,2196.39496964,56
carcassonne-ucttuned355-vs-ucttuned75-1000its,858,802,2217.645395473,2203.981775625,56
carcassonne-uct275-vs-uct125-1000its,860,804,2200.14656051,2159.313309788,56
carcassonne-uct275-vs-uct160-1000its,860,804,2205.167965951,2119.507943216,56
carcassonne-uct370-vs-uct445-1000its,860,804,2214.910626452,2193.460264969,56
carcassonne-ucttuned340-vs-ucttuned250-1000its,860,804,2245.854937271,2160.979062911,56
carcassonne-boltzmann295-vs-boltzmann245-1000its,862,806,2187.72371047,2114.163134892,56
carcassonne-uct475-vs-uct265-1000its,864,808,2245.745879099,2203.24617476,56
carcassonne-ucttuned410-vs-ucttuned405-1000its,864,808,2302.946911703,2267.201603888,56
carcassonne-boltzmann125-vs-boltzmann440-1000its,866,810,2170.520580462,2081.856412967,56
carcassonne-boltzmann350-vs-boltzmann480-1000its,867,811,2208.831869176,2174.326651611,56
carcassonne-boltzmann315-vs-boltzmann130-1000its,868,812,2165.65609745,2162.396719255,56
carcassonne-uct150-vs-uct295-1000its,874,818,2140.600801985,2117.158954229,56
carcassonne-boltzmann110-vs-boltzmann240-1000its,877,821,2249.291689841,2243.291045856,56
carcassonne-boltzmann205-vs-boltzmann365-1000its,878,822,2206.640608758,2151.994458334,56
carcassonne-boltzmann50-vs-boltzmann415-1000its,878,822,2139.73415276,2149.071563796,56
carcassonne-uct255-vs-uct280-1000its,879,823,2253.202421849,2192.163385502,56
carcassonne-uct430-vs-uct290-1000its,879,823,2117.412597875,2052.333879423,56
carcassonne-ucttuned385-vs-ucttuned245-1000its,880,824,2217.915868592,2174.711906819,56
carcassonne-boltzmann320-vs-boltzmann205-1000its,884,828,2234.435497033,2194.817955386,56
carcassonne-ucttuned430-vs-ucttuned180-1000its,884,828,2160.884650529,2133.889984933,56
carcassonne-boltzmann55-vs-boltzmann185-1000its,894,838,2163.145616546,2057.877643699,56
carcassonne-ucttuned410-vs-ucttuned305-1000its,894,838,2121.509924705,2098.772260329,56
carcassonne-boltzmann330-vs-boltzmann75-1000its,896,840,2235.085918964,2165.824486865,56
carcassonne-boltzmann150-vs-boltzmann120-1000its,897,841,2314.872451763,2271.261137152,56
carcassonne-uct85-vs-uct25-1000its,897,841,2141.683102456,2125.130070307,56
carcassonne-ucttuned315-vs-ucttuned380-1000its,902,846,2197.216322829,2162.641917921,56
carcassonne-boltzmann195-vs-boltzmann330-1000its,905,849,2317.876690297,2256.771705917,56
carcassonne-ucttuned220-vs-ucttuned440-1000its,905,849,2198.132197804,2177.093222104,56
carcassonne-ucttuned225-vs-ucttuned300-1000its,905,849,2172.772987213,2139.339699133,56
carcassonne-ucttuned355-vs-ucttuned320-1000its,908,852,2181.449537355,2198.629831198,56
carcassonne-ucttuned210-vs-ucttuned220-1000its,910,854,2160.609485608,2112.007052473,56
carcassonne-ucttuned410-vs-ucttuned20-1000its,918,862,2178.236050664,2156.628964111,56
carcassonne-ucttuned260-vs-ucttuned310-1000its,920,864,2175.381033876,2094.351638074,56
carcassonne-boltzmann425-vs-boltzmann455-1000its,931,875,2220.751585527,2158.809680478,56
carcassonne-uct270-vs-uct465-1000its,952,896,2220.216890755,2159.197610208,56
carcassonne-ucttuned60-vs-ucttuned360-1000its,700,643,1756.95397466,1694.124144013,57
carcassonne-boltzmann480-vs-boltzmann345-1000its,776,719,2219.187726707,2181.054163003,57
carcassonne-boltzmann425-vs-boltzmann70-1000its,780,723,2282.213025614,2216.138706037,57
carcassonne-uct60-vs-uct40-1000its,780,723,2237.345710718,2170.633404283,57
carcassonne-boltzmann275-vs-boltzmann490-1000its,781,724,2120.784914488,2110.612052091,57
carcassonne-uct50-vs-uct375-1000its,788,731,2268.3549836,2160.667196536,57
carcassonne-boltzmann495-vs-boltzmann475-1000its,790,733,2198.454042847,2117.806565224,57
carcassonne-boltzmann240-vs-boltzmann15-1000its,791,734,2174.988603739,2147.55529976,57
carcassonne-boltzmann455-vs-boltzmann430-1000its,791,734,2217.275100935,2121.98853619,57
carcassonne-boltzmann235-vs-boltzmann440-1000its,792,735,2229.961559396,2221.207582486,57
carcassonne-uct415-vs-uct400-1000its,795,738,2192.565228509,2125.113480166,57
carcassonne-boltzmann175-vs-boltzmann350-1000its,797,740,2175.349757484,2131.542436688,57
carcassonne-uct285-vs-uct495-1000its,798,741,2225.71009407,2188.860101262,57
carcassonne-ucttuned355-vs-ucttuned340-1000its,799,742,2157.59997631,2166.405097642,57
carcassonne-boltzmann70-vs-boltzmann280-1000its,803,746,2256.36647166,2227.566899372,57
carcassonne-uct115-vs-uct25-1000its,804,747,2190.61265885,2181.088047748,57
carcassonne-ucttuned250-vs-ucttuned70-1000its,805,748,2180.848522454,2170.685181096,57
carcassonne-boltzmann10-vs-boltzmann210-1000its,806,749,2194.04581782,2206.057109284,57
carcassonne-ucttuned250-vs-ucttuned320-1000its,806,749,2252.50193482,2190.737731273,57
carcassonne-boltzmann405-vs-boltzmann130-1000its,807,750,2188.445654343,2129.493520411,57
carcassonne-boltzmann335-vs-boltzmann460-1000its,809,752,2129.597204266,2120.899143532,57
carcassonne-ucttuned225-vs-ucttuned425-1000its,809,752,2189.124951093,2150.807791953,57
carcassonne-ucttuned105-vs-ucttuned340-1000its,810,753,2242.392621753,2161.822764589,57
carcassonne-ucttuned335-vs-ucttuned445-1000its,810,753,2194.458444792,2189.371099503,57
carcassonne-ucttuned140-vs-ucttuned230-1000its,812,755,2211.579805801,2158.866396147,57
carcassonne-ucttuned280-vs-ucttuned460-1000its,812,755,2195.016456044,2152.400189521,57
carcassonne-ucttuned430-vs-ucttuned340-1000its,812,755,2216.658501681,2155.414172118,57
carcassonne-ucttuned365-vs-ucttuned110-1000its,814,757,2189.920060087,2202.860679013,57
carcassonne-ucttuned460-vs-ucttuned310-1000its,815,758,2207.619881605,2096.213707223,57
carcassonne-ucttuned335-vs-ucttuned330-1000its,816,759,2186.763467518,2151.322279082,57
carcassonne-boltzmann215-vs-boltzmann385-1000its,817,760,2143.886729672,2065.955555451,57
carcassonne-boltzmann285-vs-boltzmann375-1000its,817,760,2270.724006586,2182.993900055,57
carcassonne-ucttuned280-vs-ucttuned165-1000its,817,760,2209.568989248,2150.475827185,57
carcassonne-ucttuned90-vs-ucttuned280-1000its,821,764,2201.121835185,2206.722189621,57
carcassonne-uct350-vs-uct75-1000its,823,766,2130.504769222,2084.851045865,57
carcassonne-ucttuned385-vs-ucttuned230-1000its,824,767,2181.671802366,2127.550837519,57
carcassonne-uct315-vs-uct240-1000its,825,768,2110.253097267,2072.463628705,57
carcassonne-uct35-vs-uct365-1000its,825,768,2245.677541739,2223.775581099,57
carcassonne-uct465-vs-uct130-1000its,826,769,2203.507204975,2181.9609102,57
carcassonne-boltzmann160-vs-boltzmann325-1000its,827,770,2136.801608976,2117.911646527,57
carcassonne-boltzmann380-vs-boltzmann40-1000its,827,770,2227.899486509,2199.490713953,57
carcassonne-uct245-vs-uct40-1000its,828,771,2262.894877886,2197.937031125,57
carcassonne-boltzmann320-vs-boltzmann310-1000its,829,772,2150.442128579,2095.752925224,57
carcassonne-boltzmann490-vs-boltzmann65-1000its,832,775,2201.367838887,2146.594600684,57
carcassonne-boltzmann55-vs-boltzmann100-1000its,832,775,2267.837927986,2188.427999809,57
carcassonne-uct10-vs-uct335-1000its,832,775,2138.513121825,2128.503485399,57
carcassonne-uct435-vs-uct305-1000its,833,776,2204.204268929,2177.142607769,57
carcassonne-uct475-vs-uct385-1000its,836,779,2232.526528767,2157.216285652,57
carcassonne-boltzmann305-vs-boltzmann145-1000its,837,780,2225.121127061,2182.692641311,57
carcassonne-boltzmann175-vs-boltzmann90-1000its,838,781,2182.194106755,2146.992603888,57
carcassonne-boltzmann200-vs-boltzmann125-1000its,838,781,2191.605827727,2177.197264505,57
carcassonne-uct240-vs-uct400-1000its,838,781,2213.39420657,2150.421781332,57
carcassonne-ucttuned455-vs-ucttuned50-1000its,838,781,2257.819598171,2213.574163188,57
carcassonne-ucttuned455-vs-ucttuned110-1000its,839,782,2207.178380061,2144.288228569,57
carcassonne-boltzmann250-vs-boltzmann400-1000its,840,783,2154.380179465,2092.639010896,57
carcassonne-boltzmann40-vs-boltzmann470-1000its,840,783,2260.564005943,2226.380116767,57
carcassonne-ucttuned335-vs-ucttuned230-1000its,840,783,2270.879494635,2212.906289787,57
carcassonne-uct145-vs-uct80-1000its,841,784,2178.957205288,2151.593938264,57
carcassonne-ucttuned50-vs-ucttuned325-1000its,841,784,2183.74295847,2126.019173307,57
carcassonne-boltzmann350-vs-boltzmann240-1000its,842,785,2279.413024218,2272.006105115,57
carcassonne-uct320-vs-uct240-1000its,842,785,2211.570475236,2156.383032108,57
carcassonne-boltzmann5-vs-boltzmann380-1000its,843,786,2143.482657962,2106.178587443,57
carcassonne-ucttuned100-vs-ucttuned80-1000its,843,786,2166.407513978,2126.393231273,57
carcassonne-ucttuned30-vs-ucttuned170-1000its,843,786,2193.653359916,2146.409649378,57
carcassonne-ucttuned470-vs-ucttuned195-1000its,843,786,2272.288256749,2214.249924409,57
carcassonne-ucttuned455-vs-ucttuned175-1000its,844,787,2099.285322767,2038.48828469,57
carcassonne-uct465-vs-uct315-1000its,845,788,2197.588711404,2170.610886346,57
carcassonne-uct110-vs-uct475-1000its,847,790,2219.261392508,2202.969991629,57
carcassonne-ucttuned115-vs-ucttuned290-1000its,847,790,2142.259533633,2142.458007675,57
carcassonne-ucttuned170-vs-ucttuned135-1000its,847,790,2154.489719859,2108.648508335,57
carcassonne-uct420-vs-uct415-1000its,848,791,2199.245689239,2164.295011108,57
carcassonne-boltzmann475-vs-boltzmann365-1000its,849,792,2137.298436982,2116.990851723,57
carcassonne-uct465-vs-uct65-1000its,849,792,2269.7842872,2180.799522637,57
carcassonne-boltzmann295-vs-boltzmann205-1000its,850,793,2218.747671831,2157.130998104,57
carcassonne-uct265-vs-uct335-1000its,851,794,2192.045694919,2161.074128154,57
carcassonne-ucttuned290-vs-ucttuned210-1000its,851,794,2156.480664705,2117.617809187,57
carcassonne-ucttuned30-vs-ucttuned200-1000its,851,794,2143.802789089,2070.863442445,57
carcassonne-ucttuned320-vs-ucttuned180-1000its,851,794,2175.065365207,2111.480221625,57
carcassonne-uct205-vs-uct330-1000its,852,795,2207.371866879,2112.517351733,57
carcassonne-ucttuned395-vs-ucttuned185-1000its,852,795,2254.221744856,2234.347243484,57
carcassonne-ucttuned200-vs-ucttuned25-1000its,853,796,2197.395866417,2175.722079792,57
carcassonne-uct455-vs-uct90-1000its,854,797,2210.809832876,2154.810894011,57
carcassonne-boltzmann165-vs-boltzmann135-1000its,855,798,2152.634865344,2108.204373305,57
carcassonne-uct45-vs-uct460-1000its,855,798,2154.512114262,2121.547049696,57
carcassonne-ucttuned160-vs-ucttuned45-1000its,855,798,2198.307735086,2181.41437923,57
carcassonne-boltzmann100-vs-boltzmann435-1000its,856,799,2258.708991871,2176.955730023,57
carcassonne-ucttuned195-vs-ucttuned85-1000its,856,799,2187.261276901,2129.307795229,57
carcassonne-ucttuned45-vs-ucttuned75-1000its,858,801,2175.911010758,2127.46613227,57
carcassonne-ucttuned100-vs-ucttuned335-1000its,859,802,2173.580732957,2135.549933008,57
carcassonne-boltzmann305-vs-boltzmann460-1000its,862,805,2179.126575227,2110.83869143,57
carcassonne-boltzmann280-vs-boltzmann340-1000its,863,806,2166.145121632,2131.452444908,57
carcassonne-boltzmann85-vs-boltzmann395-1000its,865,808,2152.866172038,2122.786739453,57
carcassonne-uct215-vs-uct205-1000its,865,808,2179.729011581,2104.904461992,57
carcassonne-ucttuned445-vs-ucttuned35-1000its,866,809,2273.495063807,2200.353176085,57
carcassonne-boltzmann190-vs-boltzmann385-1000its,867,810,2173.694609694,2116.403527002,57
carcassonne-uct265-vs-uct105-1000its,867,810,2117.579556155,2114.145331876,57
carcassonne-uct385-vs-uct360-1000its,867,810,2181.070646508,2116.376652753,57
carcassonne-ucttuned60-vs-ucttuned190-1000its,867,810,2162.178501078,2099.525547092,57
carcassonne-boltzmann135-vs-boltzmann490-1000its,868,811,2219.051209494,2221.523601049,57
carcassonne-ucttuned385-vs-ucttuned185-1000its,868,811,2177.7704431,2129.431566822,57
carcassonne-boltzmann355-vs-boltzmann340-1000its,870,813,2261.925423652,2166.460169438,57
carcassonne-boltzmann45-vs-boltzmann410-1000its,872,815,2141.350620956,2146.644341021,57
carcassonne-ucttuned40-vs-ucttuned480-1000its,872,815,2227.364908186,2184.864037461,57
carcassonne-ucttuned330-vs-ucttuned445-1000its,874,817,2309.623753824,2256.509687409,57
carcassonne-uct80-vs-uct135-1000its,875,818,2198.153921149,2142.472360003,57
carcassonne-boltzmann315-vs-boltzmann230-1000its,876,819,2300.126464185,2284.932350753,57
carcassonne-uct445-vs-uct230-1000its,876,819,2218.491965246,2162.869668738,57
carcassonne-ucttuned10-vs-ucttuned435-1000its,876,819,2232.975613967,2184.475125416,57
carcassonne-uct20-vs-uct395-1000its,881,824,2224.671778927,2185.357117437,57
carcassonne-boltzmann260-vs-boltzmann55-1000its,883,826,2217.101770013,2156.04835606,57
carcassonne-ucttuned100-vs-ucttuned125-1000its,887,830,2219.747515497,2193.202943119,57
carcassonne-ucttuned195-vs-ucttuned245-1000its,887,830,2161.417552395,2150.33183858,57
carcassonne-boltzmann170-vs-boltzmann290-1000its,892,835,2234.325218757,2150.018869472,57
carcassonne-ucttuned30-vs-ucttuned25-1000its,892,835,2169.395379632,2108.606041419,57
carcassonne-boltzmann345-vs-boltzmann75-1000its,893,836,2151.530924013,2154.816745184,57
carcassonne-ucttuned195-vs-ucttuned435-1000its,893,836,2235.799413363,2170.639089687,57
carcassonne-uct425-vs-uct165-1000its,897,840,2253.725981291,2221.412837893,57
carcassonne-uct100-vs-uct145-1000its,900,843,2207.663175708,2161.883168842,57
carcassonne-ucttuned360-vs-ucttuned295-1000its,904,847,2131.545082818,2082.724740248,57
carcassonne-ucttuned270-vs-ucttuned455-1000its,907,850,2226.831287554,2214.082823489,57
carcassonne-ucttuned140-vs-ucttuned145-1000its,909,852,2192.736498341,2157.760899238,57
carcassonne-ucttuned70-vs-ucttuned10-1000its,909,852,2188.024620002,2139.479317487,57
carcassonne-ucttuned450-vs-ucttuned435-1000its,913,856,2256.521128049,2202.383908889,57
carcassonne-ucttuned25-vs-ucttuned185-1000its,917,860,2230.128253157,2162.850476366,57
carcassonne-ucttuned290-vs-ucttuned385-1000its,918,861,2203.086220474,2161.397214403,57
carcassonne-uct155-vs-uct240-1000its,923,866,2155.16935271,2174.776822875,57
carcassonne-boltzmann310-vs-boltzmann100-1000its,925,868,2180.478562721,2165.611329092,57
carcassonne-ucttuned80-vs-ucttuned295-1000its,933,876,2292.005757716,2217.752598361,57
carcassonne-uct395-vs-uct335-1000its,935,878,2131.257743137,2095.351141524,57
carcassonne-boltzmann450-vs-boltzmann300-1000its,739,681,2164.786083475,2162.257234657,58
carcassonne-ucttuned495-vs-ucttuned285-1000its,749,691,2193.657702187,2147.988057629,58
carcassonne-ucttuned50-vs-ucttuned165-1000its,753,695,2165.536041841,2113.000995392,58
carcassonne-ucttuned350-vs-ucttuned290-1000its,759,701,2175.210739552,2101.69739291,58
carcassonne-uct155-vs-uct320-1000its,760,702,2261.933569932,2202.991564799,58
carcassonne-boltzmann385-vs-boltzmann395-1000its,761,703,2178.630272789,2147.090413925,58
carcassonne-uct220-vs-uct10-1000its,768,710,2200.378352076,2171.022734998,58
carcassonne-ucttuned370-vs-ucttuned135-1000its,775,717,2217.430059866,2200.634234129,58
carcassonne-boltzmann485-vs-boltzmann130-1000its,776,718,2149.863534692,2103.157111914,58
carcassonne-boltzmann390-vs-boltzmann125-1000its,777,719,2138.570076533,2085.12380489,58
carcassonne-boltzmann95-vs-boltzmann145-1000its,777,719,2172.908078133,2134.051106698,58
carcassonne-ucttuned355-vs-ucttuned185-1000its,781,723,2135.547524475,2103.664416392,58
carcassonne-uct350-vs-uct70-1000its,784,726,2204.403187892,2171.494641089,58
carcassonne-boltzmann190-vs-boltzmann270-1000its,787,729,2263.659462265,2202.840109013,58
carcassonne-boltzmann280-vs-boltzmann320-1000its,787,729,2241.77771822,2162.986601258,58
carcassonne-uct180-vs-uct70-1000its,790,732,2325.105449767,2279.534836024,58
carcassonne-boltzmann110-vs-boltzmann350-1000its,792,734,2207.934608002,2156.267518521,58
carcassonne-boltzmann265-vs-boltzmann385-1000its,793,735,2199.811964637,2198.5598588,58
carcassonne-uct100-vs-uct260-1000its,793,735,2177.200361824,2151.797074741,58
carcassonne-uct230-vs-uct50-1000its,794,736,2191.689424919,2164.382718408,58
carcassonne-boltzmann90-vs-boltzmann210-1000its,797,739,2167.379948596,2167.511051727,58
carcassonne-uct140-vs-uct385-1000its,798,740,2145.493634368,2121.966739226,58
carcassonne-uct110-vs-uct335-1000its,799,741,2166.29170918,2147.379045557,58
carcassonne-ucttuned115-vs-ucttuned285-1000its,800,742,2235.777842033,2219.287338967,58
carcassonne-boltzmann75-vs-boltzmann140-1000its,801,743,2147.866491069,2129.339596951,58
carcassonne-ucttuned175-vs-ucttuned220-1000its,801,743,2277.411858795,2206.232117728,58
carcassonne-ucttuned465-vs-ucttuned285-1000its,801,743,2218.124277799,2206.934565682,58
carcassonne-ucttuned90-vs-ucttuned50-1000its,803,745,2267.740670703,2209.86995456,58
carcassonne-boltzmann430-vs-boltzmann170-1000its,807,749,2308.884493024,2256.448479359,58
carcassonne-boltzmann390-vs-boltzmann435-1000its,808,750,2137.839991588,2103.057356378,58
carcassonne-uct120-vs-uct190-1000its,809,751,2216.322466675,2148.097917674,58
carcassonne-boltzmann200-vs-boltzmann260-1000its,811,753,2134.055532794,2106.417257494,58
carcassonne-boltzmann285-vs-boltzmann325-1000its,811,753,2178.708890291,2174.801200837,58
carcassonne-boltzmann95-vs-boltzmann35-1000its,811,753,2224.236941071,2200.086793441,58
carcassonne-boltzmann190-vs-boltzmann435-1000its,813,755,2191.518822654,2151.116614532,58
carcassonne-ucttuned125-vs-ucttuned175-1000its,813,755,2230.198561802,2234.361786209,58
carcassonne-boltzmann110-vs-boltzmann60-1000its,814,756,2198.23033536,2181.157240361,58
carcassonne-ucttuned145-vs-ucttuned380-1000its,814,756,2263.256149662,2220.488472198,58
carcassonne-ucttuned230-vs-ucttuned425-1000its,815,757,2141.73449173,2127.123561347,58
carcassonne-uct105-vs-uct205-1000its,816,758,2240.056190788,2161.114396768,58
carcassonne-boltzmann125-vs-boltzmann305-1000its,817,759,2186.370741258,2139.433533848,58
carcassonne-boltzmann130-vs-boltzmann25-1000its,819,761,2206.045768943,2179.199120153,58
carcassonne-ucttuned170-vs-ucttuned155-1000its,819,761,2137.33632142,2078.689239951,58
carcassonne-boltzmann120-vs-boltzmann445-1000its,821,763,2226.196678745,2182.56897911,58
carcassonne-uct465-vs-uct405-1000its,821,763,2192.234242547,2138.065364383,58
carcassonne-ucttuned470-vs-ucttuned125-1000its,821,763,2189.953457567,2145.979094014,58
carcassonne-ucttuned425-vs-ucttuned215-1000its,822,764,2205.820236989,2133.881524537,58
carcassonne-uct390-vs-uct110-1000its,823,765,2182.967322937,2141.299651054,58
carcassonne-ucttuned270-vs-ucttuned120-1000its,823,765,2182.586090118,2123.364620444,58
carcassonne-uct10-vs-uct90-1000its,826,768,2151.443380132,2124.22276744,58
carcassonne-boltzmann325-vs-boltzmann375-1000its,827,769,2198.447298447,2189.476589127,58
carcassonne-uct125-vs-uct50-1000its,827,769,2243.704492677,2169.0001541,58
carcassonne-ucttuned490-vs-ucttuned130-1000its,827,769,2242.57292766,2170.330319034,58
carcassonne-uct290-vs-uct200-1000its,828,770,2199.211238856,2142.132053048,58
carcassonne-ucttuned205-vs-ucttuned210-1000its,829,771,2156.295259744,2169.175495284,58
carcassonne-uct60-vs-uct375-1000its,830,772,2241.461123463,2188.303835424,58
carcassonne-uct485-vs-uct220-1000its,831,773,2188.371176055,2149.000813452,58
carcassonne-ucttuned290-vs-ucttuned440-1000its,831,773,2263.473174888,2208.473449713,58
carcassonne-uct170-vs-uct165-1000its,832,774,2176.849358403,2109.485746133,58
carcassonne-uct220-vs-uct115-1000its,832,774,2159.964319325,2111.341536768,58
carcassonne-uct40-vs-uct250-1000its,832,774,2100.315983124,2080.152845924,58
carcassonne-uct335-vs-uct50-1000its,833,775,2209.095779724,2204.91561856,58
carcassonne-uct320-vs-uct225-1000its,834,776,2180.558547309,2133.447629834,58
carcassonne-uct55-vs-uct420-1000its,834,776,2233.139750569,2105.604027087,58
carcassonne-ucttuned485-vs-ucttuned305-1000its,834,776,2217.073494983,2145.052164482,58
carcassonne-boltzmann270-vs-boltzmann105-1000its,835,777,2275.202654775,2236.53101282,58
carcassonne-uct280-vs-uct295-1000its,836,778,2188.979510237,2136.609584953,58
carcassonne-uct320-vs-uct170-1000its,836,778,2203.573028481,2134.898367723,58
carcassonne-uct90-vs-uct390-1000its,837,779,2218.707035719,2184.971880772,58
carcassonne-boltzmann240-vs-boltzmann280-1000its,839,781,2218.698786301,2147.588193181,58
carcassonne-uct95-vs-uct425-1000its,839,781,2248.652043548,2169.772364894,58
carcassonne-uct365-vs-uct210-1000its,840,782,2155.190993212,2118.626125475,58
carcassonne-ucttuned45-vs-ucttuned335-1000its,840,782,2259.000837834,2178.529972158,58
carcassonne-ucttuned395-vs-ucttuned280-1000its,841,783,2201.269115128,2137.185446392,58
carcassonne-ucttuned400-vs-ucttuned320-1000its,841,783,2215.410020027,2165.378217277,58
carcassonne-boltzmann150-vs-boltzmann395-1000its,842,784,2249.879500852,2182.371734452,58
carcassonne-boltzmann475-vs-boltzmann155-1000its,842,784,2231.693393655,2224.262747488,58
carcassonne-ucttuned450-vs-ucttuned85-1000its,843,785,2308.355670568,2264.588635104,58
carcassonne-uct115-vs-uct160-1000its,844,786,2180.736668549,2093.773875127,58
carcassonne-uct220-vs-uct345-1000its,844,786,2234.066035894,2180.104939368,58
carcassonne-ucttuned435-vs-ucttuned80-1000its,844,786,2159.503097463,2145.147943311,58
carcassonne-boltzmann205-vs-boltzmann50-1000its,846,788,2149.140851119,2067.034945223,58
carcassonne-uct470-vs-uct370-1000its,846,788,2162.563106191,2095.619611583,58
carcassonne-ucttuned105-vs-ucttuned270-1000its,846,788,2241.189995366,2187.720534674,58
carcassonne-ucttuned305-vs-ucttuned185-1000its,847,789,2175.228904345,2178.302418796,58
carcassonne-boltzmann10-vs-boltzmann485-1000its,850,792,2206.846976195,2165.967021687,58
carcassonne-uct195-vs-uct275-1000its,851,793,2248.608910395,2205.536729069,58
carcassonne-ucttuned250-vs-ucttuned375-1000its,851,793,2260.718924421,2206.211548178,58
carcassonne-ucttuned450-vs-ucttuned330-1000its,853,795,2150.009593313,2107.794946618,58
carcassonne-boltzmann395-vs-boltzmann305-1000its,854,796,2122.915414326,2118.490228735,58
carcassonne-uct150-vs-uct350-1000its,855,797,2208.538509873,2167.895955755,58
carcassonne-ucttuned370-vs-ucttuned95-1000its,856,798,2270.099415182,2239.551018358,58
carcassonne-ucttuned60-vs-ucttuned265-1000its,856,798,2259.841752632,2203.460704573,58
carcassonne-ucttuned210-vs-ucttuned285-1000its,857,799,2195.677311167,2134.593282828,58
carcassonne-ucttuned45-vs-ucttuned230-1000its,857,799,2138.680688759,2083.396943804,58
carcassonne-uct405-vs-uct180-1000its,858,800,2143.116234969,2138.663877936,58
carcassonne-uct425-vs-uct80-1000its,858,800,2179.396775615,2131.230219288,58
carcassonne-ucttuned10-vs-ucttuned380-1000its,858,800,2213.926809727,2186.314707146,58
carcassonne-ucttuned405-vs-ucttuned75-1000its,858,800,2128.06815212,2122.981382151,58
carcassonne-uct485-vs-uct160-1000its,859,801,2169.726287285,2137.342071205,58
carcassonne-uct15-vs-uct235-1000its,862,804,2206.454833415,2113.888293186,58
carcassonne-ucttuned375-vs-ucttuned315-1000its,864,806,2243.180563127,2206.064978097,58
carcassonne-uct410-vs-uct145-1000its,869,811,2205.344390429,2162.77085,58
carcassonne-boltzmann145-vs-boltzmann235-1000its,870,812,2163.351047042,2109.987336695,58
carcassonne-boltzmann320-vs-boltzmann10-1000its,870,812,2133.097127316,2099.02877252,58
carcassonne-boltzmann60-vs-boltzmann10-1000its,871,813,2200.814885744,2140.399087568,58
carcassonne-ucttuned45-vs-ucttuned265-1000its,871,813,2179.924704803,2116.136713413,58
carcassonne-uct140-vs-uct210-1000its,872,814,2221.52742219,2180.998429209,58
carcassonne-boltzmann225-vs-boltzmann495-1000its,873,815,2204.741569054,2150.040989086,58
carcassonne-uct245-vs-uct470-1000its,874,816,2211.115408089,2139.488173142,58
carcassonne-ucttuned330-vs-ucttuned215-1000its,875,817,2194.050641406,2153.761457801,58
carcassonne-uct115-vs-uct370-1000its,876,818,2174.338888445,2155.331785559,58
carcassonne-boltzmann25-vs-boltzmann150-1000its,877,819,2233.899631544,2230.881749175,58
carcassonne-boltzmann400-vs-boltzmann145-1000its,877,819,2234.548784352,2202.846616752,58
carcassonne-uct55-vs-uct465-1000its,877,819,2141.963149239,2112.40474465,58
carcassonne-uct165-vs-uct480-1000its,880,822,2218.327657012,2178.065024313,58
carcassonne-ucttuned320-vs-ucttuned495-1000its,883,825,2281.544708094,2238.037524653,58
carcassonne-ucttuned455-vs-ucttuned485-1000its,883,825,2289.404474862,2274.411037141,58
carcassonne-boltzmann20-vs-boltzmann420-1000its,884,826,2218.040678635,2169.297420357,58
carcassonne-ucttuned290-vs-ucttuned255-1000its,887,829,2229.830982444,2170.090711661,58
carcassonne-uct265-vs-uct60-1000its,889,831,2213.935629807,2146.536787795,58
carcassonne-ucttuned125-vs-ucttuned215-1000its,889,831,2209.503443612,2157.868578426,58
carcassonne-uct270-vs-uct435-1000its,890,832,2137.053486449,2116.004539136,58
carcassonne-ucttuned75-vs-ucttuned215-1000its,891,833,2227.702267177,2160.905025955,58
carcassonne-ucttuned80-vs-ucttuned45-1000its,896,838,2253.564055689,2215.410508747,58
carcassonne-ucttuned165-vs-ucttuned35-1000its,898,840,2261.895623964,2197.028148718,58
carcassonne-boltzmann200-vs-boltzmann5-1000its,902,844,2158.777497501,2131.447644445,58
carcassonne-ucttuned175-vs-ucttuned360-1000its,911,853,2177.963516083,2065.918702927,58
carcassonne-ucttuned65-vs-ucttuned120-1000its,914,856,2278.491765112,2214.924645255,58
carcassonne-ucttuned375-vs-ucttuned430-1000its,917,859,2153.954916232,2101.615573802,58
carcassonne-ucttuned110-vs-ucttuned30-1000its,921,863,2135.322390691,2143.420002075,58
carcassonne-ucttuned70-vs-ucttuned415-1000its,926,868,2189.123961815,2164.431945035,58
carcassonne-uct385-vs-uct65-1000its,954,896,2237.572353913,2186.626069416,58
carcassonne-boltzmann460-vs-boltzmann335-1000its,967,909,2243.521931228,2224.065902374,58
carcassonne-uct490-vs-uct340-1000its,714,655,1798.196383895,1758.220926874,59
carcassonne-ucttuned300-vs-ucttuned455-1000its,744,685,2296.047002528,2251.316798396,59
carcassonne-boltzmann135-vs-boltzmann365-1000its,764,705,2206.555003679,2148.202444069,59
carcassonne-uct450-vs-uct160-1000its,767,708,2249.875955566,2167.992819049,59
carcassonne-boltzmann355-vs-boltzmann445-1000its,768,709,2213.52116585,2167.02681486,59
carcassonne-ucttuned50-vs-ucttuned420-1000its,768,709,2174.721295561,2146.086691468,59
carcassonne-boltzmann160-vs-boltzmann125-1000its,776,717,2230.500691009,2198.684605227,59
carcassonne-ucttuned470-vs-ucttuned115-1000its,777,718,2214.154242807,2179.609117616,59
carcassonne-uct405-vs-uct110-1000its,779,720,2142.875466932,2081.605101064,59
carcassonne-ucttuned235-vs-ucttuned195-1000its,784,725,2191.707947046,2171.306561086,59
carcassonne-boltzmann175-vs-boltzmann380-1000its,785,726,2236.35593583,2180.163583383,59
carcassonne-boltzmann155-vs-boltzmann110-1000its,788,729,2202.75701398,2145.846408706,59
carcassonne-boltzmann425-vs-boltzmann115-1000its,788,729,2196.75223353,2164.553180305,59
carcassonne-uct140-vs-uct435-1000its,794,735,2135.144432127,2105.477964762,59
carcassonne-ucttuned405-vs-ucttuned380-1000its,794,735,2252.815805528,2224.625633494,59
carcassonne-uct160-vs-uct115-1000its,796,737,2246.707369166,2186.699177411,59
carcassonne-boltzmann120-vs-boltzmann235-1000its,797,738,2249.05689105,2183.767604692,59
carcassonne-boltzmann125-vs-boltzmann200-1000its,797,738,2235.888370788,2201.771544045,59
carcassonne-boltzmann100-vs-boltzmann315-1000its,802,743,2213.762912,2130.682070244,59
carcassonne-boltzmann415-vs-boltzmann390-1000its,806,747,2179.570261769,2152.115721495,59
carcassonne-ucttuned60-vs-ucttuned455-1000its,806,747,2166.339522617,2122.3745196,59
carcassonne-boltzmann15-vs-boltzmann295-1000its,807,748,2232.375113828,2177.31003382,59
carcassonne-boltzmann330-vs-boltzmann30-1000its,807,748,2225.809186811,2116.320933896,59
carcassonne-boltzmann215-vs-boltzmann40-1000its,808,749,2346.400698451,2259.905101513,59
carcassonne-uct70-vs-uct110-1000its,808,749,2177.348214865,2136.280475258,59
carcassonne-ucttuned370-vs-ucttuned340-1000its,808,749,2162.0973048,2092.428622394,59
carcassonne-ucttuned385-vs-ucttuned270-1000its,809,750,2186.584460036,2108.741494759,59
carcassonne-boltzmann335-vs-boltzmann300-1000its,810,751,2155.0936797,2107.571406231,59
carcassonne-boltzmann455-vs-boltzmann90-1000its,812,753,2159.381991319,2128.857117721,59
carcassonne-boltzmann110-vs-boltzmann475-1000its,813,754,2234.393830853,2153.191719861,59
carcassonne-boltzmann300-vs-boltzmann80-1000its,813,754,2195.241556407,2117.106060807,59
carcassonne-uct480-vs-uct425-1000its,815,756,2197.952434688,2166.920886324,59
carcassonne-uct225-vs-uct210-1000its,818,759,2255.251486372,2176.891172234,59
carcassonne-uct255-vs-uct250-1000its,818,759,2158.549430704,2122.233706656,59
carcassonne-ucttuned450-vs-ucttuned305-1000its,818,759,2260.250269307,2169.443139008,59
carcassonne-ucttuned85-vs-ucttuned100-1000its,818,759,2173.981054108,2121.913885766,59
carcassonne-uct30-vs-uct180-1000its,819,760,2246.20684502,2174.836814901,59
carcassonne-ucttuned260-vs-ucttuned365-1000its,820,761,2210.651935849,2173.058282222,59
carcassonne-uct395-vs-uct45-1000its,821,762,2189.134372527,2130.976099307,59
carcassonne-boltzmann255-vs-boltzmann285-1000its,822,763,2163.672549987,2144.045813723,59
carcassonne-boltzmann180-vs-boltzmann415-1000its,823,764,2196.819602814,2123.643064464,59
carcassonne-uct65-vs-uct145-1000its,823,764,2139.763746199,2116.37263515,59
carcassonne-boltzmann380-vs-boltzmann160-1000its,828,769,2130.084784596,2109.619465374,59
carcassonne-ucttuned430-vs-ucttuned305-1000its,828,769,2291.743151943,2256.240054063,59
carcassonne-ucttuned470-vs-ucttuned240-1000its,828,769,2234.786953654,2173.836955689,59
carcassonne-boltzmann385-vs-boltzmann305-1000its,829,770,2186.361970805,2180.271961871,59
carcassonne-uct135-vs-uct105-1000its,829,770,2225.661716238,2142.956673584,59
carcassonne-ucttuned50-vs-ucttuned100-1000its,829,770,2168.420388411,2115.639635979,59
carcassonne-ucttuned115-vs-ucttuned245-1000its,830,771,2182.891976921,2135.218013826,59
carcassonne-ucttuned270-vs-ucttuned485-1000its,830,771,2151.774631874,2101.942151339,59
carcassonne-ucttuned215-vs-ucttuned255-1000its,833,774,2219.021554303,2238.895473666,59
carcassonne-boltzmann180-vs-boltzmann65-1000its,834,775,2207.526385675,2147.533260683,59
carcassonne-uct210-vs-uct185-1000its,834,775,2257.063789096,2212.407202368,59
carcassonne-uct210-vs-uct495-1000its,834,775,2264.936642175,2232.50871644,59
carcassonne-uct130-vs-uct225-1000its,835,776,2251.140915545,2184.596120033,59
carcassonne-ucttuned5-vs-ucttuned205-1000its,835,776,2209.206546079,2167.977962808,59
carcassonne-ucttuned90-vs-ucttuned290-1000its,836,777,2132.426017233,2100.455561907,59
carcassonne-boltzmann175-vs-boltzmann160-1000its,837,778,2227.923209294,2213.574543112,59
carcassonne-uct245-vs-uct330-1000its,837,778,2229.718903572,2197.648680237,59
carcassonne-ucttuned290-vs-ucttuned175-1000its,837,778,2235.055393162,2190.338597817,59
carcassonne-ucttuned355-vs-ucttuned350-1000its,837,778,2200.070943858,2140.959222997,59
carcassonne-ucttuned445-vs-ucttuned120-1000its,837,778,2219.901645789,2169.322836628,59
carcassonne-boltzmann30-vs-boltzmann405-1000its,839,780,2230.892417411,2204.300588793,59
carcassonne-boltzmann110-vs-boltzmann30-1000its,840,781,2269.423266111,2228.786883692,59
carcassonne-uct310-vs-uct190-1000its,840,781,2210.767699821,2169.994804617,59
carcassonne-ucttuned65-vs-ucttuned150-1000its,841,782,2150.51876956,2163.04805839,59
carcassonne-uct370-vs-uct320-1000its,842,783,2268.598005554,2199.125354348,59
carcassonne-uct490-vs-uct250-1000its,842,783,2121.271893775,2093.534784467,59
carcassonne-uct155-vs-uct100-1000its,843,784,2187.160060691,2162.718180375,59
carcassonne-boltzmann60-vs-boltzmann95-1000its,844,785,2203.010374609,2138.21286931,59
carcassonne-uct275-vs-uct240-1000its,844,785,2174.014590681,2144.910285259,59
carcassonne-ucttuned490-vs-ucttuned35-1000its,844,785,2142.83351376,2108.274392039,59
carcassonne-ucttuned120-vs-ucttuned205-1000its,845,786,2262.79679507,2245.493716794,59
carcassonne-ucttuned225-vs-ucttuned135-1000its,846,787,2231.362577634,2167.877517989,59
carcassonne-ucttuned355-vs-ucttuned290-1000its,846,787,2159.723606324,2099.632460683,59
carcassonne-uct225-vs-uct310-1000its,848,789,2264.845584465,2180.638130276,59
carcassonne-uct30-vs-uct75-1000its,848,789,2229.196782121,2165.786168241,59
carcassonne-uct480-vs-uct120-1000its,848,789,2158.567410527,2141.87179395,59
carcassonne-uct200-vs-uct450-1000its,851,792,2181.026808385,2154.718141113,59
carcassonne-boltzmann440-vs-boltzmann260-1000its,852,793,2233.662878746,2191.58358623,59
carcassonne-boltzmann115-vs-boltzmann100-1000its,853,794,2125.528137329,2080.368030378,59
carcassonne-boltzmann310-vs-boltzmann490-1000its,853,794,2288.816278228,2273.255553531,59
carcassonne-uct125-vs-uct280-1000its,853,794,2159.860648576,2099.932420622,59
carcassonne-ucttuned330-vs-ucttuned300-1000its,854,795,2200.500183777,2134.781320467,59
carcassonne-ucttuned375-vs-ucttuned275-1000its,855,796,2174.606377598,2101.148257541,59
carcassonne-ucttuned485-vs-ucttuned440-1000its,856,797,2167.169320886,2134.2316515,59
carcassonne-boltzmann5-vs-boltzmann25-1000its,858,799,2203.889795485,2157.659314578,59
carcassonne-uct115-vs-uct145-1000its,859,800,2215.774675386,2205.588186111,59
carcassonne-ucttuned375-vs-ucttuned35-1000its,861,802,2236.841954455,2195.205309514,59
carcassonne-boltzmann85-vs-boltzmann30-1000its,866,807,2124.797752439,2140.65843157,59
carcassonne-ucttuned235-vs-ucttuned435-1000its,866,807,2259.719072979,2203.127258841,59
carcassonne-ucttuned430-vs-ucttuned345-1000its,866,807,2170.902736121,2139.14691186,59
carcassonne-boltzmann310-vs-boltzmann185-1000its,867,808,2258.684478548,2199.251105476,59
carcassonne-boltzmann350-vs-boltzmann420-1000its,868,809,2228.169312198,2141.319246913,59
carcassonne-uct40-vs-uct165-1000its,868,809,2262.414271402,2160.866327946,59
carcassonne-uct60-vs-uct225-1000its,868,809,2223.354334018,2127.919529855,59
carcassonne-ucttuned60-vs-ucttuned445-1000its,869,810,2268.216636474,2204.688090791,59
carcassonne-boltzmann30-vs-boltzmann215-1000its,872,813,2211.841883348,2130.081758492,59
carcassonne-uct300-vs-uct365-1000its,873,814,2214.136439134,2164.853723567,59
carcassonne-uct400-vs-uct305-1000its,873,814,2259.079235905,2179.368494888,59
carcassonne-ucttuned315-vs-ucttuned475-1000its,876,817,2215.0818771,2209.618355244,59
carcassonne-uct300-vs-uct385-1000its,880,821,2217.209361015,2166.897192123,59
carcassonne-ucttuned150-vs-ucttuned230-1000its,886,827,2209.854874447,2131.310289623,59
carcassonne-ucttuned10-vs-ucttuned240-1000its,888,829,2160.158178128,2120.371021011,59
carcassonne-boltzmann185-vs-boltzmann400-1000its,890,831,2221.835094209,2170.431930903,59
carcassonne-boltzmann150-vs-boltzmann415-1000its,892,833,2193.346321508,2134.37696404,59
carcassonne-ucttuned405-vs-ucttuned335-1000its,892,833,2240.661422229,2200.061949755,59
carcassonne-boltzmann435-vs-boltzmann440-1000its,896,837,2208.041083318,2156.033889284,59
carcassonne-uct155-vs-uct380-1000its,899,840,2183.509289226,2140.652875894,59
carcassonne-uct235-vs-uct105-1000its,903,844,2234.470686348,2180.469893764,59
carcassonne-uct10-vs-uct70-1000its,907,848,2328.270063556,2297.241203451,59
carcassonne-uct75-vs-uct375-1000its,919,860,2245.603295976,2205.648816121,59
carcassonne-boltzmann430-vs-boltzmann35-1000its,750,690,2145.668143138,2142.211366444,60
carcassonne-uct430-vs-uct190-1000its,750,690,2221.856205825,2179.860918434,60
carcassonne-uct335-vs-uct130-1000its,752,692,2230.984859,2154.416785925,60
carcassonne-ucttuned155-vs-ucttuned345-1000its,758,698,2159.265812804,2131.184707995,60
carcassonne-uct285-vs-uct375-1000its,766,706,2213.109864174,2162.345607045,60
carcassonne-ucttuned40-vs-ucttuned60-1000its,769,709,2145.545090266,2103.231695821,60
carcassonne-ucttuned240-vs-ucttuned150-1000its,777,717,2255.50424259,2188.182767589,60
carcassonne-uct215-vs-uct425-1000its,778,718,2194.777786067,2111.608179706,60
carcassonne-boltzmann70-vs-boltzmann440-1000its,781,721,2189.02234217,2122.286754568,60
carcassonne-boltzmann360-vs-boltzmann185-1000its,782,722,2176.148116217,2119.229325225,60
carcassonne-ucttuned220-vs-ucttuned285-1000its,787,727,2227.296980728,2151.837960881,60
carcassonne-boltzmann300-vs-boltzmann115-1000its,788,728,2210.515751342,2162.805036711,60
carcassonne-boltzmann470-vs-boltzmann35-1000its,789,729,2177.935751619,2106.412430263,60
carcassonne-uct235-vs-uct115-1000its,790,730,2145.383785149,2084.485723035,60
carcassonne-boltzmann470-vs-boltzmann155-1000its,791,731,2181.079085091,2154.913836848,60
carcassonne-boltzmann430-vs-boltzmann445-1000its,792,732,2164.71623322,2128.503752199,60
carcassonne-uct320-vs-uct110-1000its,792,732,2231.427358623,2175.756128363,60
carcassonne-ucttuned185-vs-ucttuned45-1000its,792,732,2161.24323344,2127.003034414,60
carcassonne-ucttuned200-vs-ucttuned205-1000its,793,733,2219.288654245,2156.160015877,60
carcassonne-boltzmann400-vs-boltzmann270-1000its,795,735,2239.729463511,2166.372037692,60
carcassonne-uct410-vs-uct360-1000its,795,735,2183.683152248,2109.438343742,60
carcassonne-uct90-vs-uct60-1000its,795,735,2206.095106619,2129.10311975,60
carcassonne-boltzmann10-vs-boltzmann340-1000its,796,736,2205.742531996,2128.202946898,60
carcassonne-boltzmann35-vs-boltzmann390-1000its,798,738,2207.234569038,2157.267417823,60
carcassonne-boltzmann235-vs-boltzmann170-1000its,800,740,2230.451989103,2148.645277891,60
carcassonne-uct155-vs-uct475-1000its,800,740,2171.80297285,2151.371699324,60
carcassonne-ucttuned340-vs-ucttuned405-1000its,800,740,2165.501783305,2148.436432553,60
carcassonne-boltzmann160-vs-boltzmann360-1000its,801,741,2363.602310408,2281.77692959,60
carcassonne-ucttuned90-vs-ucttuned460-1000its,802,742,2133.41220925,2145.074342471,60
carcassonne-uct240-vs-uct85-1000its,803,743,2188.964364499,2149.230915394,60
carcassonne-boltzmann65-vs-boltzmann485-1000its,804,744,2192.838660524,2136.94860093,60
carcassonne-boltzmann290-vs-boltzmann465-1000its,807,747,2156.968285513,2110.121180023,60
carcassonne-ucttuned55-vs-ucttuned260-1000its,808,748,2185.010161348,2114.701754896,60
carcassonne-boltzmann160-vs-boltzmann110-1000its,810,750,2246.663652561,2175.072652011,60
carcassonne-boltzmann180-vs-boltzmann90-1000its,812,752,2178.669875111,2170.534160134,60
carcassonne-uct60-vs-uct480-1000its,812,752,2160.329583749,2104.834419822,60
carcassonne-uct195-vs-uct380-1000its,813,753,2266.669934702,2203.583761365,60
carcassonne-ucttuned210-vs-ucttuned25-1000its,813,753,2281.366972203,2301.750204304,60
carcassonne-ucttuned105-vs-ucttuned290-1000its,815,755,2109.839528197,2106.643420253,60
carcassonne-uct430-vs-uct240-1000its,817,757,2209.694182272,2159.818845825,60
carcassonne-boltzmann425-vs-boltzmann325-1000its,818,758,2187.204515707,2150.326463239,60
carcassonne-uct145-vs-uct365-1000its,818,758,2195.282451726,2086.497980632,60
carcassonne-ucttuned240-vs-ucttuned350-1000its,818,758,2241.716457889,2177.104494216,60
carcassonne-boltzmann95-vs-boltzmann45-1000its,819,759,2233.229324963,2153.059114258,60
carcassonne-ucttuned150-vs-ucttuned380-1000its,819,759,2176.654236379,2138.527197962,60
carcassonne-uct340-vs-uct430-1000its,824,764,2095.586217033,2060.789554425,60
carcassonne-ucttuned335-vs-ucttuned370-1000its,824,764,2210.933806085,2160.427895935,60
carcassonne-uct400-vs-uct325-1000its,825,765,2238.3327471,2178.623572237,60
carcassonne-uct190-vs-uct145-1000its,826,766,2160.160991904,2146.749111233,60
carcassonne-ucttuned15-vs-ucttuned460-1000its,826,766,2212.541942127,2177.66298421,60
carcassonne-uct385-vs-uct380-1000its,827,767,2160.709024702,2142.305552803,60
carcassonne-ucttuned85-vs-ucttuned5-1000its,829,769,2208.244008628,2152.339453862,60
carcassonne-uct305-vs-uct235-1000its,830,770,2145.67644325,2076.822280126,60
carcassonne-ucttuned315-vs-ucttuned220-1000its,831,771,2191.385897555,2148.984100039,60
carcassonne-boltzmann220-vs-boltzmann280-1000its,834,774,2190.894078068,2156.495871671,60
carcassonne-uct440-vs-uct285-1000its,834,774,2156.092543292,2085.581396575,60
carcassonne-ucttuned435-vs-ucttuned475-1000its,834,774,2201.672969698,2119.639700641,60
carcassonne-boltzmann215-vs-boltzmann420-1000its,835,775,2246.3125907,2190.538856835,60
carcassonne-boltzmann430-vs-boltzmann15-1000its,835,775,2213.124704608,2132.703366768,60
carcassonne-boltzmann105-vs-boltzmann470-1000its,837,777,2185.183489671,2162.380431172,60
carcassonne-ucttuned190-vs-ucttuned45-1000its,838,778,2185.957764594,2101.887041977,60
carcassonne-boltzmann365-vs-boltzmann180-1000its,840,780,2166.908586114,2121.500060681,60
carcassonne-uct115-vs-uct135-1000its,840,780,2209.784544335,2175.812010027,60
carcassonne-uct30-vs-uct170-1000its,841,781,2210.016884717,2166.395606596,60
carcassonne-boltzmann145-vs-boltzmann215-1000its,842,782,2152.146123857,2093.502138519,60
carcassonne-uct80-vs-uct355-1000its,842,782,2207.268640094,2197.099170971,60
carcassonne-ucttuned195-vs-ucttuned90-1000its,844,784,2271.232388064,2191.204959166,60
carcassonne-uct280-vs-uct180-1000its,845,785,2188.633837828,2161.508519469,60
carcassonne-uct435-vs-uct255-1000its,847,787,2203.629070467,2109.530349065,60
carcassonne-uct95-vs-uct305-1000its,847,787,2137.194397882,2062.322680804,60
carcassonne-boltzmann270-vs-boltzmann245-1000its,848,788,2166.934480936,2114.027932413,60
carcassonne-ucttuned485-vs-ucttuned220-1000its,848,788,2202.274977271,2188.262870395,60
carcassonne-boltzmann290-vs-boltzmann395-1000its,849,789,2231.528125072,2153.148881884,60
carcassonne-boltzmann360-vs-boltzmann390-1000its,849,789,2222.972191289,2181.688520924,60
carcassonne-boltzmann350-vs-boltzmann180-1000its,850,790,2267.036151072,2219.445495388,60
carcassonne-uct235-vs-uct415-1000its,851,791,2161.738102036,2123.314726318,60
carcassonne-uct210-vs-uct430-1000its,852,792,2170.824244713,2101.157559758,60
carcassonne-uct100-vs-uct480-1000its,853,793,2199.658303037,2152.705101539,60
carcassonne-uct115-vs-uct110-1000its,853,793,2197.626170685,2129.930613808,60
carcassonne-uct90-vs-uct485-1000its,853,793,2201.500834241,2116.464667389,60
carcassonne-ucttuned465-vs-ucttuned230-1000its,853,793,2167.228941256,2159.915148354,60
carcassonne-boltzmann35-vs-boltzmann435-1000its,854,794,2203.220881681,2140.300251231,60
carcassonne-boltzmann315-vs-boltzmann465-1000its,857,797,2214.611256859,2164.608268738,60
carcassonne-uct200-vs-uct230-1000its,857,797,2155.401830257,2104.16249945,60
carcassonne-uct430-vs-uct145-1000its,857,797,2171.434511511,2142.819515667,60
carcassonne-ucttuned105-vs-ucttuned250-1000its,857,797,2192.053660965,2126.003556087,60
carcassonne-uct455-vs-uct390-1000its,858,798,2240.806755566,2165.009326555,60
carcassonne-boltzmann405-vs-boltzmann345-1000its,859,799,2293.132917219,2214.139820704,60
carcassonne-uct325-vs-uct220-1000its,859,799,2211.913759477,2174.941673849,60
carcassonne-boltzmann370-vs-boltzmann345-1000its,860,800,2221.349871746,2181.424524429,60
carcassonne-boltzmann5-vs-boltzmann200-1000its,860,800,2227.088914968,2204.545063633,60
carcassonne-boltzmann310-vs-boltzmann345-1000its,861,801,2220.18316091,2144.418802185,60
carcassonne-ucttuned200-vs-ucttuned360-1000its,861,801,2174.102263522,2129.00212799,60
carcassonne-uct415-vs-uct15-1000its,863,803,2161.30072399,2127.910067279,60
carcassonne-boltzmann5-vs-boltzmann95-1000its,864,804,2241.775778357,2210.034899788,60
carcassonne-uct55-vs-uct460-1000its,865,805,2179.696983201,2139.184342118,60
carcassonne-ucttuned150-vs-ucttuned105-1000its,865,805,2245.46220414,2205.141155911,60
carcassonne-ucttuned335-vs-ucttuned355-1000its,865,805,2126.17033478,2065.079479305,60
carcassonne-uct285-vs-uct220-1000its,866,806,2153.234106939,2139.833387763,60
carcassonne-uct375-vs-uct155-1000its,866,806,2194.330213055,2104.88402632,60
carcassonne-ucttuned295-vs-ucttuned35-1000its,866,806,2242.502829865,2166.182920066,60
carcassonne-ucttuned460-vs-ucttuned100-1000its,866,806,2207.289309166,2154.87517695,60
carcassonne-boltzmann40-vs-boltzmann110-1000its,867,807,2229.535309696,2236.893917996,60
carcassonne-boltzmann60-vs-boltzmann225-1000its,867,807,2150.624525743,2097.999707619,60
carcassonne-boltzmann375-vs-boltzmann280-1000its,868,808,2220.318480459,2169.506762821,60
carcassonne-uct130-vs-uct80-1000its,869,809,2186.020597761,2168.299582593,60
carcassonne-ucttuned135-vs-ucttuned225-1000its,869,809,2230.877123296,2167.477191374,60
carcassonne-ucttuned225-vs-ucttuned355-1000its,870,810,2247.915515272,2194.753146918,60
carcassonne-uct110-vs-uct350-1000its,872,812,2236.124298659,2203.509707954,60
carcassonne-ucttuned180-vs-ucttuned270-1000its,874,814,2167.135404317,2125.402895533,60
carcassonne-ucttuned335-vs-ucttuned110-1000its,877,817,2261.206636447,2179.832114373,60
carcassonne-uct415-vs-uct180-1000its,878,818,2354.292440799,2313.536797798,60
carcassonne-boltzmann300-vs-boltzmann495-1000its,885,825,2227.432163304,2178.412180336,60
carcassonne-uct440-vs-uct300-1000its,885,825,2232.21182504,2180.503273715,60
carcassonne-uct215-vs-uct270-1000its,886,826,2138.857505614,2086.736036157,60
carcassonne-boltzmann360-vs-boltzmann300-1000its,887,827,2274.177351504,2246.022628356,60
carcassonne-uct90-vs-uct290-1000its,887,827,2195.189950383,2169.230043607,60
carcassonne-uct445-vs-uct275-1000its,889,829,2241.985859005,2228.524497054,60
carcassonne-ucttuned310-vs-ucttuned225-1000its,893,833,2146.507758906,2093.348933932,60
carcassonne-boltzmann60-vs-boltzmann255-1000its,894,834,2213.418782437,2157.228706626,60
carcassonne-ucttuned450-vs-ucttuned385-1000its,895,835,2206.774650631,2142.759536814,60
carcassonne-uct450-vs-uct135-1000its,897,837,2183.91857424,2153.977731219,60
carcassonne-boltzmann275-vs-boltzmann115-1000its,903,843,2189.028005114,2100.759662565,60
carcassonne-uct365-vs-uct315-1000its,905,845,2128.344549095,2065.624745612,60
carcassonne-uct75-vs-uct170-1000its,906,846,2234.519099715,2140.892374984,60
carcassonne-uct205-vs-uct140-1000its,908,848,2354.674012412,2299.795084085,60
carcassonne-ucttuned15-vs-ucttuned105-1000its,908,848,2203.923847514,2139.402273713,60
carcassonne-ucttuned20-vs-ucttuned220-1000its,909,849,2165.953781701,2129.491013841,60
carcassonne-ucttuned240-vs-ucttuned385-1000its,909,849,2215.189427065,2206.038927819,60
carcassonne-boltzmann130-vs-boltzmann230-1000its,910,850,2188.976886542,2135.078547729,60
carcassonne-boltzmann300-vs-boltzmann125-1000its,918,858,2216.997105056,2139.284509518,60
carcassonne-uct230-vs-uct205-1000its,921,861,2186.104439686,2174.419542624,60
carcassonne-uct295-vs-uct315-1000its,923,863,2230.337583503,2157.872990458,60
carcassonne-uct290-vs-uct300-1000its,929,869,2182.999381439,2103.167621336,60
carcassonne-boltzmann55-vs-boltzmann420-1000its,930,870,2167.939382513,2112.783901793,60
carcassonne-boltzmann25-vs-boltzmann420-1000its,931,871,2135.320066812,2076.508046428,60
carcassonne-ucttuned5-vs-ucttuned395-1000its,934,874,2205.852899121,2149.383937745,60
carcassonne-ucttuned325-vs-ucttuned435-1000its,686,625,1760.121070945,1704.664622307,61
carcassonne-boltzmann465-vs-boltzmann435-1000its,750,689,2154.937401287,2113.774551801,61
carcassonne-boltzmann5-vs-boltzmann195-1000its,762,701,2243.723380858,2157.194104481,61
carcassonne-uct375-vs-uct470-1000its,763,702,2194.174578451,2141.113388779,61
carcassonne-ucttuned460-vs-ucttuned105-1000its,765,704,2164.094369747,2134.341364464,61
carcassonne-uct170-vs-uct95-1000its,775,714,2197.129544526,2152.792449213,61
carcassonne-ucttuned495-vs-ucttuned105-1000its,775,714,2217.362472554,2124.029825371,61
carcassonne-boltzmann460-vs-boltzmann475-1000its,779,718,2169.383311266,2148.89727792,61
carcassonne-uct225-vs-uct155-1000its,780,719,2164.688804884,2126.868045459,61
carcassonne-uct205-vs-uct105-1000its,782,721,2194.735328468,2157.573332686,61
carcassonne-ucttuned180-vs-ucttuned90-1000its,785,724,2222.511755306,2150.190595682,61
carcassonne-ucttuned415-vs-ucttuned75-1000its,785,724,2141.48779954,2158.033066186,61
carcassonne-boltzmann55-vs-boltzmann465-1000its,786,725,2189.637203069,2145.873322215,61
carcassonne-boltzmann40-vs-boltzmann320-1000its,793,732,2219.07267808,2197.449596524,61
carcassonne-ucttuned260-vs-ucttuned435-1000its,793,732,2184.554777368,2127.747102833,61
carcassonne-uct175-vs-uct445-1000its,795,734,2227.86376712,2182.101799821,61
carcassonne-boltzmann385-vs-boltzmann45-1000its,797,736,2220.593114157,2193.551638073,61
carcassonne-ucttuned260-vs-ucttuned35-1000its,800,739,2209.044592735,2181.632359968,61
carcassonne-boltzmann210-vs-boltzmann440-1000its,802,741,2245.490677225,2161.586738103,61
carcassonne-boltzmann465-vs-boltzmann475-1000its,802,741,2119.559801882,2070.600042884,61
carcassonne-uct260-vs-uct140-1000its,803,742,2221.879201231,2196.171222029,61
carcassonne-ucttuned180-vs-ucttuned250-1000its,804,743,2185.786703945,2176.350068451,61
carcassonne-ucttuned325-vs-ucttuned405-1000its,804,743,2379.878307212,2289.516284734,61
carcassonne-uct415-vs-uct375-1000its,805,744,2179.428010277,2181.207733243,61
carcassonne-uct130-vs-uct35-1000its,807,746,2249.257305017,2202.8081809,61
carcassonne-ucttuned190-vs-ucttuned60-1000its,812,751,2242.146387827,2189.578602614,61
carcassonne-boltzmann430-vs-boltzmann50-1000its,813,752,2227.737885979,2153.91035274,61
carcassonne-ucttuned125-vs-ucttuned35-1000its,813,752,2204.703008591,2110.165425467,61
carcassonne-ucttuned275-vs-ucttuned400-1000its,814,753,2170.65052443,2133.43324038,61
carcassonne-boltzmann245-vs-boltzmann400-1000its,815,754,2183.3479311,2140.130622374,61
carcassonne-boltzmann495-vs-boltzmann215-1000its,817,756,2212.396169089,2130.026641233,61
carcassonne-uct115-vs-uct425-1000its,817,756,2141.387465509,2087.136999402,61
carcassonne-uct320-vs-uct435-1000its,817,756,2233.920501837,2162.687982487,61
carcassonne-ucttuned355-vs-ucttuned245-1000its,818,757,2193.394254825,2131.118594959,61
carcassonne-uct170-vs-uct295-1000its,819,758,2233.075427518,2166.652624434,61
carcassonne-ucttuned450-vs-ucttuned210-1000its,819,758,2217.042981976,2134.380456536,61
carcassonne-uct350-vs-uct435-1000its,822,761,2239.992329028,2194.005642603,61
carcassonne-ucttuned100-vs-ucttuned310-1000its,824,763,2169.2710062,2119.853309016,61
carcassonne-ucttuned175-vs-ucttuned310-1000its,825,764,2169.601779199,2150.254832678,61
carcassonne-boltzmann130-vs-boltzmann65-1000its,829,768,2217.025722269,2174.217122536,61
carcassonne-boltzmann5-vs-boltzmann230-1000its,829,768,2305.877685591,2241.290943676,61
carcassonne-ucttuned490-vs-ucttuned80-1000its,829,768,2178.865677314,2132.331089645,61
carcassonne-boltzmann395-vs-boltzmann450-1000its,830,769,2213.163785765,2172.739235006,61
carcassonne-uct370-vs-uct360-1000its,830,769,2153.937536046,2175.056425838,61
carcassonne-uct50-vs-uct70-1000its,830,769,2214.149036315,2144.577409537,61
carcassonne-uct85-vs-uct45-1000its,832,771,2116.046953147,2102.292602455,61
carcassonne-ucttuned160-vs-ucttuned480-1000its,837,776,2232.183156443,2154.511478391,61
carcassonne-uct370-vs-uct65-1000its,838,777,2160.87479076,2128.472544083,61
carcassonne-boltzmann460-vs-boltzmann290-1000its,840,779,2190.782581787,2145.71633038,61
carcassonne-ucttuned170-vs-ucttuned55-1000its,842,781,2288.233415011,2216.528747882,61
carcassonne-ucttuned10-vs-ucttuned425-1000its,843,782,2182.2332182,2124.701017505,61
carcassonne-boltzmann445-vs-boltzmann160-1000its,844,783,2229.134375245,2167.264453376,61
carcassonne-ucttuned150-vs-ucttuned455-1000its,844,783,2172.448416507,2113.476290827,61
carcassonne-boltzmann30-vs-boltzmann280-1000its,846,785,2147.582171551,2129.553029043,61
carcassonne-boltzmann425-vs-boltzmann65-1000its,848,787,2259.977892864,2227.330314817,61
carcassonne-ucttuned90-vs-ucttuned350-1000its,850,789,2183.512477747,2116.205602432,61
carcassonne-boltzmann225-vs-boltzmann190-1000its,851,790,2154.759273237,2131.527393634,61
carcassonne-boltzmann405-vs-boltzmann320-1000its,851,790,2209.934312769,2194.219881585,61
carcassonne-boltzmann125-vs-boltzmann5-1000its,852,791,2212.717505931,2195.471178517,61
carcassonne-boltzmann35-vs-boltzmann140-1000its,852,791,2185.626955239,2154.900315911,61
carcassonne-uct20-vs-uct70-1000its,852,791,2180.637938098,2129.302683938,61
carcassonne-boltzmann205-vs-boltzmann240-1000its,853,792,2213.235424366,2146.887010519,61
carcassonne-boltzmann435-vs-boltzmann425-1000its,854,793,2142.504853932,2103.630585206,61
carcassonne-uct440-vs-uct400-1000its,854,793,2164.076855921,2141.487278293,61
carcassonne-ucttuned395-vs-ucttuned25-1000its,854,793,2182.413036791,2087.948470617,61
carcassonne-ucttuned135-vs-ucttuned75-1000its,855,794,2189.133984679,2197.142069372,61
carcassonne-ucttuned495-vs-ucttuned75-1000its,856,795,2211.979922506,2158.693183411,61
carcassonne-boltzmann65-vs-boltzmann10-1000its,857,796,2225.061574595,2164.780561681,61
carcassonne-boltzmann120-vs-boltzmann115-1000its,861,800,2225.020649794,2186.264688962,61
carcassonne-ucttuned145-vs-ucttuned335-1000its,861,800,2198.41061457,2152.150795237,61
carcassonne-ucttuned340-vs-ucttuned430-1000its,863,802,2158.693986142,2112.90408751,61
carcassonne-ucttuned25-vs-ucttuned425-1000its,864,803,2200.345073351,2177.506551815,61
carcassonne-uct340-vs-uct140-1000its,865,804,2144.144040255,2052.648244341,61
carcassonne-ucttuned310-vs-ucttuned300-1000its,865,804,2204.530533417,2191.676058451,61
carcassonne-ucttuned285-vs-ucttuned290-1000its,870,809,2236.974643506,2158.62160324,61
carcassonne-uct470-vs-uct75-1000its,871,810,2173.487687451,2180.030353455,61
carcassonne-uct270-vs-uct365-1000its,872,811,2205.272022622,2123.902633593,61
carcassonne-uct200-vs-uct395-1000its,874,813,2220.520940568,2130.931061305,61
carcassonne-uct290-vs-uct40-1000its,875,814,2233.926459394,2153.820743606,61
carcassonne-ucttuned180-vs-ucttuned70-1000its,875,814,2240.120707158,2206.136173093,61
carcassonne-boltzmann160-vs-boltzmann400-1000its,878,817,2300.442389767,2211.450608174,61
carcassonne-boltzmann490-vs-boltzmann130-1000its,878,817,2191.887048423,2127.625061465,61
carcassonne-uct30-vs-uct425-1000its,878,817,2220.606377842,2158.751403558,61
carcassonne-ucttuned10-vs-ucttuned295-1000its,879,818,2149.49411098,2115.238227879,61
carcassonne-ucttuned270-vs-ucttuned200-1000its,879,818,2166.103814673,2133.980736444,61
carcassonne-uct250-vs-uct50-1000its,881,820,2217.658901022,2196.954308665,61
carcassonne-boltzmann145-vs-boltzmann65-1000its,883,822,2195.157494109,2193.81040944,61
carcassonne-ucttuned415-vs-ucttuned360-1000its,883,822,2170.321170386,2112.75441314,61
carcassonne-boltzmann110-vs-boltzmann445-1000its,884,823,2315.268761116,2251.667989741,61
carcassonne-uct480-vs-uct40-1000its,884,823,2170.654997735,2130.350900613,61
carcassonne-uct395-vs-uct265-1000its,885,824,2233.437654912,2154.663960652,61
carcassonne-boltzmann55-vs-boltzmann95-1000its,886,825,2274.560388918,2188.902249448,61
carcassonne-boltzmann270-vs-boltzmann445-1000its,887,826,2162.918140621,2095.731280313,61
carcassonne-ucttuned205-vs-ucttuned215-1000its,887,826,2286.797061697,2192.54953488,61
carcassonne-uct380-vs-uct35-1000its,889,828,2173.444837209,2195.837779384,61
carcassonne-ucttuned470-vs-ucttuned255-1000its,891,830,2176.353680805,2147.11266127,61
carcassonne-ucttuned100-vs-ucttuned435-1000its,893,832,2157.987974923,2122.113870283,61
carcassonne-boltzmann305-vs-boltzmann375-1000its,898,837,2170.001754078,2109.25348108,61
carcassonne-ucttuned135-vs-ucttuned40-1000its,900,839,2193.44940515,2112.994786823,61
carcassonne-ucttuned230-vs-ucttuned85-1000its,900,839,2171.702635298,2091.891584721,61
carcassonne-ucttuned460-vs-ucttuned10-1000its,901,840,2139.853887374,2114.507775794,61
carcassonne-uct125-vs-uct335-1000its,904,843,2275.179825492,2233.676397499,61
carcassonne-uct330-vs-uct255-1000its,905,844,2223.761689517,2152.583646588,61
carcassonne-boltzmann495-vs-boltzmann105-1000its,906,845,2213.370725061,2175.550040736,61
carcassonne-uct80-vs-uct325-1000its,908,847,2192.631832385,2144.943635976,61
carcassonne-ucttuned15-vs-ucttuned390-1000its,916,855,2197.857302196,2141.499850327,61
carcassonne-ucttuned130-vs-ucttuned415-1000its,922,861,2197.360918552,2170.74914585,61
carcassonne-boltzmann315-vs-boltzmann370-1000its,938,877,2228.655101637,2152.886373556,61
carcassonne-uct55-vs-uct300-1000its,949,888,2203.26532906,2157.356958006,61
carcassonne-ucttuned60-vs-ucttuned375-1000its,970,909,2224.249535754,2203.676829349,61
carcassonne-uct420-vs-uct455-1000its,745,683,2158.881728251,2094.553201348,62
carcassonne-boltzmann475-vs-boltzmann180-1000its,763,701,2192.203814986,2154.820923116,62
carcassonne-boltzmann495-vs-boltzmann465-1000its,764,702,2208.706940898,2137.805683802,62
carcassonne-uct465-vs-uct25-1000its,772,710,2161.928590668,2098.343491056,62
carcassonne-uct125-vs-uct115-1000its,786,724,2149.890217718,2131.925896518,62
carcassonne-boltzmann245-vs-boltzmann150-1000its,787,725,2168.574232664,2147.791414594,62
carcassonne-boltzmann290-vs-boltzmann80-1000its,788,726,2219.177617325,2146.92177033,62
carcassonne-boltzmann480-vs-boltzmann260-1000its,795,733,2177.535809304,2146.932641146,62
carcassonne-boltzmann55-vs-boltzmann275-1000its,795,733,2222.777339466,2164.083593739,62
carcassonne-uct485-vs-uct130-1000its,795,733,2183.722852175,2154.748379352,62
carcassonne-ucttuned145-vs-ucttuned265-1000its,801,739,2181.315023922,2158.630132669,62
carcassonne-uct310-vs-uct180-1000its,803,741,2148.93522511,2101.987010256,62
carcassonne-uct490-vs-uct5-1000its,803,741,2218.602348806,2196.04480215,62
carcassonne-boltzmann40-vs-boltzmann335-1000its,804,742,2208.82879003,2128.656481688,62
carcassonne-boltzmann300-vs-boltzmann450-1000its,808,746,2191.588173509,2120.651061507,62
carcassonne-boltzmann340-vs-boltzmann455-1000its,808,746,2154.37348712,2115.556157536,62
carcassonne-ucttuned70-vs-ucttuned55-1000its,809,747,2213.5158769,2198.367739245,62
carcassonne-uct470-vs-uct35-1000its,810,748,2210.497503941,2169.294448653,62
carcassonne-boltzmann385-vs-boltzmann410-1000its,811,749,2179.046402693,2164.552577686,62
carcassonne-uct380-vs-uct60-1000its,811,749,2163.912080103,2158.696349811,62
carcassonne-ucttuned240-vs-ucttuned415-1000its,811,749,2209.756622592,2160.093473398,62
carcassonne-uct105-vs-uct450-1000its,812,750,2194.328603029,2142.484218823,62
carcassonne-uct25-vs-uct360-1000its,812,750,2169.090604607,2150.664432002,62
carcassonne-uct475-vs-uct80-1000its,812,750,2161.560949548,2130.202998602,62
carcassonne-boltzmann135-vs-boltzmann190-1000its,814,752,2206.244355094,2196.058229241,62
carcassonne-boltzmann95-vs-boltzmann50-1000its,814,752,2150.827042688,2139.572631144,62
carcassonne-boltzmann415-vs-boltzmann95-1000its,815,753,2186.133471506,2168.89411018,62
carcassonne-boltzmann340-vs-boltzmann435-1000its,817,755,2158.278166509,2157.701131105,62
carcassonne-ucttuned150-vs-ucttuned205-1000its,817,755,2186.519886934,2180.792611842,62
carcassonne-boltzmann495-vs-boltzmann205-1000its,819,757,2177.655038493,2154.372453383,62
carcassonne-ucttuned410-vs-ucttuned125-1000its,819,757,2208.954742073,2161.00571475,62
carcassonne-boltzmann110-vs-boltzmann465-1000its,821,759,2285.175189616,2218.852620283,62
carcassonne-ucttuned425-vs-ucttuned490-1000its,821,759,2236.224191441,2219.147520774,62
carcassonne-ucttuned60-vs-ucttuned65-1000its,821,759,2212.203922593,2147.14630281,62
carcassonne-ucttuned240-vs-ucttuned120-1000its,822,760,2226.97591204,2135.089539274,62
carcassonne-uct440-vs-uct480-1000its,823,761,2220.801285335,2159.45530094,62
carcassonne-uct255-vs-uct285-1000its,824,762,2185.453588682,2121.454119604,62
carcassonne-ucttuned335-vs-ucttuned220-1000its,825,763,2166.749335537,2089.265435428,62
carcassonne-uct405-vs-uct270-1000its,828,766,2208.212840259,2171.024735612,62
carcassonne-boltzmann255-vs-boltzmann85-1000its,829,767,2170.891573705,2143.577085598,62
carcassonne-ucttuned115-vs-ucttuned85-1000its,830,768,2243.776223248,2228.612699483,62
carcassonne-ucttuned415-vs-ucttuned70-1000its,830,768,2159.888623889,2144.467788099,62
carcassonne-ucttuned45-vs-ucttuned165-1000its,830,768,2168.41897468,2133.972896088,62
carcassonne-boltzmann405-vs-boltzmann250-1000its,831,769,2161.388722785,2114.620267254,62
carcassonne-uct495-vs-uct215-1000its,831,769,2261.454708917,2247.840052297,62
carcassonne-ucttuned190-vs-ucttuned480-1000its,831,769,2229.201463473,2214.958815924,62
carcassonne-ucttuned125-vs-ucttuned320-1000its,833,771,2217.529734493,2166.011113119,62
carcassonne-ucttuned415-vs-ucttuned450-1000its,834,772,2176.419948204,2147.177858544,62
carcassonne-boltzmann460-vs-boltzmann75-1000its,835,773,2169.9089053,2119.82452582,62
carcassonne-ucttuned125-vs-ucttuned305-1000its,837,775,2239.205094827,2195.659195665,62
carcassonne-ucttuned250-vs-ucttuned180-1000its,837,775,2190.583251072,2148.808890656,62
carcassonne-ucttuned375-vs-ucttuned120-1000its,839,777,2258.971985227,2205.91322812,62
carcassonne-uct295-vs-uct280-1000its,841,779,2169.954410586,2190.467316781,62
carcassonne-boltzmann225-vs-boltzmann475-1000its,843,781,2266.421660521,2190.27711231,62
carcassonne-boltzmann365-vs-boltzmann360-1000its,843,781,2185.026349545,2191.326537718,62
carcassonne-uct120-vs-uct65-1000its,843,781,2202.320715808,2182.398084039,62
carcassonne-boltzmann490-vs-boltzmann290-1000its,844,782,2233.812134124,2175.617095032,62
carcassonne-boltzmann295-vs-boltzmann390-1000its,845,783,2234.027136958,2162.600871331,62
carcassonne-uct105-vs-uct75-1000its,845,783,2204.913013619,2078.978193449,62
carcassonne-uct110-vs-uct460-1000its,845,783,2207.808443336,2153.46101489,62
carcassonne-uct40-vs-uct430-1000its,845,783,2195.510848674,2158.810821209,62
carcassonne-uct305-vs-uct55-1000its,846,784,2231.424502615,2205.14040732,62
carcassonne-boltzmann20-vs-boltzmann165-1000its,848,786,2119.296866439,2073.540307672,62
carcassonne-ucttuned320-vs-ucttuned385-1000its,848,786,2213.093309308,2181.881960729,62
carcassonne-ucttuned460-vs-ucttuned35-1000its,848,786,2233.521866783,2164.390638861,62
carcassonne-boltzmann105-vs-boltzmann20-1000its,849,787,2220.379847489,2170.295503547,62
carcassonne-ucttuned210-vs-ucttuned375-1000its,849,787,2288.818511791,2251.626241828,62
carcassonne-boltzmann450-vs-boltzmann205-1000its,850,788,2186.144418591,2145.820116891,62
carcassonne-uct285-vs-uct360-1000its,851,789,2115.105791087,2069.119568424,62
carcassonne-uct410-vs-uct255-1000its,852,790,2225.953740607,2199.118569962,62
carcassonne-boltzmann60-vs-boltzmann340-1000its,854,792,2199.752890031,2163.430633512,62
carcassonne-uct115-vs-uct45-1000its,854,792,2304.603802064,2243.647349325,62
carcassonne-uct350-vs-uct145-1000its,855,793,2228.598777119,2204.916182969,62
carcassonne-uct100-vs-uct265-1000its,856,794,2228.614241361,2196.785802576,62
carcassonne-uct245-vs-uct490-1000its,856,794,2232.027108761,2150.66276266,62
carcassonne-ucttuned405-vs-ucttuned210-1000its,864,802,2196.148431148,2180.998063454,62
carcassonne-uct130-vs-uct350-1000its,866,804,2224.939162303,2153.683994808,62
carcassonne-boltzmann190-vs-boltzmann260-1000its,868,806,2171.19907652,2103.61172891,62
carcassonne-boltzmann465-vs-boltzmann265-1000its,868,806,2199.591855655,2192.368523605,62
carcassonne-ucttuned90-vs-ucttuned345-1000its,869,807,2224.855846948,2121.605830556,62
carcassonne-boltzmann360-vs-boltzmann475-1000its,871,809,2171.844820095,2149.107746044,62
carcassonne-boltzmann405-vs-boltzmann300-1000its,872,810,2226.360196481,2181.630797564,62
carcassonne-uct185-vs-uct485-1000its,872,810,2201.772582017,2197.901667421,62
carcassonne-uct325-vs-uct355-1000its,872,810,2193.91502344,2136.82192931,62
carcassonne-uct470-vs-uct195-1000its,873,811,2141.427600353,2103.447634248,62
carcassonne-uct125-vs-uct355-1000its,874,812,2233.297094249,2153.895475183,62
carcassonne-ucttuned115-vs-ucttuned410-1000its,875,813,2200.473436283,2130.609353675,62
carcassonne-boltzmann405-vs-boltzmann125-1000its,877,815,2156.560788583,2110.432002616,62
carcassonne-uct425-vs-uct335-1000its,877,815,2178.64057744,2171.164233158,62
carcassonne-ucttuned15-vs-ucttuned115-1000its,878,816,2202.896434129,2099.18635277,62
carcassonne-boltzmann220-vs-boltzmann310-1000its,879,817,2266.600146605,2225.411247618,62
carcassonne-uct70-vs-uct375-1000its,879,817,2167.820103252,2161.023370792,62
carcassonne-uct30-vs-uct140-1000its,884,822,2174.757341517,2114.480133087,62
carcassonne-ucttuned105-vs-ucttuned300-1000its,885,823,2204.264385901,2111.797667235,62
carcassonne-boltzmann455-vs-boltzmann15-1000its,887,825,2250.319998019,2225.968411257,62
carcassonne-uct220-vs-uct245-1000its,887,825,2154.277159715,2102.015037906,62
carcassonne-uct160-vs-uct15-1000its,888,826,2220.809135321,2194.79404777,62
carcassonne-ucttuned365-vs-ucttuned420-1000its,888,826,2246.501576583,2206.567541448,62
carcassonne-ucttuned365-vs-ucttuned10-1000its,891,829,2197.599084658,2150.827036493,62
carcassonne-ucttuned165-vs-ucttuned55-1000its,902,840,2187.157409686,2147.283752231,62
carcassonne-ucttuned60-vs-ucttuned105-1000its,904,842,2221.362073433,2167.666265862,62
carcassonne-uct315-vs-uct445-1000its,906,844,2213.183459315,2181.048871425,62
carcassonne-uct195-vs-uct65-1000its,907,845,2184.061999499,2143.799962032,62
carcassonne-boltzmann145-vs-boltzmann185-1000its,925,863,2126.349210754,2087.725591496,62
carcassonne-ucttuned280-vs-ucttuned35-1000its,929,867,2182.464072724,2143.247442159,62
carcassonne-boltzmann25-vs-boltzmann385-1000its,935,873,2161.823555676,2130.007325778,62
carcassonne-boltzmann20-vs-boltzmann290-1000its,943,881,2146.936315315,2137.207501299,62
carcassonne-ucttuned405-vs-ucttuned360-1000its,672,609,1706.972400196,1713.359513044,63
carcassonne-ucttuned320-vs-ucttuned345-1000its,746,683,2200.361694232,2162.460293397,63
carcassonne-ucttuned325-vs-ucttuned190-1000its,769,706,2193.995284135,2168.526419358,63
carcassonne-boltzmann415-vs-boltzmann495-1000its,770,707,2143.165864314,2088.776309774,63
carcassonne-uct20-vs-uct300-1000its,773,710,2113.489015378,2102.31398477,63
carcassonne-uct355-vs-uct70-1000its,774,711,2148.18709922,2103.761603978,63
carcassonne-boltzmann375-vs-boltzmann320-1000its,775,712,2164.8953231,2076.250289285,63
carcassonne-uct240-vs-uct480-1000its,775,712,2244.058167265,2167.368717943,63
carcassonne-boltzmann380-vs-boltzmann185-1000its,777,714,2118.114948509,2127.090976497,63
carcassonne-ucttuned165-vs-ucttuned25-1000its,781,718,2207.743457278,2181.411234156,63
carcassonne-uct185-vs-uct220-1000its,788,725,2259.489169112,2179.188440622,63
carcassonne-boltzmann75-vs-boltzmann435-1000its,791,728,2242.101129572,2167.271372127,63
carcassonne-boltzmann195-vs-boltzmann50-1000its,794,731,2175.518579374,2125.717899992,63
carcassonne-uct350-vs-uct235-1000its,795,732,2337.351697249,2267.783722787,63
carcassonne-uct65-vs-uct110-1000its,795,732,2233.006062002,2226.653267843,63
carcassonne-boltzmann100-vs-boltzmann195-1000its,798,735,2131.064186739,2101.685759851,63
carcassonne-boltzmann135-vs-boltzmann460-1000its,798,735,2210.575208969,2131.933528928,63
carcassonne-uct415-vs-uct25-1000its,802,739,2155.586545149,2140.815822273,63
carcassonne-boltzmann345-vs-boltzmann270-1000its,807,744,2217.082319004,2128.408321915,63
carcassonne-uct275-vs-uct320-1000its,807,744,2218.479104499,2146.28780765,63
carcassonne-uct230-vs-uct45-1000its,809,746,2249.22969794,2215.026503695,63
carcassonne-uct390-vs-uct95-1000its,813,750,2187.006585884,2138.036743578,63
carcassonne-ucttuned270-vs-ucttuned450-1000its,814,751,2123.166453306,2073.829125261,63
carcassonne-boltzmann205-vs-boltzmann95-1000its,815,752,2199.44115823,2152.938287461,63
carcassonne-boltzmann50-vs-boltzmann340-1000its,816,753,2196.059061547,2185.155216196,63
carcassonne-boltzmann30-vs-boltzmann160-1000its,817,754,2201.367596503,2165.602667063,63
carcassonne-uct140-vs-uct200-1000its,817,754,2251.2921467,2219.100140489,63
carcassonne-uct470-vs-uct305-1000its,818,755,2238.829309855,2166.191011093,63
carcassonne-uct70-vs-uct435-1000its,818,755,2217.374842814,2161.734175219,63
carcassonne-ucttuned145-vs-ucttuned405-1000its,819,756,2229.014474252,2178.249620126,63
carcassonne-ucttuned265-vs-ucttuned295-1000its,819,756,2226.896655681,2228.315622467,63
carcassonne-ucttuned495-vs-ucttuned240-1000its,821,758,2174.016838875,2193.184452394,63
carcassonne-boltzmann215-vs-boltzmann340-1000its,822,759,2235.580124063,2192.969254748,63
carcassonne-boltzmann355-vs-boltzmann345-1000its,823,760,2245.650650492,2193.199896923,63
carcassonne-ucttuned285-vs-ucttuned100-1000its,823,760,2219.651301456,2157.045783034,63
carcassonne-uct385-vs-uct250-1000its,824,761,2147.728712625,2147.11615294,63
carcassonne-ucttuned480-vs-ucttuned445-1000its,825,762,2160.758016573,2110.539180827,63
carcassonne-uct375-vs-uct255-1000its,826,763,2208.550994347,2148.337347416,63
carcassonne-uct230-vs-uct390-1000its,828,765,2195.468215876,2150.808971763,63
carcassonne-ucttuned275-vs-ucttuned220-1000its,828,765,2175.198158713,2134.407658823,63
carcassonne-ucttuned415-vs-ucttuned435-1000its,828,765,2226.52891553,2134.844989045,63
carcassonne-uct425-vs-uct265-1000its,830,767,2266.949954483,2215.415700101,63
carcassonne-boltzmann390-vs-boltzmann430-1000its,831,768,2232.393445058,2165.271364832,63
carcassonne-uct410-vs-uct115-1000its,831,768,2274.179634709,2202.802854765,63
carcassonne-ucttuned200-vs-ucttuned310-1000its,831,768,2206.477684756,2147.621216011,63
carcassonne-boltzmann310-vs-boltzmann255-1000its,832,769,2191.836801171,2174.969105223,63
carcassonne-uct75-vs-uct85-1000its,833,770,2144.523591746,2105.789943134,63
carcassonne-ucttuned165-vs-ucttuned405-1000its,833,770,2254.755988123,2212.631727427,63
carcassonne-ucttuned270-vs-ucttuned225-1000its,833,770,2188.456212656,2148.638003708,63
carcassonne-uct140-vs-uct220-1000its,834,771,2203.381556928,2127.697669746,63
carcassonne-ucttuned185-vs-ucttuned300-1000its,834,771,2162.275126281,2138.248946662,63
carcassonne-boltzmann300-vs-boltzmann455-1000its,838,775,2205.370815153,2156.790599402,63
carcassonne-boltzmann280-vs-boltzmann160-1000its,840,777,2139.644431323,2135.32703618,63
carcassonne-boltzmann435-vs-boltzmann165-1000its,840,777,2196.077690484,2126.117014454,63
carcassonne-ucttuned165-vs-ucttuned410-1000its,840,777,2245.294556914,2174.473307574,63
carcassonne-uct135-vs-uct240-1000its,841,778,2221.057561627,2191.406968826,63
carcassonne-uct385-vs-uct60-1000its,841,778,2159.700166033,2073.944219307,63
carcassonne-ucttuned55-vs-ucttuned455-1000its,842,779,2204.612707367,2201.487414846,63
carcassonne-uct260-vs-uct365-1000its,849,786,2191.431972976,2136.614900232,63
carcassonne-uct350-vs-uct115-1000its,850,787,2190.693354378,2169.382030095,63
carcassonne-ucttuned195-vs-ucttuned325-1000its,850,787,2247.966365267,2190.177244878,63
carcassonne-boltzmann135-vs-boltzmann110-1000its,851,788,2171.969031746,2160.986848229,63
carcassonne-boltzmann365-vs-boltzmann195-1000its,851,788,2184.819981249,2146.627660184,63
carcassonne-uct120-vs-uct310-1000its,851,788,2152.865854878,2131.564193362,63
carcassonne-boltzmann350-vs-boltzmann20-1000its,854,791,2271.069128792,2229.582892607,63
carcassonne-ucttuned5-vs-ucttuned225-1000its,854,791,2206.689206625,2179.575501411,63
carcassonne-boltzmann350-vs-boltzmann90-1000its,855,792,2234.840961427,2184.507302511,63
carcassonne-boltzmann405-vs-boltzmann10-1000its,856,793,2220.676273376,2181.102788095,63
carcassonne-ucttuned455-vs-ucttuned305-1000its,856,793,2233.452428534,2148.385161917,63
carcassonne-boltzmann370-vs-boltzmann195-1000its,858,795,2212.744264031,2132.481672702,63
carcassonne-uct10-vs-uct160-1000its,858,795,2153.022274993,2111.786288758,63
carcassonne-ucttuned205-vs-ucttuned30-1000its,858,795,2162.871707532,2144.764732455,63
carcassonne-uct240-vs-uct160-1000its,859,796,2252.398639136,2218.473548153,63
carcassonne-uct430-vs-uct400-1000its,859,796,2252.410335558,2209.929185476,63
carcassonne-ucttuned55-vs-ucttuned380-1000its,860,797,2229.940697432,2140.910706924,63
carcassonne-boltzmann15-vs-boltzmann285-1000its,861,798,2274.299515121,2228.115148138,63
carcassonne-ucttuned270-vs-ucttuned405-1000its,861,798,2157.600611225,2091.104218601,63
carcassonne-boltzmann345-vs-boltzmann495-1000its,862,799,2224.685413978,2186.27384094,63
carcassonne-ucttuned220-vs-ucttuned395-1000its,864,801,2187.592777829,2123.633720994,63
carcassonne-uct305-vs-uct260-1000its,865,802,2199.81368802,2149.271399267,63
carcassonne-uct445-vs-uct490-1000its,865,802,2204.026067351,2165.230141527,63
carcassonne-uct130-vs-uct310-1000its,866,803,2187.909657365,2153.296136541,63
carcassonne-ucttuned350-vs-ucttuned240-1000its,866,803,2233.161310921,2164.64690378,63
carcassonne-uct115-vs-uct195-1000its,867,804,2180.22287236,2131.626549781,63
carcassonne-uct195-vs-uct140-1000its,867,804,2326.444000322,2260.132489804,63
carcassonne-uct90-vs-uct455-1000its,868,805,2203.371305652,2146.025637414,63
carcassonne-uct25-vs-uct405-1000its,869,806,2166.902098765,2085.726967162,63
carcassonne-uct20-vs-uct330-1000its,870,807,2230.03619306,2218.141501337,63
carcassonne-ucttuned165-vs-ucttuned15-1000its,870,807,2212.085964528,2165.574531543,63
carcassonne-ucttuned320-vs-ucttuned350-1000its,872,809,2150.429516726,2154.318051305,63
carcassonne-boltzmann10-vs-boltzmann130-1000its,876,813,2184.043322715,2102.294318298,63
carcassonne-boltzmann125-vs-boltzmann465-1000its,877,814,2263.887699008,2188.664186549,63
carcassonne-boltzmann475-vs-boltzmann400-1000its,878,815,2203.012626653,2151.9851391,63
carcassonne-uct390-vs-uct180-1000its,878,815,2231.009810369,2219.447384787,63
carcassonne-boltzmann350-vs-boltzmann340-1000its,882,819,2122.994260758,2103.538479912,63
carcassonne-boltzmann235-vs-boltzmann140-1000its,884,821,2242.919825505,2173.893807213,63
carcassonne-ucttuned140-vs-ucttuned35-1000its,885,822,2134.666675096,2116.149983234,63
carcassonne-boltzmann60-vs-boltzmann465-1000its,888,825,2159.279389624,2131.733628101,63
carcassonne-ucttuned495-vs-ucttuned20-1000its,890,827,2252.851818823,2214.107023298,63
carcassonne-uct5-vs-uct220-1000its,891,828,2225.652027895,2202.514751673,63
carcassonne-ucttuned200-vs-ucttuned290-1000its,892,829,2215.16037839,2157.120649737,63
carcassonne-uct270-vs-uct110-1000its,893,830,2174.759480337,2138.101098964,63
carcassonne-uct405-vs-uct470-1000its,893,830,2337.221049339,2333.97218477,63
carcassonne-uct5-vs-uct250-1000its,896,833,2211.947354085,2148.747747992,63
carcassonne-ucttuned80-vs-ucttuned90-1000its,900,837,2207.406878571,2161.056130805,63
carcassonne-uct205-vs-uct355-1000its,901,838,2194.337345803,2121.417132298,63
carcassonne-ucttuned115-vs-ucttuned280-1000its,904,841,2175.890487968,2160.488596321,63
carcassonne-ucttuned440-vs-ucttuned175-1000its,909,846,2140.192859455,2115.068683196,63
carcassonne-uct305-vs-uct100-1000its,918,855,2237.150132879,2147.355903082,63
carcassonne-uct70-vs-uct425-1000its,947,884,2141.631179386,2096.623192931,63
carcassonne-ucttuned25-vs-ucttuned400-1000its,959,896,2180.937333137,2137.723364189,63
carcassonne-ucttuned300-vs-ucttuned445-1000its,984,921,2188.61716858,2118.628662132,63
carcassonne-boltzmann200-vs-boltzmann280-1000its,753,689,2104.575759376,2076.60970396,64
carcassonne-uct90-vs-uct340-1000its,761,697,2224.180813,2184.735820657,64
carcassonne-boltzmann365-vs-boltzmann320-1000its,769,705,2193.110846415,2147.214290611,64
carcassonne-boltzmann450-vs-boltzmann365-1000its,777,713,2207.324533559,2169.39956708,64
carcassonne-uct430-vs-uct475-1000its,777,713,2246.24392712,2187.192559735,64
carcassonne-ucttuned350-vs-ucttuned430-1000its,777,713,2163.377669084,2158.58563526,64
carcassonne-ucttuned180-vs-ucttuned130-1000its,779,715,2194.348760516,2136.222139415,64
carcassonne-boltzmann150-vs-boltzmann100-1000its,781,717,2181.715135927,2138.601954471,64
carcassonne-boltzmann215-vs-boltzmann300-1000its,781,717,2188.85444208,2151.666416471,64
carcassonne-boltzmann100-vs-boltzmann370-1000its,786,722,2143.058197493,2118.654827693,64
carcassonne-boltzmann35-vs-boltzmann115-1000its,787,723,2212.670545027,2119.278437628,64
carcassonne-ucttuned435-vs-ucttuned465-1000its,789,725,2201.326312268,2151.024641837,64
carcassonne-boltzmann210-vs-boltzmann315-1000its,796,732,2185.012921423,2136.348211562,64
carcassonne-uct195-vs-uct265-1000its,797,733,2254.754800557,2150.851510878,64
carcassonne-uct370-vs-uct215-1000its,797,733,2184.9145159,2143.878337538,64
carcassonne-ucttuned335-vs-ucttuned240-1000its,797,733,2256.507621975,2199.456818282,64
carcassonne-uct380-vs-uct365-1000its,798,734,2180.527246925,2135.746582775,64
carcassonne-uct215-vs-uct485-1000its,802,738,2231.652444483,2179.765813139,64
carcassonne-ucttuned305-vs-ucttuned245-1000its,805,741,2101.360330362,2065.08367206,64
carcassonne-ucttuned445-vs-ucttuned305-1000its,805,741,2183.72309505,2142.253112072,64
carcassonne-uct100-vs-uct485-1000its,806,742,2232.553419317,2162.549611812,64
carcassonne-boltzmann155-vs-boltzmann230-1000its,807,743,2202.766407288,2141.44791466,64
carcassonne-boltzmann385-vs-boltzmann405-1000its,808,744,2177.923843479,2158.81706032,64
carcassonne-ucttuned320-vs-ucttuned215-1000its,810,746,2103.064276687,2079.861826294,64
carcassonne-boltzmann10-vs-boltzmann325-1000its,811,747,2159.362103724,2086.533283292,64
carcassonne-uct290-vs-uct365-1000its,812,748,2223.592673964,2187.510719516,64
carcassonne-uct165-vs-uct150-1000its,814,750,2220.431962379,2176.653184983,64
carcassonne-uct230-vs-uct475-1000its,814,750,2145.66168148,2064.771239736,64
carcassonne-uct230-vs-uct40-1000its,815,751,2212.906693788,2152.540496401,64
carcassonne-uct385-vs-uct230-1000its,817,753,2199.118519546,2129.390318413,64
carcassonne-uct180-vs-uct295-1000its,818,754,2159.101748826,2083.644202851,64
carcassonne-boltzmann125-vs-boltzmann330-1000its,820,756,2208.198427842,2146.787825842,64
carcassonne-boltzmann470-vs-boltzmann435-1000its,820,756,2249.895391035,2227.183999298,64
carcassonne-boltzmann235-vs-boltzmann335-1000its,821,757,2185.59089446,2120.420050014,64
carcassonne-boltzmann85-vs-boltzmann260-1000its,821,757,2255.204441073,2219.614556337,64
carcassonne-uct385-vs-uct255-1000its,821,757,2208.752198915,2121.876297127,64
carcassonne-uct235-vs-uct55-1000its,822,758,2170.422349872,2155.594249627,64
carcassonne-boltzmann320-vs-boltzmann15-1000its,823,759,2117.560429877,2090.61780278,64
carcassonne-ucttuned335-vs-ucttuned140-1000its,824,760,2225.207463302,2160.512579771,64
carcassonne-ucttuned490-vs-ucttuned445-1000its,825,761,2226.219129252,2158.950141667,64
carcassonne-boltzmann145-vs-boltzmann260-1000its,829,765,2240.194911957,2198.726029426,64
carcassonne-boltzmann270-vs-boltzmann170-1000its,829,765,2245.649588468,2205.784919781,64
carcassonne-uct245-vs-uct305-1000its,832,768,2223.479007411,2173.317345722,64
carcassonne-uct460-vs-uct270-1000its,832,768,2248.415313938,2215.347782634,64
carcassonne-ucttuned130-vs-ucttuned405-1000its,832,768,2226.356526444,2165.702756239,64
carcassonne-ucttuned240-vs-ucttuned395-1000its,832,768,2266.679086831,2285.648482131,64
carcassonne-ucttuned345-vs-ucttuned40-1000its,832,768,2223.842837619,2191.516244825,64
carcassonne-ucttuned495-vs-ucttuned280-1000its,832,768,2273.495177815,2177.066674498,64
carcassonne-ucttuned50-vs-ucttuned470-1000its,832,768,2127.25491768,2132.755482413,64
carcassonne-boltzmann155-vs-boltzmann85-1000its,833,769,2182.065781899,2122.291505015,64
carcassonne-ucttuned265-vs-ucttuned485-1000its,833,769,2161.389175065,2169.510053583,64
carcassonne-ucttuned95-vs-ucttuned395-1000its,835,771,2201.980589728,2166.560828733,64
carcassonne-boltzmann130-vs-boltzmann20-1000its,840,776,2241.962091846,2190.548316568,64
carcassonne-ucttuned115-vs-ucttuned100-1000its,840,776,2179.496554271,2138.950556525,64
carcassonne-ucttuned175-vs-ucttuned200-1000its,840,776,2154.391395996,2102.233556836,64
carcassonne-ucttuned125-vs-ucttuned20-1000its,842,778,2204.019714292,2152.841529078,64
carcassonne-boltzmann495-vs-boltzmann290-1000its,843,779,2215.381094935,2201.649160846,64
carcassonne-ucttuned195-vs-ucttuned355-1000its,843,779,2193.267702342,2123.27073208,64
carcassonne-ucttuned400-vs-ucttuned65-1000its,843,779,2220.115082767,2150.946631539,64
carcassonne-ucttuned100-vs-ucttuned400-1000its,844,780,2158.691052886,2108.910187664,64
carcassonne-ucttuned330-vs-ucttuned255-1000its,845,781,2161.355968343,2123.251402611,64
carcassonne-uct125-vs-uct40-1000its,846,782,2151.672411821,2096.666044934,64
carcassonne-ucttuned325-vs-ucttuned375-1000its,848,784,2147.136664859,2151.724691907,64
carcassonne-uct30-vs-uct165-1000its,849,785,2150.218653835,2106.875813159,64
carcassonne-uct395-vs-uct405-1000its,850,786,2167.416109785,2096.633924349,64
carcassonne-boltzmann245-vs-boltzmann220-1000its,851,787,2221.320963504,2188.342488892,64
carcassonne-ucttuned45-vs-ucttuned345-1000its,851,787,2279.114178174,2206.262025614,64
carcassonne-uct270-vs-uct5-1000its,852,788,2171.875086846,2146.324974868,64
carcassonne-boltzmann310-vs-boltzmann45-1000its,853,789,2204.457895048,2184.831185293,64
carcassonne-uct105-vs-uct140-1000its,853,789,2224.847731146,2155.428651566,64
carcassonne-ucttuned25-vs-ucttuned340-1000its,853,789,2172.62070871,2084.81270616,64
carcassonne-ucttuned390-vs-ucttuned130-1000its,854,790,2153.841922923,2118.097589156,64
carcassonne-uct245-vs-uct80-1000its,855,791,2184.216254638,2151.914648868,64
carcassonne-uct360-vs-uct235-1000its,855,791,2199.192724488,2184.665824621,64
carcassonne-boltzmann330-vs-boltzmann115-1000its,856,792,2255.09546089,2216.299305678,64
carcassonne-ucttuned335-vs-ucttuned255-1000its,859,795,2227.290921105,2184.189804111,64
carcassonne-boltzmann165-vs-boltzmann120-1000its,860,796,2209.921097274,2168.703321587,64
carcassonne-ucttuned165-vs-ucttuned445-1000its,860,796,2211.827679992,2143.480978556,64
carcassonne-uct450-vs-uct110-1000its,861,797,2224.744932114,2183.150552588,64
carcassonne-ucttuned480-vs-ucttuned120-1000its,861,797,2186.594550076,2147.824360122,64
carcassonne-ucttuned415-vs-ucttuned425-1000its,864,800,2288.312866668,2223.694083988,64
carcassonne-ucttuned495-vs-ucttuned45-1000its,864,800,2171.335154585,2123.15949455,64
carcassonne-ucttuned105-vs-ucttuned190-1000its,866,802,2123.941418205,2118.842285723,64
carcassonne-boltzmann475-vs-boltzmann190-1000its,868,804,2194.333348015,2179.118530343,64
carcassonne-ucttuned155-vs-ucttuned110-1000its,868,804,2246.165278011,2205.353772773,64
carcassonne-boltzmann450-vs-boltzmann170-1000its,869,805,2198.821088002,2184.467175721,64
carcassonne-ucttuned35-vs-ucttuned70-1000its,869,805,2174.585568888,2153.168466914,64
carcassonne-uct265-vs-uct295-1000its,871,807,2273.404567121,2223.344512376,64
carcassonne-boltzmann215-vs-boltzmann200-1000its,872,808,2142.782212749,2090.415550945,64
carcassonne-boltzmann100-vs-boltzmann300-1000its,874,810,2200.295672805,2160.683241504,64
carcassonne-boltzmann245-vs-boltzmann250-1000its,875,811,2195.656841839,2168.013247278,64
carcassonne-boltzmann280-vs-boltzmann30-1000its,877,813,2185.268222947,2158.256135745,64
carcassonne-boltzmann45-vs-boltzmann425-1000its,877,813,2195.750269089,2137.920930975,64
carcassonne-boltzmann35-vs-boltzmann125-1000its,878,814,2228.937257723,2183.892766045,64
carcassonne-ucttuned310-vs-ucttuned380-1000its,878,814,2212.878813829,2159.348766422,64
carcassonne-ucttuned60-vs-ucttuned85-1000its,878,814,2279.779178476,2210.030140917,64
carcassonne-ucttuned55-vs-ucttuned385-1000its,879,815,2215.927744753,2164.406202517,64
carcassonne-uct100-vs-uct190-1000its,881,817,2216.282429159,2151.857781599,64
carcassonne-uct205-vs-uct420-1000its,881,817,2223.454744148,2153.06678359,64
carcassonne-uct185-vs-uct440-1000its,885,821,2233.156636036,2172.058588723,64
carcassonne-ucttuned200-vs-ucttuned415-1000its,887,823,2142.721325633,2091.798647716,64
carcassonne-uct110-vs-uct145-1000its,892,828,2199.075170542,2144.667695397,64
carcassonne-uct115-vs-uct285-1000its,895,831,2171.181014077,2116.137263922,64
carcassonne-uct370-vs-uct425-1000its,898,834,2262.406602872,2189.194416372,64
carcassonne-uct60-vs-uct310-1000its,899,835,2135.280384433,2085.3872598,64
carcassonne-boltzmann330-vs-boltzmann240-1000its,900,836,2234.989685244,2195.858260233,64
carcassonne-uct320-vs-uct340-1000its,904,840,2252.406778333,2173.455336908,64
carcassonne-boltzmann175-vs-boltzmann65-1000its,905,841,2199.424424937,2159.872508469,64
carcassonne-uct15-vs-uct435-1000its,905,841,2265.028669703,2199.835166805,64
carcassonne-ucttuned210-vs-ucttuned360-1000its,906,842,2234.403127522,2183.501526209,64
carcassonne-ucttuned395-vs-ucttuned140-1000its,907,843,2199.592007989,2127.428799971,64
carcassonne-uct50-vs-uct55-1000its,909,845,2201.478008507,2204.749740702,64
carcassonne-ucttuned80-vs-ucttuned30-1000its,944,880,2198.575060398,2149.264651463,64
carcassonne-ucttuned10-vs-ucttuned170-1000its,947,883,2338.805323863,2243.497763565,64
carcassonne-uct485-vs-uct320-1000its,968,904,2268.313698621,2242.746691726,64
carcassonne-boltzmann490-vs-boltzmann245-1000its,756,691,2178.16463715,2140.781629396,65
carcassonne-uct245-vs-uct290-1000its,761,696,2255.903217439,2163.81679575,65
carcassonne-uct450-vs-uct50-1000its,765,700,2146.513326876,2068.38722474,65
carcassonne-boltzmann75-vs-boltzmann465-1000its,770,705,2195.019054502,2170.230718539,65
carcassonne-boltzmann405-vs-boltzmann200-1000its,772,707,2202.58166326,2146.991438833,65
carcassonne-uct430-vs-uct470-1000its,780,715,2193.508778706,2156.553494571,65
carcassonne-ucttuned85-vs-ucttuned465-1000its,785,720,2189.5501071,2131.78556704,65
carcassonne-boltzmann170-vs-boltzmann425-1000its,786,721,2198.235457342,2188.1725636,65
carcassonne-boltzmann435-vs-boltzmann215-1000its,787,722,2185.313886155,2117.695601452,65
carcassonne-uct170-vs-uct440-1000its,789,724,2270.299190438,2199.428011536,65
carcassonne-boltzmann90-vs-boltzmann300-1000its,790,725,2137.494710844,2101.027746019,65
carcassonne-ucttuned410-vs-ucttuned95-1000its,792,727,2188.225133798,2120.317774495,65
carcassonne-ucttuned390-vs-ucttuned155-1000its,793,728,2288.334613744,2213.901347878,65
carcassonne-uct70-vs-uct305-1000its,796,731,2278.615474929,2219.486263907,65
carcassonne-boltzmann290-vs-boltzmann75-1000its,803,738,2169.103075716,2125.90740776,65
carcassonne-uct465-vs-uct490-1000its,804,739,2200.983660405,2170.587642941,65
carcassonne-boltzmann410-vs-boltzmann115-1000its,805,740,2143.688792234,2120.32556616,65
carcassonne-boltzmann60-vs-boltzmann75-1000its,806,741,2261.604807242,2202.012184697,65
carcassonne-boltzmann325-vs-boltzmann370-1000its,809,744,2200.375478566,2163.923061058,65
carcassonne-uct220-vs-uct120-1000its,809,744,2232.890228598,2130.741117124,65
carcassonne-ucttuned145-vs-ucttuned295-1000its,809,744,2204.039189304,2187.059674028,65
carcassonne-ucttuned10-vs-ucttuned180-1000its,810,745,2193.712604577,2152.970553368,65
carcassonne-boltzmann310-vs-boltzmann165-1000its,811,746,2162.494656901,2136.427548677,65
carcassonne-uct330-vs-uct250-1000its,811,746,2208.110638183,2194.728348064,65
carcassonne-uct160-vs-uct155-1000its,812,747,2254.898172467,2229.034720971,65
carcassonne-boltzmann30-vs-boltzmann320-1000its,813,748,2243.070734525,2180.746389701,65
carcassonne-ucttuned400-vs-ucttuned145-1000its,814,749,2207.311085029,2192.45041196,65
carcassonne-boltzmann250-vs-boltzmann370-1000its,816,751,2138.369796521,2111.934951193,65
carcassonne-boltzmann395-vs-boltzmann310-1000its,816,751,2225.382810413,2132.09330234,65
carcassonne-ucttuned60-vs-ucttuned450-1000its,816,751,2221.334777639,2182.85249446,65
carcassonne-uct390-vs-uct60-1000its,817,752,2307.155675156,2269.308572354,65
carcassonne-boltzmann400-vs-boltzmann50-1000its,818,753,2195.958756627,2121.695240621,65
carcassonne-uct125-vs-uct390-1000its,818,753,2192.287659594,2158.065680974,65
carcassonne-boltzmann430-vs-boltzmann355-1000its,820,755,2175.640775687,2172.982358759,65
carcassonne-uct120-vs-uct465-1000its,820,755,2190.636047899,2185.249213193,65
carcassonne-uct160-vs-uct200-1000its,820,755,2177.314712486,2157.502348274,65
carcassonne-ucttuned250-vs-ucttuned60-1000its,820,755,2253.347056606,2193.7932936,65
carcassonne-uct50-vs-uct390-1000its,821,756,2149.814464263,2134.92525392,65
carcassonne-ucttuned370-vs-ucttuned140-1000its,821,756,2181.294865537,2138.463066293,65
carcassonne-boltzmann265-vs-boltzmann85-1000its,822,757,2191.492831469,2148.195357368,65
carcassonne-boltzmann495-vs-boltzmann35-1000its,822,757,2189.491918374,2173.244073661,65
carcassonne-uct20-vs-uct150-1000its,822,757,2195.890041933,2150.999638084,65
carcassonne-ucttuned160-vs-ucttuned260-1000its,822,757,2238.290300545,2166.405077091,65
carcassonne-ucttuned370-vs-ucttuned325-1000its,823,758,2253.087598994,2240.847999523,65
carcassonne-ucttuned205-vs-ucttuned150-1000its,824,759,2182.490846455,2155.199629933,65
carcassonne-boltzmann5-vs-boltzmann145-1000its,825,760,2143.721470648,2108.994672792,65
carcassonne-boltzmann240-vs-boltzmann40-1000its,826,761,2161.044930001,2087.350182207,65
carcassonne-boltzmann470-vs-boltzmann325-1000its,826,761,2140.863636738,2126.549848769,65
carcassonne-boltzmann250-vs-boltzmann475-1000its,827,762,2160.29876859,2106.906999446,65
carcassonne-boltzmann495-vs-boltzmann260-1000its,828,763,2193.669736357,2161.10924635,65
carcassonne-ucttuned320-vs-ucttuned210-1000its,828,763,2193.209485073,2173.034962225,65
carcassonne-boltzmann45-vs-boltzmann290-1000its,829,764,2198.492047359,2138.907897991,65
carcassonne-boltzmann400-vs-boltzmann420-1000its,830,765,2254.322609698,2199.872517648,65
carcassonne-boltzmann130-vs-boltzmann315-1000its,832,767,2231.831123825,2157.30727687,65
carcassonne-boltzmann440-vs-boltzmann305-1000its,832,767,2160.356094454,2165.259946683,65
carcassonne-uct40-vs-uct290-1000its,832,767,2136.63754165,2126.111497606,65
carcassonne-uct285-vs-uct330-1000its,833,768,2232.109312475,2179.65854318,65
carcassonne-uct415-vs-uct245-1000its,833,768,2211.995420167,2118.878375161,65
carcassonne-boltzmann450-vs-boltzmann180-1000its,835,770,2201.849083205,2157.896321075,65
carcassonne-boltzmann360-vs-boltzmann145-1000its,836,771,2210.485816427,2118.756535432,65
carcassonne-boltzmann450-vs-boltzmann135-1000its,837,772,2124.129681348,2088.602944522,65
carcassonne-ucttuned420-vs-ucttuned435-1000its,837,772,2211.713230369,2168.514075086,65
carcassonne-uct115-vs-uct330-1000its,839,774,2250.684778551,2175.054787737,65
carcassonne-uct265-vs-uct465-1000its,839,774,2179.837614741,2135.331123981,65
carcassonne-uct335-vs-uct355-1000its,840,775,2240.417513399,2188.854533328,65
carcassonne-uct480-vs-uct265-1000its,841,776,2174.075560642,2105.700795092,65
carcassonne-uct280-vs-uct370-1000its,846,781,2123.406855862,2089.781031321,65
carcassonne-uct375-vs-uct165-1000its,847,782,2210.780655894,2162.361182862,65
carcassonne-uct140-vs-uct340-1000its,848,783,2203.444703562,2197.08518967,65
carcassonne-boltzmann495-vs-boltzmann75-1000its,849,784,2229.158966543,2151.995917649,65
carcassonne-uct490-vs-uct220-1000its,849,784,2132.601732018,2108.343758861,65
carcassonne-uct340-vs-uct130-1000its,850,785,2219.885763098,2212.257642638,65
carcassonne-uct60-vs-uct370-1000its,850,785,2165.867593412,2117.611109492,65
carcassonne-boltzmann360-vs-boltzmann130-1000its,852,787,2176.858158464,2137.825863914,65
carcassonne-uct240-vs-uct180-1000its,852,787,2160.526902632,2110.284773947,65
carcassonne-uct205-vs-uct470-1000its,853,788,2252.76894778,2174.699115512,65
carcassonne-ucttuned490-vs-ucttuned450-1000its,853,788,2158.139388717,2091.743646572,65
carcassonne-ucttuned225-vs-ucttuned460-1000its,854,789,2207.138654775,2141.650903929,65
carcassonne-uct155-vs-uct450-1000its,855,790,2172.906297729,2144.80690927,65
carcassonne-boltzmann120-vs-boltzmann270-1000its,856,791,2219.928840937,2169.45600736,65
carcassonne-boltzmann65-vs-boltzmann310-1000its,857,792,2189.630306288,2152.019926859,65
carcassonne-uct180-vs-uct425-1000its,857,792,2131.403611669,2142.786100497,65
carcassonne-boltzmann75-vs-boltzmann445-1000its,858,793,2216.677568847,2142.058456128,65
carcassonne-boltzmann335-vs-boltzmann75-1000its,859,794,2148.128794418,2074.385539213,65
carcassonne-boltzmann210-vs-boltzmann495-1000its,860,795,2214.650483014,2191.722812057,65
carcassonne-uct320-vs-uct480-1000its,860,795,2208.873575948,2167.64199697,65
carcassonne-ucttuned445-vs-ucttuned265-1000its,860,795,2234.164489045,2143.587455322,65
carcassonne-uct20-vs-uct100-1000its,863,798,2196.377054006,2192.171356224,65
carcassonne-boltzmann185-vs-boltzmann30-1000its,865,800,2223.659920851,2194.634094941,65
carcassonne-uct10-vs-uct235-1000its,866,801,2238.689867623,2187.928605535,65
carcassonne-uct285-vs-uct415-1000its,868,803,2129.220835144,2106.69131447,65
carcassonne-uct395-vs-uct140-1000its,869,804,2258.010913743,2192.380844508,65
carcassonne-boltzmann380-vs-boltzmann100-1000its,870,805,2204.565499687,2155.727484049,65
carcassonne-boltzmann430-vs-boltzmann240-1000its,870,805,2194.601490069,2180.807828456,65
carcassonne-boltzmann155-vs-boltzmann105-1000its,873,808,2191.92705615,2163.76428796,65
carcassonne-uct290-vs-uct390-1000its,873,808,2205.967863585,2157.981575264,65
carcassonne-uct490-vs-uct295-1000its,874,809,2137.7648834,2145.49197976,65
carcassonne-ucttuned15-vs-ucttuned375-1000its,874,809,2219.481998562,2152.426318404,65
carcassonne-ucttuned55-vs-ucttuned300-1000its,874,809,2192.299267065,2167.02278885,65
carcassonne-ucttuned345-vs-ucttuned245-1000its,875,810,2161.89353239,2133.107409028,65
carcassonne-ucttuned395-vs-ucttuned355-1000its,875,810,2229.714301551,2210.037771054,65
carcassonne-ucttuned200-vs-ucttuned15-1000its,878,813,2129.686223462,2099.347560548,65
carcassonne-uct215-vs-uct490-1000its,881,816,2171.847993818,2142.768554646,65
carcassonne-uct390-vs-uct420-1000its,881,816,2189.043785705,2153.175264974,65
carcassonne-boltzmann470-vs-boltzmann255-1000its,884,819,2184.720580256,2161.45350397,65
carcassonne-uct5-vs-uct125-1000its,885,820,2132.843028658,2082.220662723,65
carcassonne-uct405-vs-uct70-1000its,886,821,2257.624732075,2213.616069798,65
carcassonne-ucttuned205-vs-ucttuned360-1000its,891,826,2219.34465685,2179.510838783,65
carcassonne-ucttuned25-vs-ucttuned455-1000its,896,831,2282.665147017,2222.547347179,65
carcassonne-ucttuned425-vs-ucttuned295-1000its,898,833,2205.757437495,2128.603885293,65
carcassonne-ucttuned430-vs-ucttuned255-1000its,902,837,2167.184973058,2100.650750251,65
carcassonne-ucttuned340-vs-ucttuned380-1000its,909,844,2184.509370947,2169.255217257,65
carcassonne-uct165-vs-uct295-1000its,916,851,2261.795719393,2203.982529458,65
carcassonne-uct45-vs-uct430-1000its,919,854,2262.36378756,2196.827287276,65
carcassonne-boltzmann225-vs-boltzmann205-1000its,929,864,2218.523904335,2176.27209178,65
carcassonne-ucttuned150-vs-ucttuned255-1000its,950,885,2148.512720768,2117.379951295,65
carcassonne-ucttuned250-vs-ucttuned130-1000its,960,895,2158.629397714,2158.986712504,65
carcassonne-ucttuned485-vs-ucttuned365-1000its,964,899,2206.664769187,2145.67905295,65
carcassonne-ucttuned230-vs-ucttuned170-1000its,725,659,2233.999357044,2191.723180465,66
carcassonne-boltzmann270-vs-boltzmann305-1000its,761,695,2141.891889044,2055.785553695,66
carcassonne-ucttuned240-vs-ucttuned450-1000its,767,701,2290.617296844,2210.459551332,66
carcassonne-boltzmann115-vs-boltzmann450-1000its,771,705,2198.660850966,2123.886606891,66
carcassonne-ucttuned405-vs-ucttuned85-1000its,772,706,2249.94501086,2217.369491249,66
carcassonne-boltzmann15-vs-boltzmann470-1000its,778,712,2131.153306391,2116.685669111,66
carcassonne-boltzmann425-vs-boltzmann60-1000its,778,712,2248.609400567,2206.369346896,66
carcassonne-boltzmann195-vs-boltzmann350-1000its,781,715,2195.705407939,2211.068967874,66
carcassonne-ucttuned205-vs-ucttuned470-1000its,782,716,2204.451819932,2212.905150067,66
carcassonne-ucttuned230-vs-ucttuned410-1000its,786,720,2199.196595185,2173.229397993,66
carcassonne-boltzmann250-vs-boltzmann180-1000its,790,724,2270.245017008,2189.317115431,66
carcassonne-ucttuned110-vs-ucttuned255-1000its,791,725,2175.74113946,2116.646520843,66
carcassonne-boltzmann235-vs-boltzmann445-1000its,792,726,2253.666162993,2160.198241998,66
carcassonne-boltzmann455-vs-boltzmann205-1000its,793,727,2195.225249324,2172.330786601,66
carcassonne-ucttuned430-vs-ucttuned65-1000its,795,729,2224.205285158,2196.691849843,66
carcassonne-boltzmann345-vs-boltzmann120-1000its,796,730,2190.325171921,2150.433474489,66
carcassonne-boltzmann430-vs-boltzmann120-1000its,799,733,2237.27903504,2145.07964433,66
carcassonne-uct20-vs-uct245-1000its,799,733,2197.313414967,2120.955135497,66
carcassonne-uct295-vs-uct310-1000its,799,733,2208.518528616,2162.271284853,66
carcassonne-uct75-vs-uct450-1000its,800,734,2262.822683668,2231.224505793,66
carcassonne-boltzmann25-vs-boltzmann400-1000its,801,735,2208.056563137,2154.324446774,66
carcassonne-ucttuned255-vs-ucttuned385-1000its,801,735,2204.233688817,2196.638143407,66
carcassonne-boltzmann200-vs-boltzmann100-1000its,803,737,2162.306303227,2100.353809068,66
carcassonne-uct135-vs-uct185-1000its,803,737,2247.102421273,2160.316693452,66
carcassonne-ucttuned210-vs-ucttuned475-1000its,805,739,2225.476454458,2199.057696659,66
carcassonne-uct435-vs-uct400-1000its,806,740,2174.51227805,2136.780902585,66
carcassonne-uct365-vs-uct5-1000its,807,741,2187.960595523,2165.371277007,66
carcassonne-boltzmann135-vs-boltzmann325-1000its,808,742,2162.176108311,2125.067870805,66
carcassonne-ucttuned245-vs-ucttuned435-1000its,808,742,2203.17029765,2124.428415851,66
carcassonne-boltzmann450-vs-boltzmann145-1000its,809,743,2234.795597991,2155.712175662,66
carcassonne-boltzmann280-vs-boltzmann305-1000its,810,744,2242.088874519,2138.177344332,66
carcassonne-uct35-vs-uct485-1000its,810,744,2195.365321805,2146.795720293,66
carcassonne-boltzmann200-vs-boltzmann220-1000its,811,745,2290.521550641,2241.208066548,66
carcassonne-uct230-vs-uct240-1000its,812,746,2146.021077259,2115.190874131,66
carcassonne-uct350-vs-uct10-1000its,812,746,2099.954706824,2090.930594012,66
carcassonne-boltzmann40-vs-boltzmann310-1000its,815,749,2177.340922982,2104.652344553,66
carcassonne-ucttuned200-vs-ucttuned435-1000its,815,749,2179.10135689,2092.027253117,66
carcassonne-boltzmann495-vs-boltzmann230-1000its,816,750,2172.211609118,2108.353903212,66
carcassonne-uct45-vs-uct170-1000its,816,750,2215.214576086,2143.063359822,66
carcassonne-ucttuned385-vs-ucttuned160-1000its,816,750,2194.803647733,2130.048585942,66
carcassonne-ucttuned415-vs-ucttuned485-1000its,819,753,2248.301481837,2180.459045395,66
carcassonne-ucttuned110-vs-ucttuned440-1000its,821,755,2165.074042241,2104.455232062,66
carcassonne-uct15-vs-uct60-1000its,822,756,2260.711397653,2206.91223176,66
carcassonne-boltzmann285-vs-boltzmann60-1000its,823,757,2193.429528853,2154.595377882,66
carcassonne-ucttuned135-vs-ucttuned315-1000its,824,758,2280.5023104,2199.597132172,66
carcassonne-ucttuned70-vs-ucttuned275-1000its,826,760,2168.906999885,2127.578139571,66
carcassonne-ucttuned190-vs-ucttuned485-1000its,827,761,2215.095319966,2156.832809046,66
carcassonne-uct25-vs-uct290-1000its,829,763,2182.306719111,2146.739911915,66
carcassonne-uct80-vs-uct85-1000its,829,763,2273.455920518,2237.973989596,66
carcassonne-ucttuned385-vs-ucttuned420-1000its,829,763,2182.515710404,2141.265369936,66
carcassonne-uct120-vs-uct405-1000its,830,764,2147.709295188,2114.045250649,66
carcassonne-boltzmann210-vs-boltzmann285-1000its,831,765,2184.510620296,2176.024076059,66
carcassonne-uct160-vs-uct305-1000its,832,766,2146.397494137,2129.593344854,66
carcassonne-boltzmann270-vs-boltzmann490-1000its,833,767,2175.040537915,2086.16651048,66
carcassonne-ucttuned160-vs-ucttuned300-1000its,833,767,2210.756401787,2196.376694552,66
carcassonne-ucttuned335-vs-ucttuned340-1000its,834,768,2162.973952527,2156.454891351,66
carcassonne-ucttuned355-vs-ucttuned475-1000its,836,770,2244.227898012,2197.934664387,66
carcassonne-ucttuned400-vs-ucttuned225-1000its,836,770,2211.798444998,2152.607623257,66
carcassonne-boltzmann350-vs-boltzmann130-1000its,838,772,2191.347036495,2141.586574323,66
carcassonne-uct470-vs-uct435-1000its,839,773,2164.572183583,2164.147687151,66
carcassonne-uct100-vs-uct45-1000its,840,774,2152.292950581,2176.664313159,66
carcassonne-ucttuned140-vs-ucttuned80-1000its,840,774,2247.026058579,2199.939767156,66
carcassonne-ucttuned265-vs-ucttuned405-1000its,841,775,2213.693717478,2122.982630717,66
carcassonne-ucttuned205-vs-ucttuned110-1000its,842,776,2219.332980162,2175.390482363,66
carcassonne-boltzmann25-vs-boltzmann175-1000its,844,778,2133.398888625,2122.18953187,66
carcassonne-uct10-vs-uct475-1000its,847,781,2252.732142701,2190.360458189,66
carcassonne-uct295-vs-uct290-1000its,847,781,2198.680737678,2180.304051358,66
carcassonne-uct5-vs-uct490-1000its,847,781,2119.785008537,2123.263113868,66
carcassonne-ucttuned195-vs-ucttuned480-1000its,847,781,2234.256855999,2183.270179078,66
carcassonne-uct260-vs-uct75-1000its,850,784,2199.167871296,2122.638318212,66
carcassonne-ucttuned40-vs-ucttuned300-1000its,852,786,2197.403706619,2140.651995246,66
carcassonne-ucttuned495-vs-ucttuned405-1000its,852,786,2215.306661947,2208.367968821,66
carcassonne-uct170-vs-uct325-1000its,853,787,2173.195459619,2127.736406619,66
carcassonne-uct40-vs-uct155-1000its,853,787,2164.95004634,2113.742430301,66
carcassonne-boltzmann380-vs-boltzmann465-1000its,854,788,2162.135248522,2072.098602735,66
carcassonne-boltzmann340-vs-boltzmann475-1000its,855,789,2222.98277778,2160.798983278,66
carcassonne-uct50-vs-uct195-1000its,857,791,2181.800313283,2150.346743759,66
carcassonne-ucttuned15-vs-ucttuned485-1000its,857,791,2165.129372909,2114.986857347,66
carcassonne-boltzmann405-vs-boltzmann310-1000its,858,792,2198.072113407,2150.07940886,66
carcassonne-boltzmann165-vs-boltzmann95-1000its,860,794,2193.364420022,2171.573460688,66
carcassonne-boltzmann55-vs-boltzmann25-1000its,860,794,2205.026006893,2159.308583971,66
carcassonne-uct430-vs-uct340-1000its,860,794,2253.336256084,2248.899172266,66
carcassonne-ucttuned135-vs-ucttuned20-1000its,860,794,2224.159180276,2225.809771065,66
carcassonne-uct190-vs-uct225-1000its,861,795,2121.655644929,2073.75258383,66
carcassonne-uct430-vs-uct485-1000its,861,795,2193.978181006,2133.115056492,66
carcassonne-uct175-vs-uct145-1000its,862,796,2149.127202097,2120.557467311,66
carcassonne-uct275-vs-uct380-1000its,862,796,2207.577980458,2144.224523156,66
carcassonne-ucttuned490-vs-ucttuned255-1000its,862,796,2211.879615258,2200.907107406,66
carcassonne-ucttuned360-vs-ucttuned240-1000its,863,797,2203.749475124,2137.478997014,66
carcassonne-ucttuned350-vs-ucttuned100-1000its,866,800,2278.246532507,2207.911860636,66
carcassonne-uct95-vs-uct320-1000its,867,801,2209.831408509,2131.568750262,66
carcassonne-boltzmann230-vs-boltzmann195-1000its,870,804,2170.766077212,2102.110893013,66
carcassonne-ucttuned205-vs-ucttuned335-1000its,870,804,2191.533977827,2129.489218748,66
carcassonne-ucttuned295-vs-ucttuned90-1000its,871,805,2246.862184466,2197.533435363,66
carcassonne-boltzmann355-vs-boltzmann400-1000its,872,806,2228.511960546,2178.634623021,66
carcassonne-ucttuned330-vs-ucttuned305-1000its,872,806,2149.428843293,2108.568278177,66
carcassonne-boltzmann50-vs-boltzmann125-1000its,875,809,2237.042899022,2182.853274329,66
carcassonne-ucttuned115-vs-ucttuned485-1000its,875,809,2161.754054588,2140.043284391,66
carcassonne-uct195-vs-uct80-1000its,876,810,2179.70771306,2142.825507207,66
carcassonne-ucttuned30-vs-ucttuned20-1000its,876,810,2176.098986632,2141.568698965,66
carcassonne-uct375-vs-uct320-1000its,878,812,2231.526144742,2175.837939248,66
carcassonne-boltzmann200-vs-boltzmann235-1000its,879,813,2171.732167829,2120.939660981,66
carcassonne-uct175-vs-uct250-1000its,879,813,2251.694778968,2231.697555729,66
carcassonne-ucttuned200-vs-ucttuned165-1000its,880,814,2210.970948261,2203.061174974,66
carcassonne-uct180-vs-uct130-1000its,881,815,2183.995130338,2151.960030849,66
carcassonne-uct365-vs-uct190-1000its,885,819,2148.781810406,2109.555620751,66
carcassonne-uct300-vs-uct150-1000its,886,820,2163.009096958,2113.651512807,66
carcassonne-uct315-vs-uct485-1000its,887,821,2188.482464125,2139.726884235,66
carcassonne-uct80-vs-uct225-1000its,887,821,2153.205580028,2140.460284967,66
carcassonne-boltzmann75-vs-boltzmann40-1000its,888,822,2172.344605548,2146.94015117,66
carcassonne-uct35-vs-uct100-1000its,890,824,2205.091590341,2164.441859239,66
carcassonne-ucttuned495-vs-ucttuned185-1000its,890,824,2121.355673826,2086.766945495,66
carcassonne-uct365-vs-uct70-1000its,892,826,2240.54703206,2201.901340823,66
carcassonne-ucttuned125-vs-ucttuned450-1000its,892,826,2269.973353885,2178.453282716,66
carcassonne-uct45-vs-uct485-1000its,893,827,2169.907873587,2105.147322904,66
carcassonne-uct220-vs-uct435-1000its,895,829,2219.96501156,2140.492423122,66
carcassonne-uct305-vs-uct335-1000its,896,830,2182.983194976,2199.58391142,66
carcassonne-uct20-vs-uct360-1000its,900,834,2244.331942229,2157.440988275,66
carcassonne-uct455-vs-uct310-1000its,901,835,2185.742293734,2152.682460888,66
carcassonne-ucttuned450-vs-ucttuned170-1000its,901,835,2204.256147447,2101.546383746,66
carcassonne-uct165-vs-uct35-1000its,902,836,2171.517705202,2146.666565912,66
carcassonne-boltzmann120-vs-boltzmann495-1000its,914,848,2240.443923341,2148.115089127,66
carcassonne-ucttuned30-vs-ucttuned110-1000its,919,853,2181.527148926,2165.315952834,66
carcassonne-ucttuned35-vs-ucttuned165-1000its,932,866,2182.023634557,2094.268411482,66
carcassonne-boltzmann370-vs-boltzmann325-1000its,651,584,1752.402187597,1747.33434077,67
carcassonne-boltzmann310-vs-boltzmann270-1000its,755,688,2200.235138052,2143.79182912,67
carcassonne-uct490-vs-uct480-1000its,765,698,2150.32570511,2097.055263311,67
carcassonne-boltzmann160-vs-boltzmann225-1000its,780,713,2201.151690211,2176.202021594,67
carcassonne-boltzmann110-vs-boltzmann245-1000its,782,715,2166.277413098,2115.820705067,67
carcassonne-ucttuned155-vs-ucttuned300-1000its,783,716,2249.665973505,2160.59598778,67
carcassonne-uct360-vs-uct275-1000its,785,718,2204.280557519,2178.730607871,67
carcassonne-boltzmann170-vs-boltzmann125-1000its,787,720,2310.718495307,2232.697888348,67
carcassonne-boltzmann215-vs-boltzmann150-1000its,789,722,2104.101474969,2069.562745919,67
carcassonne-boltzmann265-vs-boltzmann460-1000its,789,722,2172.389947959,2189.308052586,67
carcassonne-boltzmann240-vs-boltzmann410-1000its,791,724,2198.089136593,2177.092901895,67
carcassonne-boltzmann20-vs-boltzmann460-1000its,793,726,2183.298095541,2148.774519919,67
carcassonne-uct490-vs-uct60-1000its,794,727,2210.07523921,2139.726597116,67
carcassonne-ucttuned160-vs-ucttuned310-1000its,794,727,2233.930028163,2160.130394599,67
carcassonne-ucttuned30-vs-ucttuned470-1000its,799,732,2140.361425596,2070.970514712,67
carcassonne-ucttuned210-vs-ucttuned295-1000its,800,733,2138.599054419,2099.676710594,67
carcassonne-boltzmann225-vs-boltzmann75-1000its,801,734,2174.390716231,2170.474325564,67
carcassonne-boltzmann325-vs-boltzmann165-1000its,801,734,2153.045215107,2115.980110844,67
carcassonne-ucttuned455-vs-ucttuned190-1000its,801,734,2151.499752439,2097.787579894,67
carcassonne-ucttuned205-vs-ucttuned55-1000its,804,737,2179.972413615,2168.057569906,67
carcassonne-ucttuned95-vs-ucttuned385-1000its,804,737,2189.872853109,2141.767178408,67
carcassonne-boltzmann40-vs-boltzmann285-1000its,805,738,2231.214728122,2170.710493282,67
carcassonne-boltzmann5-vs-boltzmann65-1000its,805,738,2146.143648114,2091.016536134,67
carcassonne-boltzmann65-vs-boltzmann80-1000its,805,738,2257.907426868,2188.744849687,67
carcassonne-uct165-vs-uct460-1000its,807,740,2192.586333585,2141.854732544,67
carcassonne-uct70-vs-uct350-1000its,807,740,2187.808906282,2153.477549342,67
carcassonne-ucttuned225-vs-ucttuned155-1000its,808,741,2139.398850438,2187.448211489,67
carcassonne-ucttuned45-vs-ucttuned110-1000its,809,742,2075.484581493,2060.21552485,67
carcassonne-boltzmann345-vs-boltzmann215-1000its,810,743,2148.135442316,2150.442360073,67
carcassonne-ucttuned170-vs-ucttuned330-1000its,810,743,2207.771587774,2169.158066713,67
carcassonne-boltzmann60-vs-boltzmann65-1000its,811,744,2142.911628757,2140.151791316,67
carcassonne-boltzmann245-vs-boltzmann375-1000its,815,748,2249.403247408,2170.281976211,67
carcassonne-boltzmann160-vs-boltzmann75-1000its,817,750,2255.743394519,2206.105100712,67
carcassonne-uct330-vs-uct60-1000its,817,750,2210.950795329,2145.638349961,67
carcassonne-ucttuned230-vs-ucttuned295-1000its,818,751,2230.791708199,2193.745477599,67
carcassonne-ucttuned60-vs-ucttuned290-1000its,820,753,2260.88623882,2203.03962046,67
carcassonne-uct490-vs-uct195-1000its,821,754,2149.796905313,2132.42156309,67
carcassonne-ucttuned490-vs-ucttuned240-1000its,821,754,2129.715616509,2063.361379229,67
carcassonne-uct110-vs-uct235-1000its,822,755,2254.876351389,2228.591382969,67
carcassonne-ucttuned440-vs-ucttuned225-1000its,823,756,2187.718907168,2145.264920427,67
carcassonne-boltzmann280-vs-boltzmann95-1000its,824,757,2320.800085009,2242.243886327,67
carcassonne-ucttuned255-vs-ucttuned155-1000its,826,759,2203.490541274,2188.310097149,67
carcassonne-ucttuned305-vs-ucttuned450-1000its,826,759,2180.561579147,2149.288289546,67
carcassonne-ucttuned145-vs-ucttuned235-1000its,828,761,2249.658128746,2187.62277017,67
carcassonne-boltzmann310-vs-boltzmann155-1000its,829,762,2207.173521327,2176.910716516,67
carcassonne-uct80-vs-uct430-1000its,830,763,2230.671622371,2163.018865349,67
carcassonne-uct370-vs-uct15-1000its,833,766,2187.271106093,2138.06135946,67
carcassonne-ucttuned95-vs-ucttuned100-1000its,833,766,2185.999528973,2144.587176868,67
carcassonne-uct440-vs-uct70-1000its,835,768,2277.639945065,2221.058985603,67
carcassonne-ucttuned135-vs-ucttuned170-1000its,836,769,2237.995798918,2170.188739275,67
carcassonne-boltzmann180-vs-boltzmann305-1000its,837,770,2185.348830492,2103.761193488,67
carcassonne-boltzmann105-vs-boltzmann150-1000its,838,771,2263.646333771,2205.376020624,67
carcassonne-boltzmann120-vs-boltzmann335-1000its,838,771,2130.557839259,2102.410551238,67
carcassonne-uct230-vs-uct410-1000its,839,772,2162.05621556,2118.09906487,67
carcassonne-ucttuned330-vs-ucttuned70-1000its,839,772,2265.951830098,2216.549000302,67
carcassonne-boltzmann225-vs-boltzmann260-1000its,841,774,2157.21898165,2087.569735461,67
carcassonne-ucttuned100-vs-ucttuned105-1000its,841,774,2250.497894118,2219.426677373,67
carcassonne-boltzmann370-vs-boltzmann125-1000its,842,775,2123.771120239,2105.980418816,67
carcassonne-ucttuned120-vs-ucttuned310-1000its,845,778,2212.916798982,2180.249023708,67
carcassonne-uct170-vs-uct40-1000its,846,779,2120.829924666,2097.673289753,67
carcassonne-ucttuned270-vs-ucttuned105-1000its,847,780,2208.747222239,2156.364296653,67
carcassonne-boltzmann100-vs-boltzmann290-1000its,849,782,2223.310369533,2209.522122561,67
carcassonne-ucttuned420-vs-ucttuned495-1000its,849,782,2199.569308025,2171.181862675,67
carcassonne-boltzmann440-vs-boltzmann430-1000its,850,783,2205.064211378,2182.114826264,67
carcassonne-boltzmann45-vs-boltzmann200-1000its,850,783,2237.390151534,2201.405237851,67
carcassonne-uct25-vs-uct235-1000its,850,783,2181.853537401,2124.974466035,67
carcassonne-uct260-vs-uct295-1000its,850,783,2218.804563646,2168.89489218,67
carcassonne-ucttuned290-vs-ucttuned410-1000its,850,783,2166.17440881,2130.965715489,67
carcassonne-boltzmann35-vs-boltzmann385-1000its,851,784,2165.272628888,2135.577730864,67
carcassonne-ucttuned25-vs-ucttuned135-1000its,851,784,2162.921538693,2109.111188502,67
carcassonne-ucttuned55-vs-ucttuned245-1000its,851,784,2182.793999052,2155.230448842,67
carcassonne-uct100-vs-uct430-1000its,855,788,2165.724534203,2099.703762444,67
carcassonne-ucttuned255-vs-ucttuned340-1000its,856,789,2213.764952194,2179.046137893,67
carcassonne-boltzmann345-vs-boltzmann365-1000its,858,791,2254.440044871,2234.322155595,67
carcassonne-uct365-vs-uct120-1000its,859,792,2262.054220877,2219.057323011,67
carcassonne-ucttuned270-vs-ucttuned300-1000its,859,792,2188.703751514,2140.022195773,67
carcassonne-ucttuned170-vs-ucttuned450-1000its,860,793,2235.420371697,2176.074088711,67
carcassonne-uct400-vs-uct455-1000its,861,794,2207.813390155,2166.86188808,67
carcassonne-uct480-vs-uct395-1000its,862,795,2220.939705604,2166.786906929,67
carcassonne-ucttuned380-vs-ucttuned435-1000its,866,799,2216.79922998,2191.296917972,67
carcassonne-uct215-vs-uct465-1000its,872,805,2206.406863117,2200.912842275,67
carcassonne-ucttuned30-vs-ucttuned90-1000its,872,805,2234.282651564,2198.248809079,67
carcassonne-uct180-vs-uct150-1000its,874,807,2230.462212682,2173.414719612,67
carcassonne-ucttuned30-vs-ucttuned145-1000its,875,808,2128.883098243,2092.389684859,67
carcassonne-ucttuned455-vs-ucttuned140-1000its,875,808,2184.440070372,2137.326436022,67
carcassonne-boltzmann175-vs-boltzmann215-1000its,877,810,2219.959171156,2190.724276385,67
carcassonne-boltzmann215-vs-boltzmann35-1000its,877,810,2196.091479433,2151.362224133,67
carcassonne-ucttuned235-vs-ucttuned100-1000its,877,810,2181.298274588,2162.152320421,67
carcassonne-ucttuned40-vs-ucttuned160-1000its,877,810,2228.997089559,2204.55818136,67
carcassonne-boltzmann410-vs-boltzmann190-1000its,878,811,2164.224367518,2119.879477132,67
carcassonne-uct455-vs-uct25-1000its,878,811,2233.095247938,2216.576711366,67
carcassonne-ucttuned40-vs-ucttuned215-1000its,878,811,2172.477834809,2129.291821304,67
carcassonne-boltzmann330-vs-boltzmann100-1000its,884,817,2213.436331465,2141.7089174,67
carcassonne-uct245-vs-uct250-1000its,887,820,2253.93549267,2178.245084125,67
carcassonne-ucttuned30-vs-ucttuned295-1000its,892,825,2201.166877956,2172.090917981,67
carcassonne-ucttuned375-vs-ucttuned180-1000its,892,825,2192.426199118,2158.633390747,67
carcassonne-uct415-vs-uct85-1000its,893,826,2201.158216669,2148.607069459,67
carcassonne-ucttuned65-vs-ucttuned475-1000its,894,827,2174.429484504,2084.642210473,67
carcassonne-boltzmann145-vs-boltzmann30-1000its,896,829,2153.014894352,2145.625007971,67
carcassonne-uct35-vs-uct355-1000its,899,832,2191.9649132,2145.407783905,67
carcassonne-uct395-vs-uct490-1000its,899,832,2220.683735509,2163.023880091,67
carcassonne-uct30-vs-uct405-1000its,904,837,2175.46048991,2128.574763928,67
carcassonne-boltzmann75-vs-boltzmann260-1000its,913,846,2230.491908953,2184.079005531,67
carcassonne-uct370-vs-uct415-1000its,913,846,2157.81871807,2103.654426561,67
carcassonne-ucttuned170-vs-ucttuned195-1000its,915,848,2253.540581629,2208.974527298,67
carcassonne-ucttuned105-vs-ucttuned20-1000its,916,849,2225.08192911,2124.46408966,67
carcassonne-boltzmann370-vs-boltzmann185-1000its,920,853,2263.706574385,2197.927933271,67
carcassonne-boltzmann5-vs-boltzmann425-1000its,927,860,2224.435128826,2174.634347775,67
carcassonne-boltzmann215-vs-boltzmann55-1000its,933,866,2203.607108098,2173.52660641,67
carcassonne-ucttuned455-vs-ucttuned260-1000its,945,878,2267.806585278,2208.051902067,67
carcassonne-uct55-vs-uct445-1000its,961,894,2216.292218771,2175.427634629,67
carcassonne-boltzmann470-vs-boltzmann460-1000its,722,654,1743.549169818,1765.11356307,68
carcassonne-boltzmann115-vs-boltzmann370-1000its,745,677,2281.870575302,2227.807956059,68
carcassonne-boltzmann445-vs-boltzmann215-1000its,751,683,2253.111511462,2231.658734668,68
carcassonne-boltzmann490-vs-boltzmann155-1000its,760,692,2158.71395735,2099.174594234,68
carcassonne-uct120-vs-uct195-1000its,765,697,2219.302260521,2217.283460184,68
carcassonne-boltzmann305-vs-boltzmann335-1000its,768,700,2254.324661353,2207.330764067,68
carcassonne-boltzmann415-vs-boltzmann300-1000its,769,701,2180.31067825,2173.019805087,68
carcassonne-uct275-vs-uct135-1000its,783,715,2204.406297772,2125.616761452,68
carcassonne-ucttuned110-vs-ucttuned285-1000its,783,715,2246.729766244,2229.499707824,68
carcassonne-uct340-vs-uct245-1000its,784,716,2121.532908887,2125.949840803,68
carcassonne-boltzmann45-vs-boltzmann255-1000its,788,720,2215.03955199,2176.57808984,68
carcassonne-boltzmann405-vs-boltzmann340-1000its,789,721,2195.321705405,2157.237557779,68
carcassonne-ucttuned40-vs-ucttuned325-1000its,792,724,2198.264753444,2129.451121746,68
carcassonne-boltzmann65-vs-boltzmann180-1000its,796,728,2238.004298659,2162.910905321,68
carcassonne-ucttuned440-vs-ucttuned430-1000its,796,728,2262.276898097,2214.785299664,68
carcassonne-uct300-vs-uct145-1000its,799,731,2170.966825533,2131.266197606,68
carcassonne-boltzmann410-vs-boltzmann270-1000its,803,735,2185.004802493,2133.619018701,68
carcassonne-boltzmann175-vs-boltzmann330-1000its,805,737,2225.573833171,2203.431423942,68
carcassonne-ucttuned265-vs-ucttuned205-1000its,808,740,2193.032868036,2160.831277433,68
carcassonne-ucttuned185-vs-ucttuned260-1000its,809,741,2169.013001685,2138.749255014,68
carcassonne-boltzmann175-vs-boltzmann195-1000its,811,743,2177.508036475,2109.872646691,68
carcassonne-ucttuned45-vs-ucttuned395-1000its,813,745,2198.700183718,2149.064195373,68
carcassonne-boltzmann240-vs-boltzmann255-1000its,814,746,2211.259028997,2136.808972023,68
carcassonne-ucttuned125-vs-ucttuned80-1000its,814,746,2220.634391808,2168.253723245,68
carcassonne-uct45-vs-uct320-1000its,815,747,2152.097888061,2117.143006394,68
carcassonne-uct85-vs-uct450-1000its,815,747,2175.182388391,2162.234960372,68
carcassonne-uct485-vs-uct295-1000its,817,749,2195.018874525,2151.070793943,68
carcassonne-uct240-vs-uct255-1000its,820,752,2289.214746785,2211.861601887,68
carcassonne-boltzmann360-vs-boltzmann175-1000its,821,753,2216.454732951,2146.834128528,68
carcassonne-boltzmann85-vs-boltzmann275-1000its,823,755,2267.365736637,2215.63145469,68
carcassonne-boltzmann415-vs-boltzmann320-1000its,826,758,2173.849519423,2171.352838894,68
carcassonne-uct135-vs-uct90-1000its,827,759,2125.370922783,2101.986136438,68
carcassonne-ucttuned320-vs-ucttuned395-1000its,830,762,2138.090203413,2110.266461591,68
carcassonne-boltzmann450-vs-boltzmann125-1000its,831,763,2177.560514021,2153.313833438,68
carcassonne-boltzmann15-vs-boltzmann215-1000its,834,766,2158.302506954,2127.275571724,68
carcassonne-boltzmann300-vs-boltzmann335-1000its,834,766,2217.530532955,2192.023864237,68
carcassonne-boltzmann305-vs-boltzmann175-1000its,834,766,2190.245769182,2150.41304154,68
carcassonne-ucttuned335-vs-ucttuned170-1000its,834,766,2237.15128443,2169.113181707,68
carcassonne-uct410-vs-uct380-1000its,835,767,2149.989543178,2085.292098115,68
carcassonne-ucttuned460-vs-ucttuned445-1000its,835,767,2164.968933861,2151.09259554,68
carcassonne-uct135-vs-uct410-1000its,836,768,2142.749680223,2151.269937685,68
carcassonne-ucttuned85-vs-ucttuned75-1000its,837,769,2212.400839264,2169.587145357,68
carcassonne-uct180-vs-uct60-1000its,840,772,2198.505411264,2153.198467479,68
carcassonne-uct455-vs-uct355-1000its,840,772,2203.648127265,2162.347655217,68
carcassonne-uct80-vs-uct330-1000its,841,773,2164.38019364,2119.111728717,68
carcassonne-boltzmann365-vs-boltzmann30-1000its,842,774,2175.557103908,2190.994239967,68
carcassonne-boltzmann95-vs-boltzmann375-1000its,842,774,2097.669680228,2082.644004966,68
carcassonne-boltzmann235-vs-boltzmann310-1000its,843,775,2216.398442712,2257.136038219,68
carcassonne-uct60-vs-uct305-1000its,843,775,2221.549894871,2183.241973149,68
carcassonne-ucttuned320-vs-ucttuned265-1000its,843,775,2184.878092034,2140.219811964,68
carcassonne-ucttuned415-vs-ucttuned115-1000its,844,776,2150.337903471,2070.267062508,68
carcassonne-uct85-vs-uct205-1000its,845,777,2310.201676223,2258.109077736,68
carcassonne-ucttuned90-vs-ucttuned300-1000its,845,777,2148.745843825,2119.662037717,68
carcassonne-ucttuned340-vs-ucttuned275-1000its,846,778,2223.622837249,2234.696195696,68
carcassonne-boltzmann15-vs-boltzmann350-1000its,847,779,2236.574378387,2163.585110942,68
carcassonne-uct350-vs-uct210-1000its,848,780,2139.628473935,2089.461859921,68
carcassonne-uct495-vs-uct450-1000its,848,780,2277.811967106,2221.311855899,68
carcassonne-ucttuned110-vs-ucttuned400-1000its,848,780,2182.292875346,2113.920827565,68
carcassonne-boltzmann330-vs-boltzmann370-1000its,851,783,2178.332551513,2138.759288998,68
carcassonne-uct450-vs-uct205-1000its,851,783,2183.990738798,2123.170045651,68
carcassonne-uct65-vs-uct125-1000its,851,783,2200.750436582,2154.784801616,68
carcassonne-boltzmann115-vs-boltzmann345-1000its,852,784,2186.146984941,2144.864467237,68
carcassonne-boltzmann415-vs-boltzmann490-1000its,852,784,2151.021299356,2101.4318094,68
carcassonne-uct480-vs-uct135-1000its,852,784,2230.329281666,2214.169068616,68
carcassonne-ucttuned25-vs-ucttuned420-1000its,852,784,2218.989760228,2183.666661079,68
carcassonne-uct275-vs-uct170-1000its,853,785,2178.672138873,2164.024611607,68
carcassonne-uct200-vs-uct85-1000its,855,787,2146.163052612,2132.694648682,68
carcassonne-ucttuned210-vs-ucttuned95-1000its,855,787,2185.098254885,2146.909106949,68
carcassonne-ucttuned175-vs-ucttuned270-1000its,856,788,2181.138186225,2141.793376686,68
carcassonne-boltzmann450-vs-boltzmann5-1000its,857,789,2199.248517568,2207.066879376,68
carcassonne-ucttuned150-vs-ucttuned50-1000its,858,790,2190.616247213,2152.894109835,68
carcassonne-ucttuned85-vs-ucttuned250-1000its,858,790,2273.741593717,2236.617141841,68
carcassonne-ucttuned240-vs-ucttuned230-1000its,859,791,2208.198708368,2152.420484303,68
carcassonne-ucttuned205-vs-ucttuned60-1000its,860,792,2234.324967628,2165.197290121,68
carcassonne-uct155-vs-uct35-1000its,861,793,2265.042755547,2263.192033359,68
carcassonne-uct245-vs-uct10-1000its,861,793,2174.71204777,2129.087089527,68
carcassonne-uct450-vs-uct230-1000its,862,794,2188.956624066,2202.581942349,68
carcassonne-boltzmann130-vs-boltzmann370-1000its,863,795,2198.833172953,2163.128301987,68
carcassonne-uct125-vs-uct345-1000its,863,795,2286.734308106,2225.444215915,68
carcassonne-uct30-vs-uct35-1000its,863,795,2202.237469997,2083.473513321,68
carcassonne-ucttuned490-vs-ucttuned375-1000its,864,796,2219.643973989,2181.40038428,68
carcassonne-boltzmann285-vs-boltzmann295-1000its,865,797,2207.778655988,2143.273056791,68
carcassonne-uct320-vs-uct30-1000its,865,797,2255.523271374,2228.846564542,68
carcassonne-ucttuned5-vs-ucttuned450-1000its,866,798,2169.791292045,2151.446880806,68
carcassonne-uct125-vs-uct320-1000its,869,801,2163.181671954,2139.87327157,68
carcassonne-ucttuned120-vs-ucttuned340-1000its,871,803,2157.731158322,2107.109024167,68
carcassonne-boltzmann405-vs-boltzmann25-1000its,873,805,2249.355151169,2213.606259588,68
carcassonne-uct80-vs-uct50-1000its,873,805,2179.771566754,2101.686304855,68
carcassonne-boltzmann340-vs-boltzmann325-1000its,875,807,2204.003828865,2154.686595311,68
carcassonne-uct115-vs-uct130-1000its,876,808,2238.8545143,2203.818120593,68
carcassonne-ucttuned150-vs-ucttuned395-1000its,877,809,2190.377226362,2109.642506088,68
carcassonne-ucttuned170-vs-ucttuned335-1000its,879,811,2176.663478808,2132.725891038,68
carcassonne-uct15-vs-uct125-1000its,881,813,2288.622635175,2227.353385448,68
carcassonne-ucttuned90-vs-ucttuned415-1000its,881,813,2154.052831907,2129.273364644,68
carcassonne-boltzmann185-vs-boltzmann345-1000its,886,818,2206.50657025,2118.524496619,68
carcassonne-ucttuned120-vs-ucttuned95-1000its,891,823,2165.9434961,2095.305076823,68
carcassonne-ucttuned100-vs-ucttuned155-1000its,893,825,2283.399301193,2252.41041876,68
carcassonne-ucttuned480-vs-ucttuned160-1000its,893,825,2183.532658228,2177.153647163,68
carcassonne-uct370-vs-uct115-1000its,894,826,2170.620602605,2102.985913963,68
carcassonne-boltzmann445-vs-boltzmann130-1000its,896,828,2268.666714397,2188.300433453,68
carcassonne-boltzmann355-vs-boltzmann270-1000its,898,830,2193.495107526,2117.024693353,68
carcassonne-uct180-vs-uct350-1000its,902,834,2219.060629802,2151.433320785,68
carcassonne-boltzmann225-vs-boltzmann5-1000its,904,836,2286.251756878,2253.058397161,68
carcassonne-uct120-vs-uct270-1000its,908,840,2185.560842747,2136.38983232,68
carcassonne-ucttuned320-vs-ucttuned230-1000its,909,841,2198.280968624,2164.982790876,68
carcassonne-uct410-vs-uct185-1000its,915,847,2222.744119607,2135.058076876,68
carcassonne-ucttuned435-vs-ucttuned190-1000its,915,847,2258.388501662,2213.975027034,68
carcassonne-boltzmann430-vs-boltzmann115-1000its,917,849,2236.785535034,2247.71487617,68
carcassonne-boltzmann315-vs-boltzmann85-1000its,919,851,2225.284121221,2195.634004066,68
carcassonne-uct35-vs-uct225-1000its,919,851,2081.990459143,2033.765521519,68
carcassonne-uct340-vs-uct100-1000its,923,855,2205.172040389,2158.27514428,68
carcassonne-uct345-vs-uct20-1000its,926,858,2232.650871882,2139.391062328,68
carcassonne-uct160-vs-uct490-1000its,930,862,2208.452603008,2186.039276419,68
carcassonne-uct305-vs-uct455-1000its,931,863,2247.006226459,2196.515365219,68
carcassonne-uct220-vs-uct60-1000its,933,865,2166.833734533,2145.713292605,68
carcassonne-uct120-vs-uct305-1000its,946,878,2199.223615671,2203.074315464,68
carcassonne-uct220-vs-uct95-1000its,749,680,2193.526106476,2151.222534239,69
carcassonne-boltzmann410-vs-boltzmann340-1000its,751,682,2194.05073967,2154.276363954,69
carcassonne-uct360-vs-uct140-1000its,771,702,2213.307736534,2154.749098173,69
carcassonne-uct380-vs-uct355-1000its,775,706,2184.189316639,2164.980297613,69
carcassonne-boltzmann410-vs-boltzmann440-1000its,778,709,2168.009746158,2137.196392008,69
carcassonne-uct140-vs-uct320-1000its,778,709,2163.0618245,2138.524754281,69
carcassonne-uct160-vs-uct455-1000its,786,717,2181.419601683,2101.961138641,69
carcassonne-ucttuned465-vs-ucttuned400-1000its,789,720,2271.188047925,2225.826096702,69
carcassonne-uct395-vs-uct60-1000its,790,721,2162.332716635,2168.260874273,69
carcassonne-ucttuned440-vs-ucttuned200-1000its,794,725,2093.180854944,2062.574985704,69
carcassonne-boltzmann285-vs-boltzmann300-1000its,795,726,2185.537598216,2152.217934177,69
carcassonne-ucttuned450-vs-ucttuned425-1000its,795,726,2219.783086283,2233.521624236,69
carcassonne-uct180-vs-uct250-1000its,796,727,2234.902356988,2175.552582137,69
carcassonne-ucttuned200-vs-ucttuned490-1000its,796,727,2122.434828048,2078.184902975,69
carcassonne-boltzmann405-vs-boltzmann85-1000its,802,733,2140.1259829,2116.120206823,69
carcassonne-ucttuned425-vs-ucttuned135-1000its,802,733,2180.513201161,2127.515194765,69
carcassonne-ucttuned470-vs-ucttuned300-1000its,802,733,2177.830261223,2126.36888228,69
carcassonne-boltzmann150-vs-boltzmann315-1000its,804,735,2202.394107763,2135.837933425,69
carcassonne-uct60-vs-uct425-1000its,806,737,2241.259222298,2194.149096161,69
carcassonne-ucttuned30-vs-ucttuned195-1000its,806,737,2183.150662049,2190.333234691,69
carcassonne-uct280-vs-uct275-1000its,809,740,2203.478915332,2181.011213826,69
carcassonne-uct165-vs-uct170-1000its,810,741,2147.08435473,2119.554465816,69
carcassonne-uct440-vs-uct100-1000its,810,741,2141.851815385,2099.602896358,69
carcassonne-ucttuned255-vs-ucttuned475-1000its,810,741,2192.605590278,2133.660597993,69
carcassonne-boltzmann415-vs-boltzmann50-1000its,811,742,2270.303139889,2234.66601325,69
carcassonne-boltzmann450-vs-boltzmann275-1000its,812,743,2198.686139479,2184.137272743,69
carcassonne-uct65-vs-uct410-1000its,812,743,2188.262944703,2172.967264934,69
carcassonne-ucttuned360-vs-ucttuned460-1000its,812,743,2225.548496669,2221.913803949,69
carcassonne-boltzmann250-vs-boltzmann260-1000its,813,744,2206.83063873,2176.727226357,69
carcassonne-uct125-vs-uct400-1000its,813,744,2270.490334672,2227.367904469,69
carcassonne-boltzmann250-vs-boltzmann455-1000its,815,746,2152.033917868,2098.726517364,69
carcassonne-uct160-vs-uct215-1000its,816,747,2206.530567625,2193.651229858,69
carcassonne-boltzmann110-vs-boltzmann365-1000its,820,751,2177.332196028,2103.166860793,69
carcassonne-boltzmann5-vs-boltzmann375-1000its,821,752,2202.552170804,2138.512025236,69
carcassonne-ucttuned100-vs-ucttuned255-1000its,823,754,2213.162115439,2192.356090822,69
carcassonne-ucttuned450-vs-ucttuned265-1000its,826,757,2186.376776459,2122.798853325,69
carcassonne-uct310-vs-uct270-1000its,828,759,2289.517840692,2185.121148031,69
carcassonne-uct470-vs-uct490-1000its,829,760,2236.298858881,2171.460616062,69
carcassonne-boltzmann495-vs-boltzmann320-1000its,832,763,2300.499235215,2215.342978269,69
carcassonne-ucttuned190-vs-ucttuned275-1000its,832,763,2120.208041283,2128.631469419,69
carcassonne-uct130-vs-uct190-1000its,834,765,2149.266326671,2064.18076302,69
carcassonne-uct185-vs-uct175-1000its,834,765,2206.275112451,2120.896629737,69
carcassonne-boltzmann390-vs-boltzmann310-1000its,835,766,2166.816902285,2116.713286298,69
carcassonne-ucttuned425-vs-ucttuned20-1000its,838,769,2157.686480863,2100.474643127,69
carcassonne-uct490-vs-uct80-1000its,839,770,2186.202597198,2147.152212707,69
carcassonne-uct125-vs-uct300-1000its,840,771,2208.565872371,2133.202548165,69
carcassonne-uct435-vs-uct40-1000its,840,771,2209.353377742,2160.760073511,69
carcassonne-boltzmann425-vs-boltzmann475-1000its,841,772,2187.652481071,2137.030919501,69
carcassonne-boltzmann160-vs-boltzmann95-1000its,842,773,2265.412335523,2230.590280175,69
carcassonne-uct345-vs-uct50-1000its,842,773,2135.196441743,2078.775901169,69
carcassonne-ucttuned355-vs-ucttuned50-1000its,844,775,2184.835813986,2114.941596727,69
carcassonne-uct30-vs-uct450-1000its,845,776,2237.063919981,2226.081105451,69
carcassonne-boltzmann355-vs-boltzmann20-1000its,846,777,2186.34241931,2162.558641267,69
carcassonne-uct485-vs-uct435-1000its,846,777,2152.769443328,2141.738139836,69
carcassonne-ucttuned490-vs-ucttuned205-1000its,846,777,2237.674870353,2132.558362175,69
carcassonne-ucttuned415-vs-ucttuned325-1000its,847,778,2165.648959852,2157.474277712,69
carcassonne-boltzmann130-vs-boltzmann240-1000its,849,780,2141.934770748,2118.307460303,69
carcassonne-uct495-vs-uct195-1000its,850,781,2198.071870282,2166.902490977,69
carcassonne-boltzmann45-vs-boltzmann105-1000its,852,783,2181.99763741,2158.614179853,69
carcassonne-boltzmann490-vs-boltzmann485-1000its,852,783,2262.945875732,2245.464929708,69
carcassonne-uct220-vs-uct275-1000its,852,783,2235.430933817,2200.424495887,69
carcassonne-uct360-vs-uct5-1000its,852,783,2172.112845621,2164.65655077,69
carcassonne-uct110-vs-uct445-1000its,853,784,2165.598578879,2163.309743197,69
carcassonne-uct75-vs-uct225-1000its,855,786,2275.41212934,2217.297709639,69
carcassonne-ucttuned395-vs-ucttuned125-1000its,855,786,2253.309472467,2221.87139857,69
carcassonne-boltzmann220-vs-boltzmann15-1000its,856,787,2185.65022352,2134.991375552,69
carcassonne-uct345-vs-uct60-1000its,856,787,2224.667897406,2185.534896795,69
carcassonne-ucttuned320-vs-ucttuned335-1000its,856,787,2228.531708337,2182.58920159,69
carcassonne-boltzmann10-vs-boltzmann370-1000its,857,788,2198.816459707,2103.015431023,69
carcassonne-boltzmann205-vs-boltzmann230-1000its,858,789,2193.180306673,2164.870429931,69
carcassonne-boltzmann300-vs-boltzmann100-1000its,858,789,2191.32232735,2199.674439656,69
carcassonne-ucttuned240-vs-ucttuned20-1000its,858,789,2275.661666259,2243.11203127,69
carcassonne-boltzmann75-vs-boltzmann475-1000its,859,790,2234.95785011,2173.247176673,69
carcassonne-boltzmann90-vs-boltzmann120-1000its,859,790,2225.986504499,2160.479552792,69
carcassonne-boltzmann295-vs-boltzmann55-1000its,860,791,2248.659466395,2183.743109361,69
carcassonne-boltzmann315-vs-boltzmann490-1000its,861,792,2188.445963004,2126.090284337,69
carcassonne-ucttuned320-vs-ucttuned490-1000its,862,793,2170.210156302,2139.732930412,69
carcassonne-boltzmann380-vs-boltzmann55-1000its,863,794,2210.297478157,2141.256442905,69
carcassonne-uct70-vs-uct225-1000its,863,794,2256.641460807,2184.784094321,69
carcassonne-ucttuned80-vs-ucttuned425-1000its,864,795,2163.376441447,2130.210183356,69
carcassonne-boltzmann155-vs-boltzmann220-1000its,865,796,2225.503461753,2200.029067577,69
carcassonne-ucttuned10-vs-ucttuned95-1000its,865,796,2167.162928822,2122.661999836,69
carcassonne-uct220-vs-uct370-1000its,866,797,2247.162078757,2173.95492607,69
carcassonne-uct175-vs-uct360-1000its,867,798,2248.357579104,2209.737477695,69
carcassonne-ucttuned400-vs-ucttuned40-1000its,867,798,2197.580923129,2154.401811582,69
carcassonne-boltzmann85-vs-boltzmann290-1000its,870,801,2162.422698691,2161.12761242,69
carcassonne-ucttuned45-vs-ucttuned215-1000its,870,801,2248.470770394,2247.220571449,69
carcassonne-ucttuned490-vs-ucttuned110-1000its,871,802,2140.430544037,2129.163003997,69
carcassonne-uct325-vs-uct175-1000its,872,803,2153.082754005,2135.605377029,69
carcassonne-ucttuned460-vs-ucttuned65-1000its,872,803,2141.694501113,2124.785900764,69
carcassonne-uct45-vs-uct105-1000its,876,807,2246.686345771,2168.87308164,69
carcassonne-ucttuned60-vs-ucttuned125-1000its,876,807,2179.775674757,2163.846212691,69
carcassonne-boltzmann430-vs-boltzmann340-1000its,877,808,2197.559741015,2158.062401555,69
carcassonne-uct55-vs-uct100-1000its,877,808,2195.185352241,2171.905372856,69
carcassonne-boltzmann165-vs-boltzmann80-1000its,878,809,2158.457037909,2101.456061898,69
carcassonne-ucttuned35-vs-ucttuned275-1000its,879,810,2259.027123785,2162.377496208,69
carcassonne-boltzmann420-vs-boltzmann200-1000its,881,812,2177.373511095,2166.065124788,69
carcassonne-uct230-vs-uct310-1000its,881,812,2182.550320118,2135.028175734,69
carcassonne-ucttuned275-vs-ucttuned180-1000its,882,813,2207.795229182,2146.341078106,69
carcassonne-ucttuned65-vs-ucttuned330-1000its,882,813,2139.540395717,2115.744100845,69
carcassonne-ucttuned440-vs-ucttuned160-1000its,885,816,2242.061897112,2210.281773727,69
carcassonne-ucttuned325-vs-ucttuned455-1000its,886,817,2176.144817477,2146.866612739,69
carcassonne-boltzmann305-vs-boltzmann70-1000its,888,819,2233.03814201,2185.684132273,69
carcassonne-uct55-vs-uct310-1000its,888,819,2154.045729585,2098.698713212,69
carcassonne-ucttuned490-vs-ucttuned20-1000its,889,820,2183.935899967,2176.209041941,69
carcassonne-ucttuned370-vs-ucttuned295-1000its,892,823,2215.362766919,2184.551245637,69
carcassonne-uct270-vs-uct300-1000its,901,832,2154.944370759,2083.887256318,69
carcassonne-ucttuned240-vs-ucttuned180-1000its,901,832,2154.906529844,2085.532605555,69
carcassonne-ucttuned335-vs-ucttuned260-1000its,907,838,2167.069804557,2132.970185102,69
carcassonne-boltzmann15-vs-boltzmann425-1000its,910,841,2244.325437286,2207.14652868,69
carcassonne-uct50-vs-uct30-1000its,910,841,2221.399719726,2182.145462077,69
carcassonne-boltzmann70-vs-boltzmann365-1000its,917,848,2187.493196739,2079.293651496,69
carcassonne-uct415-vs-uct210-1000its,945,876,2272.48143264,2244.993893897,69
carcassonne-boltzmann215-vs-boltzmann235-1000its,951,882,2234.839411287,2208.566160513,69
carcassonne-boltzmann285-vs-boltzmann180-1000its,965,896,2223.514494071,2144.569730075,69
carcassonne-uct325-vs-uct480-1000its,762,692,2219.938556114,2202.627837672,70
carcassonne-boltzmann175-vs-boltzmann250-1000its,777,707,2099.02571943,2061.0729501,70
carcassonne-uct395-vs-uct325-1000its,777,707,2241.48814156,2232.193608533,70
carcassonne-ucttuned270-vs-ucttuned410-1000its,782,712,2166.136358326,2099.641895346,70
carcassonne-ucttuned105-vs-ucttuned230-1000its,783,713,2340.367028712,2277.413758038,70
carcassonne-boltzmann185-vs-boltzmann280-1000its,786,716,2198.024746781,2172.704463459,70
carcassonne-ucttuned305-vs-ucttuned110-1000its,787,717,2204.352653276,2171.272340817,70
carcassonne-uct340-vs-uct310-1000its,789,719,2225.328513378,2216.492687103,70
carcassonne-boltzmann40-vs-boltzmann55-1000its,793,723,2143.147477688,2122.79958881,70
carcassonne-boltzmann85-vs-boltzmann410-1000its,793,723,2238.511806791,2224.403047771,70
carcassonne-ucttuned320-vs-ucttuned45-1000its,793,723,2146.719493756,2135.15320077,70
carcassonne-boltzmann135-vs-boltzmann195-1000its,794,724,2244.714932422,2240.959335147,70
carcassonne-boltzmann315-vs-boltzmann420-1000its,794,724,2258.694262457,2210.261707059,70
carcassonne-boltzmann375-vs-boltzmann170-1000its,796,726,2204.456712483,2141.775684067,70
carcassonne-ucttuned50-vs-ucttuned350-1000its,797,727,2170.672689104,2144.646059583,70
carcassonne-boltzmann160-vs-boltzmann240-1000its,798,728,2214.119127027,2201.760612959,70
carcassonne-boltzmann70-vs-boltzmann160-1000its,800,730,2165.70363978,2135.720352126,70
carcassonne-ucttuned400-vs-ucttuned95-1000its,801,731,2241.113455838,2152.543060548,70
carcassonne-boltzmann360-vs-boltzmann220-1000its,804,734,2178.72310925,2153.616447683,70
carcassonne-uct50-vs-uct315-1000its,806,736,2198.453935596,2131.477582574,70
carcassonne-ucttuned395-vs-ucttuned495-1000its,806,736,2176.041792889,2115.600261511,70
carcassonne-boltzmann295-vs-boltzmann180-1000its,810,740,2269.716541121,2222.97857267,70
carcassonne-ucttuned275-vs-ucttuned425-1000its,810,740,2199.401433035,2180.020017168,70
carcassonne-boltzmann180-vs-boltzmann190-1000its,811,741,2134.514722271,2122.73180962,70
carcassonne-boltzmann290-vs-boltzmann485-1000its,811,741,2161.875093039,2106.431383598,70
carcassonne-ucttuned485-vs-ucttuned250-1000its,811,741,2201.659070013,2133.650740473,70
carcassonne-ucttuned180-vs-ucttuned135-1000its,812,742,2214.207899658,2134.382609707,70
carcassonne-boltzmann200-vs-boltzmann430-1000its,813,743,2235.864620324,2212.201567516,70
carcassonne-boltzmann290-vs-boltzmann170-1000its,813,743,2283.164443935,2226.383838969,70
carcassonne-boltzmann95-vs-boltzmann370-1000its,813,743,2143.24461112,2102.25967733,70
carcassonne-boltzmann235-vs-boltzmann350-1000its,814,744,2164.707168329,2187.100292556,70
carcassonne-ucttuned10-vs-ucttuned210-1000its,814,744,2215.492078249,2157.49448061,70
carcassonne-boltzmann10-vs-boltzmann120-1000its,815,745,2139.96916981,2081.541631035,70
carcassonne-ucttuned300-vs-ucttuned140-1000its,815,745,2234.360851723,2164.372148807,70
carcassonne-ucttuned465-vs-ucttuned305-1000its,815,745,2181.06272904,2131.212571618,70
carcassonne-uct260-vs-uct390-1000its,817,747,2186.98093432,2131.742193081,70
carcassonne-uct310-vs-uct165-1000its,817,747,2175.531972119,2114.28585668,70
carcassonne-boltzmann375-vs-boltzmann495-1000its,818,748,2304.908623033,2239.478189223,70
carcassonne-uct55-vs-uct20-1000its,818,748,2206.62914106,2104.238947003,70
carcassonne-uct410-vs-uct205-1000its,819,749,2155.639407503,2135.516813379,70
carcassonne-ucttuned215-vs-ucttuned450-1000its,819,749,2146.469781112,2107.735338437,70
carcassonne-boltzmann270-vs-boltzmann360-1000its,820,750,2163.083397104,2117.789597009,70
carcassonne-boltzmann390-vs-boltzmann210-1000its,820,750,2165.465236713,2123.449963378,70
carcassonne-uct170-vs-uct240-1000its,820,750,2162.964618289,2130.163709337,70
carcassonne-uct230-vs-uct365-1000its,822,752,2277.266015205,2232.57438852,70
carcassonne-uct25-vs-uct295-1000its,822,752,2165.807666454,2106.476056062,70
carcassonne-boltzmann315-vs-boltzmann200-1000its,823,753,2161.382750193,2122.600566223,70
carcassonne-uct80-vs-uct435-1000its,823,753,2175.265191932,2121.282545974,70
carcassonne-uct260-vs-uct65-1000its,824,754,2146.232946936,2144.840943127,70
carcassonne-boltzmann210-vs-boltzmann195-1000its,825,755,2226.384213856,2167.866337877,70
carcassonne-boltzmann485-vs-boltzmann115-1000its,825,755,2193.887642052,2169.238400686,70
carcassonne-ucttuned330-vs-ucttuned245-1000its,825,755,2216.581046848,2132.895231371,70
carcassonne-ucttuned470-vs-ucttuned25-1000its,826,756,2175.971199389,2100.450532107,70
carcassonne-boltzmann485-vs-boltzmann490-1000its,827,757,2181.437238315,2165.732288868,70
carcassonne-ucttuned190-vs-ucttuned280-1000its,827,757,2228.402067779,2229.971702997,70
carcassonne-uct280-vs-uct310-1000its,828,758,2158.325667435,2125.477562328,70
carcassonne-uct275-vs-uct140-1000its,829,759,2178.29417083,2123.546483917,70
carcassonne-ucttuned225-vs-ucttuned70-1000its,830,760,2131.927902368,2123.676091365,70
carcassonne-ucttuned445-vs-ucttuned140-1000its,831,761,2225.815496169,2187.638567779,70
carcassonne-boltzmann45-vs-boltzmann35-1000its,834,764,2215.646469151,2164.723834665,70
carcassonne-boltzmann470-vs-boltzmann55-1000its,835,765,2178.622602763,2148.465264886,70
carcassonne-uct495-vs-uct420-1000its,835,765,2226.36134713,2186.807652174,70
carcassonne-ucttuned75-vs-ucttuned435-1000its,835,765,2146.822040334,2131.656126933,70
carcassonne-boltzmann230-vs-boltzmann130-1000its,837,767,2234.641747035,2223.510064104,70
carcassonne-uct255-vs-uct35-1000its,838,768,2229.14261974,2160.07624855,70
carcassonne-uct495-vs-uct300-1000its,838,768,2245.203361839,2154.591605063,70
carcassonne-boltzmann160-vs-boltzmann450-1000its,839,769,2224.78139577,2169.059114427,70
carcassonne-ucttuned475-vs-ucttuned310-1000its,839,769,2214.810079055,2147.805960137,70
carcassonne-ucttuned25-vs-ucttuned410-1000its,840,770,2203.992450049,2172.324065059,70
carcassonne-boltzmann250-vs-boltzmann200-1000its,841,771,2153.344202529,2104.283832468,70
carcassonne-boltzmann65-vs-boltzmann275-1000its,841,771,2190.349817748,2150.189461782,70
carcassonne-boltzmann255-vs-boltzmann195-1000its,842,772,2238.432061975,2124.983563137,70
carcassonne-uct180-vs-uct355-1000its,843,773,2180.667110521,2157.893051715,70
carcassonne-uct475-vs-uct155-1000its,843,773,2157.92952149,2131.025317879,70
carcassonne-boltzmann300-vs-boltzmann55-1000its,845,775,2216.368946301,2182.210981539,70
carcassonne-uct125-vs-uct15-1000its,846,776,2121.284299179,2122.115433025,70
carcassonne-boltzmann100-vs-boltzmann335-1000its,847,777,2220.046718673,2187.930820968,70
carcassonne-uct40-vs-uct45-1000its,848,778,2182.986672573,2160.200863798,70
carcassonne-uct5-vs-uct50-1000its,848,778,2203.297552805,2145.476179026,70
carcassonne-boltzmann305-vs-boltzmann350-1000its,849,779,2211.278602605,2159.994153706,70
carcassonne-uct170-vs-uct60-1000its,850,780,2325.027214709,2308.331830767,70
carcassonne-uct80-vs-uct95-1000its,850,780,2278.372214654,2201.867011787,70
carcassonne-ucttuned445-vs-ucttuned40-1000its,852,782,2209.327428385,2174.518768075,70
carcassonne-uct305-vs-uct165-1000its,853,783,2185.891091287,2134.801255857,70
carcassonne-uct450-vs-uct140-1000its,853,783,2145.916297958,2117.290013158,70
carcassonne-ucttuned280-vs-ucttuned105-1000its,854,784,2232.912521923,2149.7714308,70
carcassonne-ucttuned50-vs-ucttuned95-1000its,855,785,2160.437093035,2071.761187818,70
carcassonne-boltzmann230-vs-boltzmann220-1000its,857,787,2194.447474017,2155.468880959,70
carcassonne-boltzmann55-vs-boltzmann120-1000its,857,787,2209.69492004,2119.716150638,70
carcassonne-boltzmann285-vs-boltzmann310-1000its,860,790,2221.103728961,2177.264784488,70
carcassonne-uct300-vs-uct355-1000its,860,790,2225.683103099,2174.684789774,70
carcassonne-uct455-vs-uct65-1000its,860,790,2199.373522568,2242.196732638,70
carcassonne-ucttuned75-vs-ucttuned95-1000its,860,790,2280.318019963,2220.983180348,70
carcassonne-ucttuned115-vs-ucttuned425-1000its,864,794,2191.613388914,2145.962758922,70
carcassonne-boltzmann155-vs-boltzmann490-1000its,865,795,2175.395070372,2130.669737789,70
carcassonne-boltzmann325-vs-boltzmann130-1000its,866,796,2200.536928084,2177.690691528,70
carcassonne-uct25-vs-uct165-1000its,866,796,2173.276553883,2143.293564098,70
carcassonne-ucttuned50-vs-ucttuned340-1000its,866,796,2323.037437997,2272.14646193,70
carcassonne-ucttuned60-vs-ucttuned220-1000its,867,797,2222.494723042,2185.567201928,70
carcassonne-ucttuned200-vs-ucttuned220-1000its,868,798,2174.163347419,2057.50867348,70
carcassonne-ucttuned475-vs-ucttuned465-1000its,868,798,2164.854964091,2164.887501883,70
carcassonne-uct200-vs-uct255-1000its,870,800,2215.97740903,2166.864683472,70
carcassonne-uct15-vs-uct440-1000its,871,801,2208.965540779,2180.258860297,70
carcassonne-ucttuned290-vs-ucttuned470-1000its,871,801,2161.510357933,2171.853252344,70
carcassonne-boltzmann310-vs-boltzmann410-1000its,872,802,2140.840529162,2081.142404105,70
carcassonne-ucttuned25-vs-ucttuned155-1000its,872,802,2183.661718151,2135.599613374,70
carcassonne-boltzmann290-vs-boltzmann415-1000its,873,803,2161.326430365,2148.314916885,70
carcassonne-uct200-vs-uct495-1000its,874,804,2168.985770089,2145.080527959,70
carcassonne-uct15-vs-uct75-1000its,875,805,2213.468970273,2128.526859453,70
carcassonne-ucttuned135-vs-ucttuned10-1000its,876,806,2227.045946313,2207.42350137,70
carcassonne-boltzmann245-vs-boltzmann420-1000its,877,807,2191.231662583,2118.280328495,70
carcassonne-uct255-vs-uct370-1000its,877,807,2173.492160046,2124.209260308,70
carcassonne-ucttuned395-vs-ucttuned345-1000its,877,807,2261.3395027,2184.494651402,70
carcassonne-boltzmann125-vs-boltzmann20-1000its,878,808,2224.42875245,2186.189083542,70
carcassonne-boltzmann75-vs-boltzmann175-1000its,879,809,2229.901430537,2181.049252186,70
carcassonne-uct495-vs-uct220-1000its,880,810,2253.087458057,2249.380871505,70
carcassonne-boltzmann170-vs-boltzmann20-1000its,881,811,2203.615544877,2137.20750134,70
carcassonne-uct175-vs-uct395-1000its,881,811,2260.474479944,2224.062546169,70
carcassonne-ucttuned45-vs-ucttuned150-1000its,881,811,2276.628242886,2200.433733322,70
carcassonne-uct130-vs-uct205-1000its,884,814,2263.56315422,2245.668226142,70
carcassonne-uct25-vs-uct445-1000its,884,814,2148.681063439,2116.492159596,70
carcassonne-ucttuned440-vs-ucttuned325-1000its,884,814,2187.958069686,2164.804721954,70
carcassonne-uct145-vs-uct60-1000its,885,815,2173.440801836,2183.3459168,70
carcassonne-uct95-vs-uct485-1000its,888,818,2175.39683666,2173.468306596,70
carcassonne-ucttuned225-vs-ucttuned490-1000its,892,822,2210.897137477,2178.238739929,70
carcassonne-ucttuned300-vs-ucttuned25-1000its,892,822,2116.496513732,2090.385183145,70
carcassonne-ucttuned40-vs-ucttuned65-1000its,893,823,2181.446549327,2064.026307337,70
carcassonne-ucttuned35-vs-ucttuned375-1000its,894,824,2172.506278121,2104.786688082,70
carcassonne-uct355-vs-uct175-1000its,896,826,2138.200421473,2085.09812749,70
carcassonne-ucttuned470-vs-ucttuned105-1000its,897,827,2279.713315172,2223.584163524,70
carcassonne-ucttuned220-vs-ucttuned455-1000its,900,830,2160.735749907,2149.259766371,70
carcassonne-ucttuned45-vs-ucttuned245-1000its,901,831,2224.298894025,2173.479601233,70
carcassonne-uct245-vs-uct495-1000its,906,836,2199.947675576,2139.30087742,70
carcassonne-ucttuned140-vs-ucttuned360-1000its,909,839,2228.128220691,2201.677812305,70
carcassonne-ucttuned275-vs-ucttuned240-1000its,910,840,2215.682188768,2154.024607864,70
carcassonne-ucttuned30-vs-ucttuned130-1000its,918,848,2133.695373811,2138.084777097,70
carcassonne-ucttuned75-vs-ucttuned330-1000its,918,848,2123.952515889,2035.933377075,70
carcassonne-ucttuned220-vs-ucttuned425-1000its,928,858,2198.698665091,2112.283499933,70
carcassonne-boltzmann285-vs-boltzmann330-1000its,930,860,2221.800321837,2161.932174337,70
carcassonne-uct220-vs-uct465-1000its,946,876,2287.958917014,2216.962327664,70
carcassonne-boltzmann270-vs-boltzmann390-1000its,784,713,2186.776602886,2131.131652,71
carcassonne-uct120-vs-uct395-1000its,786,715,2256.495605204,2230.584924371,71
carcassonne-ucttuned110-vs-ucttuned420-1000its,786,715,2168.900827231,2134.148399226,71
carcassonne-ucttuned330-vs-ucttuned55-1000its,789,718,2170.247367333,2118.674191109,71
carcassonne-boltzmann230-vs-boltzmann430-1000its,793,722,2217.358541889,2240.337512277,71
carcassonne-ucttuned335-vs-ucttuned200-1000its,796,725,2167.819788231,2115.984786779,71
carcassonne-boltzmann340-vs-boltzmann390-1000its,797,726,2255.389522927,2173.646189454,71
carcassonne-boltzmann350-vs-boltzmann290-1000its,798,727,2291.735248701,2210.20658586,71
carcassonne-ucttuned485-vs-ucttuned60-1000its,798,727,2263.685369227,2191.894927398,71
carcassonne-ucttuned275-vs-ucttuned445-1000its,799,728,2188.90112718,2127.675501534,71
carcassonne-boltzmann170-vs-boltzmann365-1000its,801,730,2267.743078781,2186.944678091,71
carcassonne-boltzmann15-vs-boltzmann155-1000its,805,734,2254.362442007,2216.867839415,71
carcassonne-boltzmann305-vs-boltzmann360-1000its,805,734,2178.072909715,2128.476983026,71
carcassonne-boltzmann375-vs-boltzmann380-1000its,805,734,2180.017755673,2132.856899451,71
carcassonne-boltzmann385-vs-boltzmann240-1000its,805,734,2211.798635223,2152.369699006,71
carcassonne-uct470-vs-uct460-1000its,806,735,2176.348638228,2154.151903314,71
carcassonne-boltzmann300-vs-boltzmann245-1000its,807,736,2261.422458804,2246.125570022,71
carcassonne-ucttuned445-vs-ucttuned405-1000its,807,736,2149.371124728,2141.745883625,71
carcassonne-boltzmann325-vs-boltzmann455-1000its,808,737,2173.535916031,2130.483600174,71
carcassonne-ucttuned370-vs-ucttuned285-1000its,808,737,2241.331027005,2187.762249044,71
carcassonne-boltzmann350-vs-boltzmann335-1000its,809,738,2234.985841693,2179.385882338,71
carcassonne-boltzmann415-vs-boltzmann260-1000its,810,739,2198.958205552,2164.360674721,71
carcassonne-uct425-vs-uct200-1000its,812,741,2166.627296336,2110.435394735,71
carcassonne-boltzmann335-vs-boltzmann365-1000its,814,743,2306.283196046,2269.726705034,71
carcassonne-boltzmann385-vs-boltzmann330-1000its,814,743,2249.941937359,2193.746716245,71
carcassonne-boltzmann95-vs-boltzmann10-1000its,814,743,2199.682748736,2165.221931366,71
carcassonne-uct220-vs-uct170-1000its,815,744,2210.294756157,2171.129690462,71
carcassonne-ucttuned395-vs-ucttuned485-1000its,815,744,2206.801996226,2133.883104017,71
carcassonne-boltzmann315-vs-boltzmann205-1000its,820,749,2176.069117259,2126.185432708,71
carcassonne-ucttuned200-vs-ucttuned475-1000its,820,749,2221.162400039,2169.291173255,71
carcassonne-boltzmann10-vs-boltzmann105-1000its,821,750,2191.994797467,2124.905689019,71
carcassonne-uct210-vs-uct265-1000its,821,750,2218.802221322,2222.947235582,71
carcassonne-boltzmann170-vs-boltzmann250-1000its,822,751,2180.921689519,2149.977443836,71
carcassonne-boltzmann335-vs-boltzmann405-1000its,823,752,2284.0559613,2242.900810154,71
carcassonne-ucttuned70-vs-ucttuned330-1000its,823,752,2193.756431752,2162.28822833,71
carcassonne-boltzmann275-vs-boltzmann195-1000its,824,753,2146.345397795,2084.750573932,71
carcassonne-ucttuned440-vs-ucttuned450-1000its,824,753,2147.207382605,2081.151645811,71
carcassonne-uct180-vs-uct475-1000its,827,756,2225.226627891,2207.524291493,71
carcassonne-uct445-vs-uct220-1000its,827,756,2178.220056411,2133.394847509,71
carcassonne-boltzmann435-vs-boltzmann170-1000its,828,757,2179.231595927,2171.623905639,71
carcassonne-ucttuned260-vs-ucttuned250-1000its,829,758,2186.438832135,2128.287147394,71
carcassonne-uct225-vs-uct265-1000its,831,760,2169.627180584,2120.951595656,71
carcassonne-boltzmann20-vs-boltzmann350-1000its,832,761,2181.490320166,2147.190053828,71
carcassonne-uct60-vs-uct85-1000its,832,761,2237.084068768,2159.596924571,71
carcassonne-boltzmann380-vs-boltzmann260-1000its,833,762,2216.64606784,2150.957506763,71
carcassonne-uct75-vs-uct5-1000its,833,762,2244.117901746,2205.938319971,71
carcassonne-ucttuned120-vs-ucttuned155-1000its,833,762,2245.053809474,2214.594649553,71
carcassonne-boltzmann155-vs-boltzmann120-1000its,835,764,2144.096605168,2093.347279703,71
carcassonne-boltzmann435-vs-boltzmann485-1000its,835,764,2107.511236398,2067.372706721,71
carcassonne-ucttuned285-vs-ucttuned325-1000its,835,764,2221.528390399,2180.024539533,71
carcassonne-boltzmann165-vs-boltzmann245-1000its,837,766,2182.499184992,2155.271202304,71
carcassonne-uct420-vs-uct45-1000its,837,766,2145.119726832,2088.588864827,71
carcassonne-ucttuned430-vs-ucttuned60-1000its,838,767,2221.902131106,2182.783293207,71
carcassonne-boltzmann60-vs-boltzmann195-1000its,839,768,2194.705033306,2116.369161752,71
carcassonne-boltzmann475-vs-boltzmann210-1000its,840,769,2227.755301944,2164.159101444,71
carcassonne-boltzmann260-vs-boltzmann250-1000its,841,770,2214.751254376,2175.132265072,71
carcassonne-boltzmann100-vs-boltzmann45-1000its,844,773,2231.169777718,2183.409136839,71
carcassonne-boltzmann135-vs-boltzmann265-1000its,844,773,2177.583585928,2139.905045492,71
carcassonne-boltzmann145-vs-boltzmann370-1000its,847,776,2199.666330985,2174.754283671,71
carcassonne-uct195-vs-uct400-1000its,847,776,2237.606799377,2183.139963226,71
carcassonne-uct265-vs-uct195-1000its,847,776,2190.360121685,2151.46319927,71
carcassonne-boltzmann450-vs-boltzmann55-1000its,849,778,2183.477402154,2138.180625831,71
carcassonne-boltzmann20-vs-boltzmann280-1000its,851,780,2239.642172649,2176.833988441,71
carcassonne-uct145-vs-uct215-1000its,851,780,2144.449344551,2104.259049064,71
carcassonne-uct470-vs-uct455-1000its,851,780,2194.842981968,2145.661107951,71
carcassonne-ucttuned375-vs-ucttuned90-1000its,851,780,2241.367638254,2165.538821798,71
carcassonne-ucttuned50-vs-ucttuned65-1000its,851,780,2170.848772165,2079.285495139,71
carcassonne-boltzmann265-vs-boltzmann435-1000its,852,781,2231.574593543,2169.084904489,71
carcassonne-boltzmann85-vs-boltzmann350-1000its,853,782,2193.30856277,2176.534992102,71
carcassonne-ucttuned210-vs-ucttuned380-1000its,854,783,2208.843839562,2162.624006797,71
carcassonne-ucttuned300-vs-ucttuned385-1000its,854,783,2190.257102449,2180.698295991,71
carcassonne-boltzmann430-vs-boltzmann235-1000its,856,785,2142.503440974,2157.018136951,71
carcassonne-ucttuned35-vs-ucttuned340-1000its,856,785,2344.010834827,2236.770645925,71
carcassonne-ucttuned95-vs-ucttuned5-1000its,856,785,2214.347461428,2118.686407982,71
carcassonne-boltzmann15-vs-boltzmann45-1000its,857,786,2272.313026704,2215.663828185,71
carcassonne-uct385-vs-uct495-1000its,858,787,2143.136679255,2128.108080864,71
carcassonne-ucttuned370-vs-ucttuned110-1000its,860,789,2146.964225881,2071.659406004,71
carcassonne-uct275-vs-uct415-1000its,861,790,2139.438195924,2089.306689184,71
carcassonne-uct260-vs-uct205-1000its,862,791,2253.071129199,2198.658526354,71
carcassonne-boltzmann200-vs-boltzmann155-1000its,865,794,2264.544555655,2202.998106556,71
carcassonne-ucttuned320-vs-ucttuned245-1000its,865,794,2173.187317941,2101.743377148,71
carcassonne-ucttuned140-vs-ucttuned330-1000its,868,797,2114.840983038,2105.172452596,71
carcassonne-uct35-vs-uct30-1000its,870,799,2167.050653889,2092.420836749,71
carcassonne-ucttuned80-vs-ucttuned475-1000its,872,801,2179.924929815,2120.535436664,71
carcassonne-ucttuned330-vs-ucttuned285-1000its,874,803,2231.713354865,2168.357220876,71
carcassonne-boltzmann110-vs-boltzmann100-1000its,877,806,2172.990568818,2123.120970824,71
carcassonne-uct105-vs-uct405-1000its,879,808,2236.483624801,2187.418245377,71
carcassonne-uct105-vs-uct115-1000its,881,810,2241.155271314,2134.762960575,71
carcassonne-boltzmann165-vs-boltzmann360-1000its,882,811,2172.897577412,2103.374308268,71
carcassonne-uct375-vs-uct270-1000its,883,812,2127.851120502,2130.41545207,71
carcassonne-boltzmann165-vs-boltzmann130-1000its,884,813,2192.368575714,2142.259221867,71
carcassonne-boltzmann305-vs-boltzmann130-1000its,884,813,2344.99430647,2274.230051714,71
carcassonne-boltzmann445-vs-boltzmann265-1000its,885,814,2187.308168022,2138.825117521,71
carcassonne-boltzmann345-vs-boltzmann430-1000its,886,815,2148.905867391,2111.065514167,71
carcassonne-ucttuned190-vs-ucttuned205-1000its,888,817,2250.086205899,2214.163041393,71
carcassonne-boltzmann205-vs-boltzmann495-1000its,890,819,2191.726153847,2084.709033496,71
carcassonne-boltzmann90-vs-boltzmann290-1000its,892,821,2253.534219519,2232.046505419,71
carcassonne-boltzmann85-vs-boltzmann240-1000its,893,822,2154.159346177,2101.276312861,71
carcassonne-boltzmann440-vs-boltzmann340-1000its,894,823,2228.26285138,2173.798052732,71
carcassonne-ucttuned25-vs-ucttuned210-1000its,895,824,2308.185534001,2283.838939067,71
carcassonne-ucttuned450-vs-ucttuned235-1000its,903,832,2177.270181479,2156.190798778,71
carcassonne-boltzmann255-vs-boltzmann200-1000its,907,836,2216.79055072,2177.407583408,71
carcassonne-ucttuned55-vs-ucttuned390-1000its,909,838,2184.892730314,2144.437030577,71
carcassonne-ucttuned165-vs-ucttuned315-1000its,914,843,2164.215069467,2137.021735623,71
carcassonne-boltzmann30-vs-boltzmann380-1000its,918,847,2210.898272287,2154.921177057,71
carcassonne-ucttuned125-vs-ucttuned335-1000its,918,847,2261.02333223,2202.993136107,71
carcassonne-ucttuned50-vs-ucttuned320-1000its,918,847,2209.234154931,2105.233600241,71
carcassonne-uct125-vs-uct315-1000its,921,850,2162.998237199,2137.302996981,71
carcassonne-ucttuned110-vs-ucttuned370-1000its,921,850,2185.398145708,2175.096848305,71
carcassonne-uct175-vs-uct425-1000its,923,852,2237.951930113,2205.275138166,71
carcassonne-boltzmann10-vs-boltzmann440-1000its,925,854,2254.011055038,2185.068752883,71
carcassonne-uct10-vs-uct215-1000its,937,866,2138.640726591,2081.984957014,71
carcassonne-uct135-vs-uct280-1000its,961,890,2130.447082382,2091.160440636,71
carcassonne-ucttuned225-vs-ucttuned30-1000its,701,629,1724.032761935,1694.193786801,72
carcassonne-boltzmann420-vs-boltzmann50-1000its,768,696,2193.577396785,2190.387290845,72
carcassonne-boltzmann170-vs-boltzmann315-1000its,777,705,2220.703901195,2145.219534291,72
carcassonne-boltzmann35-vs-boltzmann165-1000its,777,705,2182.79050652,2161.772153413,72
carcassonne-boltzmann10-vs-boltzmann455-1000its,779,707,2135.618200931,2085.128260377,72
carcassonne-boltzmann75-vs-boltzmann355-1000its,784,712,2227.727670031,2210.760702555,72
carcassonne-boltzmann165-vs-boltzmann365-1000its,788,716,2169.48140018,2115.164416356,72
carcassonne-uct400-vs-uct90-1000its,788,716,2147.114786906,2152.220362098,72
carcassonne-ucttuned250-vs-ucttuned100-1000its,791,719,2170.670581085,2126.415729228,72
carcassonne-boltzmann140-vs-boltzmann240-1000its,793,721,2178.712087465,2142.093093232,72
carcassonne-uct10-vs-uct365-1000its,801,729,2204.07872674,2163.834980252,72
carcassonne-boltzmann65-vs-boltzmann325-1000its,804,732,2186.864636696,2106.95886272,72
carcassonne-boltzmann215-vs-boltzmann470-1000its,805,733,2172.093229437,2151.102606358,72
carcassonne-boltzmann390-vs-boltzmann385-1000its,808,736,2158.535366898,2172.028057171,72
carcassonne-boltzmann370-vs-boltzmann255-1000its,809,737,2245.478546882,2213.045908284,72
carcassonne-ucttuned290-vs-ucttuned235-1000its,809,737,2208.865022901,2178.996964642,72
carcassonne-ucttuned45-vs-ucttuned355-1000its,810,738,2162.829721329,2119.766455046,72
carcassonne-uct455-vs-uct340-1000its,811,739,2140.431079931,2128.258108256,72
carcassonne-uct440-vs-uct225-1000its,813,741,2154.991701445,2123.581428126,72
carcassonne-ucttuned190-vs-ucttuned335-1000its,815,743,2216.26199108,2186.796574461,72
carcassonne-uct465-vs-uct220-1000its,816,744,2153.904762056,2107.29875696,72
carcassonne-ucttuned335-vs-ucttuned425-1000its,816,744,2222.390477841,2173.298463487,72
carcassonne-uct110-vs-uct380-1000its,817,745,2218.859244198,2178.697775299,72
carcassonne-uct205-vs-uct360-1000its,817,745,2130.265728925,2080.269221077,72
carcassonne-boltzmann280-vs-boltzmann25-1000its,823,751,2171.454770305,2131.222477034,72
carcassonne-ucttuned100-vs-ucttuned430-1000its,824,752,2146.425999754,2094.831038787,72
carcassonne-uct145-vs-uct370-1000its,826,754,2208.69376926,2131.522758218,72
carcassonne-uct415-vs-uct80-1000its,826,754,2188.139016793,2134.464443392,72
carcassonne-ucttuned75-vs-ucttuned205-1000its,832,760,2196.300169833,2107.944214438,72
carcassonne-ucttuned365-vs-ucttuned220-1000its,833,761,2157.220694404,2118.110840953,72
carcassonne-uct170-vs-uct445-1000its,835,763,2163.027900964,2087.941188342,72
carcassonne-ucttuned155-vs-ucttuned480-1000its,835,763,2236.334051788,2192.026985591,72
carcassonne-uct180-vs-uct305-1000its,837,765,2202.291588348,2172.938897145,72
carcassonne-uct230-vs-uct200-1000its,838,766,2192.910259938,2123.492054604,72
carcassonne-ucttuned295-vs-ucttuned465-1000its,838,766,2340.262197637,2309.058549272,72
carcassonne-boltzmann235-vs-boltzmann175-1000its,839,767,2240.683504313,2157.367304888,72
carcassonne-uct280-vs-uct340-1000its,839,767,2189.426680774,2129.989631963,72
carcassonne-boltzmann205-vs-boltzmann300-1000its,841,769,2200.501682423,2174.069849879,72
carcassonne-uct25-vs-uct390-1000its,842,770,2232.811996549,2160.009038128,72
carcassonne-ucttuned210-vs-ucttuned170-1000its,842,770,2150.964023287,2099.048190992,72
carcassonne-ucttuned240-vs-ucttuned265-1000its,842,770,2197.961468273,2188.357787473,72
carcassonne-boltzmann355-vs-boltzmann435-1000its,843,771,2128.395998148,2090.318667697,72
carcassonne-uct165-vs-uct405-1000its,843,771,2156.448980382,2163.438954844,72
carcassonne-uct25-vs-uct120-1000its,844,772,2209.623096843,2158.910584619,72
carcassonne-ucttuned350-vs-ucttuned295-1000its,846,774,2144.799811328,2114.633509511,72
carcassonne-uct105-vs-uct270-1000its,847,775,2215.363537606,2152.587022246,72
carcassonne-uct450-vs-uct360-1000its,847,775,2236.261084015,2203.42574293,72
carcassonne-ucttuned65-vs-ucttuned55-1000its,849,777,2248.934128767,2175.852427092,72
carcassonne-uct395-vs-uct270-1000its,850,778,2159.346513259,2141.162157874,72
carcassonne-uct40-vs-uct120-1000its,851,779,2197.639194979,2147.098387437,72
carcassonne-boltzmann455-vs-boltzmann215-1000its,853,781,2154.589925124,2133.787824171,72
carcassonne-uct105-vs-uct275-1000its,853,781,2205.425555663,2153.635201408,72
carcassonne-uct315-vs-uct280-1000its,853,781,2207.337651533,2229.436870101,72
carcassonne-ucttuned445-vs-ucttuned295-1000its,853,781,2239.281481835,2186.957729949,72
carcassonne-boltzmann415-vs-boltzmann355-1000its,854,782,2161.257394378,2107.102107007,72
carcassonne-uct355-vs-uct330-1000its,854,782,2103.767741298,2092.730636417,72
carcassonne-boltzmann485-vs-boltzmann450-1000its,858,786,2227.195400978,2185.588200036,72
carcassonne-uct325-vs-uct65-1000its,858,786,2201.182217801,2128.460923659,72
carcassonne-uct125-vs-uct255-1000its,859,787,2217.629295212,2216.998318864,72
carcassonne-ucttuned425-vs-ucttuned345-1000its,865,793,2181.230502279,2115.980156554,72
carcassonne-boltzmann5-vs-boltzmann150-1000its,866,794,2224.86735804,2192.437810815,72
carcassonne-ucttuned265-vs-ucttuned395-1000its,867,795,2146.041258604,2092.729101022,72
carcassonne-boltzmann90-vs-boltzmann340-1000its,868,796,2244.832043694,2185.875040681,72
carcassonne-uct190-vs-uct100-1000its,868,796,2299.540783436,2192.930688979,72
carcassonne-boltzmann180-vs-boltzmann225-1000its,869,797,2210.156250646,2205.518723209,72
carcassonne-uct495-vs-uct335-1000its,869,797,2164.855560855,2143.214036179,72
carcassonne-uct70-vs-uct35-1000its,869,797,2301.228366363,2235.774594886,72
carcassonne-boltzmann255-vs-boltzmann405-1000its,870,798,2287.624504556,2234.674520638,72
carcassonne-ucttuned115-vs-ucttuned200-1000its,870,798,2236.939996077,2204.890964714,72
carcassonne-boltzmann260-vs-boltzmann20-1000its,872,800,2121.513116563,2069.114989608,72
carcassonne-ucttuned240-vs-ucttuned490-1000its,872,800,2133.651758874,2134.954656777,72
carcassonne-boltzmann85-vs-boltzmann460-1000its,873,801,2229.431814941,2203.694878755,72
carcassonne-uct375-vs-uct495-1000its,874,802,2174.444861327,2152.921360839,72
carcassonne-boltzmann295-vs-boltzmann410-1000its,875,803,2173.688385787,2111.158067415,72
carcassonne-ucttuned45-vs-ucttuned210-1000its,875,803,2154.183556713,2098.425571227,72
carcassonne-ucttuned305-vs-ucttuned480-1000its,876,804,2200.213759877,2167.50801115,72
carcassonne-uct360-vs-uct95-1000its,878,806,2139.76663723,2118.852797842,72
carcassonne-uct230-vs-uct280-1000its,879,807,2258.721870488,2198.036824056,72
carcassonne-ucttuned490-vs-ucttuned325-1000its,879,807,2225.077964077,2140.422907632,72
carcassonne-uct10-vs-uct340-1000its,880,808,2268.038070458,2204.293472739,72
carcassonne-ucttuned240-vs-ucttuned375-1000its,880,808,2234.826724026,2185.706978249,72
carcassonne-uct260-vs-uct120-1000its,883,811,2174.641991218,2131.410893702,72
carcassonne-boltzmann495-vs-boltzmann460-1000its,884,812,2161.368814475,2129.367393966,72
carcassonne-uct35-vs-uct440-1000its,884,812,2251.189146133,2180.389839472,72
carcassonne-ucttuned395-vs-ucttuned390-1000its,884,812,2331.107267646,2274.105940453,72
carcassonne-boltzmann160-vs-boltzmann45-1000its,887,815,2206.948138766,2140.368273522,72
carcassonne-ucttuned290-vs-ucttuned415-1000its,888,816,2126.111589673,2082.647025955,72
carcassonne-boltzmann305-vs-boltzmann495-1000its,891,819,2217.706336502,2198.141319179,72
carcassonne-boltzmann435-vs-boltzmann95-1000its,892,820,2204.758667457,2145.221325521,72
carcassonne-boltzmann150-vs-boltzmann335-1000its,893,821,2285.067753329,2217.06548903,72
carcassonne-uct175-vs-uct375-1000its,905,833,2169.992728838,2138.583048278,72
carcassonne-uct40-vs-uct370-1000its,905,833,2216.68294386,2148.319488349,72
carcassonne-uct325-vs-uct125-1000its,907,835,2223.762242837,2156.466457196,72
carcassonne-ucttuned380-vs-ucttuned460-1000its,907,835,2211.993475882,2160.563248364,72
carcassonne-uct5-vs-uct280-1000its,912,840,2170.719404955,2147.359763946,72
carcassonne-ucttuned425-vs-ucttuned175-1000its,914,842,2138.188885505,2116.212799151,72
carcassonne-uct145-vs-uct160-1000its,940,868,2264.142361883,2164.525058058,72
carcassonne-ucttuned30-vs-ucttuned375-1000its,950,878,2224.905230345,2194.809943449,72
carcassonne-uct40-vs-uct235-1000its,982,910,2253.835799781,2193.462473675,72
carcassonne-boltzmann65-vs-boltzmann200-1000its,995,923,2300.350912041,2237.833680189,72
carcassonne-boltzmann305-vs-boltzmann65-1000its,757,684,2259.473589947,2201.707010885,73
carcassonne-uct395-vs-uct200-1000its,771,698,2203.038753608,2139.394877177,73
carcassonne-boltzmann210-vs-boltzmann50-1000its,777,704,2206.339409561,2114.087114764,73
carcassonne-ucttuned135-vs-ucttuned130-1000its,781,708,2152.412296794,2157.734679263,73
carcassonne-boltzmann485-vs-boltzmann205-1000its,786,713,2138.695718929,2122.424729097,73
carcassonne-uct195-vs-uct170-1000its,791,718,2218.775694403,2198.156525729,73
carcassonne-uct315-vs-uct370-1000its,795,722,2210.437060747,2176.657157818,73
carcassonne-uct475-vs-uct440-1000its,796,723,2134.165889739,2077.0038425,73
carcassonne-ucttuned475-vs-ucttuned305-1000its,797,724,2223.765775916,2171.650021331,73
carcassonne-uct5-vs-uct240-1000its,798,725,2205.694267279,2196.481538983,73
carcassonne-boltzmann220-vs-boltzmann170-1000its,800,727,2230.551679622,2226.318514359,73
carcassonne-boltzmann260-vs-boltzmann445-1000its,800,727,2180.645141276,2170.717394359,73
carcassonne-boltzmann455-vs-boltzmann365-1000its,802,729,2218.537228426,2180.475122299,73
carcassonne-boltzmann480-vs-boltzmann340-1000its,805,732,2210.725580703,2149.822703789,73
carcassonne-boltzmann155-vs-boltzmann75-1000its,808,735,2220.944130673,2190.196785605,73
carcassonne-boltzmann55-vs-boltzmann375-1000its,808,735,2261.207819794,2177.82832401,73
carcassonne-ucttuned70-vs-ucttuned435-1000its,809,736,2206.724963881,2177.947494731,73
carcassonne-uct430-vs-uct80-1000its,810,737,2225.954518513,2175.144856815,73
carcassonne-boltzmann430-vs-boltzmann215-1000its,814,741,2147.171696687,2116.818044137,73
carcassonne-uct235-vs-uct420-1000its,818,745,2191.375368513,2175.787909119,73
carcassonne-boltzmann420-vs-boltzmann80-1000its,819,746,2194.414639636,2156.851077111,73
carcassonne-ucttuned180-vs-ucttuned290-1000its,820,747,2218.127303463,2127.931550496,73
carcassonne-ucttuned245-vs-ucttuned415-1000its,820,747,2199.196151463,2132.794210642,73
carcassonne-boltzmann360-vs-boltzmann160-1000its,821,748,2272.989174447,2233.755034014,73
carcassonne-uct120-vs-uct175-1000its,824,751,2222.704064793,2190.789596044,73
carcassonne-boltzmann25-vs-boltzmann485-1000its,825,752,2184.970267385,2140.815877283,73
carcassonne-ucttuned160-vs-ucttuned390-1000its,828,755,2258.749618543,2229.653960309,73
carcassonne-boltzmann490-vs-boltzmann495-1000its,829,756,2143.768054969,2115.403341514,73
carcassonne-uct20-vs-uct250-1000its,830,757,2173.937576578,2146.449898347,73
carcassonne-ucttuned420-vs-ucttuned380-1000its,831,758,2201.416174346,2122.722649616,73
carcassonne-boltzmann25-vs-boltzmann325-1000its,832,759,2259.801168375,2169.67577916,73
carcassonne-uct440-vs-uct275-1000its,832,759,2181.72056714,2117.53974038,73
carcassonne-ucttuned255-vs-ucttuned175-1000its,833,760,2265.441339699,2182.119378394,73
carcassonne-ucttuned270-vs-ucttuned90-1000its,834,761,2184.168143137,2150.473147526,73
carcassonne-boltzmann300-vs-boltzmann185-1000its,835,762,2217.27782978,2134.785673819,73
carcassonne-uct350-vs-uct335-1000its,835,762,2231.462844765,2245.32158775,73
carcassonne-ucttuned265-vs-ucttuned105-1000its,835,762,2174.35024414,2154.06375331,73
carcassonne-boltzmann440-vs-boltzmann210-1000its,836,763,2195.69660813,2123.425288313,73
carcassonne-boltzmann75-vs-boltzmann375-1000its,837,764,2208.416604978,2138.17171891,73
carcassonne-uct255-vs-uct305-1000its,837,764,2226.11033024,2179.893280839,73
carcassonne-boltzmann140-vs-boltzmann435-1000its,838,765,2158.398075725,2111.237147938,73
carcassonne-ucttuned35-vs-ucttuned445-1000its,838,765,2226.481611719,2167.00147535,73
carcassonne-ucttuned385-vs-ucttuned170-1000its,838,765,2106.815657489,2081.146884433,73
carcassonne-uct250-vs-uct130-1000its,841,768,2225.926871607,2185.630110387,73
carcassonne-uct430-vs-uct95-1000its,841,768,2141.891108815,2106.223834748,73
carcassonne-ucttuned495-vs-ucttuned360-1000its,841,768,2252.618949538,2183.031019154,73
carcassonne-boltzmann330-vs-boltzmann455-1000its,842,769,2170.214949923,2189.785596744,73
carcassonne-ucttuned175-vs-ucttuned100-1000its,842,769,2211.204183941,2198.183022554,73
carcassonne-ucttuned225-vs-ucttuned200-1000its,842,769,2298.191761307,2250.83874558,73
carcassonne-ucttuned315-vs-ucttuned105-1000its,843,770,2153.737239788,2135.692655906,73
carcassonne-ucttuned60-vs-ucttuned120-1000its,843,770,2228.746418532,2146.873265219,73
carcassonne-boltzmann310-vs-boltzmann195-1000its,845,772,2123.393043128,2128.882759424,73
carcassonne-ucttuned430-vs-ucttuned450-1000its,845,772,2270.70054282,2233.490492853,73
carcassonne-uct25-vs-uct365-1000its,846,773,2255.445081327,2190.882855536,73
carcassonne-ucttuned410-vs-ucttuned365-1000its,847,774,2167.48548058,2153.107709002,73
carcassonne-uct10-vs-uct120-1000its,848,775,2220.723760569,2195.21854142,73
carcassonne-boltzmann480-vs-boltzmann10-1000its,850,777,2291.460853319,2294.150402663,73
carcassonne-uct115-vs-uct95-1000its,853,780,2261.167739327,2205.474118386,73
carcassonne-ucttuned390-vs-ucttuned475-1000its,853,780,2127.282639477,2108.985499871,73
carcassonne-boltzmann10-vs-boltzmann430-1000its,854,781,2207.216649909,2061.492604363,73
carcassonne-uct40-vs-uct265-1000its,854,781,2218.712011994,2181.677653719,73
carcassonne-boltzmann45-vs-boltzmann5-1000its,855,782,2104.866702401,2104.060710726,73
carcassonne-ucttuned420-vs-ucttuned480-1000its,855,782,2217.695757032,2207.042005538,73
carcassonne-uct35-vs-uct45-1000its,856,783,2236.92129729,2205.546426339,73
carcassonne-uct175-vs-uct110-1000its,858,785,2177.82994181,2130.562387313,73
carcassonne-ucttuned30-vs-ucttuned300-1000its,858,785,2248.542793052,2231.587747716,73
carcassonne-ucttuned110-vs-ucttuned340-1000its,861,788,2191.517372975,2171.092847208,73
carcassonne-boltzmann395-vs-boltzmann435-1000its,863,790,2163.344039627,2134.013927632,73
carcassonne-uct15-vs-uct5-1000its,863,790,2179.703612577,2140.494860784,73
carcassonne-uct260-vs-uct425-1000its,863,790,2250.841044024,2210.06918847,73
carcassonne-uct300-vs-uct170-1000its,865,792,2165.9965909,2114.245299937,73
carcassonne-ucttuned440-vs-ucttuned20-1000its,865,792,2135.867882646,2121.561541414,73
carcassonne-uct320-vs-uct325-1000its,866,793,2241.420004872,2198.267812803,73
carcassonne-uct370-vs-uct220-1000its,867,794,2225.432931355,2160.749582732,73
carcassonne-uct55-vs-uct210-1000its,867,794,2184.309496964,2134.981351302,73
carcassonne-uct120-vs-uct475-1000its,868,795,2201.833173326,2112.382427559,73
carcassonne-ucttuned130-vs-ucttuned280-1000its,868,795,2206.606381479,2122.751746315,73
carcassonne-ucttuned185-vs-ucttuned165-1000its,868,795,2186.622386807,2111.441593417,73
carcassonne-uct375-vs-uct115-1000its,869,796,2271.573237473,2246.79762069,73
carcassonne-boltzmann5-vs-boltzmann445-1000its,870,797,2325.954663901,2267.670687047,73
carcassonne-ucttuned20-vs-ucttuned265-1000its,871,798,2236.391612125,2182.371319445,73
carcassonne-ucttuned35-vs-ucttuned270-1000its,871,798,2250.56385117,2203.407882718,73
carcassonne-boltzmann125-vs-boltzmann265-1000its,872,799,2221.703327276,2199.961076704,73
carcassonne-ucttuned130-vs-ucttuned110-1000its,872,799,2152.720863428,2073.836129688,73
carcassonne-uct155-vs-uct110-1000its,873,800,2238.67975361,2144.346726501,73
carcassonne-uct435-vs-uct245-1000its,873,800,2221.799068231,2186.568999429,73
carcassonne-ucttuned470-vs-ucttuned270-1000its,874,801,2223.63257099,2198.556036456,73
carcassonne-boltzmann145-vs-boltzmann130-1000its,875,802,2262.942635569,2201.74362084,73
carcassonne-boltzmann175-vs-boltzmann40-1000its,875,802,2172.458187302,2107.742347542,73
carcassonne-uct295-vs-uct95-1000its,875,802,2249.211590478,2213.081512536,73
carcassonne-uct365-vs-uct460-1000its,876,803,2178.794960562,2147.283722959,73
carcassonne-uct5-vs-uct200-1000its,880,807,2191.660198835,2167.729696116,73
carcassonne-ucttuned195-vs-ucttuned60-1000its,882,809,2151.63805613,2092.137973426,73
carcassonne-uct100-vs-uct140-1000its,883,810,2169.181949173,2146.552396409,73
carcassonne-ucttuned350-vs-ucttuned390-1000its,883,810,2157.696193678,2128.465017999,73
carcassonne-boltzmann220-vs-boltzmann20-1000its,884,811,2279.131811831,2205.414478443,73
carcassonne-uct445-vs-uct135-1000its,884,811,2194.413859485,2130.944815755,73
carcassonne-uct270-vs-uct280-1000its,885,812,2212.489828533,2132.352595798,73
carcassonne-uct355-vs-uct65-1000its,886,813,2252.842605124,2218.915740441,73
carcassonne-uct435-vs-uct460-1000its,886,813,2224.974790797,2200.914102569,73
carcassonne-ucttuned185-vs-ucttuned95-1000its,886,813,2264.815350161,2192.893505652,73
carcassonne-ucttuned415-vs-ucttuned355-1000its,886,813,2223.707984198,2130.03221455,73
carcassonne-ucttuned95-vs-ucttuned145-1000its,886,813,2248.631867102,2232.841908615,73
carcassonne-boltzmann215-vs-boltzmann335-1000its,888,815,2163.992830186,2150.765282401,73
carcassonne-uct85-vs-uct55-1000its,894,821,2178.885978968,2200.972475314,73
carcassonne-uct355-vs-uct475-1000its,901,828,2175.847889012,2132.826412809,73
carcassonne-ucttuned75-vs-ucttuned235-1000its,901,828,2246.147412666,2181.299199117,73
carcassonne-ucttuned10-vs-ucttuned230-1000its,902,829,2205.221260725,2172.940470266,73
carcassonne-ucttuned260-vs-ucttuned275-1000its,902,829,2236.462876609,2186.076294294,73
carcassonne-boltzmann355-vs-boltzmann165-1000its,905,832,2172.007552687,2131.633341595,73
carcassonne-uct80-vs-uct465-1000its,911,838,2284.392313298,2239.334937292,73
carcassonne-uct145-vs-uct65-1000its,913,840,2231.423474454,2196.496010144,73
carcassonne-uct80-vs-uct90-1000its,922,849,2187.214533796,2137.446593415,73
carcassonne-ucttuned180-vs-ucttuned325-1000its,930,857,2148.792733569,2118.35170446,73
carcassonne-ucttuned15-vs-ucttuned10-1000its,931,858,2136.930662151,2060.706280176,73
carcassonne-ucttuned365-vs-ucttuned430-1000its,936,863,2166.219505047,2121.172656514,73
carcassonne-uct10-vs-uct385-1000its,949,876,2181.141416027,2137.853377682,73
carcassonne-ucttuned405-vs-ucttuned200-1000its,956,883,2220.053641551,2169.302102497,73
carcassonne-uct155-vs-uct150-1000its,761,687,2193.013769309,2142.384055165,74
carcassonne-uct380-vs-uct190-1000its,768,694,2229.686266851,2191.74300547,74
carcassonne-uct75-vs-uct210-1000its,784,710,2219.700696208,2204.6998104,74
carcassonne-uct25-vs-uct345-1000its,788,714,2175.595963737,2106.997791667,74
carcassonne-uct400-vs-uct255-1000its,788,714,2217.918708139,2168.537173077,74
carcassonne-boltzmann395-vs-boltzmann430-1000its,794,720,2211.241774244,2185.195248252,74
carcassonne-boltzmann460-vs-boltzmann305-1000its,799,725,2244.927153867,2198.737204509,74
carcassonne-uct305-vs-uct135-1000its,799,725,2281.489979597,2181.781078637,74
carcassonne-uct490-vs-uct460-1000its,799,725,2167.089478593,2111.626721599,74
carcassonne-boltzmann315-vs-boltzmann335-1000its,805,731,2186.162262939,2146.668276661,74
carcassonne-uct135-vs-uct80-1000its,811,737,2185.272724358,2158.205844146,74
carcassonne-boltzmann245-vs-boltzmann325-1000its,812,738,2229.429465208,2204.385016367,74
carcassonne-ucttuned190-vs-ucttuned490-1000its,813,739,2197.214024443,2158.027074931,74
carcassonne-boltzmann345-vs-boltzmann415-1000its,814,740,2196.605981773,2184.914286873,74
carcassonne-boltzmann140-vs-boltzmann260-1000its,817,743,2230.83974253,2174.861294501,74
carcassonne-boltzmann20-vs-boltzmann15-1000its,819,745,2230.122852298,2221.83477571,74
carcassonne-boltzmann185-vs-boltzmann135-1000its,820,746,2178.025407757,2125.478772229,74
carcassonne-boltzmann265-vs-boltzmann395-1000its,820,746,2183.873040328,2167.706762274,74
carcassonne-uct470-vs-uct290-1000its,821,747,2197.719342022,2136.687274382,74
carcassonne-ucttuned10-vs-ucttuned345-1000its,821,747,2236.674600525,2195.761761591,74
carcassonne-ucttuned460-vs-ucttuned265-1000its,821,747,2130.240159109,2105.901262556,74
carcassonne-boltzmann260-vs-boltzmann320-1000its,822,748,2189.663425117,2206.867325051,74
carcassonne-uct325-vs-uct290-1000its,824,750,2239.396764556,2240.963951881,74
carcassonne-boltzmann440-vs-boltzmann35-1000its,825,751,2159.749553627,2124.192346593,74
carcassonne-boltzmann175-vs-boltzmann495-1000its,827,753,2203.680271308,2119.833636872,74
carcassonne-ucttuned200-vs-ucttuned430-1000its,827,753,2216.501482344,2130.344531983,74
carcassonne-boltzmann135-vs-boltzmann255-1000its,828,754,2146.343914813,2128.564729837,74
carcassonne-boltzmann345-vs-boltzmann140-1000its,828,754,2327.678751975,2290.344976154,74
carcassonne-boltzmann460-vs-boltzmann490-1000its,829,755,2166.024688766,2101.531814815,74
carcassonne-ucttuned295-vs-ucttuned110-1000its,829,755,2141.275438412,2080.67607926,74
carcassonne-ucttuned45-vs-ucttuned40-1000its,829,755,2209.761937189,2180.275092135,74
carcassonne-boltzmann280-vs-boltzmann400-1000its,830,756,2213.777150734,2162.859397097,74
carcassonne-uct250-vs-uct310-1000its,831,757,2186.697976943,2135.943120617,74
carcassonne-boltzmann215-vs-boltzmann90-1000its,836,762,2128.997491082,2112.614828016,74
carcassonne-ucttuned155-vs-ucttuned230-1000its,836,762,2139.667896015,2148.008455364,74
carcassonne-ucttuned345-vs-ucttuned90-1000its,838,764,2167.005486704,2159.784190782,74
carcassonne-boltzmann475-vs-boltzmann245-1000its,839,765,2165.542371889,2112.141849896,74
carcassonne-ucttuned495-vs-ucttuned270-1000its,839,765,2204.53041896,2185.252276356,74
carcassonne-boltzmann300-vs-boltzmann25-1000its,843,769,2128.652876548,2090.927039308,74
carcassonne-uct470-vs-uct410-1000its,843,769,2250.270459625,2210.183843149,74
carcassonne-ucttuned160-vs-ucttuned430-1000its,843,769,2211.265545898,2158.996235962,74
carcassonne-ucttuned200-vs-ucttuned35-1000its,843,769,2177.90676388,2121.122634413,74
carcassonne-boltzmann230-vs-boltzmann225-1000its,845,771,2198.346979002,2180.179669658,74
carcassonne-uct385-vs-uct180-1000its,845,771,2158.225109359,2129.045373976,74
carcassonne-uct75-vs-uct335-1000its,845,771,2153.221396291,2128.700303588,74
carcassonne-boltzmann165-vs-boltzmann430-1000its,846,772,2203.065054548,2176.917284029,74
carcassonne-uct10-vs-uct450-1000its,846,772,2155.941943804,2090.074908086,74
carcassonne-uct385-vs-uct370-1000its,846,772,2211.685869496,2200.401814473,74
carcassonne-boltzmann155-vs-boltzmann350-1000its,847,773,2175.728600784,2154.011333821,74
carcassonne-boltzmann45-vs-boltzmann175-1000its,849,775,2197.728898788,2126.926149082,74
carcassonne-uct145-vs-uct180-1000its,854,780,2171.732932515,2130.774477226,74
carcassonne-uct430-vs-uct280-1000its,854,780,2197.650097043,2151.796052524,74
carcassonne-uct45-vs-uct190-1000its,855,781,2236.703145156,2221.426474402,74
carcassonne-uct165-vs-uct435-1000its,857,783,2196.639312262,2208.550215971,74
carcassonne-ucttuned430-vs-ucttuned425-1000its,857,783,2173.227768869,2115.277925562,74
carcassonne-ucttuned75-vs-ucttuned360-1000its,857,783,2270.116205647,2248.870851269,74
carcassonne-boltzmann300-vs-boltzmann285-1000its,859,785,2206.483097361,2144.102133795,74
carcassonne-uct315-vs-uct165-1000its,859,785,2183.045371508,2097.173274237,74
carcassonne-ucttuned30-vs-ucttuned250-1000its,859,785,2239.355760781,2199.485357455,74
carcassonne-boltzmann175-vs-boltzmann105-1000its,861,787,2241.206868349,2209.934438837,74
carcassonne-boltzmann345-vs-boltzmann485-1000its,861,787,2249.738316869,2209.532835094,74
carcassonne-ucttuned310-vs-ucttuned210-1000its,861,787,2159.565707213,2151.091077535,74
carcassonne-uct275-vs-uct285-1000its,864,790,2119.503327821,2121.091372336,74
carcassonne-boltzmann480-vs-boltzmann410-1000its,866,792,2179.133014443,2155.886017937,74
carcassonne-boltzmann415-vs-boltzmann340-1000its,868,794,2139.18302878,2097.773297193,74
carcassonne-uct235-vs-uct310-1000its,868,794,2218.759470235,2149.396526235,74
carcassonne-ucttuned225-vs-ucttuned195-1000its,868,794,2139.565764644,2107.034944698,74
carcassonne-ucttuned355-vs-ucttuned465-1000its,868,794,2184.62733269,2134.118838927,74
carcassonne-ucttuned40-vs-ucttuned340-1000its,868,794,2157.681784663,2094.033924144,74
carcassonne-ucttuned380-vs-ucttuned120-1000its,869,795,2255.028386934,2228.28399702,74
carcassonne-boltzmann260-vs-boltzmann185-1000its,870,796,2169.749435801,2151.869275863,74
carcassonne-boltzmann270-vs-boltzmann415-1000its,870,796,2317.06084936,2234.452421884,74
carcassonne-boltzmann85-vs-boltzmann420-1000its,871,797,2337.88399363,2245.091277783,74
carcassonne-ucttuned30-vs-ucttuned5-1000its,871,797,2152.521774893,2056.635939645,74
carcassonne-boltzmann25-vs-boltzmann300-1000its,874,800,2263.629764584,2244.217292912,74
carcassonne-boltzmann495-vs-boltzmann110-1000its,874,800,2239.564516316,2173.161347188,74
carcassonne-ucttuned350-vs-ucttuned385-1000its,876,802,2137.652584794,2103.057243355,74
carcassonne-uct475-vs-uct295-1000its,878,804,2189.654003529,2092.129254946,74
carcassonne-uct55-vs-uct160-1000its,880,806,2283.713873936,2202.23914652,74
carcassonne-boltzmann365-vs-boltzmann125-1000its,882,808,2204.928065816,2132.002557637,74
carcassonne-boltzmann395-vs-boltzmann460-1000its,882,808,2226.032977601,2156.127435606,74
carcassonne-uct10-vs-uct240-1000its,884,810,2298.759149433,2248.434860125,74
carcassonne-boltzmann30-vs-boltzmann235-1000its,885,811,2257.393887087,2201.106661454,74
carcassonne-ucttuned100-vs-ucttuned260-1000its,885,811,2168.344155393,2107.763538283,74
carcassonne-ucttuned420-vs-ucttuned295-1000its,886,812,2212.635577904,2192.091160398,74
carcassonne-uct80-vs-uct245-1000its,889,815,2114.345219905,2101.085380421,74
carcassonne-ucttuned480-vs-ucttuned375-1000its,896,822,2215.609880135,2181.72704465,74
carcassonne-ucttuned85-vs-ucttuned455-1000its,896,822,2197.977065597,2156.659418319,74
carcassonne-boltzmann360-vs-boltzmann285-1000its,903,829,2120.253637817,2113.99387653,74
carcassonne-ucttuned175-vs-ucttuned355-1000its,903,829,2219.106808021,2194.07621838,74
carcassonne-boltzmann345-vs-boltzmann185-1000its,908,834,2202.017248041,2167.551374142,74
carcassonne-uct30-vs-uct310-1000its,912,838,2208.839039366,2147.106174573,74
carcassonne-ucttuned50-vs-ucttuned315-1000its,914,840,2322.731549017,2209.210726405,74
carcassonne-ucttuned85-vs-ucttuned230-1000its,915,841,2157.039582276,2088.654647423,74
carcassonne-boltzmann425-vs-boltzmann340-1000its,918,844,2160.771179301,2149.090716616,74
carcassonne-boltzmann435-vs-boltzmann260-1000its,922,848,2174.646856836,2135.261321656,74
carcassonne-uct165-vs-uct25-1000its,923,849,2212.146653516,2182.616431233,74
carcassonne-ucttuned125-vs-ucttuned55-1000its,929,855,2145.66793008,2139.289429601,74
carcassonne-ucttuned110-vs-ucttuned350-1000its,933,859,2144.03314541,2128.805886423,74
carcassonne-ucttuned365-vs-ucttuned405-1000its,935,861,2303.891204636,2253.498946087,74
carcassonne-ucttuned410-vs-ucttuned485-1000its,947,873,2130.953187797,2095.949583628,74
carcassonne-ucttuned105-vs-ucttuned150-1000its,962,888,2195.578469335,2136.679216991,74
carcassonne-boltzmann485-vs-boltzmann295-1000its,748,673,2212.740528852,2171.594404069,75
carcassonne-boltzmann460-vs-boltzmann375-1000its,752,677,2192.179050951,2138.852633868,75
carcassonne-boltzmann375-vs-boltzmann240-1000its,771,696,2158.20223269,2088.529965426,75
carcassonne-uct345-vs-uct455-1000its,776,701,2136.641750154,2124.328160962,75
carcassonne-boltzmann25-vs-boltzmann415-1000its,785,710,2250.953108644,2180.945245098,75
carcassonne-boltzmann185-vs-boltzmann245-1000its,788,713,2219.197257527,2160.661251233,75
carcassonne-boltzmann20-vs-boltzmann265-1000its,791,716,2172.507243831,2149.370371726,75
carcassonne-ucttuned160-vs-ucttuned360-1000its,791,716,2222.711601685,2165.106323938,75
carcassonne-boltzmann420-vs-boltzmann390-1000its,796,721,2235.634765096,2199.400119594,75
carcassonne-ucttuned155-vs-ucttuned270-1000its,796,721,2275.186533157,2221.678323112,75
carcassonne-boltzmann440-vs-boltzmann300-1000its,799,724,2185.08434144,2103.171629456,75
carcassonne-ucttuned95-vs-ucttuned480-1000its,799,724,2230.813228064,2187.021293174,75
carcassonne-boltzmann125-vs-boltzmann210-1000its,801,726,2219.327644122,2128.974925401,75
carcassonne-uct65-vs-uct205-1000its,801,726,2230.018641298,2169.629829504,75
carcassonne-uct150-vs-uct70-1000its,804,729,2177.545368494,2135.927766742,75
carcassonne-ucttuned275-vs-ucttuned225-1000its,804,729,2220.099820687,2156.597302732,75
carcassonne-uct185-vs-uct400-1000its,805,730,2153.344634093,2090.459201173,75
carcassonne-uct100-vs-uct390-1000its,808,733,2258.005392356,2187.414782856,75
carcassonne-boltzmann125-vs-boltzmann185-1000its,810,735,2182.637312874,2163.78619714,75
carcassonne-boltzmann460-vs-boltzmann455-1000its,812,737,2235.245385472,2200.730676748,75
carcassonne-boltzmann420-vs-boltzmann255-1000its,814,739,2225.213063817,2202.100400482,75
carcassonne-ucttuned275-vs-ucttuned375-1000its,814,739,2198.140922834,2175.748706418,75
carcassonne-ucttuned215-vs-ucttuned490-1000its,816,741,2218.650061916,2175.622494331,75
carcassonne-boltzmann270-vs-boltzmann135-1000its,819,744,2215.485762661,2148.545924013,75
carcassonne-boltzmann335-vs-boltzmann85-1000its,819,744,2186.28698758,2169.611029991,75
carcassonne-boltzmann130-vs-boltzmann460-1000its,820,745,2156.069283048,2079.738368316,75
carcassonne-boltzmann85-vs-boltzmann265-1000its,823,748,2263.436543344,2278.097873323,75
carcassonne-ucttuned330-vs-ucttuned360-1000its,823,748,2241.198043538,2180.166990109,75
carcassonne-uct295-vs-uct405-1000its,826,751,2243.996693865,2190.310440959,75
carcassonne-boltzmann200-vs-boltzmann415-1000its,828,753,2143.583554304,2126.841991771,75
carcassonne-boltzmann220-vs-boltzmann85-1000its,828,753,2185.111911654,2148.226963252,75
carcassonne-ucttuned365-vs-ucttuned35-1000its,828,753,2193.633236001,2112.381664458,75
carcassonne-boltzmann185-vs-boltzmann130-1000its,829,754,2180.912298105,2120.884576516,75
carcassonne-boltzmann325-vs-boltzmann80-1000its,830,755,2143.90419955,2154.73578691,75
carcassonne-ucttuned175-vs-ucttuned430-1000its,830,755,2174.779228831,2144.854769001,75
carcassonne-ucttuned350-vs-ucttuned40-1000its,831,756,2181.046934517,2148.410864733,75
carcassonne-ucttuned55-vs-ucttuned150-1000its,832,757,2221.648720551,2145.790900802,75
carcassonne-uct255-vs-uct245-1000its,833,758,2217.427058949,2212.526306115,75
carcassonne-uct255-vs-uct265-1000its,833,758,2090.695903636,2074.402988224,75
carcassonne-boltzmann10-vs-boltzmann310-1000its,835,760,2216.89123801,2120.798462257,75
carcassonne-boltzmann325-vs-boltzmann320-1000its,835,760,2133.872958968,2082.96039575,75
carcassonne-uct440-vs-uct330-1000its,837,762,2261.019000787,2195.386657426,75
carcassonne-boltzmann335-vs-boltzmann265-1000its,838,763,2127.513970463,2087.215332116,75
carcassonne-boltzmann85-vs-boltzmann310-1000its,838,763,2178.495683349,2139.271803433,75
carcassonne-boltzmann230-vs-boltzmann390-1000its,839,764,2140.005771124,2153.556463243,75
carcassonne-boltzmann375-vs-boltzmann325-1000its,839,764,2183.390778349,2159.344177039,75
carcassonne-boltzmann235-vs-boltzmann210-1000its,840,765,2193.834883575,2166.33992723,75
carcassonne-uct120-vs-uct105-1000its,841,766,2226.460113266,2168.983679842,75
carcassonne-uct280-vs-uct315-1000its,843,768,2230.884938793,2178.805183947,75
carcassonne-boltzmann35-vs-boltzmann440-1000its,844,769,2186.299325439,2122.389114074,75
carcassonne-ucttuned495-vs-ucttuned450-1000its,845,770,2203.268720653,2153.699480835,75
carcassonne-boltzmann375-vs-boltzmann340-1000its,848,773,2117.238908992,2111.764074582,75
carcassonne-uct35-vs-uct420-1000its,848,773,2184.226736026,2139.121733215,75
carcassonne-ucttuned10-vs-ucttuned415-1000its,848,773,2260.980723872,2194.053814974,75
carcassonne-uct440-vs-uct115-1000its,850,775,2147.669344358,2156.967093858,75
carcassonne-uct430-vs-uct265-1000its,851,776,2244.898587519,2198.167412153,75
carcassonne-uct85-vs-uct340-1000its,852,777,2222.764434772,2201.793019884,75
carcassonne-uct330-vs-uct340-1000its,853,778,2154.092893062,2110.619576942,75
carcassonne-uct415-vs-uct395-1000its,853,778,2254.131479432,2192.79930161,75
carcassonne-ucttuned5-vs-ucttuned410-1000its,858,783,2199.246544838,2181.396248573,75
carcassonne-ucttuned320-vs-ucttuned365-1000its,861,786,2148.190732747,2108.930803561,75
carcassonne-uct340-vs-uct470-1000its,863,788,2257.581016987,2200.380387902,75
carcassonne-uct345-vs-uct375-1000its,863,788,2165.189377658,2143.714467657,75
carcassonne-ucttuned420-vs-ucttuned350-1000its,863,788,2170.618435745,2103.859802581,75
carcassonne-uct260-vs-uct370-1000its,864,789,2203.009187028,2150.51113678,75
carcassonne-uct400-vs-uct205-1000its,866,791,2237.749897847,2189.412847516,75
carcassonne-boltzmann5-vs-boltzmann460-1000its,869,794,2199.042903391,2125.645281416,75
carcassonne-uct25-vs-uct440-1000its,871,796,2156.421957075,2094.990181776,75
carcassonne-ucttuned490-vs-ucttuned30-1000its,872,797,2128.278855671,2141.031857392,75
carcassonne-boltzmann190-vs-boltzmann10-1000its,874,799,2132.427612408,2101.069810992,75
carcassonne-boltzmann200-vs-boltzmann205-1000its,874,799,2143.900476899,2081.247002277,75
carcassonne-uct160-vs-uct60-1000its,874,799,2262.29044935,2254.170686941,75
carcassonne-uct180-vs-uct245-1000its,875,800,2169.2519157,2109.36789425,75
carcassonne-ucttuned420-vs-ucttuned205-1000its,875,800,2168.628147239,2110.635734707,75
carcassonne-uct155-vs-uct225-1000its,877,802,2219.878254598,2204.88278576,75
carcassonne-ucttuned445-vs-ucttuned180-1000its,882,807,2265.660678848,2217.723417522,75
carcassonne-boltzmann155-vs-boltzmann290-1000its,884,809,2213.50993041,2134.686305229,75
carcassonne-boltzmann280-vs-boltzmann190-1000its,889,814,2138.300944373,2090.992378084,75
carcassonne-ucttuned150-vs-ucttuned370-1000its,889,814,2223.529003518,2136.340209307,75
carcassonne-boltzmann180-vs-boltzmann95-1000its,890,815,2170.431610581,2143.421627658,75
carcassonne-boltzmann120-vs-boltzmann360-1000its,891,816,2123.428027292,2104.256563364,75
carcassonne-ucttuned410-vs-ucttuned230-1000its,891,816,2164.367940206,2124.316468637,75
carcassonne-uct265-vs-uct20-1000its,900,825,2255.904490792,2185.107888818,75
carcassonne-ucttuned240-vs-ucttuned115-1000its,902,827,2293.438222434,2284.974912977,75
carcassonne-boltzmann140-vs-boltzmann475-1000its,910,835,2219.942805348,2140.744230031,75
carcassonne-boltzmann75-vs-boltzmann285-1000its,910,835,2152.755052823,2111.968101948,75
carcassonne-uct20-vs-uct110-1000its,915,840,2161.641997891,2112.888240145,75
carcassonne-ucttuned40-vs-ucttuned440-1000its,918,843,2177.622006261,2143.830181566,75
carcassonne-uct5-vs-uct195-1000its,919,844,2165.695569879,2133.217183722,75
carcassonne-ucttuned80-vs-ucttuned115-1000its,919,844,2177.533467529,2164.460513457,75
carcassonne-ucttuned320-vs-ucttuned440-1000its,928,853,2199.162957822,2176.43519809,75
carcassonne-boltzmann240-vs-boltzmann125-1000its,931,856,2250.996442632,2166.385655664,75
carcassonne-uct330-vs-uct400-1000its,931,856,2162.295819956,2133.844756629,75
carcassonne-uct5-vs-uct135-1000its,936,861,2141.708792439,2101.386434845,75
carcassonne-ucttuned425-vs-ucttuned200-1000its,955,880,2153.083791668,2124.896260575,75
carcassonne-boltzmann60-vs-boltzmann315-1000its,767,691,2187.615458945,2128.46721049,76
carcassonne-boltzmann445-vs-boltzmann295-1000its,776,700,2258.50715946,2225.434644954,76
carcassonne-uct300-vs-uct65-1000its,777,701,2195.745713028,2135.621230762,76
carcassonne-ucttuned285-vs-ucttuned240-1000its,785,709,2185.554173992,2130.077987468,76
carcassonne-uct415-vs-uct30-1000its,792,716,2156.293076016,2127.929324529,76
carcassonne-uct120-vs-uct420-1000its,793,717,2225.230819294,2132.427791583,76
carcassonne-ucttuned225-vs-ucttuned230-1000its,795,719,2305.169309824,2222.611166514,76
carcassonne-uct435-vs-uct100-1000its,796,720,2175.652369547,2099.721122791,76
carcassonne-ucttuned435-vs-ucttuned315-1000its,800,724,2178.680591706,2106.586670973,76
carcassonne-ucttuned425-vs-ucttuned360-1000its,801,725,2223.912509948,2153.277882333,76
carcassonne-boltzmann430-vs-boltzmann410-1000its,802,726,2170.181873079,2138.528829784,76
carcassonne-boltzmann130-vs-boltzmann105-1000its,804,728,2179.239234513,2106.321116877,76
carcassonne-ucttuned125-vs-ucttuned400-1000its,806,730,2193.213070093,2162.988053805,76
carcassonne-boltzmann135-vs-boltzmann395-1000its,807,731,2179.883931395,2126.47983715,76
carcassonne-ucttuned255-vs-ucttuned250-1000its,808,732,2095.969060093,2109.148974304,76
carcassonne-ucttuned90-vs-ucttuned385-1000its,808,732,2186.043128796,2123.019952459,76
carcassonne-ucttuned145-vs-ucttuned300-1000its,810,734,2227.138075962,2184.968903394,76
carcassonne-boltzmann15-vs-boltzmann460-1000its,814,738,2244.449009307,2201.399053443,76
carcassonne-boltzmann45-vs-boltzmann150-1000its,814,738,2214.801991609,2152.530575098,76
carcassonne-boltzmann290-vs-boltzmann220-1000its,817,741,2112.371667226,2111.288387985,76
carcassonne-boltzmann295-vs-boltzmann360-1000its,817,741,2285.491203075,2212.177597234,76
carcassonne-boltzmann440-vs-boltzmann400-1000its,817,741,2167.486032457,2155.693138252,76
carcassonne-boltzmann255-vs-boltzmann50-1000its,818,742,2198.923378553,2180.192561764,76
carcassonne-boltzmann75-vs-boltzmann275-1000its,819,743,2189.539696397,2150.588039743,76
carcassonne-boltzmann195-vs-boltzmann490-1000its,820,744,2196.608628148,2125.206602588,76
carcassonne-uct120-vs-uct280-1000its,820,744,2132.407748209,2087.678092209,76
carcassonne-ucttuned260-vs-ucttuned375-1000its,820,744,2128.813073329,2093.179727589,76
carcassonne-ucttuned70-vs-ucttuned400-1000its,820,744,2257.005524563,2194.367196208,76
carcassonne-boltzmann175-vs-boltzmann205-1000its,821,745,2211.170100209,2193.201860023,76
carcassonne-ucttuned165-vs-ucttuned255-1000its,822,746,2206.618796396,2144.811390651,76
carcassonne-ucttuned75-vs-ucttuned110-1000its,823,747,2213.980084236,2170.177774091,76
carcassonne-boltzmann395-vs-boltzmann45-1000its,824,748,2146.968857617,2104.552473154,76
carcassonne-ucttuned430-vs-ucttuned355-1000its,824,748,2217.855849701,2183.931676298,76
carcassonne-boltzmann415-vs-boltzmann255-1000its,826,750,2128.561160186,2078.656989398,76
carcassonne-ucttuned365-vs-ucttuned215-1000its,828,752,2140.017049234,2114.210446455,76
carcassonne-ucttuned45-vs-ucttuned450-1000its,828,752,2209.565439737,2219.432827654,76
carcassonne-boltzmann270-vs-boltzmann430-1000its,829,753,2194.071837943,2173.110173451,76
carcassonne-uct385-vs-uct120-1000its,829,753,2174.255364204,2099.363925765,76
carcassonne-ucttuned150-vs-ucttuned485-1000its,830,754,2205.643305215,2119.434424153,76
carcassonne-uct55-vs-uct170-1000its,831,755,2185.185415163,2168.692877333,76
carcassonne-boltzmann350-vs-boltzmann125-1000its,832,756,2216.57951879,2150.301211651,76
carcassonne-ucttuned340-vs-ucttuned200-1000its,832,756,2208.48161976,2173.151141817,76
carcassonne-boltzmann175-vs-boltzmann440-1000its,835,759,2234.657274626,2198.270944367,76
carcassonne-ucttuned135-vs-ucttuned390-1000its,835,759,2186.733291753,2160.589024967,76
carcassonne-ucttuned460-vs-ucttuned30-1000its,836,760,2201.394853996,2117.813726556,76
carcassonne-ucttuned55-vs-ucttuned400-1000its,836,760,2188.397224705,2167.224174479,76
carcassonne-boltzmann325-vs-boltzmann490-1000its,837,761,2152.627644104,2131.575633444,76
carcassonne-uct70-vs-uct55-1000its,837,761,2189.961548405,2132.305089722,76
carcassonne-boltzmann35-vs-boltzmann225-1000its,839,763,2151.32131015,2093.876956795,76
carcassonne-boltzmann145-vs-boltzmann390-1000its,841,765,2163.557435459,2147.521005489,76
carcassonne-boltzmann380-vs-boltzmann445-1000its,841,765,2181.33584317,2143.300028776,76
carcassonne-uct485-vs-uct195-1000its,842,766,2157.905875996,2107.636289843,76
carcassonne-boltzmann230-vs-boltzmann275-1000its,843,767,2238.181508311,2183.000101406,76
carcassonne-boltzmann355-vs-boltzmann185-1000its,843,767,2257.775625278,2172.097066025,76
carcassonne-ucttuned455-vs-ucttuned135-1000its,844,768,2166.572926259,2103.661535952,76
carcassonne-boltzmann285-vs-boltzmann465-1000its,847,771,2289.832496388,2282.90153581,76
carcassonne-uct315-vs-uct90-1000its,847,771,2224.400430575,2186.709412714,76
carcassonne-uct235-vs-uct85-1000its,848,772,2221.041475431,2181.001212133,76
carcassonne-ucttuned90-vs-ucttuned405-1000its,848,772,2181.01119365,2163.411227299,76
carcassonne-boltzmann195-vs-boltzmann285-1000its,849,773,2183.940539775,2122.140495061,76
carcassonne-ucttuned100-vs-ucttuned145-1000its,849,773,2176.248175339,2154.752867184,76
carcassonne-ucttuned335-vs-ucttuned175-1000its,849,773,2202.820085949,2151.92790251,76
carcassonne-uct75-vs-uct155-1000its,850,774,2191.387357995,2144.412853855,76
carcassonne-ucttuned55-vs-ucttuned160-1000its,853,777,2159.543940298,2145.367475072,76
carcassonne-uct15-vs-uct295-1000its,854,778,2143.861324713,2083.612155693,76
carcassonne-ucttuned375-vs-ucttuned335-1000its,856,780,2361.187590386,2321.510798382,76
carcassonne-uct235-vs-uct270-1000its,857,781,2213.845597966,2132.026301521,76
carcassonne-ucttuned415-vs-ucttuned380-1000its,858,782,2157.652824332,2102.608619655,76
carcassonne-uct160-vs-uct110-1000its,861,785,2133.160762427,2099.308445222,76
carcassonne-ucttuned25-vs-ucttuned100-1000its,863,787,2157.745162111,2171.190209622,76
carcassonne-uct5-vs-uct155-1000its,865,789,2183.385138026,2118.157942949,76
carcassonne-ucttuned50-vs-ucttuned5-1000its,865,789,2175.78775374,2118.245301633,76
carcassonne-boltzmann215-vs-boltzmann480-1000its,866,790,2136.803767067,2078.69227331,76
carcassonne-uct245-vs-uct460-1000its,866,790,2241.185248066,2210.731638204,76
carcassonne-uct230-vs-uct10-1000its,867,791,2213.554527449,2171.57747967,76
carcassonne-uct470-vs-uct25-1000its,867,791,2158.694885272,2116.148972975,76
carcassonne-boltzmann425-vs-boltzmann50-1000its,868,792,2310.982347509,2206.043286461,76
carcassonne-uct470-vs-uct215-1000its,871,795,2110.473944314,2100.132041739,76
carcassonne-boltzmann125-vs-boltzmann370-1000its,876,800,2224.637656034,2126.314843446,76
carcassonne-ucttuned440-vs-ucttuned270-1000its,879,803,2219.44048925,2195.806297959,76
carcassonne-boltzmann15-vs-boltzmann20-1000its,881,805,2275.667949701,2215.905463201,76
carcassonne-uct255-vs-uct140-1000its,884,808,2185.157960679,2139.986958805,76
carcassonne-ucttuned155-vs-ucttuned335-1000its,891,815,2179.260453714,2162.73352073,76
carcassonne-boltzmann135-vs-boltzmann85-1000its,892,816,2180.416180721,2128.545889063,76
carcassonne-uct460-vs-uct315-1000its,892,816,2253.728583045,2218.874476855,76
carcassonne-boltzmann195-vs-boltzmann220-1000its,896,820,2203.002997297,2200.271509928,76
carcassonne-ucttuned120-vs-ucttuned40-1000its,899,823,2162.826954309,2102.639664281,76
carcassonne-ucttuned490-vs-ucttuned125-1000its,899,823,2155.995956973,2179.257788028,76
carcassonne-uct445-vs-uct65-1000its,901,825,2217.981728333,2175.031620394,76
carcassonne-boltzmann425-vs-boltzmann135-1000its,904,828,2231.539266305,2179.276003153,76
carcassonne-uct20-vs-uct265-1000its,910,834,2223.601737517,2147.488037569,76
carcassonne-uct135-vs-uct40-1000its,924,848,2164.348092704,2100.298841525,76
carcassonne-uct55-vs-uct430-1000its,924,848,2146.301425637,2091.620081497,76
carcassonne-boltzmann415-vs-boltzmann225-1000its,928,852,2203.527542785,2171.723276628,76
carcassonne-boltzmann290-vs-boltzmann125-1000its,941,865,2254.51418666,2180.906381035,76
carcassonne-ucttuned95-vs-ucttuned420-1000its,955,879,2152.461016362,2092.098024977,76
carcassonne-uct245-vs-uct90-1000its,766,689,2177.18084562,2103.966001938,77
carcassonne-boltzmann15-vs-boltzmann445-1000its,767,690,2240.561829964,2208.8226883,77
carcassonne-uct435-vs-uct220-1000its,767,690,2218.541699328,2147.696171873,77
carcassonne-boltzmann260-vs-boltzmann310-1000its,779,702,2196.183950307,2168.074681939,77
carcassonne-uct460-vs-uct440-1000its,779,702,2207.127516535,2138.771592005,77
carcassonne-uct305-vs-uct255-1000its,780,703,2309.109570575,2242.418258506,77
carcassonne-boltzmann50-vs-boltzmann240-1000its,786,709,2130.432257972,2082.456598011,77
carcassonne-boltzmann275-vs-boltzmann350-1000its,789,712,2256.178319417,2231.42371025,77
carcassonne-boltzmann225-vs-boltzmann375-1000its,794,717,2212.535730807,2173.554383776,77
carcassonne-boltzmann30-vs-boltzmann250-1000its,794,717,2204.584849898,2157.086313946,77
carcassonne-boltzmann290-vs-boltzmann60-1000its,797,720,2268.018322633,2201.305093996,77
carcassonne-uct335-vs-uct480-1000its,797,720,2193.169100898,2116.983697823,77
carcassonne-ucttuned395-vs-ucttuned425-1000its,801,724,2259.206846418,2242.173086948,77
carcassonne-uct85-vs-uct170-1000its,807,730,2182.872132517,2092.51919182,77
carcassonne-ucttuned295-vs-ucttuned30-1000its,810,733,2191.514690252,2117.452519688,77
carcassonne-ucttuned315-vs-ucttuned445-1000its,811,734,2205.584302742,2213.642411432,77
carcassonne-boltzmann25-vs-boltzmann200-1000its,812,735,2162.037616166,2129.066361241,77
carcassonne-boltzmann85-vs-boltzmann150-1000its,812,735,2244.916647152,2201.270057786,77
carcassonne-boltzmann460-vs-boltzmann345-1000its,816,739,2202.560996739,2147.246157762,77
carcassonne-uct290-vs-uct165-1000its,817,740,2161.983683474,2144.077063562,77
carcassonne-boltzmann350-vs-boltzmann320-1000its,818,741,2176.338160274,2153.209936252,77
carcassonne-boltzmann430-vs-boltzmann220-1000its,818,741,2205.285235091,2157.635031659,77
carcassonne-boltzmann210-vs-boltzmann465-1000its,820,743,2108.068237611,2091.025664994,77
carcassonne-uct375-vs-uct140-1000its,821,744,2212.958793296,2153.938037703,77
carcassonne-ucttuned390-vs-ucttuned485-1000its,821,744,2230.980574568,2146.711560284,77
carcassonne-ucttuned415-vs-ucttuned110-1000its,821,744,2211.51167319,2139.576987326,77
carcassonne-boltzmann165-vs-boltzmann440-1000its,822,745,2245.395714966,2151.65686136,77
carcassonne-uct180-vs-uct395-1000its,823,746,2204.97174911,2118.54994398,77
carcassonne-uct305-vs-uct310-1000its,824,747,2240.150478284,2158.608928599,77
carcassonne-ucttuned400-vs-ucttuned140-1000its,824,747,2167.945462129,2131.322567892,77
carcassonne-boltzmann245-vs-boltzmann265-1000its,827,750,2206.137173097,2139.778594055,77
carcassonne-ucttuned30-vs-ucttuned205-1000its,827,750,2230.069320585,2181.968746122,77
carcassonne-boltzmann150-vs-boltzmann140-1000its,828,751,2151.955258626,2138.444611525,77
carcassonne-ucttuned395-vs-ucttuned265-1000its,830,753,2158.71999557,2128.159245957,77
carcassonne-boltzmann80-vs-boltzmann30-1000its,831,754,2183.657496001,2143.314206251,77
carcassonne-uct285-vs-uct380-1000its,832,755,2232.014849926,2194.449089304,77
carcassonne-boltzmann290-vs-boltzmann135-1000its,834,757,2156.735147265,2104.794868215,77
carcassonne-uct90-vs-uct400-1000its,836,759,2201.114429769,2152.538241406,77
carcassonne-ucttuned315-vs-ucttuned415-1000its,836,759,2267.523902756,2207.316884928,77
carcassonne-boltzmann285-vs-boltzmann420-1000its,837,760,2272.525170809,2258.906220505,77
carcassonne-ucttuned210-vs-ucttuned340-1000its,837,760,2239.107980361,2258.566808729,77
carcassonne-boltzmann485-vs-boltzmann435-1000its,839,762,2220.78330028,2183.764646287,77
carcassonne-uct155-vs-uct65-1000its,839,762,2134.627191104,2111.330304491,77
carcassonne-uct265-vs-uct405-1000its,841,764,2149.957132984,2147.775394344,77
carcassonne-boltzmann75-vs-boltzmann15-1000its,842,765,2269.124990452,2239.579410266,77
carcassonne-uct485-vs-uct110-1000its,842,765,2204.442563298,2161.291726952,77
carcassonne-ucttuned225-vs-ucttuned285-1000its,842,765,2202.563975999,2157.175123365,77
carcassonne-ucttuned290-vs-ucttuned345-1000its,842,765,2128.667358871,2148.581417158,77
carcassonne-boltzmann280-vs-boltzmann425-1000its,843,766,2286.830031029,2252.91831149,77
carcassonne-ucttuned280-vs-ucttuned160-1000its,844,767,2201.141834346,2173.920640701,77
carcassonne-uct255-vs-uct340-1000its,845,768,2209.209384629,2114.997242911,77
carcassonne-boltzmann205-vs-boltzmann340-1000its,847,770,2237.060662343,2165.750017146,77
carcassonne-boltzmann365-vs-boltzmann165-1000its,848,771,2231.957750455,2198.206890293,77
carcassonne-ucttuned120-vs-ucttuned125-1000its,849,772,2151.640015124,2095.120755328,77
carcassonne-ucttuned255-vs-ucttuned150-1000its,850,773,2222.269806737,2152.828110345,77
carcassonne-boltzmann300-vs-boltzmann195-1000its,852,775,2257.821673882,2189.728739202,77
carcassonne-boltzmann195-vs-boltzmann30-1000its,855,778,2203.211881863,2160.690375722,77
carcassonne-boltzmann90-vs-boltzmann490-1000its,855,778,2197.339440067,2189.974507908,77
carcassonne-ucttuned400-vs-ucttuned115-1000its,857,780,2141.310485572,2093.970941848,77
carcassonne-ucttuned125-vs-ucttuned155-1000its,859,782,2194.408072658,2121.121941417,77
carcassonne-boltzmann390-vs-boltzmann160-1000its,860,783,2257.684701584,2227.64070695,77
carcassonne-boltzmann145-vs-boltzmann205-1000its,861,784,2279.947235998,2241.017618931,77
carcassonne-uct155-vs-uct205-1000its,861,784,2189.713768772,2144.122178521,77
carcassonne-uct450-vs-uct90-1000its,861,784,2170.616388278,2154.043070801,77
carcassonne-ucttuned330-vs-ucttuned120-1000its,863,786,2164.116831294,2138.744377653,77
carcassonne-uct285-vs-uct215-1000its,865,788,2134.792090545,2109.594578998,77
carcassonne-uct445-vs-uct185-1000its,865,788,2211.638228441,2170.181937567,77
carcassonne-boltzmann180-vs-boltzmann165-1000its,866,789,2176.239944195,2115.876618074,77
carcassonne-uct165-vs-uct245-1000its,867,790,2187.664989737,2167.345358149,77
carcassonne-uct445-vs-uct110-1000its,867,790,2272.52613311,2235.308905326,77
carcassonne-boltzmann410-vs-boltzmann265-1000its,868,791,2184.181791679,2149.830652409,77
carcassonne-ucttuned485-vs-ucttuned480-1000its,869,792,2217.535742501,2124.372954635,77
carcassonne-ucttuned20-vs-ucttuned285-1000its,870,793,2188.98524449,2113.468764923,77
carcassonne-boltzmann190-vs-boltzmann80-1000its,872,795,2186.472583216,2157.30681448,77
carcassonne-uct460-vs-uct420-1000its,874,797,2212.399051605,2159.634856551,77
carcassonne-boltzmann200-vs-boltzmann135-1000its,876,799,2252.804521394,2218.515557732,77
carcassonne-ucttuned180-vs-ucttuned255-1000its,876,799,2183.522205372,2105.579336075,77
carcassonne-uct430-vs-uct370-1000its,877,800,2140.85538943,2064.577141139,77
carcassonne-ucttuned50-vs-ucttuned485-1000its,877,800,2187.900701985,2146.511002828,77
carcassonne-boltzmann240-vs-boltzmann345-1000its,880,803,2243.329919735,2185.40522374,77
carcassonne-uct415-vs-uct255-1000its,881,804,2203.550446757,2128.704370792,77
carcassonne-ucttuned70-vs-ucttuned420-1000its,881,804,2298.866850594,2223.362100225,77
carcassonne-uct95-vs-uct440-1000its,883,806,2242.628602763,2164.653495173,77
carcassonne-boltzmann180-vs-boltzmann275-1000its,885,808,2237.047002155,2171.528013257,77
carcassonne-boltzmann415-vs-boltzmann400-1000its,885,808,2169.985288238,2119.479986548,77
carcassonne-uct465-vs-uct485-1000its,885,808,2171.096258918,2166.650474888,77
carcassonne-uct145-vs-uct90-1000its,886,809,2145.751184069,2095.323104962,77
carcassonne-ucttuned85-vs-ucttuned285-1000its,889,812,2149.522185699,2151.219855629,77
carcassonne-uct475-vs-uct200-1000its,890,813,2213.523187191,2156.535137235,77
carcassonne-ucttuned190-vs-ucttuned470-1000its,890,813,2195.281805504,2158.986477095,77
carcassonne-ucttuned360-vs-ucttuned365-1000its,891,814,2169.618735726,2146.006750161,77
carcassonne-ucttuned420-vs-ucttuned225-1000its,891,814,2177.963910992,2119.155494907,77
carcassonne-boltzmann15-vs-boltzmann245-1000its,892,815,2196.98355505,2137.652507092,77
carcassonne-boltzmann180-vs-boltzmann300-1000its,892,815,2161.405826064,2089.980072982,77
carcassonne-ucttuned400-vs-ucttuned50-1000its,895,818,2212.073603191,2208.313061749,77
carcassonne-ucttuned50-vs-ucttuned70-1000its,895,818,2287.189325111,2201.705460215,77
carcassonne-uct195-vs-uct180-1000its,896,819,2242.389573984,2223.510281841,77
carcassonne-uct300-vs-uct270-1000its,898,821,2128.406476622,2042.908430044,77
carcassonne-uct65-vs-uct220-1000its,900,823,2172.648866219,2131.78395397,77
carcassonne-uct285-vs-uct265-1000its,902,825,2208.397692482,2119.496885314,77
carcassonne-uct405-vs-uct380-1000its,905,828,2105.911507453,2038.455925738,77
carcassonne-boltzmann155-vs-boltzmann25-1000its,908,831,2202.764302848,2164.162676629,77
carcassonne-boltzmann310-vs-boltzmann450-1000its,908,831,2214.021489225,2145.220039977,77
carcassonne-uct295-vs-uct340-1000its,911,834,2187.4078409,2118.083628804,77
carcassonne-uct390-vs-uct405-1000its,911,834,2149.539110833,2129.994479183,77
carcassonne-boltzmann265-vs-boltzmann275-1000its,915,838,2226.093549705,2222.911954831,77
carcassonne-ucttuned145-vs-ucttuned390-1000its,915,838,2223.495622197,2153.77863469,77
carcassonne-ucttuned45-vs-ucttuned440-1000its,918,841,2167.833894967,2160.522108782,77
carcassonne-ucttuned335-vs-ucttuned210-1000its,919,842,2183.13373996,2157.225966773,77
carcassonne-boltzmann410-vs-boltzmann435-1000its,926,849,2196.047698413,2168.464148804,77
carcassonne-uct75-vs-uct115-1000its,927,850,2292.813554894,2297.211629306,77
carcassonne-boltzmann290-vs-boltzmann390-1000its,935,858,2148.790661361,2116.268556665,77
carcassonne-boltzmann290-vs-boltzmann385-1000its,960,883,2260.970111968,2233.575911931,77
carcassonne-boltzmann115-vs-boltzmann110-1000its,761,683,2143.516484324,2103.120811444,78
carcassonne-ucttuned50-vs-ucttuned145-1000its,769,691,2179.961575959,2107.289123453,78
carcassonne-boltzmann420-vs-boltzmann320-1000its,772,694,2264.64532983,2231.927120538,78
carcassonne-boltzmann20-vs-boltzmann310-1000its,774,696,2167.828593366,2114.085927138,78
carcassonne-ucttuned385-vs-ucttuned495-1000its,776,698,2186.162958465,2125.207125961,78
carcassonne-ucttuned200-vs-ucttuned100-1000its,778,700,2244.900844285,2154.121296663,78
carcassonne-boltzmann60-vs-boltzmann300-1000its,790,712,2192.35187195,2134.11274545,78
carcassonne-boltzmann105-vs-boltzmann85-1000its,792,714,2197.032371736,2125.218981413,78
carcassonne-uct5-vs-uct395-1000its,793,715,2152.329984038,2088.534515816,78
carcassonne-boltzmann310-vs-boltzmann485-1000its,797,719,2196.675232357,2165.925007243,78
carcassonne-boltzmann25-vs-boltzmann85-1000its,799,721,2220.968983442,2172.323614651,78
carcassonne-uct375-vs-uct300-1000its,799,721,2217.198783273,2155.558965235,78
carcassonne-boltzmann435-vs-boltzmann415-1000its,805,727,2196.064184238,2138.986655782,78
carcassonne-boltzmann365-vs-boltzmann345-1000its,807,729,2149.983374554,2150.598889585,78
carcassonne-boltzmann405-vs-boltzmann20-1000its,807,729,2141.869390008,2102.998142474,78
carcassonne-uct145-vs-uct300-1000its,809,731,2158.313296684,2124.543536125,78
carcassonne-uct465-vs-uct350-1000its,811,733,2183.092593973,2189.239886087,78
carcassonne-ucttuned440-vs-ucttuned315-1000its,812,734,2246.892207104,2181.317575383,78
carcassonne-boltzmann280-vs-boltzmann440-1000its,815,737,2210.378936127,2141.840659402,78
carcassonne-ucttuned195-vs-ucttuned210-1000its,816,738,2135.873599625,2100.654319942,78
carcassonne-uct95-vs-uct280-1000its,818,740,2231.427820514,2171.898884124,78
carcassonne-ucttuned375-vs-ucttuned370-1000its,818,740,2217.314324236,2217.766243026,78
carcassonne-uct150-vs-uct60-1000its,819,741,2271.019050378,2191.158818732,78
carcassonne-uct450-vs-uct265-1000its,823,745,2129.745518838,2085.126678655,78
carcassonne-ucttuned150-vs-ucttuned175-1000its,823,745,2214.448980638,2174.105537117,78
carcassonne-boltzmann295-vs-boltzmann190-1000its,825,747,2120.72177756,2141.217010356,78
carcassonne-boltzmann80-vs-boltzmann215-1000its,825,747,2197.144622808,2173.504082387,78
carcassonne-uct220-vs-uct160-1000its,827,749,2215.829845552,2179.195084254,78
carcassonne-boltzmann50-vs-boltzmann245-1000its,829,751,2143.76344708,2090.383792953,78
carcassonne-ucttuned130-vs-ucttuned315-1000its,829,751,2259.515265056,2192.69529042,78
carcassonne-boltzmann155-vs-boltzmann365-1000its,832,754,2175.711013285,2123.07990938,78
carcassonne-boltzmann305-vs-boltzmann245-1000its,832,754,2148.861719191,2113.660180224,78
carcassonne-boltzmann85-vs-boltzmann335-1000its,833,755,2129.616359953,2137.682105959,78
carcassonne-boltzmann95-vs-boltzmann400-1000its,833,755,2215.058773256,2139.182648417,78
carcassonne-boltzmann270-vs-boltzmann375-1000its,834,756,2190.958883512,2134.497388955,78
carcassonne-ucttuned315-vs-ucttuned385-1000its,836,758,2216.742070636,2166.299604213,78
carcassonne-boltzmann250-vs-boltzmann230-1000its,837,759,2285.688545798,2226.054464586,78
carcassonne-ucttuned185-vs-ucttuned270-1000its,838,760,2256.700034273,2175.737859822,78
carcassonne-ucttuned245-vs-ucttuned400-1000its,838,760,2200.200609488,2169.192508689,78
carcassonne-boltzmann275-vs-boltzmann375-1000its,839,761,2202.573403009,2165.196174786,78
carcassonne-boltzmann145-vs-boltzmann360-1000its,840,762,2252.21437601,2164.058077489,78
carcassonne-boltzmann470-vs-boltzmann395-1000its,840,762,2178.593771032,2096.510258712,78
carcassonne-uct130-vs-uct105-1000its,840,762,2126.207386991,2059.290054965,78
carcassonne-ucttuned130-vs-ucttuned120-1000its,840,762,2263.989612731,2219.680325298,78
carcassonne-boltzmann290-vs-boltzmann85-1000its,841,763,2240.226369791,2166.5036791,78
carcassonne-boltzmann470-vs-boltzmann345-1000its,841,763,2201.638339446,2145.610225008,78
carcassonne-uct85-vs-uct105-1000its,842,764,2213.891289865,2213.913854758,78
carcassonne-uct85-vs-uct370-1000its,842,764,2171.625690486,2145.856636663,78
carcassonne-ucttuned295-vs-ucttuned485-1000its,842,764,2166.073328336,2129.304055311,78
carcassonne-uct415-vs-uct425-1000its,844,766,2183.417420511,2146.181169628,78
carcassonne-ucttuned285-vs-ucttuned405-1000its,846,768,2152.726293631,2141.668878302,78
carcassonne-ucttuned285-vs-ucttuned190-1000its,847,769,2141.233411727,2100.002839136,78
carcassonne-ucttuned30-vs-ucttuned275-1000its,847,769,2174.243294234,2081.14781365,78
carcassonne-ucttuned105-vs-ucttuned400-1000its,851,773,2194.636304131,2107.708392234,78
carcassonne-uct305-vs-uct245-1000its,853,775,2185.536951573,2141.828597593,78
carcassonne-ucttuned10-vs-ucttuned270-1000its,855,777,2235.536942941,2181.944125336,78
carcassonne-ucttuned145-vs-ucttuned110-1000its,857,779,2171.954124939,2144.443455154,78
carcassonne-uct270-vs-uct40-1000its,858,780,2201.499594873,2159.339388783,78
carcassonne-uct10-vs-uct345-1000its,860,782,2205.732144675,2151.083316137,78
carcassonne-uct355-vs-uct260-1000its,861,783,2244.342547026,2146.780925467,78
carcassonne-ucttuned455-vs-ucttuned85-1000its,861,783,2142.920652138,2097.748550969,78
carcassonne-uct90-vs-uct165-1000its,862,784,2250.011433157,2164.625306015,78
carcassonne-uct145-vs-uct250-1000its,864,786,2185.42111873,2108.06261111,78
carcassonne-uct235-vs-uct475-1000its,865,787,2268.678798217,2198.259429447,78
carcassonne-uct200-vs-uct150-1000its,867,789,2198.051604035,2170.531509025,78
carcassonne-uct40-vs-uct450-1000its,867,789,2247.039785978,2194.936114662,78
carcassonne-uct125-vs-uct240-1000its,868,790,2324.389728951,2240.732026921,78
carcassonne-uct390-vs-uct315-1000its,868,790,2267.297114017,2197.239289916,78
carcassonne-uct485-vs-uct115-1000its,869,791,2254.933669616,2217.345311135,78
carcassonne-ucttuned130-vs-ucttuned30-1000its,869,791,2159.006150908,2168.005282109,78
carcassonne-boltzmann385-vs-boltzmann340-1000its,870,792,2196.582135792,2160.36795055,78
carcassonne-uct95-vs-uct30-1000its,870,792,2206.822427318,2187.777679352,78
carcassonne-ucttuned340-vs-ucttuned285-1000its,870,792,2129.570934543,2089.549906287,78
carcassonne-boltzmann435-vs-boltzmann250-1000its,871,793,2188.912087455,2171.382432895,78
carcassonne-uct130-vs-uct335-1000its,871,793,2182.29793778,2148.696813675,78
carcassonne-uct380-vs-uct175-1000its,872,794,2223.475944183,2174.823010493,78
carcassonne-boltzmann480-vs-boltzmann160-1000its,873,795,2169.151231505,2120.188143226,78
carcassonne-boltzmann130-vs-boltzmann465-1000its,875,797,2171.240985217,2140.806820528,78
carcassonne-uct330-vs-uct200-1000its,876,798,2159.451242682,2162.830556723,78
carcassonne-boltzmann350-vs-boltzmann145-1000its,877,799,2181.381813984,2186.115341705,78
carcassonne-boltzmann95-vs-boltzmann150-1000its,877,799,2190.187450721,2156.961426554,78
carcassonne-ucttuned475-vs-ucttuned365-1000its,877,799,2200.010794901,2146.937088906,78
carcassonne-ucttuned30-vs-ucttuned75-1000its,878,800,2188.652295185,2161.293246313,78
carcassonne-uct280-vs-uct155-1000its,879,801,2139.792783476,2083.97243739,78
carcassonne-ucttuned390-vs-ucttuned120-1000its,879,801,2245.510585706,2217.562198712,78
carcassonne-ucttuned305-vs-ucttuned375-1000its,882,804,2179.718431594,2143.387826049,78
carcassonne-ucttuned70-vs-ucttuned325-1000its,882,804,2193.197964507,2110.792433887,78
carcassonne-ucttuned115-vs-ucttuned405-1000its,883,805,2222.489960839,2236.62515705,78
carcassonne-ucttuned340-vs-ucttuned170-1000its,886,808,2274.070495231,2221.876142623,78
carcassonne-boltzmann10-vs-boltzmann390-1000its,888,810,2287.546075623,2208.629712792,78
carcassonne-ucttuned135-vs-ucttuned460-1000its,888,810,2252.802985759,2219.120218479,78
carcassonne-boltzmann210-vs-boltzmann205-1000its,889,811,2245.56997257,2168.68239202,78
carcassonne-boltzmann60-vs-boltzmann320-1000its,892,814,2252.894922001,2222.600292894,78
carcassonne-ucttuned170-vs-ucttuned160-1000its,892,814,2131.830527404,2075.214080697,78
carcassonne-boltzmann30-vs-boltzmann375-1000its,895,817,2162.426592448,2076.906808902,78
carcassonne-ucttuned265-vs-ucttuned10-1000its,895,817,2128.053614339,2084.736456454,78
carcassonne-ucttuned30-vs-ucttuned175-1000its,897,819,2218.856497674,2155.019595683,78
carcassonne-ucttuned35-vs-ucttuned5-1000its,897,819,2191.252429591,2145.560463162,78
carcassonne-ucttuned45-vs-ucttuned100-1000its,898,820,2196.04655272,2181.186145363,78
carcassonne-boltzmann5-vs-boltzmann455-1000its,900,822,2174.488961382,2105.068880659,78
carcassonne-uct165-vs-uct440-1000its,901,823,2294.579765638,2255.464206283,78
carcassonne-boltzmann110-vs-boltzmann360-1000its,907,829,2193.35082392,2171.345505124,78
carcassonne-uct260-vs-uct250-1000its,908,830,2207.857437114,2168.646908491,78
carcassonne-uct95-vs-uct330-1000its,910,832,2160.852966474,2154.170026514,78
carcassonne-boltzmann40-vs-boltzmann440-1000its,915,837,2240.205582303,2194.834606677,78
carcassonne-uct125-vs-uct450-1000its,919,841,2226.830390728,2188.199528784,78
carcassonne-ucttuned205-vs-ucttuned125-1000its,919,841,2222.047074512,2171.588861899,78
carcassonne-ucttuned430-vs-ucttuned235-1000its,925,847,2245.582575868,2229.04899152,78
carcassonne-uct50-vs-uct245-1000its,937,859,2141.850275598,2095.621423887,78
carcassonne-ucttuned240-vs-ucttuned305-1000its,755,676,2208.128587144,2120.127341759,79
carcassonne-boltzmann430-vs-boltzmann165-1000its,757,678,2188.929490013,2150.194124206,79
carcassonne-uct320-vs-uct345-1000its,766,687,2187.205814081,2157.182035358,79
carcassonne-ucttuned190-vs-ucttuned465-1000its,768,689,2130.051621314,2113.44086915,79
carcassonne-boltzmann180-vs-boltzmann15-1000its,778,699,2250.148644697,2220.778120837,79
carcassonne-boltzmann425-vs-boltzmann490-1000its,781,702,2170.743062932,2141.960923954,79
carcassonne-uct495-vs-uct480-1000its,783,704,2274.145465006,2193.183607863,79
carcassonne-uct460-vs-uct385-1000its,785,706,2258.430040428,2245.216251624,79
carcassonne-boltzmann55-vs-boltzmann210-1000its,787,708,2174.255761522,2165.812707358,79
carcassonne-boltzmann390-vs-boltzmann335-1000its,788,709,2197.05318547,2152.923488323,79
carcassonne-ucttuned60-vs-ucttuned140-1000its,792,713,2143.705497798,2122.664215925,79
carcassonne-boltzmann490-vs-boltzmann200-1000its,793,714,2222.158847405,2207.69945599,79
carcassonne-uct230-vs-uct155-1000its,797,718,2191.772232686,2092.804513258,79
carcassonne-boltzmann435-vs-boltzmann375-1000its,798,719,2140.521048608,2090.439112014,79
carcassonne-ucttuned135-vs-ucttuned115-1000its,798,719,2248.979801908,2191.758233068,79
carcassonne-ucttuned215-vs-ucttuned495-1000its,799,720,2206.896462126,2169.770514353,79
carcassonne-boltzmann165-vs-boltzmann150-1000its,802,723,2206.790815207,2182.196282547,79
carcassonne-boltzmann365-vs-boltzmann415-1000its,803,724,2281.398753157,2218.637855729,79
carcassonne-uct280-vs-uct125-1000its,805,726,2122.493279666,2085.77796957,79
carcassonne-boltzmann485-vs-boltzmann235-1000its,807,728,2202.955394939,2177.219457861,79
carcassonne-uct45-vs-uct60-1000its,807,728,2242.541249117,2153.274254407,79
carcassonne-ucttuned470-vs-ucttuned375-1000its,808,729,2198.526448106,2150.744178306,79
carcassonne-boltzmann290-vs-boltzmann100-1000its,809,730,2155.238919529,2117.203231329,79
carcassonne-ucttuned165-vs-ucttuned70-1000its,809,730,2241.935243911,2186.638138795,79
carcassonne-boltzmann445-vs-boltzmann400-1000its,810,731,2231.951865589,2174.989295607,79
carcassonne-ucttuned130-vs-ucttuned195-1000its,812,733,2240.388817388,2183.718841513,79
carcassonne-ucttuned310-vs-ucttuned485-1000its,812,733,2224.597755341,2125.505136415,79
carcassonne-ucttuned170-vs-ucttuned400-1000its,813,734,2153.512748386,2155.387253588,79
carcassonne-boltzmann125-vs-boltzmann280-1000its,814,735,2236.793508091,2162.970617524,79
carcassonne-boltzmann105-vs-boltzmann15-1000its,817,738,2182.990901002,2150.613366822,79
carcassonne-uct440-vs-uct360-1000its,818,739,2151.784620949,2113.132099743,79
carcassonne-uct15-vs-uct35-1000its,819,740,2209.428755441,2195.972441301,79
carcassonne-uct350-vs-uct120-1000its,819,740,2201.428133525,2122.851255865,79
carcassonne-ucttuned295-vs-ucttuned150-1000its,821,742,2191.822942104,2176.606757589,79
carcassonne-boltzmann405-vs-boltzmann330-1000its,822,743,2210.444542343,2160.540903228,79
carcassonne-ucttuned405-vs-ucttuned125-1000its,822,743,2206.866179557,2122.42532961,79
carcassonne-boltzmann155-vs-boltzmann400-1000its,824,745,2201.657885937,2185.274559248,79
carcassonne-uct60-vs-uct185-1000its,824,745,2271.449872917,2184.68241683,79
carcassonne-uct185-vs-uct445-1000its,826,747,2225.66496748,2190.013074914,79
carcassonne-boltzmann145-vs-boltzmann455-1000its,829,750,2204.551648768,2167.431239924,79
carcassonne-boltzmann185-vs-boltzmann430-1000its,829,750,2192.494565155,2106.692651043,79
carcassonne-uct485-vs-uct450-1000its,830,751,2185.914515748,2139.217843403,79
carcassonne-ucttuned80-vs-ucttuned105-1000its,831,752,2155.459817545,2151.032256164,79
carcassonne-boltzmann320-vs-boltzmann225-1000its,832,753,2222.020365509,2151.203757289,79
carcassonne-uct75-vs-uct90-1000its,832,753,2207.289813282,2163.367725874,79
carcassonne-uct160-vs-uct205-1000its,834,755,2205.120494299,2151.483065649,79
carcassonne-uct185-vs-uct365-1000its,835,756,2135.864573236,2085.168350906,79
carcassonne-uct250-vs-uct5-1000its,835,756,2268.849249526,2246.256582389,79
carcassonne-boltzmann450-vs-boltzmann120-1000its,836,757,2242.405803225,2150.209076082,79
carcassonne-boltzmann85-vs-boltzmann40-1000its,836,757,2154.023121747,2132.533701414,79
carcassonne-uct260-vs-uct115-1000its,836,757,2277.19978023,2218.173679103,79
carcassonne-ucttuned475-vs-ucttuned405-1000its,838,759,2153.806033024,2108.965180119,79
carcassonne-boltzmann190-vs-boltzmann340-1000its,840,761,2197.167860424,2130.484113387,79
carcassonne-uct430-vs-uct335-1000its,841,762,2222.754476644,2160.686122139,79
carcassonne-boltzmann100-vs-boltzmann245-1000its,842,763,2215.689800917,2125.293596783,79
carcassonne-boltzmann155-vs-boltzmann225-1000its,842,763,2184.497078826,2124.843384834,79
carcassonne-boltzmann480-vs-boltzmann460-1000its,842,763,2194.084550689,2174.390705974,79
carcassonne-boltzmann425-vs-boltzmann380-1000its,843,764,2199.363331009,2166.246878222,79
carcassonne-uct20-vs-uct390-1000its,843,764,2171.865492482,2152.483913708,79
carcassonne-uct140-vs-uct315-1000its,844,765,2250.636570229,2188.039833754,79
carcassonne-ucttuned280-vs-ucttuned200-1000its,844,765,2221.997144536,2175.636692015,79
carcassonne-ucttuned330-vs-ucttuned460-1000its,844,765,2220.185866717,2181.299855148,79
carcassonne-boltzmann460-vs-boltzmann465-1000its,845,766,2198.117749666,2133.240650823,79
carcassonne-uct70-vs-uct230-1000its,846,767,2194.533317126,2130.491939969,79
carcassonne-boltzmann135-vs-boltzmann145-1000its,847,768,2183.995485116,2144.977605232,79
carcassonne-boltzmann410-vs-boltzmann315-1000its,847,768,2215.465191815,2144.318096935,79
carcassonne-uct185-vs-uct435-1000its,848,769,2233.061893503,2210.283034976,79
carcassonne-boltzmann265-vs-boltzmann130-1000its,849,770,2252.310580922,2216.310860868,79
carcassonne-uct310-vs-uct250-1000its,850,771,2127.737169819,2136.76851504,79
carcassonne-uct445-vs-uct100-1000its,850,771,2146.835322374,2065.885809369,79
carcassonne-ucttuned75-vs-ucttuned100-1000its,850,771,2180.77324716,2150.993537632,79
carcassonne-boltzmann195-vs-boltzmann185-1000its,851,772,2201.656914523,2156.048772691,79
carcassonne-uct165-vs-uct350-1000its,852,773,2235.004828463,2206.394477525,79
carcassonne-uct390-vs-uct285-1000its,852,773,2254.065931164,2160.236476113,79
carcassonne-ucttuned410-vs-ucttuned490-1000its,852,773,2170.54226062,2161.957372055,79
carcassonne-ucttuned475-vs-ucttuned495-1000its,852,773,2217.106909912,2166.335260023,79
carcassonne-uct290-vs-uct425-1000its,853,774,2211.652037458,2188.712092092,79
carcassonne-boltzmann215-vs-boltzmann360-1000its,854,775,2207.542901843,2146.449217439,79
carcassonne-uct280-vs-uct55-1000its,855,776,2216.430370743,2184.097201178,79
carcassonne-uct15-vs-uct220-1000its,856,777,2164.995552426,2127.564695584,79
carcassonne-ucttuned150-vs-ucttuned100-1000its,856,777,2167.447618916,2142.844861696,79
carcassonne-boltzmann435-vs-boltzmann400-1000its,857,778,2254.10964138,2215.469239981,79
carcassonne-boltzmann245-vs-boltzmann340-1000its,858,779,2196.815561142,2170.862462043,79
carcassonne-uct475-vs-uct145-1000its,860,781,2159.887674224,2144.463969586,79
carcassonne-ucttuned120-vs-ucttuned195-1000its,861,782,2150.040378614,2073.913309743,79
carcassonne-ucttuned70-vs-ucttuned430-1000its,861,782,2199.923569284,2173.103167484,79
carcassonne-uct415-vs-uct300-1000its,862,783,2243.357812031,2146.653846056,79
carcassonne-ucttuned150-vs-ucttuned310-1000its,864,785,2272.548936331,2193.46897969,79
carcassonne-uct130-vs-uct260-1000its,866,787,2240.481506986,2146.471276129,79
carcassonne-ucttuned330-vs-ucttuned270-1000its,866,787,2156.815956651,2152.242760405,79
carcassonne-ucttuned490-vs-ucttuned465-1000its,870,791,2306.896677997,2292.942829849,79
carcassonne-boltzmann30-vs-boltzmann325-1000its,871,792,2277.320840942,2198.216790158,79
carcassonne-boltzmann460-vs-boltzmann310-1000its,871,792,2280.158057399,2196.074221305,79
carcassonne-ucttuned225-vs-ucttuned345-1000its,871,792,2137.166614979,2136.298137372,79
carcassonne-boltzmann380-vs-boltzmann70-1000its,873,794,2233.18902204,2153.452991468,79
carcassonne-uct235-vs-uct485-1000its,874,795,2148.057647661,2101.652628942,79
carcassonne-boltzmann240-vs-boltzmann470-1000its,875,796,2260.473100485,2205.537154565,79
carcassonne-boltzmann280-vs-boltzmann410-1000its,875,796,2131.951302076,2098.875407842,79
carcassonne-uct280-vs-uct475-1000its,879,800,2146.10122466,2073.615415285,79
carcassonne-ucttuned25-vs-ucttuned330-1000its,881,802,2185.071196924,2165.497881792,79
carcassonne-uct35-vs-uct395-1000its,882,803,2159.918523279,2141.176287766,79
carcassonne-uct490-vs-uct180-1000its,884,805,2167.965618043,2135.945594559,79
carcassonne-ucttuned160-vs-ucttuned255-1000its,884,805,2200.529246535,2135.106085888,79
carcassonne-boltzmann120-vs-boltzmann45-1000its,891,812,2195.756697942,2191.451533875,79
carcassonne-ucttuned65-vs-ucttuned425-1000its,893,814,2232.121632466,2166.005987067,79
carcassonne-ucttuned485-vs-ucttuned225-1000its,895,816,2188.197350741,2131.22706255,79
carcassonne-boltzmann105-vs-boltzmann455-1000its,897,818,2165.873262,2172.249179511,79
carcassonne-boltzmann95-vs-boltzmann350-1000its,901,822,2176.478840429,2123.24040051,79
carcassonne-ucttuned285-vs-ucttuned225-1000its,904,825,2227.071579515,2193.058676388,79
carcassonne-boltzmann340-vs-boltzmann100-1000its,910,831,2173.364995632,2146.6238723,79
carcassonne-boltzmann460-vs-boltzmann285-1000its,910,831,2173.247599281,2115.665230787,79
carcassonne-boltzmann490-vs-boltzmann240-1000its,910,831,2257.250398127,2185.445443583,79
carcassonne-uct315-vs-uct70-1000its,910,831,2154.761048263,2100.810507249,79
carcassonne-uct260-vs-uct485-1000its,918,839,2200.735364116,2101.02355385,79
carcassonne-ucttuned40-vs-ucttuned5-1000its,923,844,2182.599330566,2116.934200677,79
carcassonne-ucttuned395-vs-ucttuned360-1000its,760,680,2217.074855507,2146.304999574,80
carcassonne-boltzmann35-vs-boltzmann460-1000its,766,686,2254.38644236,2193.790978994,80
carcassonne-uct415-vs-uct20-1000its,771,691,2175.47126132,2170.488351746,80
carcassonne-boltzmann10-vs-boltzmann15-1000its,784,704,2140.006425195,2150.321405751,80
carcassonne-uct85-vs-uct385-1000its,786,706,2230.809397965,2137.782872536,80
carcassonne-boltzmann390-vs-boltzmann85-1000its,787,707,2172.27034531,2126.031367671,80
carcassonne-uct260-vs-uct165-1000its,790,710,2223.895309843,2107.942235842,80
carcassonne-ucttuned345-vs-ucttuned405-1000its,790,710,2283.653314945,2233.151763263,80
carcassonne-boltzmann90-vs-boltzmann430-1000its,791,711,2234.48394803,2176.619408647,80
carcassonne-uct170-vs-uct275-1000its,800,720,2219.591980138,2136.429829463,80
carcassonne-uct50-vs-uct310-1000its,800,720,2144.053609538,2099.656239695,80
carcassonne-uct195-vs-uct155-1000its,803,723,2178.02955085,2149.023465054,80
carcassonne-uct190-vs-uct390-1000its,804,724,2191.455302961,2162.928472053,80
carcassonne-uct375-vs-uct465-1000its,805,725,2197.000520954,2167.50125305,80
carcassonne-uct210-vs-uct490-1000its,807,727,2189.901775309,2153.159865467,80
carcassonne-ucttuned130-vs-ucttuned70-1000its,807,727,2249.092154829,2189.881995662,80
carcassonne-boltzmann40-vs-boltzmann455-1000its,808,728,2169.688852825,2148.312042437,80
carcassonne-boltzmann270-vs-boltzmann315-1000its,809,729,2190.191763096,2152.411440872,80
carcassonne-uct415-vs-uct60-1000its,812,732,2179.737577264,2110.759760914,80
carcassonne-boltzmann485-vs-boltzmann300-1000its,813,733,2178.269418688,2178.319322882,80
carcassonne-boltzmann170-vs-boltzmann80-1000its,815,735,2133.431241816,2134.470196741,80
carcassonne-uct385-vs-uct400-1000its,815,735,2234.936210447,2167.417561017,80
carcassonne-uct115-vs-uct210-1000its,816,736,2256.897107763,2213.008888889,80
carcassonne-ucttuned310-vs-ucttuned35-1000its,816,736,2216.219488301,2228.736673217,80
carcassonne-uct40-vs-uct415-1000its,818,738,2179.971274912,2112.04293618,80
carcassonne-boltzmann125-vs-boltzmann470-1000its,821,741,2271.045918684,2233.631315488,80
carcassonne-ucttuned115-vs-ucttuned205-1000its,822,742,2139.574064738,2084.90405837,80
carcassonne-uct245-vs-uct110-1000its,823,743,2216.662343807,2153.551238632,80
carcassonne-uct470-vs-uct405-1000its,824,744,2176.961001964,2169.515517199,80
carcassonne-ucttuned100-vs-ucttuned420-1000its,825,745,2179.903539957,2139.161900816,80
carcassonne-ucttuned25-vs-ucttuned160-1000its,827,747,2243.857183228,2209.507509135,80
carcassonne-uct175-vs-uct305-1000its,828,748,2198.804436422,2206.581704354,80
carcassonne-uct315-vs-uct490-1000its,828,748,2148.771143626,2124.668222171,80
carcassonne-boltzmann215-vs-boltzmann275-1000its,831,751,2251.832662971,2190.75102479,80
carcassonne-boltzmann220-vs-boltzmann330-1000its,831,751,2234.3636662,2173.459892624,80
carcassonne-uct245-vs-uct325-1000its,832,752,2207.213402143,2163.442245538,80
carcassonne-boltzmann235-vs-boltzmann370-1000its,833,753,2167.174103223,2068.126160324,80
carcassonne-boltzmann165-vs-boltzmann145-1000its,834,754,2187.553865113,2162.951772722,80
carcassonne-ucttuned250-vs-ucttuned340-1000its,835,755,2123.983062748,2144.553560597,80
carcassonne-ucttuned250-vs-ucttuned450-1000its,835,755,2213.214170946,2167.010412232,80
carcassonne-boltzmann495-vs-boltzmann450-1000its,836,756,2179.897696637,2135.928690067,80
carcassonne-uct205-vs-uct40-1000its,838,758,2209.695714138,2150.834857891,80
carcassonne-uct30-vs-uct285-1000its,838,758,2142.005822605,2108.345100107,80
carcassonne-boltzmann270-vs-boltzmann470-1000its,840,760,2170.010570371,2106.79696391,80
carcassonne-ucttuned400-vs-ucttuned440-1000its,841,761,2236.020584095,2195.57023503,80
carcassonne-boltzmann490-vs-boltzmann285-1000its,842,762,2135.971495607,2088.46714739,80
carcassonne-uct325-vs-uct465-1000its,842,762,2225.142849888,2144.845950684,80
carcassonne-boltzmann335-vs-boltzmann375-1000its,843,763,2206.328772733,2140.080702534,80
carcassonne-boltzmann85-vs-boltzmann35-1000its,844,764,2187.438350287,2144.499430895,80
carcassonne-uct225-vs-uct145-1000its,844,764,2105.929260762,2075.600860561,80
carcassonne-ucttuned35-vs-ucttuned50-1000its,844,764,2180.678967594,2125.194671877,80
carcassonne-boltzmann335-vs-boltzmann180-1000its,845,765,2162.26249752,2148.058344248,80
carcassonne-ucttuned130-vs-ucttuned175-1000its,845,765,2205.127512849,2090.710690682,80
carcassonne-boltzmann140-vs-boltzmann170-1000its,846,766,2216.128530699,2131.321444619,80
carcassonne-uct270-vs-uct25-1000its,848,768,2150.603158847,2070.574401271,80
carcassonne-ucttuned155-vs-ucttuned135-1000its,848,768,2178.450647289,2106.370471045,80
carcassonne-uct145-vs-uct450-1000its,849,769,2266.486250098,2203.278900788,80
carcassonne-ucttuned480-vs-ucttuned360-1000its,849,769,2147.200669498,2101.294631927,80
carcassonne-boltzmann170-vs-boltzmann220-1000its,850,770,2234.696394644,2183.500839458,80
carcassonne-boltzmann165-vs-boltzmann110-1000its,853,773,2264.157086906,2196.990352478,80
carcassonne-boltzmann230-vs-boltzmann135-1000its,854,774,2219.855989549,2120.787480381,80
carcassonne-uct180-vs-uct450-1000its,854,774,2199.462028487,2111.813629926,80
carcassonne-ucttuned25-vs-ucttuned370-1000its,854,774,2157.482748284,2123.210381907,80
carcassonne-ucttuned65-vs-ucttuned420-1000its,854,774,2259.880141841,2239.619218768,80
carcassonne-boltzmann480-vs-boltzmann255-1000its,855,775,2233.013203274,2201.252561985,80
carcassonne-uct205-vs-uct465-1000its,856,776,2210.909364484,2143.899033503,80
carcassonne-ucttuned80-vs-ucttuned365-1000its,856,776,2151.402859381,2104.216867997,80
carcassonne-boltzmann45-vs-boltzmann405-1000its,857,777,2181.96256725,2179.624993648,80
carcassonne-uct95-vs-uct475-1000its,857,777,2202.037512522,2121.296270274,80
carcassonne-uct110-vs-uct220-1000its,859,779,2190.044769262,2154.781316661,80
carcassonne-ucttuned490-vs-ucttuned335-1000its,859,779,2147.306569232,2095.46614065,80
carcassonne-uct135-vs-uct420-1000its,860,780,2149.887660255,2112.368828799,80
carcassonne-uct235-vs-uct410-1000its,860,780,2182.485547986,2141.991484799,80
carcassonne-ucttuned235-vs-ucttuned330-1000its,861,781,2122.703166685,2066.541296968,80
carcassonne-uct330-vs-uct345-1000its,862,782,2224.178870482,2135.006990968,80
carcassonne-uct325-vs-uct340-1000its,863,783,2205.759418062,2149.241199135,80
carcassonne-uct345-vs-uct430-1000its,863,783,2201.668993949,2132.810023957,80
carcassonne-boltzmann490-vs-boltzmann475-1000its,864,784,2210.557152765,2133.073867175,80
carcassonne-boltzmann435-vs-boltzmann460-1000its,865,785,2124.212478736,2112.320733961,80
carcassonne-uct475-vs-uct105-1000its,865,785,2264.943516948,2185.886032093,80
carcassonne-uct150-vs-uct190-1000its,867,787,2214.912746514,2144.183507444,80
carcassonne-uct460-vs-uct30-1000its,867,787,2269.67926633,2215.977511954,80
carcassonne-ucttuned360-vs-ucttuned260-1000its,867,787,2262.580415658,2215.026486851,80
carcassonne-uct345-vs-uct300-1000its,868,788,2235.727649141,2217.752197589,80
carcassonne-uct185-vs-uct275-1000its,869,789,2234.700849275,2226.928103368,80
carcassonne-boltzmann165-vs-boltzmann50-1000its,870,790,2246.052546002,2175.001818169,80
carcassonne-uct235-vs-uct60-1000its,871,791,2205.58690738,2191.382782345,80
carcassonne-uct360-vs-uct475-1000its,871,791,2161.364137666,2105.586941333,80
carcassonne-boltzmann370-vs-boltzmann150-1000its,872,792,2171.789694483,2144.54364337,80
carcassonne-boltzmann460-vs-boltzmann355-1000its,873,793,2203.713180872,2159.673038649,80
carcassonne-uct390-vs-uct430-1000its,873,793,2233.00530985,2143.526707957,80
carcassonne-ucttuned320-vs-ucttuned460-1000its,873,793,2225.400975599,2200.647787237,80
carcassonne-boltzmann130-vs-boltzmann445-1000its,876,796,2213.924819225,2140.962124239,80
carcassonne-ucttuned385-vs-ucttuned210-1000its,877,797,2228.042567991,2168.99740504,80
carcassonne-uct305-vs-uct330-1000its,878,798,2231.28732171,2181.258899237,80
carcassonne-ucttuned50-vs-ucttuned365-1000its,878,798,2211.455522086,2148.501268872,80
carcassonne-boltzmann375-vs-boltzmann400-1000its,879,799,2230.250508273,2190.384526007,80
carcassonne-ucttuned50-vs-ucttuned125-1000its,879,799,2225.920494427,2185.89713233,80
carcassonne-uct115-vs-uct270-1000its,882,802,2159.819386876,2125.850861422,80
carcassonne-boltzmann365-vs-boltzmann310-1000its,883,803,2150.586420638,2073.804470875,80
carcassonne-uct400-vs-uct350-1000its,883,803,2254.742851111,2160.570922597,80
carcassonne-ucttuned75-vs-ucttuned355-1000its,885,805,2237.60110401,2176.723887501,80
carcassonne-uct305-vs-uct425-1000its,889,809,2179.802870457,2122.839708095,80
carcassonne-uct310-vs-uct415-1000its,891,811,2149.065807662,2101.184240425,80
carcassonne-ucttuned310-vs-ucttuned130-1000its,892,812,2207.369128121,2163.346620078,80
carcassonne-ucttuned315-vs-ucttuned250-1000its,894,814,2204.399591065,2144.417311453,80
carcassonne-ucttuned495-vs-ucttuned50-1000its,895,815,2174.011981685,2166.289020066,80
carcassonne-boltzmann30-vs-boltzmann445-1000its,896,816,2215.249960676,2142.770596809,80
carcassonne-uct405-vs-uct395-1000its,900,820,2162.801259869,2100.901844055,80
carcassonne-uct315-vs-uct220-1000its,902,822,2203.434643538,2198.172095395,80
carcassonne-ucttuned275-vs-ucttuned265-1000its,906,826,2221.562970937,2176.46544713,80
carcassonne-uct215-vs-uct240-1000its,908,828,2206.042664287,2197.652265602,80
carcassonne-uct70-vs-uct95-1000its,909,829,2228.558217428,2189.283093711,80
carcassonne-uct165-vs-uct410-1000its,916,836,2167.213979908,2173.77575507,80
carcassonne-boltzmann140-vs-boltzmann270-1000its,917,837,2225.653892976,2160.703649008,80
carcassonne-ucttuned100-vs-ucttuned360-1000its,919,839,2126.282306734,2089.690883432,80
carcassonne-ucttuned35-vs-ucttuned260-1000its,922,842,2176.619311928,2150.63079386,80
carcassonne-boltzmann55-vs-boltzmann300-1000its,929,849,2232.696098274,2143.291779533,80
carcassonne-uct255-vs-uct215-1000its,941,861,2217.851206613,2153.884763341,80
carcassonne-boltzmann465-vs-boltzmann305-1000its,945,865,2212.629694559,2191.384501728,80
carcassonne-ucttuned250-vs-ucttuned25-1000its,955,875,2125.163386753,2116.570395831,80
carcassonne-ucttuned215-vs-ucttuned105-1000its,965,885,2219.45865723,2202.554398555,80
carcassonne-uct425-vs-uct480-1000its,969,889,2247.040589344,2170.965013592,80
carcassonne-uct70-vs-uct135-1000its,982,902,2194.939326509,2159.486916953,80
carcassonne-boltzmann195-vs-boltzmann165-1000its,748,667,2244.106866993,2224.691181634,81
carcassonne-uct155-vs-uct335-1000its,752,671,2156.219818852,2141.318257081,81
carcassonne-boltzmann30-vs-boltzmann460-1000its,760,679,2190.804141951,2133.525764876,81
carcassonne-boltzmann390-vs-boltzmann175-1000its,767,686,2278.377948818,2200.708718198,81
carcassonne-boltzmann220-vs-boltzmann55-1000its,783,702,2215.221028914,2178.675630489,81
carcassonne-ucttuned415-vs-ucttuned120-1000its,790,709,2203.869040309,2144.086153592,81
carcassonne-ucttuned270-vs-ucttuned75-1000its,792,711,2144.902614119,2115.378333121,81
carcassonne-uct310-vs-uct400-1000its,793,712,2154.211872574,2118.769409867,81
carcassonne-boltzmann280-vs-boltzmann215-1000its,798,717,2227.871265272,2157.476399203,81
carcassonne-ucttuned105-vs-ucttuned330-1000its,806,725,2174.724798566,2163.339691829,81
carcassonne-ucttuned495-vs-ucttuned305-1000its,807,726,2249.023706689,2164.209055713,81
carcassonne-uct115-vs-uct65-1000its,809,728,2203.754182308,2188.468924283,81
carcassonne-boltzmann50-vs-boltzmann250-1000its,810,729,2167.16271864,2130.21114551,81
carcassonne-ucttuned320-vs-ucttuned260-1000its,810,729,2169.371881174,2135.89297049,81
carcassonne-uct290-vs-uct195-1000its,812,731,2217.675109925,2132.582617905,81
carcassonne-uct290-vs-uct410-1000its,813,732,2124.203399289,2074.087202714,81
carcassonne-ucttuned135-vs-ucttuned145-1000its,815,734,2176.319557817,2133.420255005,81
carcassonne-ucttuned205-vs-ucttuned175-1000its,818,737,2240.236114297,2188.344243571,81
carcassonne-ucttuned415-vs-ucttuned35-1000its,822,741,2234.746611667,2204.92251718,81
carcassonne-boltzmann195-vs-boltzmann85-1000its,823,742,2170.257040121,2130.025164922,81
carcassonne-uct355-vs-uct200-1000its,823,742,2175.870817165,2155.80884523,81
carcassonne-boltzmann305-vs-boltzmann185-1000its,825,744,2215.940365093,2137.236879374,81
carcassonne-ucttuned185-vs-ucttuned190-1000its,826,745,2185.690340028,2134.071500038,81
carcassonne-uct105-vs-uct330-1000its,828,747,2146.375794695,2108.869420144,81
carcassonne-boltzmann180-vs-boltzmann420-1000its,830,749,2278.776318261,2193.272774247,81
carcassonne-ucttuned390-vs-ucttuned185-1000its,830,749,2165.907919441,2128.123504463,81
carcassonne-ucttuned60-vs-ucttuned490-1000its,830,749,2140.527708319,2065.994156111,81
carcassonne-boltzmann485-vs-boltzmann215-1000its,832,751,2166.302442597,2127.971026892,81
carcassonne-ucttuned345-vs-ucttuned290-1000its,833,752,2169.321156411,2144.71380336,81
carcassonne-uct420-vs-uct115-1000its,834,753,2208.556073555,2184.483181959,81
carcassonne-uct80-vs-uct170-1000its,834,753,2147.642006974,2126.895331959,81
carcassonne-ucttuned240-vs-ucttuned110-1000its,835,754,2174.399330462,2134.846501836,81
carcassonne-boltzmann345-vs-boltzmann435-1000its,836,755,2235.732586355,2185.905621936,81
carcassonne-boltzmann5-vs-boltzmann215-1000its,840,759,2212.464501455,2152.197079606,81
carcassonne-ucttuned75-vs-ucttuned490-1000its,840,759,2191.218848098,2135.195796068,81
carcassonne-ucttuned465-vs-ucttuned330-1000its,842,761,2169.151656335,2107.606164138,81
carcassonne-ucttuned305-vs-ucttuned360-1000its,843,762,2260.010925299,2225.595045919,81
carcassonne-boltzmann20-vs-boltzmann405-1000its,845,764,2167.965067403,2124.183987517,81
carcassonne-boltzmann20-vs-boltzmann485-1000its,845,764,2254.829703077,2219.821236433,81
carcassonne-uct135-vs-uct195-1000its,846,765,2271.123312348,2163.761712497,81
carcassonne-ucttuned225-vs-ucttuned150-1000its,846,765,2221.259034156,2203.011334126,81
carcassonne-boltzmann420-vs-boltzmann195-1000its,847,766,2149.6239977,2072.834276003,81
carcassonne-boltzmann315-vs-boltzmann495-1000its,848,767,2195.071305764,2174.856415954,81
carcassonne-boltzmann465-vs-boltzmann225-1000its,851,770,2164.541121651,2123.319311206,81
carcassonne-ucttuned375-vs-ucttuned390-1000its,851,770,2198.706550397,2166.506787278,81
carcassonne-boltzmann425-vs-boltzmann335-1000its,852,771,2184.252609764,2152.060339171,81
carcassonne-boltzmann310-vs-boltzmann390-1000its,853,772,2237.676950204,2184.541409442,81
carcassonne-uct415-vs-uct230-1000its,853,772,2272.258236324,2200.482264182,81
carcassonne-ucttuned175-vs-ucttuned170-1000its,853,772,2248.074234154,2199.175478751,81
carcassonne-ucttuned165-vs-ucttuned295-1000its,856,775,2192.74638368,2120.731064734,81
carcassonne-boltzmann185-vs-boltzmann225-1000its,858,777,2259.300773906,2211.584395286,81
carcassonne-ucttuned365-vs-ucttuned415-1000its,858,777,2229.203674328,2194.011333647,81
carcassonne-uct455-vs-uct400-1000its,860,779,2167.613310954,2135.43976406,81
carcassonne-boltzmann125-vs-boltzmann350-1000its,862,781,2161.633941411,2128.17904431,81
carcassonne-uct105-vs-uct495-1000its,862,781,2233.409496163,2186.562702087,81
carcassonne-boltzmann40-vs-boltzmann70-1000its,863,782,2204.223960657,2124.795578437,81
carcassonne-ucttuned160-vs-ucttuned285-1000its,864,783,2264.204085544,2173.902769251,81
carcassonne-boltzmann485-vs-boltzmann35-1000its,865,784,2207.311506089,2141.406733504,81
carcassonne-uct430-vs-uct295-1000its,865,784,2176.027935025,2132.777530829,81
carcassonne-boltzmann465-vs-boltzmann220-1000its,866,785,2249.502433748,2176.756291549,81
carcassonne-boltzmann475-vs-boltzmann485-1000its,866,785,2234.799555425,2173.599939482,81
carcassonne-uct170-vs-uct400-1000its,866,785,2194.185299767,2125.238991036,81
carcassonne-ucttuned220-vs-ucttuned290-1000its,866,785,2222.076801388,2194.411079597,81
carcassonne-boltzmann175-vs-boltzmann265-1000its,867,786,2202.694016058,2176.134095054,81
carcassonne-ucttuned410-vs-ucttuned85-1000its,867,786,2164.073006114,2177.192780807,81
carcassonne-ucttuned325-vs-ucttuned320-1000its,868,787,2194.135090464,2167.98744905,81
carcassonne-uct160-vs-uct480-1000its,869,788,2283.130556764,2248.650169382,81
carcassonne-boltzmann15-vs-boltzmann270-1000its,870,789,2225.009442116,2083.383286225,81
carcassonne-boltzmann475-vs-boltzmann425-1000its,870,789,2147.111768174,2092.634276594,81
carcassonne-uct150-vs-uct450-1000its,870,789,2196.982909882,2138.63876907,81
carcassonne-uct480-vs-uct95-1000its,871,790,2211.182451366,2205.509643638,81
carcassonne-ucttuned380-vs-ucttuned355-1000its,873,792,2179.864643857,2124.082905611,81
carcassonne-uct360-vs-uct260-1000its,874,793,2234.271881134,2200.619988594,81
carcassonne-boltzmann370-vs-boltzmann110-1000its,876,795,2267.600474575,2219.234790372,81
carcassonne-boltzmann5-vs-boltzmann190-1000its,876,795,2201.107155751,2116.363486648,81
carcassonne-boltzmann140-vs-boltzmann85-1000its,878,797,2242.553110625,2163.191334424,81
carcassonne-boltzmann475-vs-boltzmann135-1000its,878,797,2246.314083645,2201.469671552,81
carcassonne-boltzmann470-vs-boltzmann30-1000its,879,798,2189.645206891,2165.929103474,81
carcassonne-uct280-vs-uct265-1000its,880,799,2208.353275715,2104.657941955,81
carcassonne-uct465-vs-uct265-1000its,883,802,2143.682469915,2098.373405137,81
carcassonne-ucttuned465-vs-ucttuned90-1000its,883,802,2180.192047049,2115.077492645,81
carcassonne-ucttuned250-vs-ucttuned125-1000its,884,803,2222.139608382,2138.689087118,81
carcassonne-uct20-vs-uct465-1000its,886,805,2214.638584421,2138.790646634,81
carcassonne-boltzmann155-vs-boltzmann235-1000its,891,810,2186.386703924,2111.843259304,81
carcassonne-uct5-vs-uct405-1000its,892,811,2205.084399142,2078.008118391,81
carcassonne-ucttuned40-vs-ucttuned335-1000its,899,818,2286.864525578,2216.242156198,81
carcassonne-ucttuned200-vs-ucttuned95-1000its,903,822,2149.972433717,2083.79912509,81
carcassonne-uct165-vs-uct320-1000its,904,823,2209.58764315,2215.76679336,81
carcassonne-ucttuned270-vs-ucttuned95-1000its,907,826,2240.748089166,2189.691085105,81
carcassonne-boltzmann350-vs-boltzmann105-1000its,912,831,2201.224470676,2187.894564413,81
carcassonne-ucttuned455-vs-ucttuned440-1000its,915,834,2289.209161664,2241.433233915,81
carcassonne-boltzmann370-vs-boltzmann175-1000its,921,840,2180.055678376,2111.511536974,81
carcassonne-uct80-vs-uct115-1000its,929,848,2232.985165536,2126.897238392,81
carcassonne-ucttuned20-vs-ucttuned300-1000its,929,848,2199.209924655,2122.788872784,81
carcassonne-ucttuned240-vs-ucttuned70-1000its,940,859,2186.433634699,2161.18855122,81
carcassonne-boltzmann385-vs-boltzmann95-1000its,952,871,2214.612446987,2153.344380132,81
carcassonne-uct280-vs-uct425-1000its,955,874,2168.759771819,2144.335684726,81
carcassonne-uct195-vs-uct340-1000its,961,880,2197.113365874,2165.080049248,81
carcassonne-ucttuned75-vs-ucttuned35-1000its,994,913,2173.352990331,2150.073082663,81
carcassonne-boltzmann160-vs-boltzmann405-1000its,751,669,2177.696598794,2107.741599593,82
carcassonne-boltzmann270-vs-boltzmann290-1000its,771,689,2218.9809928,2154.463973531,82
carcassonne-uct270-vs-uct470-1000its,773,691,2183.082033008,2104.342586783,82
carcassonne-uct55-vs-uct255-1000its,775,693,2252.011881871,2217.764633304,82
carcassonne-ucttuned295-vs-ucttuned310-1000its,785,703,2214.626685435,2192.492627164,82
carcassonne-boltzmann45-vs-boltzmann230-1000its,786,704,2165.165392421,2138.368607397,82
carcassonne-ucttuned140-vs-ucttuned490-1000its,788,706,2149.798726536,2107.531003379,82
carcassonne-ucttuned230-vs-ucttuned480-1000its,791,709,2207.412780149,2157.842190921,82
carcassonne-boltzmann240-vs-boltzmann435-1000its,794,712,2224.829526133,2187.929305562,82
carcassonne-ucttuned210-vs-ucttuned415-1000its,798,716,2210.262005646,2105.545345108,82
carcassonne-ucttuned185-vs-ucttuned100-1000its,801,719,2205.166294663,2112.849185622,82
carcassonne-uct220-vs-uct400-1000its,802,720,2298.299069038,2180.70564679,82
carcassonne-uct450-vs-uct75-1000its,803,721,2148.110838535,2160.989285552,82
carcassonne-boltzmann380-vs-boltzmann430-1000its,804,722,2210.21771097,2191.997960819,82
carcassonne-boltzmann80-vs-boltzmann495-1000its,804,722,2281.442893156,2271.490561782,82
carcassonne-boltzmann490-vs-boltzmann10-1000its,805,723,2187.658484393,2190.495837829,82
carcassonne-ucttuned470-vs-ucttuned350-1000its,805,723,2264.525445338,2202.110545828,82
carcassonne-boltzmann105-vs-boltzmann395-1000its,806,724,2130.291670473,2094.850704772,82
carcassonne-boltzmann90-vs-boltzmann415-1000its,812,730,2186.138647781,2144.111545842,82
carcassonne-uct265-vs-uct55-1000its,812,730,2154.389452731,2069.943149167,82
carcassonne-uct490-vs-uct360-1000its,814,732,2196.673360211,2175.446030194,82
carcassonne-boltzmann175-vs-boltzmann300-1000its,815,733,2199.512581456,2141.104040612,82
carcassonne-ucttuned85-vs-ucttuned260-1000its,819,737,2233.258282054,2174.226675311,82
carcassonne-boltzmann150-vs-boltzmann410-1000its,821,739,2149.994890679,2136.93432592,82
carcassonne-uct405-vs-uct25-1000its,821,739,2192.260482375,2166.661021671,82
carcassonne-uct270-vs-uct185-1000its,823,741,2214.919186304,2158.655366717,82
carcassonne-uct270-vs-uct20-1000its,825,743,2199.885041177,2169.230747876,82
carcassonne-ucttuned490-vs-ucttuned315-1000its,826,744,2184.740920024,2141.835189434,82
carcassonne-boltzmann215-vs-boltzmann230-1000its,827,745,2266.480763505,2243.477569616,82
carcassonne-uct365-vs-uct40-1000its,827,745,2188.603802657,2119.63511977,82
carcassonne-boltzmann200-vs-boltzmann15-1000its,828,746,2252.492748499,2210.354790688,82
carcassonne-boltzmann15-vs-boltzmann330-1000its,832,750,2158.88906271,2121.958316185,82
carcassonne-ucttuned170-vs-ucttuned455-1000its,832,750,2280.263270869,2185.601589533,82
carcassonne-ucttuned460-vs-ucttuned345-1000its,833,751,2162.331696246,2133.979624756,82
carcassonne-boltzmann120-vs-boltzmann100-1000its,834,752,2190.988826586,2186.240452634,82
carcassonne-uct305-vs-uct20-1000its,834,752,2209.991114774,2198.470619781,82
carcassonne-uct360-vs-uct320-1000its,835,753,2157.18796536,2123.885162973,82
carcassonne-ucttuned315-vs-ucttuned190-1000its,835,753,2218.034005634,2159.970691406,82
carcassonne-ucttuned155-vs-ucttuned410-1000its,840,758,2113.222207477,2085.320894986,82
carcassonne-boltzmann150-vs-boltzmann295-1000its,841,759,2150.218720277,2104.673181459,82
carcassonne-ucttuned210-vs-ucttuned110-1000its,841,759,2168.058067899,2140.038943139,82
carcassonne-ucttuned315-vs-ucttuned65-1000its,841,759,2199.291573635,2196.959575237,82
carcassonne-ucttuned360-vs-ucttuned160-1000its,841,759,2149.344236783,2105.988644933,82
carcassonne-uct245-vs-uct475-1000its,843,761,2183.800049416,2187.093227033,82
carcassonne-boltzmann275-vs-boltzmann175-1000its,845,763,2169.952659737,2111.724374906,82
carcassonne-boltzmann60-vs-boltzmann270-1000its,845,763,2328.015508647,2290.186484584,82
carcassonne-ucttuned410-vs-ucttuned190-1000its,845,763,2208.153964233,2212.321656781,82
carcassonne-uct405-vs-uct385-1000its,846,764,2203.993564632,2129.272424466,82
carcassonne-uct440-vs-uct5-1000its,846,764,2181.447808769,2148.214732499,82
carcassonne-uct485-vs-uct365-1000its,847,765,2148.247808472,2119.703182383,82
carcassonne-boltzmann445-vs-boltzmann370-1000its,848,766,2195.752684283,2134.44083096,82
carcassonne-ucttuned95-vs-ucttuned85-1000its,848,766,2188.46111443,2166.294751481,82
carcassonne-uct310-vs-uct215-1000its,850,768,2139.161486106,2135.117431555,82
carcassonne-boltzmann15-vs-boltzmann340-1000its,852,770,2286.584991244,2234.590032774,82
carcassonne-boltzmann115-vs-boltzmann430-1000its,853,771,2200.507809463,2146.794749422,82
carcassonne-ucttuned170-vs-ucttuned150-1000its,853,771,2214.54682969,2183.91232393,82
carcassonne-ucttuned45-vs-ucttuned140-1000its,853,771,2216.763793973,2176.44666082,82
carcassonne-ucttuned485-vs-ucttuned45-1000its,853,771,2157.516661783,2129.425821254,82
carcassonne-ucttuned105-vs-ucttuned40-1000its,854,772,2293.00732965,2217.886315057,82
carcassonne-boltzmann115-vs-boltzmann220-1000its,856,774,2155.511390084,2122.597601016,82
carcassonne-uct360-vs-uct80-1000its,856,774,2275.906172944,2246.163384479,82
carcassonne-uct165-vs-uct205-1000its,858,776,2182.174998045,2132.532459381,82
carcassonne-boltzmann145-vs-boltzmann435-1000its,859,777,2261.240441958,2221.449542955,82
carcassonne-uct410-vs-uct405-1000its,860,778,2268.899782307,2166.054091243,82
carcassonne-boltzmann40-vs-boltzmann210-1000its,861,779,2231.804327995,2182.035438638,82
carcassonne-boltzmann445-vs-boltzmann245-1000its,863,781,2210.057708922,2121.508770499,82
carcassonne-ucttuned315-vs-ucttuned335-1000its,864,782,2210.282021483,2153.784615363,82
carcassonne-boltzmann360-vs-boltzmann325-1000its,865,783,2132.411334456,2077.484569751,82
carcassonne-uct490-vs-uct385-1000its,865,783,2198.493510218,2151.790138323,82
carcassonne-ucttuned390-vs-ucttuned210-1000its,865,783,2153.473625188,2145.482521237,82
carcassonne-boltzmann70-vs-boltzmann400-1000its,866,784,2159.049016911,2142.39256396,82
carcassonne-boltzmann5-vs-boltzmann70-1000its,871,789,2222.000145915,2150.973282717,82
carcassonne-ucttuned175-vs-ucttuned280-1000its,871,789,2192.877174389,2142.647280316,82
carcassonne-ucttuned405-vs-ucttuned235-1000its,873,791,2260.526391813,2198.017124374,82
carcassonne-boltzmann440-vs-boltzmann415-1000its,875,793,2212.263422098,2168.456822299,82
carcassonne-ucttuned185-vs-ucttuned140-1000its,875,793,2170.047449194,2101.96613869,82
carcassonne-boltzmann235-vs-boltzmann160-1000its,876,794,2201.441207931,2169.230755224,82
carcassonne-boltzmann420-vs-boltzmann365-1000its,876,794,2193.347350003,2177.027815154,82
carcassonne-uct240-vs-uct395-1000its,876,794,2144.725204183,2090.380034876,82
carcassonne-uct400-vs-uct80-1000its,876,794,2188.311344288,2146.064557544,82
carcassonne-boltzmann220-vs-boltzmann95-1000its,877,795,2153.795209004,2149.566305025,82
carcassonne-ucttuned60-vs-ucttuned325-1000its,880,798,2278.015356827,2256.242436564,82
carcassonne-ucttuned185-vs-ucttuned200-1000its,882,800,2225.978221795,2172.151449734,82
carcassonne-ucttuned220-vs-ucttuned55-1000its,882,800,2285.336374484,2231.292752184,82
carcassonne-ucttuned255-vs-ucttuned290-1000its,884,802,2157.460433098,2143.07689641,82
carcassonne-uct240-vs-uct245-1000its,889,807,2256.758604903,2182.326209287,82
carcassonne-boltzmann435-vs-boltzmann225-1000its,893,811,2222.429900062,2199.078187745,82
carcassonne-boltzmann80-vs-boltzmann225-1000its,894,812,2180.26020198,2132.373775853,82
carcassonne-boltzmann220-vs-boltzmann400-1000its,896,814,2153.677350149,2146.738138784,82
carcassonne-uct250-vs-uct85-1000its,896,814,2195.897853948,2188.095155642,82
carcassonne-uct475-vs-uct290-1000its,897,815,2183.552488759,2150.627132686,82
carcassonne-ucttuned150-vs-ucttuned360-1000its,900,818,2301.092792156,2239.907430311,82
carcassonne-boltzmann50-vs-boltzmann465-1000its,901,819,2151.08628669,2126.335196452,82
carcassonne-uct470-vs-uct225-1000its,902,820,2226.53766896,2175.405041153,82
carcassonne-boltzmann80-vs-boltzmann420-1000its,903,821,2148.948175094,2122.919606892,82
carcassonne-uct465-vs-uct335-1000its,904,822,2250.946528027,2213.43632886,82
carcassonne-ucttuned150-vs-ucttuned250-1000its,904,822,2192.698944113,2158.000430476,82
carcassonne-uct260-vs-uct215-1000its,906,824,2178.736453526,2155.681799815,82
carcassonne-ucttuned5-vs-ucttuned330-1000its,910,828,2162.427717326,2111.424381356,82
carcassonne-uct60-vs-uct210-1000its,913,831,2200.808964612,2170.411470386,82
carcassonne-boltzmann90-vs-boltzmann455-1000its,918,836,2217.935524936,2173.691360607,82
carcassonne-uct50-vs-uct295-1000its,920,838,2189.414337321,2142.768821768,82
carcassonne-uct440-vs-uct110-1000its,938,856,2216.971737521,2181.773414379,82
carcassonne-uct115-vs-uct310-1000its,939,857,2211.016888473,2188.814207575,82
carcassonne-ucttuned490-vs-ucttuned405-1000its,945,863,2149.600886696,2125.498225671,82
carcassonne-ucttuned5-vs-ucttuned380-1000its,950,868,2185.768428551,2119.473171223,82
carcassonne-uct55-vs-uct345-1000its,961,879,2166.12421116,2115.050426141,82
carcassonne-uct105-vs-uct30-1000its,977,895,2215.697418512,2169.685738819,82
carcassonne-ucttuned270-vs-ucttuned375-1000its,645,562,1796.516589068,1782.032938475,83
carcassonne-boltzmann410-vs-boltzmann385-1000its,767,684,2107.160752605,2133.281962542,83
carcassonne-boltzmann345-vs-boltzmann350-1000its,779,696,2131.224777736,2054.415784659,83
carcassonne-boltzmann405-vs-boltzmann115-1000its,780,697,2160.755216486,2167.019469674,83
carcassonne-ucttuned245-vs-ucttuned140-1000its,791,708,2237.067411682,2157.648075277,83
carcassonne-boltzmann225-vs-boltzmann390-1000its,795,712,2174.08675074,2167.349383734,83
carcassonne-uct470-vs-uct295-1000its,799,716,2120.704656316,2085.710061631,83
carcassonne-ucttuned435-vs-ucttuned440-1000its,799,716,2194.384003347,2190.196197592,83
carcassonne-uct200-vs-uct70-1000its,801,718,2138.105194783,2098.537634606,83
carcassonne-ucttuned435-vs-ucttuned415-1000its,802,719,2149.661607755,2096.378328455,83
carcassonne-boltzmann110-vs-boltzmann485-1000its,803,720,2196.231372335,2173.994363023,83
carcassonne-boltzmann415-vs-boltzmann175-1000its,809,726,2180.394987588,2172.778633475,83
carcassonne-boltzmann155-vs-boltzmann135-1000its,810,727,2204.179190301,2169.847966278,83
carcassonne-uct10-vs-uct15-1000its,810,727,2202.908912329,2161.395647958,83
carcassonne-uct250-vs-uct400-1000its,814,731,2235.409723493,2174.430792464,83
carcassonne-uct130-vs-uct30-1000its,816,733,2139.210523337,2135.185922753,83
carcassonne-boltzmann435-vs-boltzmann345-1000its,818,735,2195.321419845,2178.196275107,83
carcassonne-uct210-vs-uct75-1000its,818,735,2255.319647125,2218.651824727,83
carcassonne-ucttuned325-vs-ucttuned130-1000its,820,737,2184.133333813,2125.396932371,83
carcassonne-ucttuned400-vs-ucttuned250-1000its,821,738,2167.653419873,2120.619504557,83
carcassonne-boltzmann300-vs-boltzmann255-1000its,823,740,2156.261218119,2175.394890199,83
carcassonne-uct325-vs-uct315-1000its,823,740,2191.214638829,2142.03110125,83
carcassonne-boltzmann185-vs-boltzmann95-1000its,824,741,2227.218061617,2177.128683385,83
carcassonne-boltzmann240-vs-boltzmann50-1000its,824,741,2127.676520994,2074.276024789,83
carcassonne-uct140-vs-uct335-1000its,825,742,2204.067685084,2182.505836001,83
carcassonne-ucttuned75-vs-ucttuned315-1000its,826,743,2186.867003191,2111.830918795,83
carcassonne-boltzmann325-vs-boltzmann5-1000its,827,744,2163.542881385,2148.112196947,83
carcassonne-uct375-vs-uct260-1000its,828,745,2235.386263054,2158.016768964,83
carcassonne-uct460-vs-uct180-1000its,829,746,2226.614245791,2219.64796144,83
carcassonne-uct190-vs-uct305-1000its,831,748,2232.042702886,2180.638337355,83
carcassonne-boltzmann80-vs-boltzmann200-1000its,832,749,2211.754215122,2151.257906571,83
carcassonne-uct435-vs-uct235-1000its,833,750,2283.52328107,2226.74163399,83
carcassonne-boltzmann160-vs-boltzmann220-1000its,836,753,2127.591809766,2061.241612217,83
carcassonne-ucttuned385-vs-ucttuned35-1000its,836,753,2097.155840747,2096.353855579,83
carcassonne-boltzmann10-vs-boltzmann375-1000its,837,754,2231.046814971,2132.305322591,83
carcassonne-ucttuned155-vs-ucttuned205-1000its,837,754,2163.382181912,2119.34024631,83
carcassonne-boltzmann440-vs-boltzmann60-1000its,838,755,2211.044814788,2162.697499146,83
carcassonne-ucttuned470-vs-ucttuned310-1000its,838,755,2192.026486191,2124.433382172,83
carcassonne-boltzmann210-vs-boltzmann150-1000its,839,756,2220.412223833,2166.052701074,83
carcassonne-boltzmann220-vs-boltzmann35-1000its,840,757,2230.837711212,2199.479016652,83
carcassonne-boltzmann495-vs-boltzmann340-1000its,842,759,2153.618792949,2131.369663736,83
carcassonne-uct370-vs-uct485-1000its,842,759,2215.086852696,2183.98363881,83
carcassonne-ucttuned335-vs-ucttuned65-1000its,843,760,2197.43141164,2113.285657184,83
carcassonne-ucttuned55-vs-ucttuned345-1000its,843,760,2154.411253177,2092.226975652,83
carcassonne-uct205-vs-uct320-1000its,845,762,2208.923714704,2162.480536113,83
carcassonne-uct340-vs-uct5-1000its,846,763,2147.088445793,2136.573801616,83
carcassonne-uct90-vs-uct465-1000its,846,763,2277.918249433,2208.377859808,83
carcassonne-uct130-vs-uct110-1000its,848,765,2197.704238485,2136.71023143,83
carcassonne-uct215-vs-uct35-1000its,849,766,2174.465503546,2122.650432616,83
carcassonne-ucttuned305-vs-ucttuned215-1000its,851,768,2147.45029166,2115.183866487,83
carcassonne-uct15-vs-uct80-1000its,852,769,2236.749076389,2163.933953054,83
carcassonne-uct410-vs-uct170-1000its,852,769,2231.35523765,2196.789095526,83
carcassonne-ucttuned410-vs-ucttuned395-1000its,852,769,2285.283914805,2244.32115616,83
carcassonne-ucttuned220-vs-ucttuned310-1000its,854,771,2208.309035696,2182.534507658,83
carcassonne-boltzmann55-vs-boltzmann495-1000its,856,773,2259.004657615,2209.102725617,83
carcassonne-uct345-vs-uct45-1000its,858,775,2212.789311484,2205.111570918,83
carcassonne-uct375-vs-uct80-1000its,858,775,2181.654468507,2184.406766632,83
carcassonne-ucttuned480-vs-ucttuned225-1000its,861,778,2209.656323942,2166.202780267,83
carcassonne-ucttuned370-vs-ucttuned175-1000its,862,779,2209.004416091,2130.322181938,83
carcassonne-boltzmann155-vs-boltzmann190-1000its,864,781,2198.960476377,2156.138879053,83
carcassonne-ucttuned195-vs-ucttuned65-1000its,865,782,2279.854606408,2220.031275101,83
carcassonne-ucttuned400-vs-ucttuned195-1000its,867,784,2203.964812347,2153.743306676,83
carcassonne-ucttuned390-vs-ucttuned490-1000its,868,785,2219.350007808,2205.787678345,83
carcassonne-uct275-vs-uct55-1000its,869,786,2255.525545362,2205.021772544,83
carcassonne-ucttuned325-vs-ucttuned440-1000its,874,791,2188.694964897,2136.638102571,83
carcassonne-ucttuned440-vs-ucttuned240-1000its,874,791,2243.63025923,2186.390974333,83
carcassonne-ucttuned385-vs-ucttuned440-1000its,875,792,2190.230010626,2165.867116309,83
carcassonne-ucttuned445-vs-ucttuned315-1000its,876,793,2220.840987045,2214.19575799,83
carcassonne-uct15-vs-uct485-1000its,877,794,2236.670945709,2177.765379414,83
carcassonne-uct285-vs-uct135-1000its,879,796,2263.460658083,2189.318332857,83
carcassonne-uct5-vs-uct460-1000its,880,797,2215.973867085,2158.490607575,83
carcassonne-uct50-vs-uct170-1000its,880,797,2152.078267012,2111.719355995,83
carcassonne-ucttuned320-vs-ucttuned80-1000its,880,797,2224.536540764,2161.586815287,83
carcassonne-uct270-vs-uct150-1000its,889,806,2247.436145443,2222.287917484,83
carcassonne-uct310-vs-uct160-1000its,890,807,2168.467608063,2135.902635596,83
carcassonne-boltzmann480-vs-boltzmann265-1000its,896,813,2207.378713741,2118.481904116,83
carcassonne-ucttuned5-vs-ucttuned350-1000its,898,815,2190.969275789,2174.209750463,83
carcassonne-uct330-vs-uct220-1000its,899,816,2245.482317007,2165.759317666,83
carcassonne-ucttuned20-vs-ucttuned330-1000its,900,817,2193.804986953,2153.177278364,83
carcassonne-boltzmann230-vs-boltzmann260-1000its,904,821,2211.265806732,2165.154304438,83
carcassonne-boltzmann480-vs-boltzmann45-1000its,905,822,2264.170583798,2222.165316116,83
carcassonne-uct360-vs-uct405-1000its,908,825,2155.765316008,2149.629560813,83
carcassonne-boltzmann55-vs-boltzmann245-1000its,911,828,2206.484226207,2154.596595206,83
carcassonne-uct5-vs-uct320-1000its,912,829,2258.260361379,2188.864775501,83
carcassonne-ucttuned10-vs-ucttuned395-1000its,917,834,2201.903487287,2134.154905304,83
carcassonne-boltzmann75-vs-boltzmann10-1000its,920,837,2199.836334059,2159.744812214,83
carcassonne-ucttuned120-vs-ucttuned150-1000its,921,838,2191.835518634,2157.188580574,83
carcassonne-ucttuned10-vs-ucttuned145-1000its,956,873,2261.916985053,2179.500780309,83
carcassonne-uct25-vs-uct270-1000its,980,897,2201.328029171,2167.480216264,83
carcassonne-uct445-vs-uct390-1000its,778,694,2171.867421657,2146.488750094,84
carcassonne-ucttuned440-vs-ucttuned405-1000its,784,700,2203.841804117,2160.4297682,84
carcassonne-boltzmann440-vs-boltzmann365-1000its,793,709,2251.411501877,2186.503916283,84
carcassonne-ucttuned365-vs-ucttuned495-1000its,797,713,2264.215896073,2131.307903711,84
carcassonne-ucttuned55-vs-ucttuned130-1000its,797,713,2223.348080601,2170.509880439,84
carcassonne-ucttuned115-vs-ucttuned470-1000its,798,714,2212.019187315,2202.31352738,84
carcassonne-boltzmann115-vs-boltzmann160-1000its,802,718,2191.201764576,2125.870718854,84
carcassonne-uct150-vs-uct30-1000its,802,718,2155.297710626,2110.244130247,84
carcassonne-boltzmann250-vs-boltzmann465-1000its,805,721,2174.108498595,2118.214945136,84
carcassonne-boltzmann125-vs-boltzmann375-1000its,806,722,2299.733162195,2237.860960921,84
carcassonne-boltzmann50-vs-boltzmann135-1000its,809,725,2231.230082168,2185.525259243,84
carcassonne-boltzmann430-vs-boltzmann65-1000its,810,726,2215.150711067,2166.140681832,84
carcassonne-ucttuned120-vs-ucttuned475-1000its,810,726,2169.70749053,2151.23739914,84
carcassonne-boltzmann495-vs-boltzmann425-1000its,812,728,2209.131026807,2212.661011891,84
carcassonne-ucttuned75-vs-ucttuned210-1000its,819,735,2196.823882815,2169.981823792,84
carcassonne-ucttuned175-vs-ucttuned40-1000its,820,736,2191.018568733,2151.141247255,84
carcassonne-ucttuned395-vs-ucttuned335-1000its,820,736,2119.482988545,2131.546935272,84
carcassonne-uct430-vs-uct315-1000its,823,739,2236.749494711,2152.361440915,84
carcassonne-uct465-vs-uct235-1000its,823,739,2213.424726664,2198.316621037,84
carcassonne-uct110-vs-uct260-1000its,824,740,2189.416474137,2171.344499736,84
carcassonne-ucttuned190-vs-ucttuned35-1000its,825,741,2176.573611648,2084.496946769,84
carcassonne-uct70-vs-uct395-1000its,826,742,2248.369905744,2235.80141886,84
carcassonne-ucttuned430-vs-ucttuned445-1000its,826,742,2211.67838566,2109.872815362,84
carcassonne-ucttuned200-vs-ucttuned175-1000its,827,743,2165.238987624,2138.603297555,84
carcassonne-ucttuned120-vs-ucttuned440-1000its,828,744,2220.151970607,2138.538911862,84
carcassonne-uct235-vs-uct300-1000its,831,747,2214.17636813,2198.31812675,84
carcassonne-ucttuned75-vs-ucttuned160-1000its,831,747,2182.644395635,2161.300737859,84
carcassonne-ucttuned125-vs-ucttuned225-1000its,832,748,2187.948794528,2114.517675838,84
carcassonne-boltzmann290-vs-boltzmann360-1000its,833,749,2207.525253546,2163.953589138,84
carcassonne-ucttuned280-vs-ucttuned370-1000its,835,751,2219.34875292,2166.653270492,84
carcassonne-boltzmann190-vs-boltzmann35-1000its,836,752,2218.15491761,2152.912548079,84
carcassonne-boltzmann255-vs-boltzmann140-1000its,836,752,2186.785555442,2163.294699572,84
carcassonne-uct415-vs-uct190-1000its,837,753,2121.838154631,2070.068207108,84
carcassonne-ucttuned435-vs-ucttuned480-1000its,837,753,2261.808778356,2266.669392957,84
carcassonne-uct230-vs-uct125-1000its,838,754,2175.031912244,2162.075981082,84
carcassonne-ucttuned445-vs-ucttuned60-1000its,838,754,2145.294625158,2079.762674403,84
carcassonne-boltzmann155-vs-boltzmann405-1000its,839,755,2179.548560234,2122.853654287,84
carcassonne-uct135-vs-uct175-1000its,840,756,2197.195590459,2163.501414881,84
carcassonne-uct450-vs-uct65-1000its,840,756,2194.779773642,2143.705366214,84
carcassonne-ucttuned135-vs-ucttuned440-1000its,841,757,2238.00306756,2179.159230512,84
carcassonne-ucttuned310-vs-ucttuned275-1000its,841,757,2188.770778225,2113.160493981,84
carcassonne-ucttuned340-vs-ucttuned365-1000its,842,758,2198.497269982,2139.679680179,84
carcassonne-boltzmann100-vs-boltzmann125-1000its,843,759,2233.567674804,2158.911338313,84
carcassonne-uct425-vs-uct120-1000its,843,759,2141.320324407,2122.801006048,84
carcassonne-uct320-vs-uct365-1000its,847,763,2304.257310991,2209.619294944,84
carcassonne-ucttuned85-vs-ucttuned410-1000its,850,766,2231.254976542,2189.689317424,84
carcassonne-boltzmann130-vs-boltzmann135-1000its,853,769,2196.532503887,2150.497674017,84
carcassonne-ucttuned350-vs-ucttuned135-1000its,853,769,2233.908348009,2186.42235017,84
carcassonne-ucttuned50-vs-ucttuned25-1000its,853,769,2130.18534768,2082.346172439,84
carcassonne-uct80-vs-uct105-1000its,854,770,2185.14319159,2157.378283044,84
carcassonne-boltzmann260-vs-boltzmann135-1000its,855,771,2305.203660904,2207.756319813,84
carcassonne-ucttuned20-vs-ucttuned30-1000its,856,772,2206.747628323,2153.648713545,84
carcassonne-ucttuned160-vs-ucttuned445-1000its,859,775,2234.433072444,2201.727175787,84
carcassonne-boltzmann440-vs-boltzmann90-1000its,860,776,2206.817500622,2198.190034834,84
carcassonne-boltzmann10-vs-boltzmann240-1000its,864,780,2235.918315114,2198.238359669,84
carcassonne-boltzmann75-vs-boltzmann270-1000its,865,781,2205.752715921,2141.582604932,84
carcassonne-uct365-vs-uct470-1000its,867,783,2221.208890688,2157.471757288,84
carcassonne-ucttuned470-vs-ucttuned155-1000its,867,783,2299.556372244,2248.778335906,84
carcassonne-uct235-vs-uct370-1000its,869,785,2226.850907738,2202.639685048,84
carcassonne-boltzmann70-vs-boltzmann320-1000its,870,786,2238.034536285,2173.936056441,84
carcassonne-ucttuned80-vs-ucttuned435-1000its,871,787,2193.191553745,2134.16264848,84
carcassonne-boltzmann125-vs-boltzmann385-1000its,872,788,2193.094526453,2143.969222152,84
carcassonne-boltzmann435-vs-boltzmann5-1000its,872,788,2137.367059577,2099.777932556,84
carcassonne-ucttuned390-vs-ucttuned150-1000its,874,790,2237.683820808,2190.005413503,84
carcassonne-ucttuned210-vs-ucttuned310-1000its,875,791,2214.374739994,2151.749544606,84
carcassonne-uct100-vs-uct310-1000its,877,793,2155.735475552,2135.044261669,84
carcassonne-uct255-vs-uct240-1000its,878,794,2229.784719188,2168.629067841,84
carcassonne-uct305-vs-uct40-1000its,878,794,2225.975341086,2181.808452025,84
carcassonne-ucttuned425-vs-ucttuned40-1000its,878,794,2187.988959066,2149.187877955,84
carcassonne-ucttuned50-vs-ucttuned330-1000its,878,794,2202.151022149,2163.306236054,84
carcassonne-uct145-vs-uct405-1000its,879,795,2198.64964602,2167.258991376,84
carcassonne-uct330-vs-uct15-1000its,879,795,2188.582658546,2160.56611887,84
carcassonne-boltzmann115-vs-boltzmann40-1000its,880,796,2155.600668279,2124.248464381,84
carcassonne-ucttuned145-vs-ucttuned115-1000its,880,796,2168.248446114,2130.227764815,84
carcassonne-boltzmann40-vs-boltzmann150-1000its,881,797,2208.128521507,2144.997702366,84
carcassonne-uct355-vs-uct110-1000its,883,799,2155.544572648,2102.451518461,84
carcassonne-uct115-vs-uct50-1000its,886,802,2144.810077471,2076.598050113,84
carcassonne-ucttuned340-vs-ucttuned135-1000its,886,802,2194.670335086,2168.036945023,84
carcassonne-boltzmann15-vs-boltzmann220-1000its,887,803,2190.988202923,2125.463415743,84
carcassonne-ucttuned5-vs-ucttuned30-1000its,888,804,2183.850140786,2192.098307398,84
carcassonne-ucttuned85-vs-ucttuned475-1000its,889,805,2254.561768318,2220.332726861,84
carcassonne-ucttuned105-vs-ucttuned145-1000its,890,806,2228.348934799,2152.230522179,84
carcassonne-ucttuned145-vs-ucttuned345-1000its,893,809,2111.125962444,2076.782162825,84
carcassonne-uct215-vs-uct130-1000its,894,810,2204.645137298,2156.694869091,84
carcassonne-uct85-vs-uct335-1000its,898,814,2200.356378962,2158.437537941,84
carcassonne-ucttuned440-vs-ucttuned465-1000its,898,814,2273.282413782,2229.417788781,84
carcassonne-boltzmann230-vs-boltzmann145-1000its,905,821,2204.251275025,2188.440134894,84
carcassonne-boltzmann480-vs-boltzmann225-1000its,905,821,2217.490600762,2159.951773804,84
carcassonne-boltzmann205-vs-boltzmann140-1000its,906,822,2211.182056433,2155.371497108,84
carcassonne-uct400-vs-uct425-1000its,910,826,2218.731231356,2146.229002901,84
carcassonne-ucttuned45-vs-ucttuned200-1000its,912,828,2186.441569069,2103.683126553,84
carcassonne-ucttuned200-vs-ucttuned405-1000its,913,829,2216.551894093,2155.961075267,84
carcassonne-ucttuned50-vs-ucttuned450-1000its,915,831,2267.870212349,2216.208872135,84
carcassonne-ucttuned140-vs-ucttuned430-1000its,917,833,2156.315087527,2126.543069257,84
carcassonne-boltzmann115-vs-boltzmann310-1000its,923,839,2144.884652138,2082.626405292,84
carcassonne-ucttuned5-vs-ucttuned365-1000its,929,845,2316.542962474,2254.137819855,84
carcassonne-ucttuned160-vs-ucttuned215-1000its,933,849,2152.739529887,2128.273317379,84
carcassonne-ucttuned5-vs-ucttuned150-1000its,935,851,2237.946688979,2207.054654919,84
carcassonne-ucttuned470-vs-ucttuned75-1000its,947,863,2220.604521929,2175.126826607,84
carcassonne-uct10-vs-uct100-1000its,954,870,2229.927520575,2177.035190757,84
carcassonne-boltzmann380-vs-boltzmann405-1000its,688,603,1759.247051346,1696.819027449,85
carcassonne-boltzmann220-vs-boltzmann70-1000its,693,608,1808.535282192,1755.178699683,85
carcassonne-uct185-vs-uct330-1000its,702,617,1705.43763876,1653.858149481,85
carcassonne-uct285-vs-uct35-1000its,770,685,2172.281719439,2151.664450287,85
carcassonne-boltzmann225-vs-boltzmann145-1000its,774,689,2179.190040735,2180.953537471,85
carcassonne-boltzmann340-vs-boltzmann180-1000its,783,698,2221.642328789,2181.448984856,85
carcassonne-uct330-vs-uct365-1000its,783,698,2209.907360332,2149.363230162,85
carcassonne-uct490-vs-uct435-1000its,791,706,2176.279326854,2156.90640378,85
carcassonne-uct25-vs-uct55-1000its,798,713,2238.881819287,2159.951215482,85
carcassonne-ucttuned185-vs-ucttuned10-1000its,798,713,2146.77470869,2125.67490861,85
carcassonne-boltzmann185-vs-boltzmann360-1000its,799,714,2268.313409279,2222.898936198,85
carcassonne-ucttuned200-vs-ucttuned85-1000its,799,714,2225.854433281,2156.460434548,85
carcassonne-uct150-vs-uct145-1000its,805,720,2238.288908712,2195.352978942,85
carcassonne-uct310-vs-uct170-1000its,805,720,2173.034873378,2200.278444607,85
carcassonne-boltzmann330-vs-boltzmann430-1000its,806,721,2254.259323106,2168.976654394,85
carcassonne-uct395-vs-uct130-1000its,807,722,2270.780956022,2258.302030197,85
carcassonne-ucttuned350-vs-ucttuned125-1000its,807,722,2238.842560947,2177.926207844,85
carcassonne-boltzmann380-vs-boltzmann320-1000its,808,723,2185.468263223,2161.748313709,85
carcassonne-boltzmann440-vs-boltzmann160-1000its,809,724,2217.937233664,2197.298273564,85
carcassonne-boltzmann40-vs-boltzmann435-1000its,810,725,2208.142641815,2201.448872382,85
carcassonne-uct40-vs-uct150-1000its,810,725,2202.415684785,2150.542612521,85
carcassonne-egreedy-1div10-vs-egreedy-1div5-1000its,812,727,2168.113816612,2159.492066962,85
carcassonne-ucttuned425-vs-ucttuned170-1000its,812,727,2236.343218872,2166.157341401,85
carcassonne-uct410-vs-uct160-1000its,816,731,2271.913150684,2200.963466543,85
carcassonne-boltzmann315-vs-boltzmann95-1000its,817,732,2214.982047312,2148.915227585,85
carcassonne-uct145-vs-uct360-1000its,818,733,2099.373135896,2094.847794361,85
carcassonne-ucttuned35-vs-ucttuned110-1000its,819,734,2204.426845202,2177.087881596,85
carcassonne-boltzmann40-vs-boltzmann485-1000its,828,743,2229.274635077,2192.779275962,85
carcassonne-boltzmann195-vs-boltzmann465-1000its,830,745,2215.654514988,2163.665057705,85
carcassonne-uct35-vs-uct155-1000its,831,746,2190.818626768,2070.767938463,85
carcassonne-ucttuned495-vs-ucttuned250-1000its,831,746,2256.366207507,2170.605125739,85
carcassonne-boltzmann325-vs-boltzmann335-1000its,834,749,2204.633817023,2182.239046374,85
carcassonne-uct105-vs-uct465-1000its,835,750,2211.713188414,2181.246466437,85
carcassonne-ucttuned285-vs-ucttuned430-1000its,835,750,2200.480340098,2169.27989034,85
carcassonne-uct460-vs-uct365-1000its,836,751,2259.144498434,2248.867442605,85
carcassonne-uct490-vs-uct455-1000its,836,751,2195.744385301,2154.293392047,85
carcassonne-ucttuned30-vs-ucttuned385-1000its,838,753,2218.947816756,2104.931353349,85
carcassonne-ucttuned210-vs-ucttuned75-1000its,840,755,2202.633902345,2144.711703696,85
carcassonne-uct40-vs-uct245-1000its,841,756,2166.437178797,2156.100894418,85
carcassonne-boltzmann220-vs-boltzmann160-1000its,844,759,2309.58145266,2296.632029491,85
carcassonne-boltzmann260-vs-boltzmann255-1000its,844,759,2239.816977384,2150.26267997,85
carcassonne-ucttuned385-vs-ucttuned330-1000its,844,759,2202.66154253,2165.448851691,85
carcassonne-boltzmann110-vs-boltzmann390-1000its,846,761,2157.257053358,2091.749299894,85
carcassonne-ucttuned460-vs-ucttuned435-1000its,846,761,2241.27436635,2226.115298862,85
carcassonne-boltzmann315-vs-boltzmann195-1000its,847,762,2205.547082579,2116.045360384,85
carcassonne-boltzmann390-vs-boltzmann220-1000its,847,762,2122.187292924,2093.048508291,85
carcassonne-ucttuned125-vs-ucttuned10-1000its,847,762,2223.035550291,2166.835282068,85
carcassonne-ucttuned310-vs-ucttuned205-1000its,848,763,2188.736558596,2171.296284817,85
carcassonne-boltzmann145-vs-boltzmann475-1000its,849,764,2150.024815785,2099.175413889,85
carcassonne-boltzmann65-vs-boltzmann400-1000its,851,766,2284.736715866,2182.629244667,85
carcassonne-uct50-vs-uct250-1000its,851,766,2229.048578497,2161.369173908,85
carcassonne-ucttuned135-vs-ucttuned345-1000its,852,767,2235.238419787,2201.292050525,85
carcassonne-boltzmann490-vs-boltzmann450-1000its,853,768,2211.104584219,2209.773295288,85
carcassonne-ucttuned360-vs-ucttuned475-1000its,854,769,2179.71636841,2079.001282763,85
carcassonne-boltzmann105-vs-boltzmann110-1000its,856,771,2218.102436097,2147.069483656,85
carcassonne-ucttuned70-vs-ucttuned185-1000its,856,771,2236.591121483,2177.074214554,85
carcassonne-boltzmann120-vs-boltzmann140-1000its,857,772,2118.133580981,2052.310718829,85
carcassonne-boltzmann120-vs-boltzmann305-1000its,861,776,2193.798857437,2166.130767564,85
carcassonne-boltzmann440-vs-boltzmann205-1000its,861,776,2174.489285289,2148.504404274,85
carcassonne-uct370-vs-uct265-1000its,861,776,2164.984396485,2146.299290163,85
carcassonne-boltzmann325-vs-boltzmann330-1000its,862,777,2170.934899858,2093.64652779,85
carcassonne-ucttuned150-vs-ucttuned470-1000its,862,777,2196.922166529,2173.350115504,85
carcassonne-boltzmann390-vs-boltzmann120-1000its,863,778,2232.354558761,2168.096924077,85
carcassonne-boltzmann360-vs-boltzmann425-1000its,864,779,2294.624290413,2285.500215876,85
carcassonne-ucttuned250-vs-ucttuned490-1000its,865,780,2229.739938011,2188.666646061,85
carcassonne-boltzmann395-vs-boltzmann110-1000its,866,781,2145.484634892,2082.924347681,85
carcassonne-uct270-vs-uct130-1000its,866,781,2182.394832156,2125.351164729,85
carcassonne-uct495-vs-uct340-1000its,867,782,2152.038863003,2146.579182536,85
carcassonne-boltzmann475-vs-boltzmann310-1000its,869,784,2257.787435239,2220.151824989,85
carcassonne-uct235-vs-uct490-1000its,869,784,2203.119029074,2177.283790341,85
carcassonne-ucttuned115-vs-ucttuned480-1000its,869,784,2167.381303027,2149.528667432,85
carcassonne-ucttuned130-vs-ucttuned400-1000its,871,786,2257.461269909,2224.009531727,85
carcassonne-ucttuned170-vs-ucttuned440-1000its,871,786,2221.020472347,2163.464777256,85
carcassonne-uct410-vs-uct245-1000its,873,788,2215.553999533,2159.268355768,85
carcassonne-uct285-vs-uct470-1000its,874,789,2144.796776472,2097.93292449,85
carcassonne-uct55-vs-uct85-1000its,874,789,2196.408146592,2187.09410189,85
carcassonne-uct110-vs-uct245-1000its,876,791,2211.215553258,2152.611984335,85
carcassonne-uct165-vs-uct125-1000its,878,793,2213.882110227,2164.794214674,85
carcassonne-boltzmann420-vs-boltzmann240-1000its,880,795,2183.920215534,2150.268509996,85
carcassonne-boltzmann110-vs-boltzmann420-1000its,881,796,2275.250264703,2243.715111903,85
carcassonne-ucttuned105-vs-ucttuned175-1000its,881,796,2224.503096091,2163.037658653,85
carcassonne-ucttuned200-vs-ucttuned90-1000its,883,798,2165.154789568,2163.178972002,85
carcassonne-ucttuned135-vs-ucttuned330-1000its,885,800,2164.513622603,2143.656744474,85
carcassonne-ucttuned390-vs-ucttuned40-1000its,887,802,2170.82585116,2089.537100501,85
carcassonne-ucttuned165-vs-ucttuned95-1000its,888,803,2173.967128364,2142.383093874,85
carcassonne-ucttuned470-vs-ucttuned455-1000its,888,803,2146.36862591,2128.189431615,85
carcassonne-ucttuned50-vs-ucttuned195-1000its,888,803,2232.828972995,2188.520593177,85
carcassonne-boltzmann200-vs-boltzmann210-1000its,893,808,2198.811211817,2132.374077825,85
carcassonne-boltzmann345-vs-boltzmann315-1000its,894,809,2142.25983923,2079.479093904,85
carcassonne-uct265-vs-uct160-1000its,894,809,2155.455344482,2075.081478672,85
carcassonne-ucttuned465-vs-ucttuned440-1000its,894,809,2140.887941638,2098.686437929,85
carcassonne-boltzmann350-vs-boltzmann160-1000its,895,810,2177.67997936,2132.226847456,85
carcassonne-uct45-vs-uct100-1000its,897,812,2260.763148099,2227.625520026,85
carcassonne-ucttuned45-vs-ucttuned375-1000its,897,812,2235.967005125,2156.356436658,85
carcassonne-boltzmann275-vs-boltzmann335-1000its,898,813,2193.101121117,2160.628782072,85
carcassonne-boltzmann25-vs-boltzmann255-1000its,900,815,2224.448911462,2143.087688243,85
carcassonne-ucttuned200-vs-ucttuned210-1000its,900,815,2172.957105622,2102.3570611,85
carcassonne-ucttuned335-vs-ucttuned125-1000its,902,817,2194.418657479,2179.90880599,85
carcassonne-ucttuned175-vs-ucttuned205-1000its,903,818,2168.482382661,2122.789538393,85
carcassonne-uct270-vs-uct490-1000its,909,824,2148.949067409,2114.222827126,85
carcassonne-boltzmann360-vs-boltzmann170-1000its,910,825,2241.350414356,2235.108946223,85
carcassonne-uct200-vs-uct280-1000its,910,825,2248.391254639,2159.396380847,85
carcassonne-ucttuned195-vs-ucttuned145-1000its,910,825,2212.736293482,2199.917846554,85
carcassonne-ucttuned370-vs-ucttuned385-1000its,918,833,2194.978286135,2157.892232273,85
carcassonne-ucttuned70-vs-ucttuned255-1000its,934,849,2148.197660764,2120.2836082,85
carcassonne-ucttuned160-vs-ucttuned25-1000its,943,858,2261.264889665,2241.427206205,85
carcassonne-ucttuned240-vs-ucttuned25-1000its,978,893,2201.608585623,2222.157649043,85
carcassonne-ucttuned250-vs-ucttuned355-1000its,779,693,2178.236175339,2140.701329319,86
carcassonne-uct100-vs-uct285-1000its,781,695,2203.668575338,2168.636439193,86
carcassonne-uct140-vs-uct430-1000its,784,698,2202.172436631,2133.944216401,86
carcassonne-boltzmann80-vs-boltzmann180-1000its,787,701,2182.639698539,2086.951226338,86
carcassonne-boltzmann115-vs-boltzmann410-1000its,794,708,2198.169221079,2132.424243197,86
carcassonne-ucttuned380-vs-ucttuned365-1000its,796,710,2156.968123047,2111.416198323,86
carcassonne-boltzmann170-vs-boltzmann90-1000its,802,716,2209.69235152,2168.919967181,86
carcassonne-boltzmann405-vs-boltzmann295-1000its,803,717,2175.470876218,2146.980799569,86
carcassonne-uct485-vs-uct395-1000its,803,717,2215.318295178,2154.214935765,86
carcassonne-uct15-vs-uct120-1000its,804,718,2169.875294813,2149.339650935,86
carcassonne-uct245-vs-uct195-1000its,806,720,2198.27300369,2177.131023416,86
carcassonne-uct145-vs-uct245-1000its,807,721,2260.89326208,2166.574223163,86
carcassonne-ucttuned465-vs-ucttuned220-1000its,808,722,2109.27454674,2071.069196804,86
carcassonne-ucttuned390-vs-ucttuned430-1000its,809,723,2153.122423131,2095.464716577,86
carcassonne-ucttuned490-vs-ucttuned250-1000its,809,723,2234.25417265,2198.560596398,86
carcassonne-ucttuned75-vs-ucttuned155-1000its,810,724,2188.620714018,2098.865669983,86
carcassonne-boltzmann210-vs-boltzmann415-1000its,811,725,2225.74102237,2229.244581714,86
carcassonne-ucttuned45-vs-ucttuned260-1000its,812,726,2250.65471032,2191.999141005,86
carcassonne-ucttuned425-vs-ucttuned235-1000its,814,728,2215.5408428,2163.145314887,86
carcassonne-boltzmann205-vs-boltzmann255-1000its,816,730,2206.60120909,2185.725702828,86
carcassonne-uct390-vs-uct70-1000its,816,730,2148.763054928,2109.525362579,86
carcassonne-ucttuned255-vs-ucttuned325-1000its,822,736,2242.607254783,2228.044304534,86
carcassonne-uct15-vs-uct20-1000its,829,743,2154.555609523,2130.155252014,86
carcassonne-ucttuned225-vs-ucttuned80-1000its,830,744,2259.686348613,2167.100947171,86
carcassonne-boltzmann60-vs-boltzmann485-1000its,831,745,2231.286923044,2161.825533111,86
carcassonne-ucttuned120-vs-ucttuned495-1000its,834,748,2236.256781379,2189.651900575,86
carcassonne-ucttuned235-vs-ucttuned240-1000its,835,749,2194.561462721,2120.43566882,86
carcassonne-ucttuned345-vs-ucttuned130-1000its,840,754,2123.428307646,2075.458032558,86
carcassonne-boltzmann465-vs-boltzmann190-1000its,843,757,2202.642733111,2211.318750316,86
carcassonne-uct145-vs-uct200-1000its,844,758,2149.728769421,2041.622334404,86
carcassonne-uct330-vs-uct170-1000its,844,758,2159.648003466,2109.896058329,86
carcassonne-uct325-vs-uct90-1000its,845,759,2194.601012379,2157.315830075,86
carcassonne-uct405-vs-uct55-1000its,845,759,2087.9931888,2128.524732039,86
carcassonne-ucttuned495-vs-ucttuned365-1000its,847,761,2140.0054013,2106.801011648,86
carcassonne-boltzmann205-vs-boltzmann245-1000its,851,765,2323.339176433,2269.070814108,86
carcassonne-boltzmann35-vs-boltzmann290-1000its,851,765,2175.6354946,2119.084060143,86
carcassonne-uct255-vs-uct130-1000its,853,767,2151.750617405,2099.655769677,86
carcassonne-boltzmann10-vs-boltzmann195-1000its,855,769,2206.637452583,2143.084806821,86
carcassonne-uct130-vs-uct385-1000its,855,769,2166.502366028,2137.243002967,86
carcassonne-ucttuned395-vs-ucttuned235-1000its,855,769,2233.693331617,2144.98468827,86
carcassonne-ucttuned20-vs-ucttuned405-1000its,856,770,2245.737336878,2183.132935412,86
carcassonne-uct140-vs-uct185-1000its,857,771,2164.87644472,2092.724803095,86
carcassonne-boltzmann495-vs-boltzmann280-1000its,858,772,2146.844111128,2108.447240558,86
carcassonne-uct360-vs-uct315-1000its,859,773,2278.244260083,2260.234231739,86
carcassonne-boltzmann10-vs-boltzmann150-1000its,860,774,2178.168442935,2115.982208889,86
carcassonne-ucttuned295-vs-ucttuned415-1000its,862,776,2243.341747282,2203.031788936,86
carcassonne-boltzmann70-vs-boltzmann105-1000its,863,777,2182.79008678,2140.502599512,86
carcassonne-uct40-vs-uct275-1000its,863,777,2201.387711071,2145.822143817,86
carcassonne-uct285-vs-uct325-1000its,865,779,2239.190059726,2167.538607862,86
carcassonne-ucttuned160-vs-ucttuned210-1000its,865,779,2176.223893847,2105.836026208,86
carcassonne-boltzmann270-vs-boltzmann480-1000its,867,781,2151.273442143,2103.369564114,86
carcassonne-uct170-vs-uct220-1000its,867,781,2254.252498172,2185.546533718,86
carcassonne-uct480-vs-uct365-1000its,867,781,2131.791921225,2077.127775355,86
carcassonne-uct180-vs-uct45-1000its,868,782,2160.474204159,2137.120030941,86
carcassonne-ucttuned80-vs-ucttuned40-1000its,868,782,2165.758403742,2138.440915125,86
carcassonne-uct45-vs-uct280-1000its,871,785,2247.333718636,2201.359668909,86
carcassonne-ucttuned35-vs-ucttuned160-1000its,871,785,2202.129991868,2135.90822547,86
carcassonne-boltzmann45-vs-boltzmann310-1000its,873,787,2271.544399336,2226.079968266,86
carcassonne-ucttuned280-vs-ucttuned215-1000its,874,788,2244.722784472,2219.100665127,86
carcassonne-uct135-vs-uct155-1000its,876,790,2205.737539915,2140.428083912,86
carcassonne-uct375-vs-uct35-1000its,876,790,2150.00067092,2133.072994199,86
carcassonne-uct5-vs-uct260-1000its,876,790,2139.873617516,2085.402657497,86
carcassonne-boltzmann165-vs-boltzmann125-1000its,882,796,2229.150071917,2146.928855961,86
carcassonne-ucttuned315-vs-ucttuned370-1000its,882,796,2273.698480306,2217.160795862,86
carcassonne-ucttuned425-vs-ucttuned85-1000its,882,796,2153.429379035,2156.697675297,86
carcassonne-boltzmann140-vs-boltzmann380-1000its,885,799,2174.06233162,2110.644914411,86
carcassonne-uct340-vs-uct250-1000its,885,799,2159.803147597,2120.896808651,86
carcassonne-ucttuned275-vs-ucttuned460-1000its,885,799,2160.921289464,2113.367047733,86
carcassonne-ucttuned460-vs-ucttuned280-1000its,892,806,2191.701040275,2151.388290452,86
carcassonne-uct380-vs-uct250-1000its,893,807,2187.562576353,2133.459846498,86
carcassonne-uct80-vs-uct470-1000its,897,811,2289.880104295,2244.725458544,86
carcassonne-uct435-vs-uct470-1000its,899,813,2319.950924567,2216.653087457,86
carcassonne-ucttuned450-vs-ucttuned150-1000its,912,826,2206.194218181,2191.415268568,86
carcassonne-ucttuned325-vs-ucttuned260-1000its,921,835,2197.54213186,2192.959299611,86
carcassonne-uct280-vs-uct285-1000its,925,839,2202.892339343,2168.642999765,86
carcassonne-ucttuned355-vs-ucttuned325-1000its,933,847,2189.912831081,2132.915086922,86
carcassonne-ucttuned330-vs-ucttuned100-1000its,934,848,2135.061695155,2080.673269445,86
carcassonne-boltzmann220-vs-boltzmann260-1000its,941,855,2248.108486685,2200.373452139,86
carcassonne-uct220-vs-uct65-1000its,942,856,2152.289713247,2109.081741558,86
carcassonne-ucttuned395-vs-ucttuned430-1000its,948,862,2133.54599847,2125.087349581,86
carcassonne-ucttuned440-vs-ucttuned35-1000its,963,877,2138.934789865,2083.170147659,86
carcassonne-uct195-vs-uct120-1000its,984,898,2215.582603027,2170.942771659,86
carcassonne-uct260-vs-uct30-1000its,734,647,2162.826812715,2104.130475946,87
carcassonne-boltzmann60-vs-boltzmann440-1000its,751,664,2199.817280233,2185.990572075,87
carcassonne-uct475-vs-uct35-1000its,773,686,2165.486879194,2118.510532835,87
carcassonne-ucttuned110-vs-ucttuned480-1000its,774,687,2200.043289802,2101.596437509,87
carcassonne-boltzmann385-vs-boltzmann470-1000its,776,689,2212.501830968,2151.256745992,87
carcassonne-ucttuned235-vs-ucttuned80-1000its,791,704,2153.451931327,2091.663426637,87
carcassonne-boltzmann175-vs-boltzmann475-1000its,794,707,2262.370108312,2164.408450621,87
carcassonne-boltzmann480-vs-boltzmann105-1000its,794,707,2212.646089252,2177.789536511,87
carcassonne-boltzmann240-vs-boltzmann140-1000its,795,708,2206.836334096,2165.190468563,87
carcassonne-uct485-vs-uct270-1000its,795,708,2194.866648485,2144.783537785,87
carcassonne-ucttuned145-vs-ucttuned430-1000its,796,709,2204.570806122,2191.910719898,87
carcassonne-ucttuned90-vs-ucttuned265-1000its,801,714,2207.510927979,2164.746454471,87
carcassonne-uct310-vs-uct145-1000its,802,715,2194.350338194,2092.286308426,87
carcassonne-boltzmann280-vs-boltzmann365-1000its,803,716,2217.9157122,2179.134163812,87
carcassonne-ucttuned240-vs-ucttuned380-1000its,803,716,2178.873912127,2150.772571065,87
carcassonne-uct390-vs-uct155-1000its,805,718,2174.121717095,2148.413968048,87
carcassonne-uct390-vs-uct25-1000its,809,722,2150.787489083,2112.470222809,87
carcassonne-ucttuned175-vs-ucttuned25-1000its,811,724,2150.138049535,2137.94443084,87
carcassonne-ucttuned420-vs-ucttuned180-1000its,814,727,2195.539696277,2125.912192384,87
carcassonne-uct475-vs-uct335-1000its,815,728,2169.590372204,2119.992303517,87
carcassonne-uct150-vs-uct465-1000its,816,729,2163.213076852,2118.91564552,87
carcassonne-uct300-vs-uct465-1000its,823,736,2134.044777187,2102.448265281,87
carcassonne-boltzmann225-vs-boltzmann95-1000its,825,738,2177.598643916,2141.132900671,87
carcassonne-ucttuned215-vs-ucttuned190-1000its,825,738,2224.557639339,2178.884159288,87
carcassonne-uct175-vs-uct455-1000its,828,741,2331.840675009,2306.047439263,87
carcassonne-uct445-vs-uct425-1000its,828,741,2203.502771627,2118.311754608,87
carcassonne-ucttuned445-vs-ucttuned100-1000its,828,741,2234.863197385,2185.596407098,87
carcassonne-boltzmann440-vs-boltzmann275-1000its,829,742,2194.000641492,2122.878005424,87
carcassonne-uct335-vs-uct495-1000its,829,742,2217.40088591,2171.692725488,87
carcassonne-boltzmann390-vs-boltzmann325-1000its,831,744,2213.508005486,2131.760404864,87
carcassonne-boltzmann315-vs-boltzmann225-1000its,832,745,2219.470663066,2165.355818172,87
carcassonne-uct65-vs-uct85-1000its,834,747,2185.772271438,2139.595289843,87
carcassonne-uct50-vs-uct480-1000its,836,749,2224.782871334,2160.355936528,87
carcassonne-uct390-vs-uct230-1000its,837,750,2231.667568812,2199.5879985,87
carcassonne-boltzmann10-vs-boltzmann445-1000its,839,752,2175.467456465,2129.307436169,87
carcassonne-ucttuned140-vs-ucttuned55-1000its,839,752,2209.270089313,2148.608565436,87
carcassonne-uct120-vs-uct155-1000its,841,754,2153.52302226,2119.069530195,87
carcassonne-uct435-vs-uct115-1000its,841,754,2166.76694284,2154.023683267,87
carcassonne-ucttuned45-vs-ucttuned490-1000its,841,754,2221.107981337,2143.877312602,87
carcassonne-boltzmann20-vs-boltzmann95-1000its,843,756,2191.95919182,2149.872650446,87
carcassonne-uct310-vs-uct135-1000its,844,757,2219.856516707,2145.900175904,87
carcassonne-uct130-vs-uct355-1000its,846,759,2225.424237019,2153.738131058,87
carcassonne-uct55-vs-uct15-1000its,846,759,2158.961650705,2155.811605176,87
carcassonne-ucttuned35-vs-ucttuned60-1000its,846,759,2212.147544335,2122.790515246,87
carcassonne-boltzmann275-vs-boltzmann210-1000its,847,760,2203.892649131,2190.490106644,87
carcassonne-ucttuned70-vs-ucttuned305-1000its,848,761,2284.799026871,2239.269379941,87
carcassonne-uct90-vs-uct210-1000its,849,762,2164.148155959,2109.621866091,87
carcassonne-ucttuned330-vs-ucttuned415-1000its,849,762,2253.927614972,2198.187357178,87
carcassonne-uct155-vs-uct210-1000its,850,763,2124.426845145,2117.494784601,87
carcassonne-ucttuned345-vs-ucttuned185-1000its,850,763,2237.075256909,2215.073308089,87
carcassonne-boltzmann450-vs-boltzmann30-1000its,851,764,2285.271050043,2196.396806947,87
carcassonne-ucttuned155-vs-ucttuned85-1000its,851,764,2208.169772976,2180.585146359,87
carcassonne-boltzmann420-vs-boltzmann210-1000its,855,768,2197.250420874,2190.182083881,87
carcassonne-uct185-vs-uct140-1000its,856,769,2180.414546856,2188.368426477,87
carcassonne-uct185-vs-uct45-1000its,856,769,2150.424150143,2075.349982275,87
carcassonne-uct365-vs-uct385-1000its,857,770,2213.190692579,2167.576742338,87
carcassonne-boltzmann365-vs-boltzmann250-1000its,859,772,2214.723172427,2166.755401832,87
carcassonne-boltzmann430-vs-boltzmann145-1000its,860,773,2282.058867568,2190.912851829,87
carcassonne-ucttuned155-vs-ucttuned30-1000its,860,773,2194.525014541,2135.675174056,87
carcassonne-ucttuned220-vs-ucttuned165-1000its,860,773,2228.523180894,2198.381438829,87
carcassonne-boltzmann175-vs-boltzmann430-1000its,862,775,2214.554921994,2119.575870367,87
carcassonne-ucttuned365-vs-ucttuned360-1000its,863,776,2193.783490712,2138.656416808,87
carcassonne-boltzmann105-vs-boltzmann445-1000its,864,777,2192.386119212,2142.657049236,87
carcassonne-ucttuned35-vs-ucttuned350-1000its,865,778,2197.317549329,2123.142013545,87
carcassonne-boltzmann300-vs-boltzmann160-1000its,867,780,2220.150913683,2182.651176961,87
carcassonne-boltzmann15-vs-boltzmann65-1000its,868,781,2206.104548792,2162.563392713,87
carcassonne-boltzmann310-vs-boltzmann420-1000its,870,783,2223.596872814,2193.278194282,87
carcassonne-uct185-vs-uct225-1000its,870,783,2165.489728391,2108.327905865,87
carcassonne-uct95-vs-uct265-1000its,873,786,2209.21144306,2152.694007143,87
carcassonne-boltzmann75-vs-boltzmann165-1000its,874,787,2170.765932628,2121.443401798,87
carcassonne-ucttuned25-vs-ucttuned280-1000its,875,788,2242.888418284,2189.073745264,87
carcassonne-uct105-vs-uct460-1000its,877,790,2171.496596585,2138.049929118,87
carcassonne-boltzmann245-vs-boltzmann490-1000its,879,792,2153.866971619,2144.171276266,87
carcassonne-ucttuned95-vs-ucttuned280-1000its,879,792,2268.911707303,2184.676189899,87
carcassonne-ucttuned20-vs-ucttuned370-1000its,881,794,2218.328386248,2212.014898025,87
carcassonne-uct295-vs-uct350-1000its,882,795,2220.383763484,2201.064298801,87
carcassonne-uct105-vs-uct295-1000its,883,796,2180.383670281,2119.230623902,87
carcassonne-boltzmann470-vs-boltzmann95-1000its,884,797,2264.426937764,2221.490449578,87
carcassonne-uct195-vs-uct495-1000its,888,801,2192.232395604,2149.477382585,87
carcassonne-ucttuned5-vs-ucttuned170-1000its,888,801,2253.177590882,2203.530580438,87
carcassonne-uct105-vs-uct395-1000its,889,802,2235.868885473,2198.104125909,87
carcassonne-uct45-vs-uct30-1000its,889,802,2121.967618121,2087.852553291,87
carcassonne-uct80-vs-uct490-1000its,889,802,2278.4853906,2270.290695975,87
carcassonne-ucttuned185-vs-ucttuned290-1000its,894,807,2145.154624834,2129.531273967,87
carcassonne-uct100-vs-uct115-1000its,898,811,2196.295242792,2132.858099566,87
carcassonne-ucttuned10-vs-ucttuned445-1000its,900,813,2221.422052275,2211.913217476,87
carcassonne-boltzmann390-vs-boltzmann280-1000its,902,815,2168.034565378,2134.117343084,87
carcassonne-boltzmann10-vs-boltzmann425-1000its,904,817,2182.027944963,2159.779567129,87
carcassonne-ucttuned75-vs-ucttuned15-1000its,906,819,2175.394613548,2132.70777302,87
carcassonne-uct470-vs-uct40-1000its,908,821,2211.263024901,2170.909622249,87
carcassonne-uct185-vs-uct470-1000its,909,822,2309.079867408,2257.70751027,87
carcassonne-ucttuned120-vs-ucttuned355-1000its,910,823,2160.927267171,2113.842372332,87
carcassonne-ucttuned330-vs-ucttuned440-1000its,912,825,2138.455173077,2124.454408987,87
carcassonne-ucttuned290-vs-ucttuned150-1000its,918,831,2216.89591436,2165.373416094,87
carcassonne-ucttuned20-vs-ucttuned225-1000its,921,834,2228.679507658,2137.865801334,87
carcassonne-uct30-vs-uct50-1000its,930,843,2195.764460417,2159.782452993,87
carcassonne-ucttuned295-vs-ucttuned305-1000its,938,851,2298.491916114,2248.449786732,87
carcassonne-uct320-vs-uct210-1000its,946,859,2152.165606976,2118.237144018,87
carcassonne-boltzmann105-vs-boltzmann340-1000its,953,866,2209.246525779,2149.059351913,87
carcassonne-boltzmann375-vs-boltzmann100-1000its,953,866,2199.226119878,2168.352745017,87
carcassonne-boltzmann135-vs-boltzmann420-1000its,965,878,2261.586204559,2167.679270631,87
carcassonne-ucttuned35-vs-ucttuned475-1000its,766,678,1834.489471203,1765.540797091,88
carcassonne-uct430-vs-uct415-1000its,774,686,2161.759197295,2086.573579707,88
carcassonne-boltzmann55-vs-boltzmann155-1000its,782,694,2199.128889907,2133.460176404,88
carcassonne-boltzmann495-vs-boltzmann275-1000its,784,696,2219.007598039,2170.321223825,88
carcassonne-boltzmann170-vs-boltzmann435-1000its,786,698,2131.264707989,2104.311836891,88
carcassonne-ucttuned430-vs-ucttuned85-1000its,787,699,2217.92087869,2193.963545858,88
carcassonne-boltzmann320-vs-boltzmann460-1000its,792,704,2216.537322702,2162.964552449,88
carcassonne-ucttuned330-vs-ucttuned430-1000its,794,706,2135.255643538,2132.6454908,88
carcassonne-boltzmann40-vs-boltzmann125-1000its,798,710,2186.870957775,2129.462052844,88
carcassonne-boltzmann205-vs-boltzmann460-1000its,801,713,2219.193581575,2192.696648458,88
carcassonne-boltzmann285-vs-boltzmann85-1000its,803,715,2234.580471003,2199.569704834,88
carcassonne-uct135-vs-uct75-1000its,803,715,2218.674969923,2139.940196385,88
carcassonne-uct170-vs-uct10-1000its,808,720,2133.549240994,2105.502822232,88
carcassonne-uct285-vs-uct445-1000its,810,722,2159.268420465,2102.200040488,88
carcassonne-boltzmann215-vs-boltzmann135-1000its,811,723,2202.980711234,2171.327935232,88
carcassonne-ucttuned205-vs-ucttuned350-1000its,811,723,2153.492528058,2123.00721584,88
carcassonne-uct305-vs-uct265-1000its,814,726,2143.947782225,2120.219047306,88
carcassonne-uct20-vs-uct95-1000its,818,730,2208.743787356,2168.188357883,88
carcassonne-uct315-vs-uct355-1000its,819,731,2128.666376204,2094.878758785,88
carcassonne-boltzmann270-vs-boltzmann20-1000its,821,733,2242.909557782,2222.176615532,88
carcassonne-ucttuned350-vs-ucttuned95-1000its,821,733,2196.811729706,2128.981025465,88
carcassonne-boltzmann290-vs-boltzmann345-1000its,825,737,2195.19701464,2154.513350475,88
carcassonne-uct110-vs-uct180-1000its,825,737,2137.443956892,2058.910676464,88
carcassonne-boltzmann100-vs-boltzmann180-1000its,827,739,2207.346850537,2148.892620179,88
carcassonne-uct495-vs-uct70-1000its,827,739,2196.74376772,2134.834770983,88
carcassonne-ucttuned160-vs-ucttuned425-1000its,827,739,2256.818529985,2170.959756116,88
carcassonne-boltzmann140-vs-boltzmann155-1000its,830,742,2193.040248223,2137.928641184,88
carcassonne-boltzmann370-vs-boltzmann395-1000its,831,743,2159.454800585,2099.640396029,88
carcassonne-ucttuned285-vs-ucttuned385-1000its,831,743,2163.699314374,2081.173788488,88
carcassonne-uct20-vs-uct495-1000its,835,747,2254.565020591,2196.753651651,88
carcassonne-uct320-vs-uct245-1000its,835,747,2147.386990201,2124.651603851,88
carcassonne-uct390-vs-uct465-1000its,835,747,2201.51471731,2149.364451431,88
carcassonne-uct405-vs-uct305-1000its,835,747,2216.312981452,2167.787543971,88
carcassonne-ucttuned470-vs-ucttuned190-1000its,835,747,2201.687606276,2157.194181124,88
carcassonne-boltzmann385-vs-boltzmann205-1000its,837,749,2081.54710162,2060.97281096,88
carcassonne-uct145-vs-uct190-1000its,837,749,2197.071448943,2084.16026092,88
carcassonne-uct495-vs-uct10-1000its,837,749,2146.367847122,2117.919942111,88
carcassonne-boltzmann105-vs-boltzmann205-1000its,841,753,2196.663003953,2145.842860738,88
carcassonne-boltzmann170-vs-boltzmann190-1000its,841,753,2208.388997369,2164.364813023,88
carcassonne-boltzmann55-vs-boltzmann360-1000its,842,754,2158.031655322,2174.423908796,88
carcassonne-ucttuned245-vs-ucttuned150-1000its,843,755,2178.784576077,2143.088729085,88
carcassonne-ucttuned485-vs-ucttuned345-1000its,843,755,2233.040488275,2141.25668664,88
carcassonne-boltzmann195-vs-boltzmann75-1000its,844,756,2279.012689537,2177.704928464,88
carcassonne-boltzmann240-vs-boltzmann455-1000its,845,757,2187.11884669,2155.173099019,88
carcassonne-boltzmann40-vs-boltzmann465-1000its,845,757,2188.338831366,2158.987568225,88
carcassonne-boltzmann345-vs-boltzmann300-1000its,846,758,2143.365060149,2103.881384585,88
carcassonne-uct470-vs-uct150-1000its,846,758,2170.056539369,2132.65237104,88
carcassonne-ucttuned330-vs-ucttuned325-1000its,846,758,2150.082751513,2137.498439682,88
carcassonne-uct265-vs-uct480-1000its,851,763,2163.020454834,2113.925657794,88
carcassonne-boltzmann305-vs-boltzmann430-1000its,852,764,2248.243578775,2185.439642479,88
carcassonne-ucttuned285-vs-ucttuned205-1000its,852,764,2285.854713335,2230.713734102,88
carcassonne-boltzmann485-vs-boltzmann350-1000its,853,765,2211.12258545,2170.86939586,88
carcassonne-uct350-vs-uct420-1000its,853,765,2154.467238341,2109.878623498,88
carcassonne-boltzmann85-vs-boltzmann140-1000its,855,767,2258.893844753,2190.021539409,88
carcassonne-ucttuned495-vs-ucttuned55-1000its,855,767,2222.54894734,2219.118554422,88
carcassonne-ucttuned340-vs-ucttuned110-1000its,857,769,2207.584845301,2218.683363573,88
carcassonne-uct130-vs-uct300-1000its,859,771,2133.331704493,2105.557206762,88
carcassonne-uct400-vs-uct385-1000its,862,774,2151.368792303,2128.575234508,88
carcassonne-uct415-vs-uct355-1000its,863,775,2276.997962619,2230.155539188,88
carcassonne-boltzmann110-vs-boltzmann205-1000its,864,776,2171.854425372,2122.113447369,88
carcassonne-ucttuned400-vs-ucttuned170-1000its,864,776,2134.198265354,2082.7067474,88
carcassonne-ucttuned460-vs-ucttuned230-1000its,870,782,2158.702418961,2101.708403609,88
carcassonne-ucttuned50-vs-ucttuned285-1000its,870,782,2188.479210962,2114.011688264,88
carcassonne-uct175-vs-uct215-1000its,871,783,2184.12343489,2143.566235056,88
carcassonne-uct260-vs-uct225-1000its,879,791,2180.66563537,2145.094723449,88
carcassonne-boltzmann105-vs-boltzmann260-1000its,880,792,2179.629181371,2145.951474312,88
carcassonne-ucttuned35-vs-ucttuned200-1000its,880,792,2134.506728181,2116.108719523,88
carcassonne-ucttuned170-vs-ucttuned495-1000its,885,797,2163.918223008,2097.248022347,88
carcassonne-uct310-vs-uct335-1000its,887,799,2206.301755777,2131.126457264,88
carcassonne-boltzmann365-vs-boltzmann435-1000its,891,803,2166.05084965,2138.319522926,88
carcassonne-uct50-vs-uct360-1000its,892,804,2187.862173009,2139.928709003,88
carcassonne-boltzmann40-vs-boltzmann65-1000its,893,805,2168.953571323,2127.617745766,88
carcassonne-ucttuned160-vs-ucttuned415-1000its,894,806,2221.099316467,2204.816824304,88
carcassonne-uct10-vs-uct135-1000its,899,811,2199.372463011,2158.501464778,88
carcassonne-boltzmann475-vs-boltzmann140-1000its,901,813,2197.045310982,2188.564035153,88
carcassonne-uct200-vs-uct205-1000its,901,813,2244.151348459,2173.46492051,88
carcassonne-boltzmann30-vs-boltzmann300-1000its,904,816,2175.258138197,2100.867269889,88
carcassonne-uct265-vs-uct280-1000its,905,817,2215.211568408,2150.9235088,88
carcassonne-ucttuned90-vs-ucttuned200-1000its,905,817,2175.537047951,2105.310188103,88
carcassonne-ucttuned475-vs-ucttuned190-1000its,906,818,2112.384261087,2090.825958959,88
carcassonne-boltzmann440-vs-boltzmann165-1000its,907,819,2248.938086614,2233.152129712,88
carcassonne-uct90-vs-uct150-1000its,907,819,2240.026193849,2215.155720322,88
carcassonne-boltzmann205-vs-boltzmann360-1000its,913,825,2238.982650905,2238.251109123,88
carcassonne-boltzmann380-vs-boltzmann375-1000its,913,825,2211.340112255,2135.127013034,88
carcassonne-ucttuned485-vs-ucttuned390-1000its,916,828,2193.669823134,2155.14299624,88
carcassonne-ucttuned55-vs-ucttuned240-1000its,926,838,2197.58941731,2198.300536174,88
carcassonne-uct180-vs-uct25-1000its,934,846,2171.859258147,2129.687239783,88
carcassonne-ucttuned295-vs-ucttuned75-1000its,938,850,2219.003144485,2192.612116319,88
carcassonne-ucttuned15-vs-ucttuned50-1000its,941,853,2186.962087198,2125.61098872,88
carcassonne-ucttuned190-vs-ucttuned130-1000its,749,660,2198.549709748,2115.597147733,89
carcassonne-uct105-vs-uct425-1000its,784,695,2246.823918893,2239.66044389,89
carcassonne-boltzmann225-vs-boltzmann430-1000its,797,708,2156.588435644,2158.902749256,89
carcassonne-uct245-vs-uct230-1000its,801,712,2204.115179471,2165.402630787,89
carcassonne-uct335-vs-uct310-1000its,806,717,2186.284411795,2097.079370378,89
carcassonne-uct105-vs-uct70-1000its,810,721,2276.347066691,2210.467649262,89
carcassonne-ucttuned170-vs-ucttuned380-1000its,811,722,2152.006830102,2096.896122862,89
carcassonne-boltzmann355-vs-boltzmann230-1000its,815,726,2227.012253556,2142.47208945,89
carcassonne-ucttuned460-vs-ucttuned260-1000its,815,726,2140.44229336,2071.39859667,89
carcassonne-boltzmann450-vs-boltzmann310-1000its,821,732,2241.141636593,2194.491161665,89
carcassonne-uct80-vs-uct210-1000its,821,732,2158.711926327,2105.583650448,89
carcassonne-boltzmann260-vs-boltzmann210-1000its,822,733,2206.549871361,2147.830225364,89
carcassonne-ucttuned335-vs-ucttuned290-1000its,822,733,2245.843480291,2187.862079043,89
carcassonne-uct445-vs-uct240-1000its,824,735,2176.239188966,2159.000772055,89
carcassonne-ucttuned255-vs-ucttuned280-1000its,824,735,2157.430342509,2110.776940352,89
carcassonne-ucttuned385-vs-ucttuned115-1000its,824,735,2154.476324688,2140.022040197,89
carcassonne-ucttuned40-vs-ucttuned95-1000its,825,736,2132.721253936,2096.544065224,89
carcassonne-ucttuned455-vs-ucttuned70-1000its,827,738,2185.598697427,2171.878293788,89
carcassonne-ucttuned165-vs-ucttuned350-1000its,829,740,2178.290024925,2133.421523118,89
carcassonne-uct445-vs-uct130-1000its,831,742,2149.934764771,2132.88262575,89
carcassonne-uct460-vs-uct495-1000its,835,746,2149.930520449,2088.352557925,89
carcassonne-ucttuned65-vs-ucttuned395-1000its,836,747,2240.031901882,2177.489507157,89
carcassonne-ucttuned435-vs-ucttuned495-1000its,838,749,2204.083193756,2144.60183652,89
carcassonne-boltzmann260-vs-boltzmann405-1000its,843,754,2181.69784318,2164.524559403,89
carcassonne-ucttuned290-vs-ucttuned180-1000its,843,754,2198.826376364,2120.02492697,89
carcassonne-ucttuned230-vs-ucttuned195-1000its,844,755,2257.120019608,2264.261107563,89
carcassonne-boltzmann410-vs-boltzmann85-1000its,845,756,2173.357748037,2147.165956561,89
carcassonne-boltzmann70-vs-boltzmann135-1000its,846,757,2182.141489101,2140.592089927,89
carcassonne-uct430-vs-uct375-1000its,847,758,2235.04496686,2120.167503121,89
carcassonne-uct410-vs-uct285-1000its,851,762,2119.166836072,2104.117096003,89
carcassonne-ucttuned40-vs-ucttuned465-1000its,853,764,2153.444233841,2115.830027663,89
carcassonne-uct45-vs-uct465-1000its,854,765,2179.457501464,2165.948911871,89
carcassonne-ucttuned40-vs-ucttuned390-1000its,856,767,2253.598317601,2222.34569249,89
carcassonne-ucttuned315-vs-ucttuned425-1000its,858,769,2196.177532207,2176.582658563,89
carcassonne-boltzmann210-vs-boltzmann170-1000its,859,770,2228.186124479,2184.89380634,89
carcassonne-uct250-vs-uct380-1000its,859,770,2246.425063638,2169.635902328,89
carcassonne-uct295-vs-uct195-1000its,859,770,2200.304771265,2159.267782986,89
carcassonne-uct5-vs-uct465-1000its,860,771,2156.705871711,2095.331511775,89
carcassonne-boltzmann50-vs-boltzmann155-1000its,863,774,2198.682124857,2167.559290477,89
carcassonne-uct50-vs-uct415-1000its,863,774,2190.11006158,2145.759189657,89
carcassonne-uct290-vs-uct20-1000its,867,778,2194.579366758,2141.864296573,89
carcassonne-ucttuned295-vs-ucttuned260-1000its,868,779,2164.286663222,2112.741222075,89
carcassonne-uct135-vs-uct415-1000its,871,782,2200.260708612,2199.854715366,89
carcassonne-ucttuned175-vs-ucttuned495-1000its,871,782,2275.196582581,2238.760503134,89
carcassonne-ucttuned380-vs-ucttuned45-1000its,871,782,2244.911090296,2224.888004249,89
carcassonne-uct135-vs-uct270-1000its,872,783,2197.018168077,2144.91745326,89
carcassonne-ucttuned35-vs-ucttuned195-1000its,872,783,2169.393177257,2150.926739896,89
carcassonne-ucttuned260-vs-ucttuned85-1000its,878,789,2222.526429435,2216.36077203,89
carcassonne-boltzmann275-vs-boltzmann35-1000its,882,793,2170.68566594,2155.87514151,89
carcassonne-boltzmann275-vs-boltzmann320-1000its,883,794,2165.603653415,2105.708114385,89
carcassonne-boltzmann400-vs-boltzmann55-1000its,885,796,2318.896995373,2282.251031989,89
carcassonne-uct255-vs-uct105-1000its,885,796,2236.566519626,2187.334084627,89
carcassonne-boltzmann240-vs-boltzmann295-1000its,888,799,2147.154337819,2082.123826569,89
carcassonne-uct65-vs-uct120-1000its,892,803,2203.304118113,2141.969856175,89
carcassonne-ucttuned330-vs-ucttuned310-1000its,895,806,2179.218726126,2140.743230814,89
carcassonne-ucttuned100-vs-ucttuned115-1000its,896,807,2204.496890654,2160.188696409,89
carcassonne-uct80-vs-uct205-1000its,897,808,2173.457199217,2131.252034383,89
carcassonne-boltzmann20-vs-boltzmann35-1000its,901,812,2238.731490278,2187.927394238,89
carcassonne-ucttuned225-vs-ucttuned105-1000its,904,815,2227.910830604,2182.955538759,89
carcassonne-ucttuned75-vs-ucttuned345-1000its,905,816,2162.635676604,2120.808852002,89
carcassonne-ucttuned305-vs-ucttuned75-1000its,909,820,2144.236098443,2100.892544441,89
carcassonne-boltzmann345-vs-boltzmann20-1000its,910,821,2167.222759599,2112.574592864,89
carcassonne-ucttuned410-vs-ucttuned370-1000its,915,826,2246.327947347,2202.221289741,89
carcassonne-uct275-vs-uct485-1000its,917,828,2210.610736685,2139.933767628,89
carcassonne-uct140-vs-uct480-1000its,920,831,2180.104414235,2183.956425578,89
carcassonne-uct135-vs-uct325-1000its,921,832,2155.081722101,2092.020738643,89
carcassonne-uct480-vs-uct145-1000its,921,832,2181.874372593,2121.862798801,89
carcassonne-uct380-vs-uct230-1000its,933,844,2240.831513137,2156.400421483,89
carcassonne-boltzmann215-vs-boltzmann70-1000its,942,853,2163.073120082,2104.22652991,89
carcassonne-ucttuned245-vs-ucttuned250-1000its,947,858,2209.608805619,2206.376233192,89
carcassonne-uct435-vs-uct25-1000its,639,549,1715.299862978,1703.374764119,90
carcassonne-uct45-vs-uct145-1000its,697,607,1804.866752436,1763.92595431,90
carcassonne-ucttuned490-vs-ucttuned280-1000its,767,677,2175.20954685,2153.076979387,90
carcassonne-boltzmann120-vs-boltzmann110-1000its,775,685,2176.733745912,2114.979600143,90
carcassonne-ucttuned270-vs-ucttuned285-1000its,775,685,2157.178657516,2096.204293785,90
carcassonne-boltzmann160-vs-boltzmann260-1000its,781,691,2208.208912908,2104.780416689,90
carcassonne-boltzmann185-vs-boltzmann200-1000its,782,692,2186.064983952,2120.865952752,90
carcassonne-boltzmann190-vs-boltzmann485-1000its,786,696,2251.892848797,2172.313068336,90
carcassonne-ucttuned115-vs-ucttuned265-1000its,786,696,2160.718798152,2107.949805348,90
carcassonne-boltzmann110-vs-boltzmann380-1000its,790,700,2199.524692637,2137.015717844,90
carcassonne-boltzmann5-vs-boltzmann335-1000its,798,708,2266.441135005,2180.119107772,90
carcassonne-ucttuned100-vs-ucttuned445-1000its,801,711,2183.40233284,2179.432148264,90
carcassonne-boltzmann430-vs-boltzmann270-1000its,813,723,2178.769607129,2174.30202543,90
carcassonne-boltzmann320-vs-boltzmann375-1000its,815,725,2183.78098814,2174.672757566,90
carcassonne-boltzmann305-vs-boltzmann55-1000its,816,726,2101.880845884,2060.323722241,90
carcassonne-boltzmann260-vs-boltzmann120-1000its,820,730,2160.184915108,2109.952586845,90
carcassonne-boltzmann485-vs-boltzmann120-1000its,821,731,2209.266243178,2181.103771333,90
carcassonne-ucttuned35-vs-ucttuned365-1000its,821,731,2197.414967219,2151.165221443,90
carcassonne-uct345-vs-uct255-1000its,828,738,2186.621947023,2155.032083841,90
carcassonne-uct155-vs-uct415-1000its,829,739,2158.423768045,2095.741820067,90
carcassonne-uct295-vs-uct365-1000its,829,739,2221.553467625,2138.075604676,90
carcassonne-ucttuned20-vs-ucttuned350-1000its,831,741,2238.645816993,2206.957837327,90
carcassonne-ucttuned320-vs-ucttuned375-1000its,831,741,2165.788612284,2148.227635681,90
carcassonne-ucttuned350-vs-ucttuned425-1000its,831,741,2268.847882502,2222.804834794,90
carcassonne-boltzmann105-vs-boltzmann120-1000its,833,743,2230.020896735,2175.444171481,90
carcassonne-ucttuned425-vs-ucttuned325-1000its,833,743,2299.114426466,2236.547230908,90
carcassonne-uct495-vs-uct370-1000its,835,745,2207.872696244,2168.40788287,90
carcassonne-ucttuned55-vs-ucttuned325-1000its,835,745,2232.449140263,2188.922026242,90
carcassonne-ucttuned20-vs-ucttuned355-1000its,836,746,2213.306408624,2141.395597109,90
carcassonne-boltzmann180-vs-boltzmann455-1000its,838,748,2208.484953649,2146.549590731,90
carcassonne-boltzmann75-vs-boltzmann350-1000its,838,748,2147.067325389,2124.656870274,90
carcassonne-ucttuned245-vs-ucttuned30-1000its,838,748,2193.310614645,2160.117876961,90
carcassonne-boltzmann455-vs-boltzmann10-1000its,839,749,2201.54398124,2139.533365752,90
carcassonne-boltzmann45-vs-boltzmann30-1000its,840,750,2179.682558696,2092.021975658,90
carcassonne-uct230-vs-uct375-1000its,841,751,2168.940129577,2106.200675924,90
carcassonne-uct385-vs-uct465-1000its,841,751,2153.345642436,2057.39123558,90
carcassonne-uct75-vs-uct300-1000its,842,752,2166.504446599,2123.297610916,90
carcassonne-boltzmann165-vs-boltzmann395-1000its,843,753,2231.816380023,2177.66169949,90
carcassonne-boltzmann5-vs-boltzmann315-1000its,844,754,2249.051525241,2165.279901131,90
carcassonne-ucttuned485-vs-ucttuned35-1000its,845,755,2275.973697632,2218.498513335,90
carcassonne-boltzmann160-vs-boltzmann230-1000its,846,756,2246.210751493,2178.939226256,90
carcassonne-ucttuned465-vs-ucttuned170-1000its,846,756,2178.762791932,2128.571027864,90
carcassonne-boltzmann55-vs-boltzmann35-1000its,847,757,2155.723619737,2173.978717184,90
carcassonne-uct445-vs-uct395-1000its,848,758,2173.439756791,2141.678446578,90
carcassonne-boltzmann195-vs-boltzmann325-1000its,850,760,2185.761048885,2147.064168162,90
carcassonne-uct95-vs-uct195-1000its,850,760,2147.970536877,2108.725601436,90
carcassonne-ucttuned185-vs-ucttuned385-1000its,850,760,2226.905211018,2191.494111907,90
carcassonne-ucttuned410-vs-ucttuned470-1000its,850,760,2188.525350853,2142.938929634,90
carcassonne-boltzmann400-vs-boltzmann475-1000its,852,762,2268.933173487,2226.721259437,90
carcassonne-boltzmann55-vs-boltzmann65-1000its,854,764,2217.967065961,2144.090401742,90
carcassonne-uct380-vs-uct385-1000its,854,764,2202.774424138,2124.190145012,90
carcassonne-boltzmann180-vs-boltzmann380-1000its,856,766,2273.83548076,2160.796974827,90
carcassonne-ucttuned275-vs-ucttuned160-1000its,861,771,2169.700459872,2168.672057384,90
carcassonne-boltzmann430-vs-boltzmann495-1000its,862,772,2175.145236104,2152.005888889,90
carcassonne-ucttuned255-vs-ucttuned70-1000its,862,772,2137.511448989,2070.933009393,90
carcassonne-uct245-vs-uct35-1000its,863,773,2181.476681258,2169.555956793,90
carcassonne-boltzmann220-vs-boltzmann195-1000its,864,774,2159.05926867,2182.212825742,90
carcassonne-ucttuned105-vs-ucttuned235-1000its,865,775,2168.687487812,2072.326881552,90
carcassonne-ucttuned20-vs-ucttuned480-1000its,867,777,2208.973111787,2142.246228073,90
carcassonne-boltzmann15-vs-boltzmann320-1000its,868,778,2220.897417559,2176.220834474,90
carcassonne-boltzmann460-vs-boltzmann10-1000its,869,779,2130.675624754,2112.217334345,90
carcassonne-ucttuned275-vs-ucttuned165-1000its,869,779,2206.143517708,2115.271394906,90
carcassonne-boltzmann305-vs-boltzmann300-1000its,870,780,2180.836648908,2131.367174155,90
carcassonne-boltzmann485-vs-boltzmann80-1000its,872,782,2201.287229936,2156.122162659,90
carcassonne-uct185-vs-uct35-1000its,874,784,2224.007359399,2131.160990787,90
carcassonne-ucttuned20-vs-ucttuned495-1000its,878,788,2174.846217376,2154.310000032,90
carcassonne-uct395-vs-uct205-1000its,882,792,2281.728968279,2246.355372311,90
carcassonne-boltzmann270-vs-boltzmann195-1000its,884,794,2206.169673429,2146.516470163,90
carcassonne-boltzmann305-vs-boltzmann320-1000its,885,795,2220.134391244,2174.003898354,90
carcassonne-uct70-vs-uct330-1000its,886,796,2162.456317686,2155.169418606,90
carcassonne-uct200-vs-uct50-1000its,888,798,2253.527427262,2222.106441775,90
carcassonne-ucttuned495-vs-ucttuned355-1000its,895,805,2322.850129444,2223.300393849,90
carcassonne-uct335-vs-uct315-1000its,897,807,2136.229468654,2079.7614567,90
carcassonne-uct50-vs-uct495-1000its,898,808,2199.822539515,2158.826558764,90
carcassonne-ucttuned380-vs-ucttuned195-1000its,899,809,2210.566535988,2173.529691601,90
carcassonne-uct290-vs-uct35-1000its,904,814,2173.60476913,2141.583320194,90
carcassonne-boltzmann115-vs-boltzmann360-1000its,905,815,2251.432842062,2165.931220198,90
carcassonne-ucttuned355-vs-ucttuned110-1000its,905,815,2157.961525618,2153.25783322,90
carcassonne-boltzmann250-vs-boltzmann145-1000its,906,816,2149.755681864,2108.182469965,90
carcassonne-uct140-vs-uct80-1000its,906,816,2234.179107153,2159.066325025,90
carcassonne-ucttuned210-vs-ucttuned10-1000its,906,816,2182.600993056,2129.778242444,90
carcassonne-ucttuned10-vs-ucttuned195-1000its,907,817,2200.704231242,2161.610170949,90
carcassonne-ucttuned95-vs-ucttuned295-1000its,909,819,2241.54212618,2241.574762258,90
carcassonne-uct15-vs-uct390-1000its,913,823,2127.294069539,2097.467945869,90
carcassonne-ucttuned370-vs-ucttuned255-1000its,915,825,2084.141010249,2075.415098194,90
carcassonne-boltzmann235-vs-boltzmann320-1000its,920,830,2245.715295108,2181.987174333,90
carcassonne-ucttuned320-vs-ucttuned285-1000its,928,838,2170.320118405,2132.319272288,90
carcassonne-boltzmann175-vs-boltzmann155-1000its,929,839,2221.289126681,2183.33961093,90
carcassonne-boltzmann395-vs-boltzmann280-1000its,969,879,2227.40228393,2170.655610232,90
carcassonne-boltzmann210-vs-boltzmann295-1000its,778,687,2223.934728687,2187.128704389,91
carcassonne-boltzmann260-vs-boltzmann195-1000its,778,687,2233.531684838,2179.748555634,91
carcassonne-boltzmann80-vs-boltzmann405-1000its,778,687,2147.28801637,2081.134911099,91
carcassonne-ucttuned350-vs-ucttuned395-1000its,778,687,2197.643723562,2142.966705811,91
carcassonne-boltzmann320-vs-boltzmann240-1000its,780,689,2195.857020162,2131.860321867,91
carcassonne-boltzmann355-vs-boltzmann10-1000its,800,709,2142.596648884,2101.043310241,91
carcassonne-uct450-vs-uct375-1000its,800,709,2279.287353207,2212.146458751,91
carcassonne-boltzmann310-vs-boltzmann175-1000its,803,712,2225.235900199,2177.261270136,91
carcassonne-uct70-vs-uct340-1000its,803,712,2216.250215241,2203.062795217,91
carcassonne-boltzmann5-vs-boltzmann235-1000its,804,713,2222.996184624,2171.434628001,91
carcassonne-uct250-vs-uct350-1000its,805,714,2196.620709628,2170.694046494,91
carcassonne-uct395-vs-uct315-1000its,805,714,2205.38494867,2143.45205536,91
carcassonne-boltzmann25-vs-boltzmann435-1000its,810,719,2199.664578065,2147.058323408,91
carcassonne-ucttuned410-vs-ucttuned375-1000its,811,720,2196.220499733,2118.958815002,91
carcassonne-ucttuned185-vs-ucttuned475-1000its,814,723,2174.553157266,2154.008684966,91
carcassonne-uct430-vs-uct165-1000its,816,725,2138.885519993,2064.813487456,91
carcassonne-uct460-vs-uct60-1000its,816,725,2163.523875907,2112.818666791,91
carcassonne-boltzmann435-vs-boltzmann50-1000its,817,726,2153.145814473,2139.454365889,91
carcassonne-boltzmann405-vs-boltzmann490-1000its,819,728,2117.821846522,2101.748073806,91
carcassonne-boltzmann235-vs-boltzmann295-1000its,825,734,2223.053379097,2128.839163564,91
carcassonne-uct480-vs-uct420-1000its,825,734,2208.637271521,2145.211720701,91
carcassonne-uct255-vs-uct485-1000its,827,736,2160.498911326,2098.056317358,91
carcassonne-ucttuned395-vs-ucttuned230-1000its,827,736,2256.474370992,2148.732215372,91
carcassonne-boltzmann405-vs-boltzmann435-1000its,830,739,2195.478917483,2129.42499977,91
carcassonne-ucttuned160-vs-ucttuned350-1000its,830,739,2346.233302812,2317.09660842,91
carcassonne-ucttuned165-vs-ucttuned275-1000its,831,740,2188.186487401,2146.050136804,91
carcassonne-ucttuned325-vs-ucttuned160-1000its,833,742,2218.60427381,2174.556225878,91
carcassonne-boltzmann445-vs-boltzmann220-1000its,834,743,2152.275735979,2148.75123585,91
carcassonne-boltzmann340-vs-boltzmann305-1000its,835,744,2160.870412446,2126.605420849,91
carcassonne-ucttuned260-vs-ucttuned415-1000its,836,745,2195.29288864,2161.959174489,91
carcassonne-uct330-vs-uct95-1000its,837,746,2303.67828686,2201.843667033,91
carcassonne-ucttuned115-vs-ucttuned365-1000its,839,748,2230.616913256,2180.859050728,91
carcassonne-ucttuned150-vs-ucttuned305-1000its,840,749,2245.814825248,2183.479842285,91
carcassonne-ucttuned195-vs-ucttuned415-1000its,842,751,2279.738157068,2208.538821697,91
carcassonne-boltzmann415-vs-boltzmann425-1000its,843,752,2226.047216794,2204.652472112,91
carcassonne-boltzmann55-vs-boltzmann115-1000its,844,753,2183.329730176,2165.815312276,91
carcassonne-boltzmann385-vs-boltzmann40-1000its,845,754,2209.330894313,2174.196456252,91
carcassonne-ucttuned480-vs-ucttuned115-1000its,845,754,2185.630513083,2135.73025189,91
carcassonne-ucttuned30-vs-ucttuned370-1000its,846,755,2181.92921719,2129.231101148,91
carcassonne-uct375-vs-uct335-1000its,850,759,2171.269574291,2143.502958137,91
carcassonne-uct295-vs-uct120-1000its,851,760,2151.856839924,2053.005497622,91
carcassonne-ucttuned40-vs-ucttuned450-1000its,852,761,2209.245424348,2130.412442672,91
carcassonne-ucttuned135-vs-ucttuned275-1000its,853,762,2190.658916995,2157.55273175,91
carcassonne-ucttuned450-vs-ucttuned5-1000its,853,762,2139.835952131,2084.42840874,91
carcassonne-ucttuned495-vs-ucttuned440-1000its,853,762,2236.712940701,2217.460238748,91
carcassonne-uct60-vs-uct290-1000its,855,764,2146.458089821,2124.201086842,91
carcassonne-ucttuned5-vs-ucttuned270-1000its,855,764,2151.266558605,2113.359281574,91
carcassonne-uct280-vs-uct235-1000its,859,768,2158.930767926,2095.673363936,91
carcassonne-uct30-vs-uct335-1000its,859,768,2222.966146025,2198.164353727,91
carcassonne-uct70-vs-uct125-1000its,859,768,2264.720082596,2193.36608009,91
carcassonne-ucttuned190-vs-ucttuned395-1000its,861,770,2155.301758121,2090.976780672,91
carcassonne-ucttuned445-vs-ucttuned355-1000its,861,770,2291.213719541,2231.281922973,91
carcassonne-uct290-vs-uct110-1000its,868,777,2214.439640974,2181.327935456,91
carcassonne-uct90-vs-uct215-1000its,872,781,2155.40985446,2165.574790781,91
carcassonne-ucttuned135-vs-ucttuned475-1000its,872,781,2175.192065665,2105.955442201,91
carcassonne-ucttuned45-vs-ucttuned125-1000its,872,781,2226.330889829,2142.447356017,91
carcassonne-uct185-vs-uct135-1000its,873,782,2207.124555221,2145.847531083,91
carcassonne-uct195-vs-uct190-1000its,876,785,2199.741213715,2163.291151242,91
carcassonne-ucttuned75-vs-ucttuned45-1000its,878,787,2129.488252987,2105.648929927,91
carcassonne-uct5-vs-uct360-1000its,885,794,2170.760024463,2078.995055711,91
carcassonne-ucttuned475-vs-ucttuned340-1000its,889,798,2271.550550625,2207.262242908,91
carcassonne-ucttuned355-vs-ucttuned190-1000its,892,801,2247.649716228,2145.437459748,91
carcassonne-ucttuned25-vs-ucttuned20-1000its,893,802,2164.474082732,2128.029171994,91
carcassonne-uct310-vs-uct45-1000its,899,808,2130.025649616,2106.747258568,91
carcassonne-uct475-vs-uct250-1000its,899,808,2193.61179921,2162.255412614,91
carcassonne-uct330-vs-uct295-1000its,900,809,2208.621513001,2187.673317807,91
carcassonne-ucttuned135-vs-ucttuned205-1000its,901,810,2199.819189771,2136.885514484,91
carcassonne-uct460-vs-uct380-1000its,902,811,2177.505813157,2167.811423765,91
carcassonne-boltzmann485-vs-boltzmann315-1000its,904,813,2248.535836925,2215.493449687,91
carcassonne-uct275-vs-uct105-1000its,905,814,2215.736110498,2139.371328415,91
carcassonne-boltzmann50-vs-boltzmann105-1000its,911,820,2325.883712827,2284.536606422,91
carcassonne-uct5-vs-uct175-1000its,913,822,2215.716884606,2159.752068737,91
carcassonne-uct105-vs-uct145-1000its,914,823,2152.962662455,2095.223625214,91
carcassonne-boltzmann215-vs-boltzmann125-1000its,917,826,2194.332894231,2177.678117022,91
carcassonne-uct415-vs-uct480-1000its,923,832,2185.799009579,2134.624807031,91
carcassonne-ucttuned195-vs-ucttuned135-1000its,927,836,2183.64912708,2127.680814309,91
carcassonne-ucttuned210-vs-ucttuned390-1000its,965,874,2088.532221009,2067.789787589,91
carcassonne-boltzmann10-vs-boltzmann365-1000its,974,883,2198.402480965,2173.976382659,91
carcassonne-boltzmann470-vs-boltzmann390-1000its,773,681,2242.489172857,2170.941837009,92
carcassonne-ucttuned85-vs-ucttuned35-1000its,782,690,2178.377724712,2120.832581429,92
carcassonne-ucttuned295-vs-ucttuned105-1000its,804,712,2252.963015364,2186.562275507,92
carcassonne-boltzmann145-vs-boltzmann430-1000its,807,715,2145.619632031,2105.34634641,92
carcassonne-uct410-vs-uct130-1000its,807,715,2289.093389786,2259.260925377,92
carcassonne-uct60-vs-uct195-1000its,810,718,2186.054668128,2134.598186325,92
carcassonne-uct150-vs-uct80-1000its,812,720,2161.148886777,2112.039105092,92
carcassonne-boltzmann165-vs-boltzmann295-1000its,813,721,2185.159142398,2173.921931964,92
carcassonne-boltzmann175-vs-boltzmann325-1000its,814,722,2228.328572125,2166.468968919,92
carcassonne-uct350-vs-uct275-1000its,815,723,2244.29009177,2174.994586092,92
carcassonne-ucttuned115-vs-ucttuned380-1000its,815,723,2200.590359637,2159.316258009,92
carcassonne-uct465-vs-uct345-1000its,819,727,2153.92950848,2131.175102688,92
carcassonne-ucttuned125-vs-ucttuned280-1000its,820,728,2208.492782369,2155.633700935,92
carcassonne-boltzmann405-vs-boltzmann105-1000its,822,730,2175.01139823,2155.564365667,92
carcassonne-boltzmann135-vs-boltzmann60-1000its,825,733,2235.643284758,2191.390773881,92
carcassonne-boltzmann410-vs-boltzmann380-1000its,826,734,2158.126071748,2104.93991246,92
carcassonne-boltzmann275-vs-boltzmann245-1000its,830,738,2116.973765492,2096.143974672,92
carcassonne-ucttuned310-vs-ucttuned360-1000its,832,740,2175.734846014,2125.911504054,92
carcassonne-boltzmann290-vs-boltzmann235-1000its,833,741,2159.304462047,2169.460504231,92
carcassonne-ucttuned65-vs-ucttuned345-1000its,833,741,2133.763586104,2100.204941734,92
carcassonne-boltzmann435-vs-boltzmann175-1000its,834,742,2180.905312376,2093.277313973,92
carcassonne-ucttuned25-vs-ucttuned275-1000its,834,742,2136.316094313,2106.459106561,92
carcassonne-uct320-vs-uct140-1000its,839,747,2165.492563259,2134.502185793,92
carcassonne-uct145-vs-uct325-1000its,840,748,2230.291743713,2176.437010844,92
carcassonne-uct430-vs-uct210-1000its,840,748,2197.144760691,2126.485321467,92
carcassonne-ucttuned375-vs-ucttuned355-1000its,841,749,2197.172372119,2151.026884226,92
carcassonne-ucttuned380-vs-ucttuned390-1000its,843,751,2248.049184713,2203.628101577,92
carcassonne-ucttuned470-vs-ucttuned425-1000its,844,752,2275.565149238,2191.017873059,92
carcassonne-boltzmann35-vs-boltzmann10-1000its,845,753,2233.837081708,2189.002255458,92
carcassonne-uct255-vs-uct190-1000its,848,756,2231.88682368,2169.864148968,92
carcassonne-boltzmann290-vs-boltzmann480-1000its,849,757,2186.506538109,2155.135935655,92
carcassonne-boltzmann30-vs-boltzmann410-1000its,849,757,2225.922840577,2194.928905176,92
carcassonne-boltzmann360-vs-boltzmann345-1000its,853,761,2204.466125262,2173.043226172,92
carcassonne-uct35-vs-uct20-1000its,853,761,2209.163813322,2130.228045982,92
carcassonne-ucttuned205-vs-ucttuned50-1000its,853,761,2130.523362071,2105.264254936,92
carcassonne-uct205-vs-uct120-1000its,854,762,2171.125382161,2123.382412456,92
carcassonne-uct245-vs-uct270-1000its,855,763,2245.139462598,2141.957580334,92
carcassonne-uct445-vs-uct370-1000its,855,763,2119.333583688,2109.822012957,92
carcassonne-ucttuned375-vs-ucttuned320-1000its,855,763,2208.926585801,2181.774759373,92
carcassonne-uct35-vs-uct410-1000its,856,764,2174.404788494,2160.984421617,92
carcassonne-uct485-vs-uct390-1000its,856,764,2201.760939325,2110.416515446,92
carcassonne-uct10-vs-uct30-1000its,857,765,2210.36108542,2187.615037646,92
carcassonne-ucttuned425-vs-ucttuned435-1000its,858,766,2205.651240514,2194.643739954,92
carcassonne-ucttuned175-vs-ucttuned240-1000its,859,767,2293.877899095,2211.762472194,92
carcassonne-ucttuned445-vs-ucttuned385-1000its,860,768,2201.340031466,2179.922540242,92
carcassonne-boltzmann490-vs-boltzmann145-1000its,863,771,2193.35019338,2184.098606718,92
carcassonne-boltzmann35-vs-boltzmann155-1000its,864,772,2179.083920695,2160.968053956,92
carcassonne-uct185-vs-uct55-1000its,864,772,2228.014414831,2236.384715504,92
carcassonne-uct305-vs-uct145-1000its,864,772,2204.649994605,2115.736847303,92
carcassonne-ucttuned325-vs-ucttuned450-1000its,865,773,2222.630369312,2153.330385374,92
carcassonne-ucttuned405-vs-ucttuned495-1000its,868,776,2172.878651016,2110.265294448,92
carcassonne-boltzmann75-vs-boltzmann50-1000its,869,777,2154.980069162,2150.94063009,92
carcassonne-uct300-vs-uct235-1000its,869,777,2199.395777837,2165.337384887,92
carcassonne-uct120-vs-uct255-1000its,873,781,2215.737564805,2194.123879437,92
carcassonne-uct265-vs-uct150-1000its,873,781,2210.509544432,2154.876363556,92
carcassonne-boltzmann45-vs-boltzmann380-1000its,876,784,2271.028411283,2196.165679388,92
carcassonne-uct220-vs-uct335-1000its,882,790,2266.972469726,2195.756501057,92
carcassonne-ucttuned405-vs-ucttuned140-1000its,883,791,2239.852817241,2166.871291621,92
carcassonne-uct250-vs-uct360-1000its,884,792,2254.242950168,2232.692421416,92
carcassonne-ucttuned355-vs-ucttuned430-1000its,885,793,2277.168009631,2247.232236676,92
carcassonne-ucttuned5-vs-ucttuned280-1000its,885,793,2269.364048524,2199.61663116,92
carcassonne-ucttuned485-vs-ucttuned70-1000its,886,794,2208.285396169,2196.294630051,92
carcassonne-uct50-vs-uct210-1000its,887,795,2172.342554696,2139.740575984,92
carcassonne-boltzmann15-vs-boltzmann205-1000its,891,799,2256.519305929,2201.03707833,92
carcassonne-uct170-vs-uct425-1000its,891,799,2164.845616455,2150.188679409,92
carcassonne-uct265-vs-uct460-1000its,893,801,2233.300526321,2200.312199568,92
carcassonne-ucttuned95-vs-ucttuned130-1000its,895,803,2239.102682317,2189.49036818,92
carcassonne-ucttuned10-vs-ucttuned130-1000its,898,806,2197.069222514,2131.923969596,92
carcassonne-boltzmann125-vs-boltzmann495-1000its,899,807,2186.888540125,2116.852931652,92
carcassonne-ucttuned35-vs-ucttuned250-1000its,901,809,2199.988450308,2161.447665358,92
carcassonne-ucttuned290-vs-ucttuned195-1000its,903,811,2199.771273766,2135.056667104,92
carcassonne-ucttuned5-vs-ucttuned60-1000its,905,813,2187.447195048,2186.573030434,92
carcassonne-uct215-vs-uct285-1000its,907,815,2205.208637752,2151.826055505,92
carcassonne-boltzmann325-vs-boltzmann110-1000its,914,822,2201.392202263,2164.215822685,92
carcassonne-uct240-vs-uct300-1000its,917,825,2131.92398605,2083.073304001,92
carcassonne-ucttuned135-vs-ucttuned255-1000its,919,827,2218.888645154,2194.775629347,92
carcassonne-uct65-vs-uct45-1000its,921,829,2199.414186908,2155.769303643,92
carcassonne-uct195-vs-uct165-1000its,928,836,2177.857583633,2166.03730587,92
carcassonne-uct305-vs-uct205-1000its,928,836,2177.301865991,2123.223343577,92
carcassonne-boltzmann120-vs-boltzmann180-1000its,947,855,2254.444130701,2204.37974333,92
carcassonne-uct90-vs-uct295-1000its,1000,908,2195.057696504,2193.747401341,92
carcassonne-boltzmann475-vs-boltzmann395-1000its,752,659,2262.252688658,2205.744997535,93
carcassonne-boltzmann95-vs-boltzmann440-1000its,787,694,2172.52094325,2195.304285341,93
carcassonne-ucttuned275-vs-ucttuned355-1000its,793,700,2153.237942724,2133.922457535,93
carcassonne-ucttuned405-vs-ucttuned55-1000its,803,710,2158.836276247,2127.19298784,93
carcassonne-ucttuned160-vs-ucttuned435-1000its,804,711,2224.118282525,2168.854632514,93
carcassonne-uct240-vs-uct65-1000its,806,713,2238.072431414,2166.464214314,93
carcassonne-boltzmann490-vs-boltzmann20-1000its,807,714,2244.955850327,2153.842260496,93
carcassonne-uct180-vs-uct330-1000its,808,715,2251.692816649,2226.271371621,93
carcassonne-uct400-vs-uct465-1000its,814,721,2257.386246179,2199.651347463,93
carcassonne-uct180-vs-uct215-1000its,815,722,2230.351757611,2163.325983516,93
carcassonne-ucttuned380-vs-ucttuned270-1000its,815,722,2214.687681934,2150.47804315,93
carcassonne-uct270-vs-uct305-1000its,821,728,2177.87172997,2106.042535914,93
carcassonne-ucttuned90-vs-ucttuned390-1000its,822,729,2225.120712638,2146.948683463,93
carcassonne-boltzmann215-vs-boltzmann405-1000its,823,730,2241.365131342,2168.530549633,93
carcassonne-uct275-vs-uct475-1000its,825,732,2230.431156616,2139.479456079,93
carcassonne-ucttuned165-vs-ucttuned40-1000its,825,732,2231.998128947,2180.074835465,93
carcassonne-boltzmann220-vs-boltzmann410-1000its,826,733,2219.983209162,2203.303281141,93
carcassonne-ucttuned200-vs-ucttuned190-1000its,827,734,2190.918055065,2190.837302658,93
carcassonne-uct105-vs-uct220-1000its,828,735,2180.333224396,2120.314914376,93
carcassonne-boltzmann50-vs-boltzmann280-1000its,829,736,2185.646547622,2154.189421192,93
carcassonne-uct45-vs-uct230-1000its,831,738,2256.289165375,2195.791299367,93
carcassonne-ucttuned135-vs-ucttuned140-1000its,831,738,2165.805132213,2154.05203423,93
carcassonne-boltzmann485-vs-boltzmann180-1000its,835,742,2147.499784802,2113.367744788,93
carcassonne-boltzmann125-vs-boltzmann160-1000its,838,745,2259.959981883,2202.713597076,93
carcassonne-boltzmann50-vs-boltzmann385-1000its,838,745,2114.41037715,2087.76779667,93
carcassonne-boltzmann255-vs-boltzmann440-1000its,840,747,2257.763825327,2144.490235827,93
carcassonne-ucttuned185-vs-ucttuned470-1000its,842,749,2225.046996084,2179.796231438,93
carcassonne-ucttuned255-vs-ucttuned185-1000its,850,757,2166.31970698,2089.997308341,93
carcassonne-ucttuned445-vs-ucttuned310-1000its,852,759,2229.582825998,2165.673254552,93
carcassonne-uct320-vs-uct255-1000its,854,761,2159.841566777,2123.574505338,93
carcassonne-ucttuned425-vs-ucttuned180-1000its,854,761,2157.287158072,2143.133156719,93
carcassonne-boltzmann260-vs-boltzmann340-1000its,855,762,2183.2364622,2143.392783371,93
carcassonne-uct180-vs-uct285-1000its,855,762,2198.420185977,2150.349475858,93
carcassonne-ucttuned185-vs-ucttuned170-1000its,856,763,2152.541010723,2091.344389952,93
carcassonne-uct130-vs-uct255-1000its,859,766,2273.468286359,2265.177084106,93
carcassonne-uct15-vs-uct150-1000its,861,768,2127.968309188,2061.877331631,93
carcassonne-ucttuned285-vs-ucttuned305-1000its,865,772,2262.35869897,2234.51977307,93
carcassonne-boltzmann485-vs-boltzmann400-1000its,866,773,2209.531992922,2172.45012606,93
carcassonne-ucttuned145-vs-ucttuned400-1000its,866,773,2147.440444737,2133.984552632,93
carcassonne-boltzmann195-vs-boltzmann370-1000its,867,774,2177.094773348,2112.326483018,93
carcassonne-ucttuned430-vs-ucttuned205-1000its,869,776,2142.673364989,2093.854238425,93
carcassonne-uct435-vs-uct230-1000its,872,779,2143.675807024,2137.125710604,93
carcassonne-uct145-vs-uct85-1000its,874,781,2229.741421233,2213.474225029,93
carcassonne-uct280-vs-uct485-1000its,877,784,2206.611888113,2160.710401241,93
carcassonne-boltzmann180-vs-boltzmann100-1000its,878,785,2220.310507444,2156.188313994,93
carcassonne-ucttuned25-vs-ucttuned215-1000its,880,787,2218.548438598,2171.793188275,93
carcassonne-uct430-vs-uct380-1000its,882,789,2178.177761205,2166.978464966,93
carcassonne-ucttuned425-vs-ucttuned115-1000its,885,792,2200.023598225,2177.212880769,93
carcassonne-ucttuned25-vs-ucttuned95-1000its,886,793,2172.046521223,2129.461397182,93
carcassonne-uct300-vs-uct160-1000its,888,795,2137.654072513,2136.352489227,93
carcassonne-uct40-vs-uct145-1000its,889,796,2209.430255238,2171.184196226,93
carcassonne-ucttuned140-vs-ucttuned325-1000its,889,796,2170.121105367,2097.965239719,93
carcassonne-ucttuned395-vs-ucttuned470-1000its,889,796,2179.976644557,2128.026443439,93
carcassonne-ucttuned170-vs-ucttuned90-1000its,891,798,2144.923864289,2101.979155241,93
carcassonne-boltzmann410-vs-boltzmann105-1000its,893,800,2233.798260219,2197.494209802,93
carcassonne-ucttuned415-vs-ucttuned455-1000its,897,804,2186.582073486,2129.373922332,93
carcassonne-uct175-vs-uct480-1000its,898,805,2110.183104676,2082.25481861,93
carcassonne-boltzmann15-vs-boltzmann180-1000its,900,807,2224.395070684,2220.85255788,93
carcassonne-ucttuned50-vs-ucttuned410-1000its,906,813,2273.520416349,2182.007004217,93
carcassonne-uct325-vs-uct400-1000its,907,814,2194.63267657,2173.938704497,93
carcassonne-ucttuned395-vs-ucttuned300-1000its,910,817,2211.988594892,2134.365133597,93
carcassonne-ucttuned190-vs-ucttuned120-1000its,911,818,2297.495389487,2263.616143532,93
carcassonne-ucttuned105-vs-ucttuned345-1000its,913,820,2214.168706717,2123.197025067,93
carcassonne-ucttuned15-vs-ucttuned130-1000its,916,823,2224.69324313,2152.555475589,93
carcassonne-ucttuned395-vs-ucttuned60-1000its,916,823,2203.593660061,2190.901692379,93
carcassonne-ucttuned390-vs-ucttuned70-1000its,928,835,2165.106661937,2129.607560429,93
carcassonne-ucttuned130-vs-ucttuned235-1000its,929,836,2144.80956051,2130.313367911,93
carcassonne-uct290-vs-uct385-1000its,932,839,2236.219842477,2182.186909185,93
carcassonne-uct260-vs-uct285-1000its,945,852,2228.07885926,2207.999620286,93
carcassonne-boltzmann60-vs-boltzmann475-1000its,952,859,2218.638243326,2165.620702964,93
carcassonne-uct330-vs-uct410-1000its,955,862,2203.791438623,2190.7739669,93
carcassonne-uct355-vs-uct275-1000its,967,874,2212.250630057,2204.908609709,93
carcassonne-uct110-vs-uct455-1000its,732,638,2221.407470476,2125.730424864,94
carcassonne-boltzmann245-vs-boltzmann65-1000its,750,656,2214.848920575,2135.831821399,94
carcassonne-boltzmann440-vs-boltzmann240-1000its,767,673,2170.765667854,2096.321382046,94
carcassonne-ucttuned405-vs-ucttuned285-1000its,775,681,2238.249595721,2156.163923079,94
carcassonne-ucttuned50-vs-ucttuned105-1000its,780,686,2231.936783142,2191.231835259,94
carcassonne-ucttuned245-vs-ucttuned295-1000its,789,695,2185.698818456,2135.51557751,94
carcassonne-uct300-vs-uct370-1000its,792,698,2215.624382197,2211.761181193,94
carcassonne-ucttuned320-vs-ucttuned305-1000its,795,701,2208.299125586,2117.244447371,94
carcassonne-boltzmann335-vs-boltzmann215-1000its,804,710,2183.014490582,2155.908732655,94
carcassonne-boltzmann140-vs-boltzmann320-1000its,808,714,2225.377884098,2172.140659845,94
carcassonne-boltzmann165-vs-boltzmann55-1000its,814,720,2161.963920399,2174.150701028,94
carcassonne-boltzmann445-vs-boltzmann275-1000its,815,721,2195.752288428,2171.640031756,94
carcassonne-boltzmann370-vs-boltzmann365-1000its,817,723,2223.201746784,2179.956439726,94
carcassonne-boltzmann225-vs-boltzmann150-1000its,821,727,2229.17977933,2185.438402094,94
carcassonne-uct255-vs-uct295-1000its,822,728,2235.245869619,2187.039812516,94
carcassonne-boltzmann410-vs-boltzmann470-1000its,823,729,2172.574039037,2106.2399986,94
carcassonne-ucttuned195-vs-ucttuned80-1000its,827,733,2234.746762853,2160.530953674,94
carcassonne-ucttuned60-vs-ucttuned400-1000its,830,736,2232.655310169,2190.730472808,94
carcassonne-ucttuned110-vs-ucttuned280-1000its,831,737,2198.899589004,2151.78337898,94
carcassonne-boltzmann325-vs-boltzmann435-1000its,833,739,2205.83322711,2145.890722113,94
carcassonne-ucttuned435-vs-ucttuned130-1000its,833,739,2226.29184461,2180.385080276,94
carcassonne-boltzmann155-vs-boltzmann40-1000its,834,740,2159.480274141,2106.10561256,94
carcassonne-boltzmann440-vs-boltzmann100-1000its,834,740,2169.318533923,2085.099448967,94
carcassonne-ucttuned45-vs-ucttuned340-1000its,834,740,2204.959611512,2147.709883679,94
carcassonne-boltzmann130-vs-boltzmann60-1000its,835,741,2210.84022805,2198.655123856,94
carcassonne-ucttuned400-vs-ucttuned340-1000its,835,741,2240.427206301,2186.714920483,94
carcassonne-uct220-vs-uct175-1000its,837,743,2233.34760858,2170.353171971,94
carcassonne-boltzmann395-vs-boltzmann245-1000its,841,747,2306.249361709,2256.745799185,94
carcassonne-ucttuned430-vs-ucttuned185-1000its,843,749,2210.991698651,2165.87570503,94
carcassonne-ucttuned220-vs-ucttuned415-1000its,845,751,2256.230276453,2203.390390012,94
carcassonne-uct290-vs-uct125-1000its,846,752,2122.269597273,2070.775247582,94
carcassonne-uct75-vs-uct385-1000its,847,753,2248.915207992,2174.540500673,94
carcassonne-ucttuned145-vs-ucttuned485-1000its,847,753,2190.607895983,2169.48696971,94
carcassonne-boltzmann245-vs-boltzmann380-1000its,848,754,2181.008402448,2140.117378128,94
carcassonne-boltzmann250-vs-boltzmann310-1000its,848,754,2156.775307866,2130.961466259,94
carcassonne-boltzmann80-vs-boltzmann415-1000its,849,755,2157.196227471,2108.047696947,94
carcassonne-boltzmann35-vs-boltzmann320-1000its,850,756,2158.749674037,2131.71966868,94
carcassonne-boltzmann115-vs-boltzmann460-1000its,851,757,2199.538731105,2170.290169803,94
carcassonne-boltzmann465-vs-boltzmann50-1000its,851,757,2163.763844184,2145.757091112,94
carcassonne-boltzmann490-vs-boltzmann220-1000its,851,757,2252.546993187,2175.564110515,94
carcassonne-uct205-vs-uct310-1000its,851,757,2174.067241333,2106.165142938,94
carcassonne-uct95-vs-uct160-1000its,851,757,2170.236529558,2164.168382961,94
carcassonne-ucttuned100-vs-ucttuned475-1000its,852,758,2189.993101607,2164.380691568,94
carcassonne-uct220-vs-uct470-1000its,856,762,2212.898062248,2165.786238283,94
carcassonne-ucttuned290-vs-ucttuned10-1000its,857,763,2196.4955194,2150.164152778,94
carcassonne-ucttuned310-vs-ucttuned400-1000its,857,763,2161.463198211,2110.833962145,94
carcassonne-ucttuned95-vs-ucttuned45-1000its,857,763,2218.556508532,2216.66705738,94
carcassonne-ucttuned30-vs-ucttuned240-1000its,858,764,2168.941458488,2173.271340583,94
carcassonne-boltzmann315-vs-boltzmann145-1000its,859,765,2224.425463584,2173.506280045,94
carcassonne-boltzmann350-vs-boltzmann95-1000its,859,765,2226.372931425,2172.368967062,94
carcassonne-ucttuned365-vs-ucttuned265-1000its,859,765,2217.754127634,2158.375002399,94
carcassonne-ucttuned185-vs-ucttuned205-1000its,863,769,2111.604880667,2099.228962866,94
carcassonne-ucttuned180-vs-ucttuned315-1000its,864,770,2197.243704862,2129.168172657,94
carcassonne-ucttuned320-vs-ucttuned10-1000its,864,770,2261.228295726,2243.1483976,94
carcassonne-ucttuned450-vs-ucttuned180-1000its,864,770,2140.257603231,2095.686217557,94
carcassonne-uct310-vs-uct395-1000its,869,775,2214.223421722,2201.488916305,94
carcassonne-boltzmann290-vs-boltzmann90-1000its,872,778,2222.192710058,2180.785988084,94
carcassonne-ucttuned450-vs-ucttuned25-1000its,874,780,2203.238060882,2192.67045634,94
carcassonne-boltzmann45-vs-boltzmann315-1000its,877,783,2147.906691178,2120.413467705,94
carcassonne-boltzmann20-vs-boltzmann190-1000its,878,784,2276.425740237,2190.435512665,94
carcassonne-uct125-vs-uct200-1000its,879,785,2232.574148445,2162.503576664,94
carcassonne-uct205-vs-uct395-1000its,879,785,2213.626511754,2145.59538051,94
carcassonne-ucttuned345-vs-ucttuned100-1000its,879,785,2195.096204965,2164.808739433,94
carcassonne-uct125-vs-uct365-1000its,881,787,2145.294362505,2106.060799051,94
carcassonne-uct155-vs-uct470-1000its,881,787,2246.295656444,2216.636780051,94
carcassonne-boltzmann150-vs-boltzmann275-1000its,885,791,2211.284537155,2202.365430433,94
carcassonne-boltzmann15-vs-boltzmann135-1000its,886,792,2154.00384143,2101.763186278,94
carcassonne-ucttuned165-vs-ucttuned345-1000its,886,792,2231.101287015,2227.095840456,94
carcassonne-ucttuned70-vs-ucttuned475-1000its,886,792,2253.157219915,2207.915250352,94
carcassonne-uct210-vs-uct355-1000its,888,794,2247.029015732,2193.578220935,94
carcassonne-ucttuned430-vs-ucttuned295-1000its,889,795,2198.289408967,2154.632961996,94
carcassonne-uct385-vs-uct295-1000its,890,796,2216.538090293,2181.32852362,94
carcassonne-ucttuned280-vs-ucttuned335-1000its,894,800,2245.324070302,2156.495485732,94
carcassonne-ucttuned285-vs-ucttuned295-1000its,896,802,2185.340953643,2151.358490897,94
carcassonne-uct120-vs-uct170-1000its,897,803,2156.996109769,2138.628368344,94
carcassonne-uct395-vs-uct280-1000its,900,806,2246.144410067,2133.23065386,94
carcassonne-uct20-vs-uct135-1000its,907,813,2172.59712401,2067.912139534,94
carcassonne-uct275-vs-uct315-1000its,908,814,2361.629972517,2286.366003204,94
carcassonne-ucttuned80-vs-ucttuned75-1000its,910,816,2249.727813688,2190.080392035,94
carcassonne-ucttuned70-vs-ucttuned80-1000its,916,822,2232.627600805,2199.487160241,94
carcassonne-uct215-vs-uct15-1000its,917,823,2141.175810793,2087.902522485,94
carcassonne-boltzmann115-vs-boltzmann365-1000its,918,824,2162.260742822,2175.135286588,94
carcassonne-uct450-vs-uct390-1000its,922,828,2172.053451219,2138.476256776,94
carcassonne-ucttuned35-vs-ucttuned55-1000its,927,833,2222.966485395,2213.290893131,94
carcassonne-uct425-vs-uct10-1000its,941,847,2244.219650046,2221.707759145,94
carcassonne-boltzmann15-vs-boltzmann355-1000its,708,613,1841.961143026,1795.178298029,95
carcassonne-boltzmann340-vs-boltzmann315-1000its,750,655,2183.667559032,2128.946099313,95
carcassonne-uct125-vs-uct295-1000its,753,658,2245.826308758,2197.198339488,95
carcassonne-uct275-vs-uct490-1000its,793,698,2178.79943121,2188.880878344,95
carcassonne-uct390-vs-uct185-1000its,798,703,2167.518593981,2111.727416842,95
carcassonne-boltzmann400-vs-boltzmann220-1000its,802,707,2218.280847483,2177.744754243,95
carcassonne-uct450-vs-uct335-1000its,803,708,2242.101750734,2206.735390747,95
carcassonne-boltzmann280-vs-boltzmann360-1000its,809,714,2180.966831317,2175.103307771,95
carcassonne-boltzmann140-vs-boltzmann20-1000its,814,719,2210.327055762,2186.612745327,95
carcassonne-boltzmann305-vs-boltzmann200-1000its,814,719,2279.80778325,2268.125908943,95
carcassonne-boltzmann40-vs-boltzmann180-1000its,814,719,2199.094909911,2170.247319684,95
carcassonne-ucttuned215-vs-ucttuned165-1000its,816,721,2146.133342165,2131.445553706,95
carcassonne-ucttuned305-vs-ucttuned300-1000its,817,722,2194.893231814,2136.487776021,95
carcassonne-ucttuned330-vs-ucttuned125-1000its,817,722,2177.187329667,2147.195906568,95
carcassonne-boltzmann210-vs-boltzmann330-1000its,819,724,2189.016769217,2168.863888788,95
carcassonne-ucttuned110-vs-ucttuned360-1000its,821,726,2176.459538934,2132.316372128,95
carcassonne-boltzmann155-vs-boltzmann45-1000its,822,727,2180.20072696,2091.978319385,95
carcassonne-boltzmann45-vs-boltzmann385-1000its,823,728,2245.809364706,2172.862385573,95
carcassonne-boltzmann175-vs-boltzmann460-1000its,828,733,2235.056198667,2187.427344268,95
carcassonne-ucttuned395-vs-ucttuned420-1000its,833,738,2235.918584706,2186.977144457,95
carcassonne-ucttuned325-vs-ucttuned480-1000its,835,740,2191.201743771,2175.51746798,95
carcassonne-boltzmann45-vs-boltzmann205-1000its,838,743,2228.93278417,2124.178818957,95
carcassonne-ucttuned315-vs-ucttuned470-1000its,840,745,2188.10633876,2176.964636434,95
carcassonne-boltzmann260-vs-boltzmann395-1000its,841,746,2357.013514529,2258.048542544,95
carcassonne-uct325-vs-uct55-1000its,842,747,2243.312866922,2220.819110401,95
carcassonne-uct480-vs-uct405-1000its,842,747,2197.843297495,2169.943961135,95
carcassonne-ucttuned485-vs-ucttuned260-1000its,843,748,2252.990577843,2180.971288133,95
carcassonne-boltzmann170-vs-boltzmann145-1000its,844,749,2171.334607296,2089.233510823,95
carcassonne-boltzmann410-vs-boltzmann310-1000its,844,749,2300.959886583,2223.325464003,95
carcassonne-ucttuned330-vs-ucttuned75-1000its,845,750,2180.286292205,2138.098919171,95
carcassonne-boltzmann45-vs-boltzmann125-1000its,846,751,2206.324288271,2139.020954474,95
carcassonne-boltzmann490-vs-boltzmann445-1000its,846,751,2168.651107023,2142.248500802,95
carcassonne-uct305-vs-uct50-1000its,848,753,2185.284517919,2173.753949533,95
carcassonne-boltzmann295-vs-boltzmann185-1000its,849,754,2223.756440381,2132.159783952,95
carcassonne-boltzmann305-vs-boltzmann35-1000its,849,754,2170.592684677,2115.934378669,95
carcassonne-boltzmann445-vs-boltzmann35-1000its,850,755,2234.8071923,2206.467869611,95
carcassonne-uct475-vs-uct150-1000its,850,755,2214.919544753,2173.258763897,95
carcassonne-boltzmann345-vs-boltzmann70-1000its,852,757,2136.513909764,2086.346115769,95
carcassonne-ucttuned475-vs-ucttuned360-1000its,854,759,2192.233242746,2153.22189326,95
carcassonne-ucttuned90-vs-ucttuned295-1000its,855,760,2139.309930029,2112.24580561,95
carcassonne-uct485-vs-uct275-1000its,857,762,2169.711181279,2105.085671448,95
carcassonne-ucttuned285-vs-ucttuned125-1000its,857,762,2165.573943552,2098.568647263,95
carcassonne-uct135-vs-uct430-1000its,859,764,2181.314252659,2145.090674165,95
carcassonne-uct130-vs-uct70-1000its,860,765,2146.305988402,2104.09911229,95
carcassonne-ucttuned355-vs-ucttuned260-1000its,860,765,2227.925142071,2172.464267017,95
carcassonne-uct175-vs-uct485-1000its,861,766,2188.595981617,2218.281142592,95
carcassonne-ucttuned335-vs-ucttuned190-1000its,861,766,2207.990512976,2129.555707303,95
carcassonne-ucttuned215-vs-ucttuned375-1000its,866,771,2186.776897383,2113.064670073,95
carcassonne-uct445-vs-uct315-1000its,868,773,2122.228753355,2106.554197359,95
carcassonne-uct10-vs-uct220-1000its,870,775,2248.647303555,2165.319689545,95
carcassonne-ucttuned400-vs-ucttuned430-1000its,870,775,2256.121352878,2138.740890618,95
carcassonne-ucttuned330-vs-ucttuned450-1000its,871,776,2203.313863337,2122.309283887,95
carcassonne-ucttuned465-vs-ucttuned40-1000its,871,776,2166.242830417,2123.433139705,95
carcassonne-boltzmann75-vs-boltzmann85-1000its,872,777,2169.013859717,2143.194067827,95
carcassonne-uct190-vs-uct395-1000its,873,778,2197.245000877,2133.044430385,95
carcassonne-ucttuned180-vs-ucttuned245-1000its,873,778,2193.342901983,2188.472267759,95
carcassonne-boltzmann55-vs-boltzmann85-1000its,874,779,2227.10907707,2161.107429488,95
carcassonne-ucttuned490-vs-ucttuned95-1000its,875,780,2218.242943674,2176.554525308,95
carcassonne-uct315-vs-uct310-1000its,878,783,2208.134547166,2111.594858704,95
carcassonne-uct85-vs-uct140-1000its,878,783,2234.976772989,2169.479830059,95
carcassonne-ucttuned485-vs-ucttuned445-1000its,890,795,2156.381126855,2089.818808434,95
carcassonne-uct190-vs-uct110-1000its,895,800,2209.58380613,2175.56270424,95
carcassonne-boltzmann80-vs-boltzmann125-1000its,908,813,2165.278932406,2117.355786303,95
carcassonne-ucttuned130-vs-ucttuned115-1000its,910,815,2265.480420227,2223.972419229,95
carcassonne-boltzmann495-vs-boltzmann150-1000its,917,822,2185.604179232,2144.957693243,95
carcassonne-boltzmann410-vs-boltzmann150-1000its,921,826,2197.743928849,2148.160340597,95
carcassonne-ucttuned355-vs-ucttuned115-1000its,927,832,2242.236287178,2190.293079159,95
carcassonne-ucttuned300-vs-ucttuned425-1000its,948,853,2313.828522549,2244.444689643,95
carcassonne-boltzmann25-vs-boltzmann125-1000its,762,666,2191.208866584,2133.779078009,96
carcassonne-uct180-vs-uct240-1000its,771,675,2192.638886272,2158.558412105,96
carcassonne-boltzmann140-vs-boltzmann40-1000its,790,694,2213.079018136,2143.768762862,96
carcassonne-uct35-vs-uct290-1000its,793,697,2231.634813631,2161.019255501,96
carcassonne-ucttuned115-vs-ucttuned420-1000its,793,697,2204.66098556,2161.381452592,96
carcassonne-boltzmann40-vs-boltzmann365-1000its,803,707,2220.47942124,2165.204376565,96
carcassonne-boltzmann65-vs-boltzmann365-1000its,806,710,2115.875718288,2098.976791703,96
carcassonne-uct190-vs-uct135-1000its,807,711,2244.551766867,2192.624315066,96
carcassonne-ucttuned305-vs-ucttuned455-1000its,817,721,2190.507035533,2160.644937459,96
carcassonne-uct285-vs-uct280-1000its,820,724,2131.757156476,2082.469331812,96
carcassonne-uct430-vs-uct185-1000its,820,724,2172.062942705,2133.776829962,96
carcassonne-uct285-vs-uct150-1000its,822,726,2143.999318247,2120.686799287,96
carcassonne-ucttuned445-vs-ucttuned465-1000its,825,729,2201.891281789,2115.070008007,96
carcassonne-ucttuned385-vs-ucttuned415-1000its,826,730,2195.21303882,2209.672564569,96
carcassonne-boltzmann35-vs-boltzmann105-1000its,827,731,2186.849769749,2096.574199295,96
carcassonne-uct440-vs-uct445-1000its,827,731,2147.208058443,2124.480243809,96
carcassonne-uct200-vs-uct155-1000its,828,732,2130.706203863,2128.398962143,96
carcassonne-boltzmann330-vs-boltzmann180-1000its,829,733,2220.012043274,2201.72565407,96
carcassonne-ucttuned270-vs-ucttuned250-1000its,829,733,2167.025594312,2123.488494917,96
carcassonne-boltzmann30-vs-boltzmann225-1000its,830,734,2147.682363974,2076.342384583,96
carcassonne-uct70-vs-uct180-1000its,833,737,2181.571113652,2123.474960016,96
carcassonne-boltzmann10-vs-boltzmann140-1000its,834,738,2188.259847023,2125.691787804,96
carcassonne-uct345-vs-uct495-1000its,835,739,2246.10452005,2149.486420191,96
carcassonne-ucttuned85-vs-ucttuned265-1000its,836,740,2175.43930163,2119.160671278,96
carcassonne-ucttuned205-vs-ucttuned410-1000its,842,746,2201.897820976,2151.511642317,96
carcassonne-boltzmann335-vs-boltzmann25-1000its,843,747,2245.252144919,2159.731155059,96
carcassonne-boltzmann400-vs-boltzmann380-1000its,843,747,2180.060914504,2140.374219427,96
carcassonne-uct50-vs-uct285-1000its,843,747,2164.872721039,2144.334255777,96
carcassonne-uct195-vs-uct365-1000its,847,751,2179.2850519,2124.953967059,96
carcassonne-ucttuned105-vs-ucttuned470-1000its,848,752,2208.029907584,2183.593346686,96
carcassonne-boltzmann190-vs-boltzmann135-1000its,849,753,2169.953376089,2100.992393093,96
carcassonne-boltzmann350-vs-boltzmann355-1000its,850,754,2152.57987882,2131.815631689,96
carcassonne-boltzmann370-vs-boltzmann140-1000its,851,755,2273.555614802,2171.979935001,96
carcassonne-ucttuned470-vs-ucttuned290-1000its,851,755,2311.666321888,2240.376946099,96
carcassonne-ucttuned230-vs-ucttuned475-1000its,853,757,2226.616256284,2185.24928973,96
carcassonne-uct340-vs-uct125-1000its,854,758,2180.321466489,2179.258184159,96
carcassonne-ucttuned410-vs-ucttuned65-1000its,856,760,2225.997370688,2173.590987045,96
carcassonne-uct360-vs-uct330-1000its,857,761,2135.900968254,2104.909463666,96
carcassonne-ucttuned45-vs-ucttuned485-1000its,857,761,2110.412824549,2072.827804126,96
carcassonne-boltzmann10-vs-boltzmann85-1000its,861,765,2195.295263829,2165.807660534,96
carcassonne-uct135-vs-uct405-1000its,862,766,2159.052385723,2107.242761308,96
carcassonne-ucttuned45-vs-ucttuned225-1000its,862,766,2237.607884123,2135.507673382,96
carcassonne-uct430-vs-uct200-1000its,864,768,2182.141193184,2104.497159406,96
carcassonne-uct470-vs-uct260-1000its,868,772,2245.439293505,2169.230132048,96
carcassonne-uct410-vs-uct485-1000its,870,774,2203.817938093,2125.035237091,96
carcassonne-uct470-vs-uct325-1000its,870,774,2233.118560319,2156.509362517,96
carcassonne-uct325-vs-uct235-1000its,872,776,2155.588798367,2129.430784933,96
carcassonne-uct100-vs-uct270-1000its,874,778,2161.628060876,2133.45762506,96
carcassonne-ucttuned305-vs-ucttuned270-1000its,876,780,2204.633552229,2130.04740989,96
carcassonne-boltzmann245-vs-boltzmann45-1000its,878,782,2174.067265974,2154.126192956,96
carcassonne-boltzmann125-vs-boltzmann455-1000its,879,783,2156.677577054,2113.273908385,96
carcassonne-ucttuned340-vs-ucttuned240-1000its,879,783,2167.389811534,2073.519509515,96
carcassonne-boltzmann205-vs-boltzmann175-1000its,880,784,2272.489874815,2183.563444555,96
carcassonne-boltzmann485-vs-boltzmann250-1000its,881,785,2114.824044413,2107.939656533,96
carcassonne-uct330-vs-uct315-1000its,884,788,2168.335029239,2173.816045539,96
carcassonne-ucttuned5-vs-ucttuned110-1000its,885,789,2158.259338134,2126.913476447,96
carcassonne-uct180-vs-uct460-1000its,888,792,2218.07414488,2180.11339922,96
carcassonne-uct5-vs-uct480-1000its,889,793,2278.664805224,2222.244489873,96
carcassonne-boltzmann490-vs-boltzmann210-1000its,891,795,2176.177751316,2150.143415781,96
carcassonne-uct50-vs-uct125-1000its,893,797,2186.551014446,2161.777125907,96
carcassonne-ucttuned485-vs-ucttuned280-1000its,899,803,2226.503941678,2165.741405393,96
carcassonne-uct205-vs-uct30-1000its,908,812,2264.543237534,2191.249323677,96
carcassonne-ucttuned195-vs-ucttuned5-1000its,910,814,2205.621366659,2144.022102021,96
carcassonne-uct260-vs-uct395-1000its,913,817,2182.835473498,2125.715916278,96
carcassonne-uct490-vs-uct115-1000its,916,820,2160.601801222,2145.744721355,96
carcassonne-ucttuned205-vs-ucttuned250-1000its,918,822,2256.511941379,2223.138588453,96
carcassonne-ucttuned155-vs-ucttuned290-1000its,925,829,2168.999385036,2131.981607675,96
carcassonne-ucttuned450-vs-ucttuned140-1000its,929,833,2230.424170621,2234.374849121,96
carcassonne-boltzmann30-vs-boltzmann210-1000its,950,854,2182.366109924,2168.966303237,96
carcassonne-uct5-vs-uct15-1000its,957,861,2198.958323488,2158.118558461,96
carcassonne-boltzmann435-vs-boltzmann480-1000its,967,871,2196.04324791,2162.229194432,96
carcassonne-boltzmann195-vs-boltzmann400-1000its,971,875,2195.857634439,2132.75287111,96
carcassonne-boltzmann60-vs-boltzmann400-1000its,761,664,2172.695579501,2065.577293672,97
carcassonne-uct70-vs-uct485-1000its,776,679,2180.685261572,2100.29728517,97
carcassonne-ucttuned375-vs-ucttuned70-1000its,781,684,2205.65104564,2178.375597277,97
carcassonne-ucttuned450-vs-ucttuned350-1000its,786,689,2252.601730629,2225.845942568,97
carcassonne-uct485-vs-uct405-1000its,787,690,2219.486078543,2101.456328402,97
carcassonne-uct220-vs-uct205-1000its,790,693,2199.886633447,2154.103225504,97
carcassonne-boltzmann455-vs-boltzmann110-1000its,799,702,2256.643462828,2227.396788716,97
carcassonne-boltzmann370-vs-boltzmann315-1000its,803,706,2193.556713386,2151.466138897,97
carcassonne-uct215-vs-uct25-1000its,806,709,2200.072977148,2159.114029343,97
carcassonne-ucttuned455-vs-ucttuned90-1000its,806,709,2128.998686798,2108.533679056,97
carcassonne-ucttuned95-vs-ucttuned375-1000its,806,709,2182.761536158,2111.459114408,97
carcassonne-boltzmann470-vs-boltzmann230-1000its,813,716,2230.067156951,2148.612270006,97
carcassonne-uct495-vs-uct255-1000its,815,718,2190.316721297,2150.688128447,97
carcassonne-boltzmann65-vs-boltzmann20-1000its,817,720,2169.784148618,2142.512780664,97
carcassonne-boltzmann485-vs-boltzmann125-1000its,819,722,2226.456845728,2165.64861917,97
carcassonne-boltzmann200-vs-boltzmann150-1000its,824,727,2182.173129351,2130.832576846,97
carcassonne-ucttuned145-vs-ucttuned105-1000its,824,727,2222.296900801,2180.721738076,97
carcassonne-boltzmann50-vs-boltzmann215-1000its,825,728,2248.312775912,2189.614783777,97
carcassonne-uct340-vs-uct435-1000its,825,728,2212.173815097,2174.749251323,97
carcassonne-ucttuned240-vs-ucttuned200-1000its,828,731,2162.29437752,2147.668780008,97
carcassonne-boltzmann5-vs-boltzmann295-1000its,830,733,2151.446125634,2109.426265712,97
carcassonne-uct435-vs-uct280-1000its,837,740,2229.812010784,2217.758019928,97
carcassonne-ucttuned440-vs-ucttuned15-1000its,839,742,2157.13756682,2147.813558152,97
carcassonne-ucttuned480-vs-ucttuned365-1000its,839,742,2127.64557432,2075.305208995,97
carcassonne-ucttuned385-vs-ucttuned235-1000its,841,744,2122.996584667,2102.62898655,97
carcassonne-ucttuned75-vs-ucttuned370-1000its,845,748,2241.116888568,2190.363990938,97
carcassonne-uct440-vs-uct245-1000its,846,749,2201.956903432,2142.519949869,97
carcassonne-ucttuned480-vs-ucttuned495-1000its,849,752,2184.850862489,2128.24523049,97
carcassonne-boltzmann20-vs-boltzmann315-1000its,850,753,2158.810596367,2106.888708052,97
carcassonne-ucttuned490-vs-ucttuned235-1000its,851,754,2203.962929255,2142.775711444,97
carcassonne-uct35-vs-uct235-1000its,852,755,2185.888565149,2174.675683619,97
carcassonne-ucttuned365-vs-ucttuned150-1000its,852,755,2165.574477135,2113.056056476,97
carcassonne-ucttuned5-vs-ucttuned425-1000its,854,757,2218.449876798,2167.699434853,97
carcassonne-boltzmann120-vs-boltzmann440-1000its,856,759,2233.206991089,2154.332195813,97
carcassonne-uct435-vs-uct190-1000its,858,761,2177.642156548,2176.674961571,97
carcassonne-uct325-vs-uct230-1000its,859,762,2209.636348332,2192.356081978,97
carcassonne-ucttuned140-vs-ucttuned335-1000its,860,763,2195.780318819,2126.054831979,97
carcassonne-ucttuned210-vs-ucttuned125-1000its,862,765,2176.186102112,2141.855043934,97
carcassonne-uct160-vs-uct125-1000its,867,770,2250.666441671,2138.894776693,97
carcassonne-uct230-vs-uct455-1000its,867,770,2223.012949496,2170.644566609,97
carcassonne-boltzmann145-vs-boltzmann305-1000its,868,771,2258.711478807,2209.951090193,97
carcassonne-uct5-vs-uct120-1000its,868,771,2218.067173806,2172.850637115,97
carcassonne-ucttuned235-vs-ucttuned190-1000its,868,771,2218.308910658,2147.5807402,97
carcassonne-ucttuned185-vs-ucttuned390-1000its,871,774,2191.584917413,2164.372726778,97
carcassonne-ucttuned65-vs-ucttuned205-1000its,871,774,2193.292756874,2142.554192451,97
carcassonne-boltzmann35-vs-boltzmann430-1000its,872,775,2235.108659704,2221.078399857,97
carcassonne-boltzmann55-vs-boltzmann390-1000its,873,776,2211.903566573,2174.894615422,97
carcassonne-ucttuned225-vs-ucttuned410-1000its,874,777,2208.096159899,2137.934002643,97
carcassonne-ucttuned135-vs-ucttuned110-1000its,877,780,2166.923306314,2155.594029499,97
carcassonne-ucttuned85-vs-ucttuned210-1000its,877,780,2134.126510751,2126.917183962,97
carcassonne-boltzmann235-vs-boltzmann275-1000its,879,782,2222.199663669,2177.433256511,97
carcassonne-ucttuned410-vs-ucttuned50-1000its,879,782,2161.43571973,2139.052975461,97
carcassonne-boltzmann45-vs-boltzmann195-1000its,881,784,2127.259960642,2069.720450869,97
carcassonne-uct15-vs-uct455-1000its,881,784,2138.724856891,2117.284130417,97
carcassonne-uct365-vs-uct395-1000its,881,784,2113.552074854,2095.408355197,97
carcassonne-boltzmann100-vs-boltzmann305-1000its,883,786,2271.525835105,2197.607390226,97
carcassonne-uct145-vs-uct490-1000its,883,786,2159.135388977,2151.557782989,97
carcassonne-boltzmann320-vs-boltzmann395-1000its,886,789,2215.090176594,2166.094527129,97
carcassonne-uct125-vs-uct150-1000its,887,790,2312.448922791,2282.020507257,97
carcassonne-uct15-vs-uct385-1000its,887,790,2237.975701158,2173.632460837,97
carcassonne-uct335-vs-uct70-1000its,888,791,2203.956555056,2157.402854793,97
carcassonne-uct230-vs-uct305-1000its,890,793,2180.378933772,2126.855664411,97
carcassonne-boltzmann420-vs-boltzmann220-1000its,893,796,2235.970973763,2161.018499018,97
carcassonne-uct350-vs-uct470-1000its,900,803,2239.606036101,2194.555967624,97
carcassonne-uct460-vs-uct150-1000its,900,803,2159.289728032,2136.21049764,97
carcassonne-ucttuned340-vs-ucttuned175-1000its,903,806,2177.825135871,2134.076960558,97
carcassonne-boltzmann400-vs-boltzmann245-1000its,904,807,2200.146626967,2184.645709658,97
carcassonne-uct320-vs-uct185-1000its,908,811,2185.552671173,2158.603993579,97
carcassonne-boltzmann325-vs-boltzmann245-1000its,909,812,2213.168235325,2145.690127912,97
carcassonne-ucttuned10-vs-ucttuned100-1000its,909,812,2242.241874948,2204.846892763,97
carcassonne-ucttuned210-vs-ucttuned60-1000its,909,812,2173.270620287,2126.968278742,97
carcassonne-ucttuned95-vs-ucttuned260-1000its,915,818,2217.659236236,2162.566189007,97
carcassonne-ucttuned330-vs-ucttuned385-1000its,945,848,2223.149153732,2169.711884739,97
carcassonne-uct365-vs-uct60-1000its,970,873,2189.92668126,2148.530653325,97
carcassonne-boltzmann460-vs-boltzmann445-1000its,681,583,1746.051479432,1708.271747898,98
carcassonne-boltzmann340-vs-boltzmann105-1000its,780,682,2218.006965878,2140.667626542,98
carcassonne-boltzmann360-vs-boltzmann35-1000its,790,692,2228.87579222,2203.815589567,98
carcassonne-uct475-vs-uct435-1000its,791,693,2243.780742139,2185.532925826,98
carcassonne-boltzmann120-vs-boltzmann55-1000its,796,698,2060.461056203,2073.54629618,98
carcassonne-ucttuned465-vs-ucttuned115-1000its,796,698,2212.224771614,2166.848859825,98
carcassonne-uct40-vs-uct255-1000its,802,704,2217.514145575,2164.194784327,98
carcassonne-boltzmann430-vs-boltzmann350-1000its,807,709,2201.762934625,2183.590291282,98
carcassonne-uct75-vs-uct125-1000its,808,710,2165.769946322,2089.288736989,98
carcassonne-boltzmann185-vs-boltzmann385-1000its,810,712,2185.995548714,2180.452374603,98
carcassonne-boltzmann450-vs-boltzmann200-1000its,810,712,2170.433101068,2121.899697145,98
carcassonne-uct235-vs-uct320-1000its,819,721,2155.225646056,2123.460413421,98
carcassonne-ucttuned495-vs-ucttuned445-1000its,821,723,2176.407040889,2131.236267377,98
carcassonne-boltzmann120-vs-boltzmann205-1000its,823,725,2166.650093685,2170.494404541,98
carcassonne-ucttuned30-vs-ucttuned50-1000its,824,726,2157.289753243,2076.772355657,98
carcassonne-boltzmann455-vs-boltzmann155-1000its,826,728,2201.903326644,2177.192218103,98
carcassonne-uct310-vs-uct490-1000its,827,729,2205.1465682,2171.647615591,98
carcassonne-boltzmann250-vs-boltzmann325-1000its,831,733,2259.944588464,2243.025572694,98
carcassonne-ucttuned415-vs-ucttuned430-1000its,831,733,2146.893408872,2122.238353368,98
carcassonne-ucttuned460-vs-ucttuned190-1000its,832,734,2144.825878357,2115.624746235,98
carcassonne-boltzmann265-vs-boltzmann340-1000its,833,735,2238.029825729,2184.424294896,98
carcassonne-ucttuned110-vs-ucttuned445-1000its,836,738,2155.299481357,2170.162808784,98
carcassonne-ucttuned230-vs-ucttuned390-1000its,836,738,2142.032234425,2081.178841224,98
carcassonne-boltzmann340-vs-boltzmann460-1000its,837,739,2159.652776024,2154.348059996,98
carcassonne-uct90-vs-uct245-1000its,837,739,2235.553322874,2191.775224614,98
carcassonne-boltzmann390-vs-boltzmann70-1000its,838,740,2202.300278971,2147.364627085,98
carcassonne-ucttuned295-vs-ucttuned330-1000its,839,741,2168.467427568,2126.760603373,98
carcassonne-ucttuned445-vs-ucttuned105-1000its,840,742,2146.618002897,2128.010266821,98
carcassonne-boltzmann460-vs-boltzmann130-1000its,841,743,2172.060275685,2107.845259107,98
carcassonne-boltzmann320-vs-boltzmann50-1000its,842,744,2202.73256626,2179.12092729,98
carcassonne-uct80-vs-uct385-1000its,842,744,2205.261511147,2164.932874917,98
carcassonne-boltzmann435-vs-boltzmann125-1000its,843,745,2245.371821155,2210.534276775,98
carcassonne-uct155-vs-uct220-1000its,847,749,2121.280443421,2060.946754213,98
carcassonne-uct300-vs-uct30-1000its,847,749,2197.957130632,2172.746402804,98
carcassonne-uct355-vs-uct195-1000its,849,751,2221.527590952,2205.520999468,98
carcassonne-uct305-vs-uct225-1000its,852,754,2169.223239162,2131.50351085,98
carcassonne-ucttuned430-vs-ucttuned100-1000its,852,754,2161.102397062,2106.239770596,98
carcassonne-boltzmann475-vs-boltzmann35-1000its,856,758,2169.754593724,2103.441155746,98
carcassonne-uct145-vs-uct115-1000its,856,758,2162.402151657,2151.964398863,98
carcassonne-uct190-vs-uct150-1000its,856,758,2175.800016857,2115.510852442,98
carcassonne-boltzmann245-vs-boltzmann40-1000its,859,761,2170.516020462,2132.859759902,98
carcassonne-boltzmann235-vs-boltzmann430-1000its,860,762,2183.615946663,2150.700359011,98
carcassonne-uct30-vs-uct375-1000its,861,763,2268.024360119,2210.980358635,98
carcassonne-ucttuned405-vs-ucttuned295-1000its,861,763,2147.487389674,2166.549535095,98
carcassonne-uct355-vs-uct325-1000its,863,765,2274.466225272,2272.113511628,98
carcassonne-uct160-vs-uct55-1000its,867,769,2254.313580304,2182.192234385,98
carcassonne-ucttuned165-vs-ucttuned425-1000its,867,769,2095.096841721,2083.259031666,98
carcassonne-uct5-vs-uct60-1000its,868,770,2253.025719624,2221.129847495,98
carcassonne-ucttuned450-vs-ucttuned480-1000its,870,772,2188.347185747,2121.967418568,98
carcassonne-boltzmann420-vs-boltzmann215-1000its,873,775,2176.525861933,2071.971328739,98
carcassonne-boltzmann5-vs-boltzmann350-1000its,875,777,2248.028146432,2192.403592918,98
carcassonne-uct55-vs-uct440-1000its,876,778,2165.081975267,2174.734633703,98
carcassonne-boltzmann95-vs-boltzmann185-1000its,877,779,2181.034620626,2140.909900139,98
carcassonne-uct440-vs-uct390-1000its,879,781,2202.940760276,2184.349046136,98
carcassonne-uct220-vs-uct145-1000its,881,783,2237.626153021,2162.689113972,98
carcassonne-uct80-vs-uct190-1000its,886,788,2162.478225755,2115.465421117,98
carcassonne-uct30-vs-uct55-1000its,889,791,2289.964100946,2217.534901795,98
carcassonne-boltzmann185-vs-boltzmann340-1000its,890,792,2172.130027414,2107.834236636,98
carcassonne-uct240-vs-uct140-1000its,891,793,2195.150164405,2194.625515194,98
carcassonne-uct20-vs-uct420-1000its,894,796,2228.05451201,2186.689308847,98
carcassonne-ucttuned150-vs-ucttuned405-1000its,894,796,2173.490108564,2158.081307499,98
carcassonne-boltzmann490-vs-boltzmann435-1000its,896,798,2259.498023214,2229.209113087,98
carcassonne-uct240-vs-uct175-1000its,896,798,2146.95154944,2112.357275393,98
carcassonne-ucttuned135-vs-ucttuned270-1000its,898,800,2182.139961814,2142.504980689,98
carcassonne-ucttuned330-vs-ucttuned480-1000its,900,802,2144.270152984,2137.467280182,98
carcassonne-ucttuned5-vs-ucttuned415-1000its,903,805,2208.468991879,2164.897094478,98
carcassonne-ucttuned115-vs-ucttuned30-1000its,908,810,2217.061149357,2143.681933229,98
carcassonne-boltzmann135-vs-boltzmann130-1000its,913,815,2222.209225107,2182.616194465,98
carcassonne-ucttuned475-vs-ucttuned245-1000its,915,817,2177.262439886,2130.086668852,98
carcassonne-ucttuned20-vs-ucttuned460-1000its,917,819,2289.718727241,2202.373362767,98
carcassonne-ucttuned65-vs-ucttuned85-1000its,918,820,2175.937765543,2153.10378879,98
carcassonne-uct145-vs-uct460-1000its,919,821,2180.719164237,2146.476801993,98
carcassonne-boltzmann385-vs-boltzmann450-1000its,921,823,2269.315745852,2242.782343837,98
carcassonne-uct210-vs-uct310-1000its,923,825,2222.291400771,2149.931670058,98
carcassonne-ucttuned10-vs-ucttuned310-1000its,938,840,2158.53292143,2123.970610291,98
carcassonne-ucttuned405-vs-ucttuned475-1000its,938,840,2237.301163653,2167.674680808,98
carcassonne-ucttuned335-vs-ucttuned20-1000its,954,856,2244.43279558,2143.516756612,98
carcassonne-ucttuned95-vs-ucttuned320-1000its,954,856,2180.888046621,2146.256529955,98
carcassonne-boltzmann470-vs-boltzmann195-1000its,717,618,2133.176635195,2123.445101449,99
carcassonne-boltzmann195-vs-boltzmann35-1000its,785,686,2135.113162872,2141.773894963,99
carcassonne-uct270-vs-uct410-1000its,797,698,2156.476400732,2126.79360465,99
carcassonne-uct385-vs-uct300-1000its,797,698,2146.34643297,2085.551027289,99
carcassonne-boltzmann40-vs-boltzmann60-1000its,801,702,2335.68188079,2296.013892816,99
carcassonne-uct185-vs-uct270-1000its,802,703,2146.553963326,2119.614640789,99
carcassonne-boltzmann455-vs-boltzmann225-1000its,803,704,2205.90699313,2141.360149767,99
carcassonne-uct355-vs-uct100-1000its,806,707,2208.077614397,2211.959479929,99
carcassonne-uct110-vs-uct465-1000its,811,712,2206.742210896,2147.293701154,99
carcassonne-ucttuned450-vs-ucttuned410-1000its,811,712,2199.297475004,2109.302825409,99
carcassonne-boltzmann105-vs-boltzmann30-1000its,812,713,2165.922620407,2131.538254258,99
carcassonne-ucttuned295-vs-ucttuned205-1000its,816,717,2232.523391623,2210.694497898,99
carcassonne-ucttuned495-vs-ucttuned385-1000its,817,718,2228.537096093,2154.824651274,99
carcassonne-uct295-vs-uct465-1000its,822,723,2237.285214776,2206.364888126,99
carcassonne-ucttuned160-vs-ucttuned325-1000its,832,733,2190.892453173,2135.537050687,99
carcassonne-uct255-vs-uct235-1000its,834,735,2192.150980374,2127.605461063,99
carcassonne-ucttuned305-vs-ucttuned485-1000its,836,737,2228.892951309,2164.413736107,99
carcassonne-ucttuned340-vs-ucttuned40-1000its,836,737,2147.299819764,2148.638521572,99
carcassonne-uct190-vs-uct280-1000its,840,741,2160.522515247,2138.433029707,99
carcassonne-uct400-vs-uct290-1000its,840,741,2266.906473488,2181.203091859,99
carcassonne-ucttuned75-vs-ucttuned325-1000its,843,744,2151.141073027,2101.996572482,99
carcassonne-boltzmann140-vs-boltzmann205-1000its,845,746,2203.521190793,2156.25969428,99
carcassonne-boltzmann295-vs-boltzmann290-1000its,846,747,2210.681440077,2126.185761182,99
carcassonne-ucttuned320-vs-ucttuned290-1000its,846,747,2240.352613108,2189.364921707,99
carcassonne-uct20-vs-uct380-1000its,847,748,2209.764160052,2133.433815954,99
carcassonne-ucttuned475-vs-ucttuned170-1000its,847,748,2174.927480047,2160.094052802,99
carcassonne-ucttuned280-vs-ucttuned175-1000its,849,750,2165.050125739,2147.309132345,99
carcassonne-uct230-vs-uct370-1000its,851,752,2178.285120078,2151.72453045,99
carcassonne-boltzmann435-vs-boltzmann240-1000its,852,753,2284.422685608,2173.361204202,99
carcassonne-ucttuned460-vs-ucttuned60-1000its,852,753,2254.16235818,2186.997092745,99
carcassonne-boltzmann305-vs-boltzmann270-1000its,853,754,2198.763717539,2169.615270282,99
carcassonne-uct35-vs-uct245-1000its,854,755,2186.237794773,2191.145803627,99
carcassonne-boltzmann260-vs-boltzmann350-1000its,855,756,2142.470779305,2124.451847081,99
carcassonne-uct340-vs-uct395-1000its,855,756,2196.958421047,2184.662771187,99
carcassonne-uct385-vs-uct365-1000its,857,758,2217.421487772,2149.162797159,99
carcassonne-boltzmann65-vs-boltzmann15-1000its,858,759,2207.337105793,2191.510642923,99
carcassonne-boltzmann350-vs-boltzmann245-1000its,859,760,2244.402718348,2198.534063917,99
carcassonne-boltzmann395-vs-boltzmann90-1000its,859,760,2223.943385574,2146.401575848,99
carcassonne-uct10-vs-uct410-1000its,863,764,2248.651024584,2177.486533852,99
carcassonne-uct135-vs-uct50-1000its,864,765,2222.465931019,2177.240796443,99
carcassonne-uct140-vs-uct275-1000its,864,765,2144.54401344,2097.362878693,99
carcassonne-ucttuned170-vs-ucttuned310-1000its,865,766,2202.26420234,2141.733462164,99
carcassonne-uct115-vs-uct230-1000its,868,769,2188.533461993,2086.626227886,99
carcassonne-ucttuned30-vs-ucttuned105-1000its,869,770,2249.318611209,2249.993108658,99
carcassonne-uct245-vs-uct225-1000its,870,771,2175.449388712,2165.36660937,99
carcassonne-uct430-vs-uct180-1000its,873,774,2177.435506066,2115.345249212,99
carcassonne-uct5-vs-uct355-1000its,873,774,2154.8160135,2124.669700768,99
carcassonne-ucttuned60-vs-ucttuned165-1000its,873,774,2173.970323531,2147.402676121,99
carcassonne-uct485-vs-uct225-1000its,877,778,2226.87970277,2171.532603155,99
carcassonne-ucttuned75-vs-ucttuned170-1000its,879,780,2240.216741653,2196.757903745,99
carcassonne-boltzmann115-vs-boltzmann400-1000its,881,782,2168.45945041,2138.762643553,99
carcassonne-boltzmann450-vs-boltzmann25-1000its,882,783,2206.602840712,2143.936769508,99
carcassonne-uct15-vs-uct460-1000its,883,784,2207.720228901,2164.327198446,99
carcassonne-uct15-vs-uct450-1000its,888,789,2191.936345508,2148.049409476,99
carcassonne-ucttuned75-vs-ucttuned265-1000its,890,791,2215.564610525,2172.865029748,99
carcassonne-uct230-vs-uct20-1000its,891,792,2233.391602876,2200.837827025,99
carcassonne-uct190-vs-uct240-1000its,892,793,2159.050411157,2125.167454169,99
carcassonne-ucttuned35-vs-ucttuned380-1000its,892,793,2157.279370598,2115.252480391,99
carcassonne-ucttuned55-vs-ucttuned95-1000its,894,795,2180.434967839,2100.978922332,99
carcassonne-uct145-vs-uct195-1000its,895,796,2262.622973275,2192.776366952,99
carcassonne-uct50-vs-uct105-1000its,895,796,2148.011442667,2079.042508693,99
carcassonne-uct475-vs-uct25-1000its,900,801,2183.704309815,2142.871846192,99
carcassonne-ucttuned470-vs-ucttuned205-1000its,900,801,2246.404674229,2189.260532119,99
carcassonne-ucttuned40-vs-ucttuned370-1000its,903,804,2191.192894705,2164.76725232,99
carcassonne-boltzmann390-vs-boltzmann365-1000its,906,807,2198.389911244,2107.013368566,99
carcassonne-boltzmann40-vs-boltzmann420-1000its,907,808,2213.083266862,2149.610745612,99
carcassonne-uct340-vs-uct205-1000its,907,808,2183.157917503,2135.461469161,99
carcassonne-uct5-vs-uct255-1000its,910,811,2208.963518449,2171.449161221,99
carcassonne-ucttuned455-vs-ucttuned65-1000its,914,815,2275.799962318,2199.037025335,99
carcassonne-ucttuned230-vs-ucttuned325-1000its,915,816,2220.837949673,2128.462126046,99
carcassonne-ucttuned280-vs-ucttuned225-1000its,920,821,2134.932347844,2093.858986986,99
carcassonne-uct5-vs-uct495-1000its,957,858,2302.187603013,2255.01704248,99
carcassonne-uct310-vs-uct195-1000its,963,864,2166.159566721,2121.508926722,99
carcassonne-uct135-vs-uct55-1000its,609,509,1691.577478075,1679.94856372,100
carcassonne-boltzmann415-vs-boltzmann10-1000its,762,662,2195.051286842,2166.692869053,100
carcassonne-ucttuned150-vs-ucttuned390-1000its,783,683,2212.975919704,2191.961730731,100
carcassonne-uct405-vs-uct360-1000its,786,686,2256.930280016,2174.389727224,100
carcassonne-boltzmann55-vs-boltzmann220-1000its,787,687,2234.147609254,2148.251951742,100
carcassonne-uct40-vs-uct65-1000its,798,698,2180.094148698,2122.622257907,100
carcassonne-ucttuned310-vs-ucttuned430-1000its,800,700,2221.659364225,2181.5840313,100
carcassonne-boltzmann250-vs-boltzmann130-1000its,802,702,2228.08326449,2216.586233932,100
carcassonne-boltzmann160-vs-boltzmann150-1000its,805,705,2200.724000741,2139.22834385,100
carcassonne-boltzmann460-vs-boltzmann370-1000its,811,711,2263.95816842,2230.253209036,100
carcassonne-boltzmann265-vs-boltzmann60-1000its,815,715,2180.268546319,2134.58262775,100
carcassonne-boltzmann50-vs-boltzmann270-1000its,815,715,2294.255969734,2231.594161691,100
carcassonne-ucttuned60-vs-ucttuned145-1000its,819,719,2241.239995327,2197.195430013,100
carcassonne-uct135-vs-uct205-1000its,820,720,2172.530712561,2103.765564906,100
carcassonne-uct80-vs-uct295-1000its,822,722,2135.619852842,2073.603423348,100
carcassonne-ucttuned170-vs-ucttuned240-1000its,826,726,2172.74669134,2143.880640046,100
carcassonne-boltzmann465-vs-boltzmann455-1000its,830,730,2192.593624679,2150.552650439,100
carcassonne-boltzmann285-vs-boltzmann340-1000its,831,731,2207.346225286,2172.726398681,100
carcassonne-boltzmann255-vs-boltzmann480-1000its,832,732,2195.052355836,2159.208511858,100
carcassonne-ucttuned230-vs-ucttuned40-1000its,835,735,2171.689843558,2179.454010897,100
carcassonne-boltzmann430-vs-boltzmann380-1000its,836,736,2232.024799871,2193.293651101,100
carcassonne-ucttuned415-vs-ucttuned400-1000its,836,736,2189.32244264,2172.505740221,100
carcassonne-boltzmann5-vs-boltzmann75-1000its,837,737,2198.726836519,2100.687567822,100
carcassonne-uct300-vs-uct325-1000its,839,739,2180.446696108,2153.933849684,100
carcassonne-uct325-vs-uct425-1000its,840,740,2235.729557251,2216.290934543,100
carcassonne-uct480-vs-uct290-1000its,840,740,2176.180021724,2128.320213086,100
carcassonne-uct230-vs-uct105-1000its,841,741,2292.038174249,2267.378508685,100
carcassonne-uct345-vs-uct200-1000its,841,741,2215.050613124,2179.141789276,100
carcassonne-uct400-vs-uct280-1000its,842,742,2211.79299328,2153.110342144,100
carcassonne-uct45-vs-uct150-1000its,843,743,2193.985510866,2185.204800566,100
carcassonne-ucttuned225-vs-ucttuned140-1000its,843,743,2152.626324899,2105.865685854,100
carcassonne-uct395-vs-uct65-1000its,844,744,2228.921816462,2150.940203634,100
carcassonne-boltzmann90-vs-boltzmann155-1000its,846,746,2183.709088292,2144.044748956,100
carcassonne-uct380-vs-uct325-1000its,846,746,2255.772449994,2220.549745458,100
carcassonne-uct405-vs-uct455-1000its,849,749,2153.903535888,2144.567011816,100
carcassonne-ucttuned60-vs-ucttuned180-1000its,849,749,2159.408337166,2161.552271752,100
carcassonne-ucttuned75-vs-ucttuned385-1000its,849,749,2272.492831829,2177.266845434,100
carcassonne-boltzmann175-vs-boltzmann85-1000its,852,752,2176.816265828,2075.034773147,100
carcassonne-uct485-vs-uct150-1000its,852,752,2171.439138686,2131.288996715,100
carcassonne-ucttuned30-vs-ucttuned245-1000its,853,753,2203.074911945,2156.962488929,100
carcassonne-boltzmann125-vs-boltzmann300-1000its,855,755,2248.670872422,2163.985507694,100
carcassonne-boltzmann270-vs-boltzmann240-1000its,856,756,2183.882164492,2118.720690681,100
carcassonne-uct165-vs-uct450-1000its,857,757,2228.15092395,2139.979730942,100
carcassonne-boltzmann320-vs-boltzmann215-1000its,858,758,2193.634765876,2159.665312403,100
carcassonne-boltzmann400-vs-boltzmann130-1000its,859,759,2138.565992328,2115.261976596,100
carcassonne-boltzmann30-vs-boltzmann305-1000its,860,760,2146.667425955,2132.967164852,100
carcassonne-ucttuned310-vs-ucttuned425-1000its,860,760,2260.039777383,2249.50404853,100
carcassonne-ucttuned380-vs-ucttuned455-1000its,860,760,2211.029930801,2180.332396521,100
carcassonne-ucttuned85-vs-ucttuned180-1000its,860,760,2233.89255572,2226.654681588,100
carcassonne-uct85-vs-uct200-1000its,861,761,2169.722575886,2128.497133917,100
carcassonne-ucttuned220-vs-ucttuned210-1000its,861,761,2105.428321119,2078.76569929,100
carcassonne-uct380-vs-uct90-1000its,862,762,2161.537055574,2125.05379186,100
carcassonne-ucttuned85-vs-ucttuned270-1000its,864,764,2202.070065993,2152.245627657,100
carcassonne-boltzmann365-vs-boltzmann290-1000its,865,765,2243.311900127,2191.002417321,100
carcassonne-boltzmann380-vs-boltzmann385-1000its,866,766,2207.204332526,2145.667012366,100
carcassonne-uct320-vs-uct25-1000its,870,770,2189.830377596,2141.19850389,100
carcassonne-ucttuned220-vs-ucttuned100-1000its,870,770,2159.44331981,2130.187634541,100
carcassonne-ucttuned220-vs-ucttuned120-1000its,872,772,2198.036734903,2165.106596801,100
carcassonne-uct100-vs-uct195-1000its,873,773,2143.57777469,2105.162654212,100
carcassonne-uct205-vs-uct130-1000its,873,773,2164.109000802,2083.820779765,100
carcassonne-uct65-vs-uct425-1000its,874,774,2295.94838092,2239.721670358,100
carcassonne-ucttuned430-vs-ucttuned475-1000its,876,776,2229.747767296,2213.633010093,100
carcassonne-boltzmann450-vs-boltzmann70-1000its,878,778,2161.797957823,2099.720582204,100
carcassonne-ucttuned370-vs-ucttuned5-1000its,879,779,2200.806090364,2121.108142077,100
carcassonne-boltzmann265-vs-boltzmann200-1000its,880,780,2204.484622003,2176.497172703,100
carcassonne-uct415-vs-uct360-1000its,880,780,2129.029455942,2110.11200453,100
carcassonne-ucttuned105-vs-ucttuned455-1000its,880,780,2201.843781924,2184.189956392,100
carcassonne-boltzmann185-vs-boltzmann460-1000its,884,784,2277.906787611,2180.263418361,100
carcassonne-uct60-vs-uct160-1000its,884,784,2264.19224663,2242.562550259,100
carcassonne-ucttuned225-vs-ucttuned85-1000its,885,785,2179.05188717,2158.366811452,100
carcassonne-boltzmann280-vs-boltzmann345-1000its,886,786,2175.023310505,2155.438976616,100
carcassonne-uct210-vs-uct440-1000its,886,786,2207.856556965,2167.882271009,100
carcassonne-boltzmann115-vs-boltzmann15-1000its,889,789,2194.539172748,2146.882475176,100
carcassonne-uct305-vs-uct180-1000its,898,798,2240.411207152,2177.700093054,100
carcassonne-ucttuned15-vs-ucttuned5-1000its,899,799,2149.287601563,2106.929781695,100
carcassonne-ucttuned250-vs-ucttuned440-1000its,900,800,2220.618865115,2152.892834043,100
carcassonne-ucttuned120-vs-ucttuned275-1000its,903,803,2222.123766337,2146.526804123,100
carcassonne-ucttuned10-vs-ucttuned115-1000its,904,804,2183.749726579,2162.334287349,100
carcassonne-uct185-vs-uct150-1000its,909,809,2206.012285574,2173.665868166,100
carcassonne-uct425-vs-uct55-1000its,909,809,2118.50493208,2083.618383107,100
carcassonne-uct145-vs-uct455-1000its,917,817,2223.616366208,2150.406711604,100
carcassonne-uct205-vs-uct5-1000its,924,824,2206.484803318,2208.263330487,100
carcassonne-boltzmann415-vs-boltzmann185-1000its,928,828,2233.084451431,2173.440277306,100
carcassonne-uct400-vs-uct25-1000its,928,828,2186.782956908,2147.886398791,100
carcassonne-uct30-vs-uct305-1000its,937,837,2185.717613041,2109.4546323,100
carcassonne-uct135-vs-uct160-1000its,940,840,2222.737107755,2160.077683202,100
carcassonne-ucttuned20-vs-ucttuned385-1000its,942,842,2202.513522728,2125.612312542,100
carcassonne-uct200-vs-uct220-1000its,952,852,2194.261666395,2137.129398571,100
carcassonne-ucttuned180-vs-ucttuned310-1000its,960,860,2198.560391267,2170.600160681,100
carcassonne-uct50-vs-uct140-1000its,968,868,2246.882121548,2163.912306839,100
carcassonne-uct410-vs-uct10-1000its,970,870,2181.658417674,2151.495325349,100
carcassonne-boltzmann305-vs-boltzmann310-1000its,745,644,2290.604209525,2207.261847564,101
carcassonne-boltzmann115-vs-boltzmann380-1000its,763,662,2292.193928666,2219.139848231,101
carcassonne-ucttuned125-vs-ucttuned435-1000its,793,692,2222.830487407,2183.715604096,101
carcassonne-uct245-vs-uct115-1000its,801,700,2122.976352026,2094.447098122,101
carcassonne-ucttuned145-vs-ucttuned270-1000its,803,702,2197.990124998,2142.713705318,101
carcassonne-boltzmann180-vs-boltzmann445-1000its,806,705,2206.616514054,2115.121624527,101
carcassonne-ucttuned345-vs-ucttuned210-1000its,806,705,2203.748572648,2187.326552817,101
carcassonne-boltzmann380-vs-boltzmann135-1000its,813,712,2245.707307152,2205.938706317,101
carcassonne-boltzmann5-vs-boltzmann240-1000its,815,714,2177.589194472,2124.10299414,101
carcassonne-uct10-vs-uct435-1000its,816,715,2168.304153182,2149.941491341,101
carcassonne-uct440-vs-uct425-1000its,817,716,2217.27494139,2150.768885336,101
carcassonne-ucttuned30-vs-ucttuned15-1000its,817,716,2211.933570102,2200.074711727,101
carcassonne-boltzmann370-vs-boltzmann190-1000its,819,718,2145.963563187,2101.769794382,101
carcassonne-boltzmann220-vs-boltzmann355-1000its,822,721,2112.91247997,2038.158301693,101
carcassonne-boltzmann365-vs-boltzmann65-1000its,822,721,2135.652358733,2098.45619126,101
carcassonne-uct375-vs-uct420-1000its,822,721,2212.857061064,2162.68218068,101
carcassonne-boltzmann40-vs-boltzmann375-1000its,824,723,2181.190820774,2177.9360276,101
carcassonne-uct350-vs-uct375-1000its,824,723,2138.098000387,2124.365889488,101
carcassonne-boltzmann35-vs-boltzmann195-1000its,826,725,2158.089174364,2104.986666383,101
carcassonne-boltzmann425-vs-boltzmann235-1000its,826,725,2193.361502976,2127.635220098,101
carcassonne-uct115-vs-uct225-1000its,827,726,2207.555508061,2177.30845151,101
carcassonne-ucttuned450-vs-ucttuned285-1000its,827,726,2168.03199369,2083.226847335,101
carcassonne-boltzmann225-vs-boltzmann335-1000its,831,730,2249.947265042,2181.524752194,101
carcassonne-ucttuned190-vs-ucttuned90-1000its,831,730,2188.054389778,2101.082609785,101
carcassonne-boltzmann490-vs-boltzmann375-1000its,832,731,2268.99191692,2216.148297897,101
carcassonne-ucttuned265-vs-ucttuned440-1000its,833,732,2160.550539659,2108.961352175,101
carcassonne-ucttuned290-vs-ucttuned115-1000its,834,733,2155.468908806,2106.12065098,101
carcassonne-boltzmann460-vs-boltzmann180-1000its,835,734,2159.716813244,2122.227580493,101
carcassonne-uct90-vs-uct175-1000its,837,736,2141.60703763,2119.146480699,101
carcassonne-boltzmann160-vs-boltzmann470-1000its,841,740,2105.196605117,2088.538091437,101
carcassonne-uct495-vs-uct120-1000its,841,740,2226.972333756,2198.782893208,101
carcassonne-boltzmann370-vs-boltzmann355-1000its,842,741,2286.700995714,2210.97894285,101
carcassonne-boltzmann75-vs-boltzmann185-1000its,842,741,2209.703336336,2091.801216251,101
carcassonne-uct475-vs-uct490-1000its,842,741,2207.719194456,2176.0675823,101
carcassonne-ucttuned175-vs-ucttuned470-1000its,842,741,2173.387909015,2145.640395091,101
carcassonne-ucttuned440-vs-ucttuned400-1000its,842,741,2251.972201081,2180.278487595,101
carcassonne-uct340-vs-uct150-1000its,843,742,2232.374876993,2152.081289631,101
carcassonne-boltzmann110-vs-boltzmann80-1000its,845,744,2158.657661868,2119.178487537,101
carcassonne-boltzmann395-vs-boltzmann130-1000its,850,749,2156.9614153,2104.953151,101
carcassonne-uct235-vs-uct70-1000its,853,752,2204.852988753,2147.814562008,101
carcassonne-boltzmann480-vs-boltzmann380-1000its,858,757,2234.979617808,2232.467683787,101
carcassonne-ucttuned230-vs-ucttuned455-1000its,862,761,2198.902568243,2180.586217886,101
carcassonne-ucttuned245-vs-ucttuned360-1000its,864,763,2170.217857477,2131.552602016,101
carcassonne-ucttuned15-vs-ucttuned260-1000its,866,765,2191.667750037,2114.197608609,101
carcassonne-boltzmann25-vs-boltzmann210-1000its,876,775,2264.239669826,2251.113607614,101
carcassonne-ucttuned385-vs-ucttuned110-1000its,878,777,2207.674016428,2166.662700116,101
carcassonne-boltzmann420-vs-boltzmann25-1000its,880,779,2230.721997939,2139.336308006,101
carcassonne-ucttuned130-vs-ucttuned5-1000its,881,780,2183.402909177,2130.238392713,101
carcassonne-boltzmann410-vs-boltzmann165-1000its,886,785,2269.866317061,2157.405400314,101
carcassonne-boltzmann70-vs-boltzmann330-1000its,886,785,2199.973504546,2160.795471208,101
carcassonne-uct15-vs-uct430-1000its,886,785,2294.979366188,2214.230100708,101
carcassonne-ucttuned245-vs-ucttuned365-1000its,886,785,2197.650049073,2143.258296079,101
carcassonne-boltzmann385-vs-boltzmann155-1000its,889,788,2185.81389996,2199.321078669,101
carcassonne-uct110-vs-uct400-1000its,891,790,2176.523018635,2182.663698795,101
carcassonne-boltzmann405-vs-boltzmann465-1000its,892,791,2250.65112871,2191.244187587,101
carcassonne-boltzmann475-vs-boltzmann215-1000its,895,794,2200.750305171,2131.506459614,101
carcassonne-ucttuned465-vs-ucttuned320-1000its,900,799,2141.593786414,2086.708817525,101
carcassonne-ucttuned485-vs-ucttuned375-1000its,907,806,2206.854400299,2146.912640963,101
carcassonne-ucttuned60-vs-ucttuned210-1000its,907,806,2163.112643568,2128.4774591,101
carcassonne-uct430-vs-uct460-1000its,909,808,2158.320502276,2095.273604887,101
carcassonne-uct70-vs-uct120-1000its,915,814,2236.863769007,2226.382502445,101
carcassonne-boltzmann230-vs-boltzmann235-1000its,923,822,2147.583968745,2119.574710633,101
carcassonne-ucttuned295-vs-ucttuned385-1000its,933,832,2195.277136302,2189.587026603,101
carcassonne-uct30-vs-uct155-1000its,935,834,2152.827135745,2111.54353476,101
carcassonne-boltzmann485-vs-boltzmann60-1000its,978,877,2191.835264173,2157.202849609,101
carcassonne-ucttuned125-vs-ucttuned245-1000its,778,676,2151.070938142,2109.769264247,102
carcassonne-boltzmann80-vs-boltzmann105-1000its,784,682,2200.005401218,2165.463419681,102
carcassonne-ucttuned185-vs-ucttuned120-1000its,788,686,2197.224847977,2192.654859501,102
carcassonne-uct65-vs-uct340-1000its,791,689,2247.537615432,2231.632451076,102
carcassonne-uct290-vs-uct400-1000its,801,699,2201.100640914,2168.971617456,102
carcassonne-boltzmann70-vs-boltzmann430-1000its,811,709,2163.382323377,2111.294364681,102
carcassonne-uct215-vs-uct155-1000its,814,712,2227.338229953,2190.670978754,102
carcassonne-uct350-vs-uct380-1000its,816,714,2223.712414931,2196.835623386,102
carcassonne-boltzmann410-vs-boltzmann250-1000its,817,715,2242.657263788,2196.345961907,102
carcassonne-boltzmann295-vs-boltzmann60-1000its,823,721,2166.239634389,2110.19124778,102
carcassonne-uct30-vs-uct380-1000its,825,723,2157.807570845,2099.357211002,102
carcassonne-uct5-vs-uct335-1000its,831,729,2180.978120577,2122.145407668,102
carcassonne-boltzmann455-vs-boltzmann460-1000its,833,731,2207.573497001,2124.27590017,102
carcassonne-boltzmann395-vs-boltzmann375-1000its,835,733,2170.140954448,2182.095936355,102
carcassonne-uct265-vs-uct215-1000its,836,734,2202.906646656,2173.776505148,102
carcassonne-ucttuned115-vs-ucttuned370-1000its,838,736,2216.275808656,2207.510217558,102
carcassonne-boltzmann35-vs-boltzmann485-1000its,841,739,2310.404686658,2283.381277291,102
carcassonne-uct105-vs-uct230-1000its,841,739,2250.497508514,2197.997377529,102
carcassonne-boltzmann395-vs-boltzmann265-1000its,842,740,2189.912695566,2176.244022007,102
carcassonne-uct205-vs-uct185-1000its,843,741,2206.523002643,2156.188842546,102
carcassonne-boltzmann195-vs-boltzmann115-1000its,847,745,2167.385135648,2179.775182676,102
carcassonne-ucttuned55-vs-ucttuned265-1000its,848,746,2195.495741746,2160.013531072,102
carcassonne-boltzmann285-vs-boltzmann50-1000its,849,747,2144.064574216,2124.176265398,102
carcassonne-ucttuned180-vs-ucttuned105-1000its,852,750,2146.375653082,2119.987509262,102
carcassonne-boltzmann20-vs-boltzmann160-1000its,853,751,2261.21253975,2206.687075412,102
carcassonne-boltzmann25-vs-boltzmann135-1000its,853,751,2258.99670746,2221.963067656,102
carcassonne-boltzmann90-vs-boltzmann265-1000its,853,751,2202.119199922,2117.178441767,102
carcassonne-uct120-vs-uct300-1000its,854,752,2205.845130961,2151.680202001,102
carcassonne-uct5-vs-uct420-1000its,855,753,2222.531441083,2172.175073906,102
carcassonne-ucttuned315-vs-ucttuned270-1000its,855,753,2196.270879233,2118.883197338,102
carcassonne-ucttuned245-vs-ucttuned420-1000its,857,755,2207.648394301,2189.499620455,102
carcassonne-uct340-vs-uct360-1000its,858,756,2260.66460947,2209.36503415,102
carcassonne-uct360-vs-uct365-1000its,859,757,2125.542526639,2078.185765346,102
carcassonne-boltzmann375-vs-boltzmann370-1000its,861,759,2125.308988739,2113.09555265,102
carcassonne-uct225-vs-uct130-1000its,862,760,2138.788924384,2103.275556349,102
carcassonne-ucttuned340-vs-ucttuned260-1000its,863,761,2276.074174374,2218.673739752,102
carcassonne-ucttuned340-vs-ucttuned30-1000its,863,761,2127.556915668,2100.426426129,102
carcassonne-uct70-vs-uct420-1000its,865,763,2216.644773414,2148.899387659,102
carcassonne-ucttuned310-vs-ucttuned270-1000its,866,764,2182.693341296,2142.782362746,102
carcassonne-boltzmann115-vs-boltzmann95-1000its,869,767,2222.416339317,2195.60882039,102
carcassonne-boltzmann45-vs-boltzmann305-1000its,869,767,2275.071107973,2209.980482975,102
carcassonne-ucttuned235-vs-ucttuned170-1000its,869,767,2244.65634868,2149.784683707,102
carcassonne-uct105-vs-uct90-1000its,870,768,2265.698922264,2244.511044638,102
carcassonne-ucttuned400-vs-ucttuned160-1000its,870,768,2213.844930485,2210.670601999,102
carcassonne-ucttuned300-vs-ucttuned315-1000its,871,769,2185.420611104,2151.495103811,102
carcassonne-uct240-vs-uct90-1000its,874,772,2224.046458752,2153.522251835,102
carcassonne-ucttuned195-vs-ucttuned225-1000its,874,772,2160.34812933,2130.07972061,102
carcassonne-boltzmann350-vs-boltzmann250-1000its,875,773,2141.732785217,2093.722600357,102
carcassonne-ucttuned375-vs-ucttuned270-1000its,876,774,2205.150558204,2135.764281535,102
carcassonne-ucttuned325-vs-ucttuned400-1000its,877,775,2233.833453464,2192.250228582,102
carcassonne-uct250-vs-uct145-1000its,878,776,2207.026780346,2154.962892747,102
carcassonne-ucttuned480-vs-ucttuned70-1000its,878,776,2180.332962817,2135.164886244,102
carcassonne-ucttuned170-vs-ucttuned355-1000its,879,777,2213.548963957,2162.04491822,102
carcassonne-ucttuned35-vs-ucttuned240-1000its,879,777,2242.344211101,2161.790371224,102
carcassonne-ucttuned385-vs-ucttuned300-1000its,879,777,2181.634233279,2110.775709739,102
carcassonne-uct190-vs-uct255-1000its,882,780,2152.654026404,2145.748837495,102
carcassonne-uct175-vs-uct260-1000its,884,782,2228.411320529,2183.680955618,102
carcassonne-ucttuned45-vs-ucttuned280-1000its,884,782,2202.88318391,2153.029229374,102
carcassonne-uct270-vs-uct245-1000its,888,786,2184.000913962,2191.83724082,102
carcassonne-uct5-vs-uct455-1000its,888,786,2188.014794954,2152.753738536,102
carcassonne-ucttuned195-vs-ucttuned115-1000its,888,786,2188.980909075,2078.960702827,102
carcassonne-boltzmann240-vs-boltzmann30-1000its,894,792,2224.278854023,2170.889838106,102
carcassonne-uct485-vs-uct330-1000its,895,793,2160.371690561,2124.728246691,102
carcassonne-uct10-vs-uct485-1000its,897,795,2260.832371222,2213.908001313,102
carcassonne-ucttuned180-vs-ucttuned275-1000its,898,796,2215.144151717,2176.300145102,102
carcassonne-uct65-vs-uct5-1000its,900,798,2162.57472991,2122.71369026,102
carcassonne-ucttuned145-vs-ucttuned15-1000its,902,800,2178.396896255,2192.413510183,102
carcassonne-uct135-vs-uct200-1000its,905,803,2219.617714366,2176.932504395,102
carcassonne-boltzmann70-vs-boltzmann95-1000its,914,812,2184.114731289,2178.291366583,102
carcassonne-uct65-vs-uct465-1000its,918,816,2182.937146375,2154.453813099,102
carcassonne-uct415-vs-uct405-1000its,920,818,2163.450728536,2140.090066529,102
carcassonne-boltzmann175-vs-boltzmann340-1000its,921,819,2200.438431073,2157.177163937,102
carcassonne-ucttuned20-vs-ucttuned210-1000its,921,819,2213.999990327,2141.212354497,102
carcassonne-ucttuned20-vs-ucttuned140-1000its,924,822,2152.810089887,2129.535240015,102
carcassonne-uct370-vs-uct5-1000its,928,826,2249.387421947,2170.056802937,102
carcassonne-ucttuned400-vs-ucttuned35-1000its,929,827,2205.987066607,2221.460286837,102
carcassonne-uct10-vs-uct25-1000its,938,836,2296.555365132,2228.243395946,102
carcassonne-boltzmann10-vs-boltzmann185-1000its,956,854,2184.519133761,2156.528476199,102
carcassonne-ucttuned60-vs-ucttuned295-1000its,970,868,2290.216978878,2230.968645644,102
carcassonne-uct80-vs-uct340-1000its,772,669,2199.410652804,2139.659751338,103
carcassonne-boltzmann470-vs-boltzmann290-1000its,785,682,2205.158778236,2161.47785823,103
carcassonne-uct165-vs-uct250-1000its,787,684,2195.011300057,2144.688625136,103
carcassonne-uct155-vs-uct285-1000its,788,685,2170.397457909,2160.645426689,103
carcassonne-uct355-vs-uct25-1000its,791,688,2174.498774725,2164.784616003,103
carcassonne-boltzmann60-vs-boltzmann285-1000its,792,689,2095.30180029,2054.585383259,103
carcassonne-boltzmann90-vs-boltzmann450-1000its,795,692,2211.705913952,2155.282517111,103
carcassonne-boltzmann350-vs-boltzmann190-1000its,805,702,2145.089450228,2130.386365725,103
carcassonne-uct200-vs-uct325-1000its,806,703,2275.039076025,2224.392921899,103
carcassonne-boltzmann45-vs-boltzmann495-1000its,810,707,2167.421094445,2093.219871935,103
carcassonne-uct140-vs-uct355-1000its,810,707,2205.619110744,2173.968243697,103
carcassonne-uct480-vs-uct185-1000its,810,707,2188.49034438,2123.320773724,103
carcassonne-ucttuned50-vs-ucttuned35-1000its,811,708,2195.538134386,2114.849702353,103
carcassonne-boltzmann25-vs-boltzmann310-1000its,812,709,2290.697549844,2172.841309792,103
carcassonne-ucttuned360-vs-ucttuned145-1000its,816,713,2190.190618235,2194.110985559,103
carcassonne-boltzmann95-vs-boltzmann230-1000its,817,714,2219.682227621,2184.658316689,103
carcassonne-ucttuned255-vs-ucttuned245-1000its,820,717,2216.551402194,2153.873587674,103
carcassonne-boltzmann400-vs-boltzmann165-1000its,822,719,2196.234068986,2190.595688097,103
carcassonne-boltzmann135-vs-boltzmann375-1000its,825,722,2170.603790045,2149.882985177,103
carcassonne-boltzmann305-vs-boltzmann40-1000its,830,727,2171.515661781,2133.157477557,103
carcassonne-uct480-vs-uct85-1000its,831,728,2270.795306129,2199.764693963,103
carcassonne-uct140-vs-uct290-1000its,832,729,2169.255009022,2136.887750194,103
carcassonne-uct255-vs-uct155-1000its,832,729,2260.529821562,2213.798697221,103
carcassonne-boltzmann95-vs-boltzmann75-1000its,834,731,2191.047464942,2160.690966712,103
carcassonne-boltzmann55-vs-boltzmann175-1000its,835,732,2300.539274955,2190.950701476,103
carcassonne-uct120-vs-uct215-1000its,835,732,2174.251589133,2126.992029022,103
carcassonne-uct10-vs-uct170-1000its,836,733,2174.178031008,2173.00565896,103
carcassonne-boltzmann210-vs-boltzmann160-1000its,840,737,2191.329934577,2166.114770961,103
carcassonne-boltzmann300-vs-boltzmann295-1000its,841,738,2190.826687363,2127.981521093,103
carcassonne-boltzmann455-vs-boltzmann310-1000its,841,738,2198.316312768,2136.148211813,103
carcassonne-ucttuned340-vs-ucttuned495-1000its,841,738,2164.017572307,2132.667314923,103
carcassonne-uct285-vs-uct110-1000its,842,739,2182.305629043,2139.040818272,103
carcassonne-boltzmann370-vs-boltzmann445-1000its,848,745,2156.418694356,2119.620145805,103
carcassonne-uct275-vs-uct205-1000its,849,746,2212.076349865,2145.95942238,103
carcassonne-boltzmann75-vs-boltzmann155-1000its,850,747,2112.755626486,2063.356848452,103
carcassonne-ucttuned425-vs-ucttuned210-1000its,851,748,2176.524152224,2101.923529404,103
carcassonne-uct100-vs-uct105-1000its,855,752,2195.867434717,2138.833730675,103
carcassonne-boltzmann490-vs-boltzmann105-1000its,856,753,2167.059534665,2123.368167979,103
carcassonne-ucttuned295-vs-ucttuned480-1000its,857,754,2160.030490642,2110.49747059,103
carcassonne-uct250-vs-uct35-1000its,858,755,2197.979609133,2168.300724583,103
carcassonne-uct400-vs-uct15-1000its,858,755,2187.453988494,2139.139215857,103
carcassonne-boltzmann395-vs-boltzmann330-1000its,861,758,2169.845346292,2120.553851868,103
carcassonne-ucttuned10-vs-ucttuned420-1000its,866,763,2162.270886136,2107.139791794,103
carcassonne-boltzmann350-vs-boltzmann385-1000its,867,764,2173.223781089,2120.189042921,103
carcassonne-ucttuned200-vs-ucttuned350-1000its,868,765,2238.73133052,2182.825913245,103
carcassonne-uct370-vs-uct310-1000its,871,768,2201.273050992,2125.252149145,103
carcassonne-boltzmann170-vs-boltzmann15-1000its,872,769,2198.511889491,2194.266073909,103
carcassonne-boltzmann155-vs-boltzmann320-1000its,873,770,2268.619896789,2214.475791865,103
carcassonne-ucttuned85-vs-ucttuned355-1000its,874,771,2198.267599482,2142.163123507,103
carcassonne-ucttuned420-vs-ucttuned150-1000its,875,772,2179.442709631,2105.88442405,103
carcassonne-ucttuned235-vs-ucttuned140-1000its,876,773,2202.04796866,2182.409476479,103
carcassonne-ucttuned80-vs-ucttuned35-1000its,877,774,2133.137887124,2122.182679304,103
carcassonne-ucttuned210-vs-ucttuned405-1000its,878,775,2180.47010594,2180.356950093,103
carcassonne-uct400-vs-uct195-1000its,879,776,2219.102875486,2197.42443427,103
carcassonne-ucttuned35-vs-ucttuned225-1000its,879,776,2233.860135912,2167.795274078,103
carcassonne-uct195-vs-uct250-1000its,881,778,2164.894502456,2125.112885437,103
carcassonne-uct115-vs-uct365-1000its,882,779,2151.984233755,2121.468502777,103
carcassonne-uct30-vs-uct45-1000its,882,779,2209.580575092,2151.025679724,103
carcassonne-ucttuned130-vs-ucttuned135-1000its,882,779,2247.232052845,2172.295065998,103
carcassonne-ucttuned400-vs-ucttuned315-1000its,887,784,2179.137225127,2175.638272506,103
carcassonne-ucttuned275-vs-ucttuned395-1000its,888,785,2217.513517794,2201.818842486,103
carcassonne-boltzmann170-vs-boltzmann140-1000its,890,787,2240.083304599,2193.433584174,103
carcassonne-uct275-vs-uct65-1000its,891,788,2269.125206766,2214.373169581,103
carcassonne-uct480-vs-uct320-1000its,892,789,2180.99768463,2147.491095653,103
carcassonne-uct5-vs-uct145-1000its,895,792,2262.643228261,2169.88238133,103
carcassonne-uct495-vs-uct175-1000its,897,794,2210.264761306,2193.404424818,103
carcassonne-uct20-vs-uct65-1000its,899,796,2201.204537925,2126.55972411,103
carcassonne-ucttuned65-vs-ucttuned180-1000its,899,796,2179.797907442,2144.808101003,103
carcassonne-ucttuned315-vs-ucttuned490-1000its,904,801,2271.200997728,2183.751711962,103
carcassonne-uct135-vs-uct45-1000its,910,807,2157.296418017,2125.002482174,103
carcassonne-uct150-vs-uct440-1000its,910,807,2290.692590053,2208.740614215,103
carcassonne-uct320-vs-uct405-1000its,910,807,2191.829953293,2165.999051727,103
carcassonne-ucttuned300-vs-ucttuned375-1000its,910,807,2307.408129055,2263.575253706,103
carcassonne-uct410-vs-uct270-1000its,917,814,2216.095667001,2158.619133058,103
carcassonne-uct320-vs-uct485-1000its,920,817,2228.493927897,2226.52274115,103
carcassonne-ucttuned75-vs-ucttuned225-1000its,935,832,2191.178404681,2141.463952223,103
carcassonne-uct125-vs-uct470-1000its,940,837,2215.163708889,2143.414271382,103
carcassonne-ucttuned10-vs-ucttuned470-1000its,944,841,2241.583828905,2206.827010427,103
carcassonne-ucttuned275-vs-ucttuned490-1000its,957,854,2244.136211955,2158.392084799,103
carcassonne-ucttuned80-vs-ucttuned65-1000its,984,881,2224.229367796,2243.574959448,103
carcassonne-boltzmann15-vs-boltzmann240-1000its,782,678,2215.719413372,2152.613358011,104
carcassonne-ucttuned260-vs-ucttuned75-1000its,782,678,2192.807598184,2138.675942446,104
carcassonne-boltzmann470-vs-boltzmann365-1000its,797,693,2195.379201053,2175.36905495,104
carcassonne-ucttuned95-vs-ucttuned220-1000its,801,697,2201.369164526,2168.166050884,104
carcassonne-uct195-vs-uct100-1000its,806,702,2149.088265807,2101.702455194,104
carcassonne-boltzmann135-vs-boltzmann100-1000its,808,704,2139.824972224,2086.314279199,104
carcassonne-boltzmann470-vs-boltzmann110-1000its,811,707,2201.536161354,2152.223920037,104
carcassonne-boltzmann385-vs-boltzmann355-1000its,812,708,2282.704764047,2202.677921306,104
carcassonne-uct220-vs-uct450-1000its,813,709,2209.057829043,2157.233394875,104
carcassonne-ucttuned390-vs-ucttuned330-1000its,825,721,2144.09303596,2121.018789003,104
carcassonne-uct250-vs-uct415-1000its,826,722,2222.365309403,2171.997434605,104
carcassonne-boltzmann355-vs-boltzmann160-1000its,833,729,2162.412675501,2108.684443084,104
carcassonne-ucttuned150-vs-ucttuned280-1000its,833,729,2223.104429925,2165.671707556,104
carcassonne-ucttuned175-vs-ucttuned370-1000its,833,729,2288.541205069,2208.490356875,104
carcassonne-uct15-vs-uct250-1000its,835,731,2173.55740335,2130.358736908,104
carcassonne-uct60-vs-uct325-1000its,835,731,2163.034623816,2146.811546111,104
carcassonne-ucttuned465-vs-ucttuned85-1000its,835,731,2220.8233468,2170.370226164,104
carcassonne-ucttuned475-vs-ucttuned75-1000its,838,734,2170.43702165,2150.776230078,104
carcassonne-ucttuned70-vs-ucttuned355-1000its,838,734,2221.749815552,2138.366956563,104
carcassonne-ucttuned215-vs-ucttuned460-1000its,840,736,2146.284389489,2118.243098347,104
carcassonne-ucttuned195-vs-ucttuned170-1000its,841,737,2247.340414429,2158.329045969,104
carcassonne-uct105-vs-uct420-1000its,844,740,2177.719463377,2146.930410749,104
carcassonne-boltzmann440-vs-boltzmann115-1000its,845,741,2207.447597674,2175.734728954,104
carcassonne-uct220-vs-uct460-1000its,845,741,2233.371302462,2160.169199177,104
carcassonne-uct190-vs-uct140-1000its,846,742,2206.085804939,2171.117238492,104
carcassonne-uct340-vs-uct415-1000its,846,742,2249.700864704,2194.584048028,104
carcassonne-ucttuned95-vs-ucttuned455-1000its,846,742,2241.766961184,2206.273081182,104
carcassonne-boltzmann430-vs-boltzmann195-1000its,849,745,2202.353833769,2191.927752235,104
carcassonne-ucttuned190-vs-ucttuned350-1000its,849,745,2191.204254405,2086.633866141,104
carcassonne-ucttuned375-vs-ucttuned75-1000its,850,746,2196.302023737,2131.652205774,104
carcassonne-ucttuned385-vs-ucttuned155-1000its,851,747,2160.202910275,2104.70137031,104
carcassonne-boltzmann415-vs-boltzmann205-1000its,852,748,2270.004503644,2231.051576859,104
carcassonne-ucttuned425-vs-ucttuned320-1000its,852,748,2184.94920154,2173.705940393,104
carcassonne-boltzmann135-vs-boltzmann220-1000its,853,749,2153.847641437,2131.214758339,104
carcassonne-uct310-vs-uct445-1000its,853,749,2299.021837318,2293.720043418,104
carcassonne-boltzmann240-vs-boltzmann155-1000its,854,750,2253.323643445,2204.491239889,104
carcassonne-boltzmann355-vs-boltzmann290-1000its,858,754,2221.175073951,2143.165403531,104
carcassonne-boltzmann15-vs-boltzmann485-1000its,860,756,2205.262650391,2131.162129246,104
carcassonne-boltzmann485-vs-boltzmann160-1000its,864,760,2215.022013571,2171.268489488,104
carcassonne-uct220-vs-uct325-1000its,864,760,2264.562043831,2196.881906627,104
carcassonne-boltzmann465-vs-boltzmann380-1000its,865,761,2165.851124031,2120.5016519,104
carcassonne-uct100-vs-uct455-1000its,865,761,2202.574865436,2152.164440531,104
carcassonne-ucttuned195-vs-ucttuned375-1000its,865,761,2185.776686191,2181.354144815,104
carcassonne-uct15-vs-uct170-1000its,867,763,2352.432260085,2236.050953126,104
carcassonne-uct185-vs-uct25-1000its,867,763,2107.365136569,2082.136870008,104
carcassonne-ucttuned430-vs-ucttuned420-1000its,867,763,2153.745222938,2141.582362735,104
carcassonne-ucttuned240-vs-ucttuned425-1000its,869,765,2199.44794984,2127.870805865,104
carcassonne-ucttuned455-vs-ucttuned95-1000its,869,765,2102.65348631,2095.207903418,104
carcassonne-uct180-vs-uct90-1000its,871,767,2243.216574519,2175.696874195,104
carcassonne-uct410-vs-uct215-1000its,872,768,2243.421474156,2193.299159123,104
carcassonne-boltzmann440-vs-boltzmann380-1000its,877,773,2215.322392724,2193.157670252,104
carcassonne-ucttuned225-vs-ucttuned205-1000its,878,774,2241.089640205,2179.386944868,104
carcassonne-boltzmann20-vs-boltzmann330-1000its,881,777,2209.307821311,2159.541213796,104
carcassonne-boltzmann50-vs-boltzmann165-1000its,883,779,2234.192105717,2148.279147294,104
carcassonne-uct15-vs-uct200-1000its,886,782,2182.682021932,2102.879987301,104
carcassonne-boltzmann330-vs-boltzmann195-1000its,889,785,2265.634046933,2192.047937256,104
carcassonne-ucttuned325-vs-ucttuned150-1000its,890,786,2198.604857875,2151.85445373,104
carcassonne-ucttuned75-vs-ucttuned365-1000its,891,787,2271.300223697,2215.536656939,104
carcassonne-uct175-vs-uct365-1000its,892,788,2231.823174809,2213.455189675,104
carcassonne-ucttuned475-vs-ucttuned325-1000its,893,789,2214.168869638,2178.6069521,104
carcassonne-ucttuned300-vs-ucttuned205-1000its,894,790,2163.131229533,2112.281596118,104
carcassonne-uct195-vs-uct480-1000its,896,792,2243.38146796,2166.133781347,104
carcassonne-uct180-vs-uct235-1000its,897,793,2127.207670768,2126.523367761,104
carcassonne-ucttuned360-vs-ucttuned205-1000its,897,793,2215.107559943,2163.162771521,104
carcassonne-ucttuned350-vs-ucttuned440-1000its,898,794,2183.990532559,2120.218112163,104
carcassonne-ucttuned210-vs-ucttuned485-1000its,902,798,2223.448025492,2148.980305255,104
carcassonne-boltzmann270-vs-boltzmann85-1000its,904,800,2267.26325626,2152.791545396,104
carcassonne-uct255-vs-uct90-1000its,905,801,2183.613856917,2151.043989766,104
carcassonne-uct150-vs-uct210-1000its,906,802,2184.992973756,2125.751174364,104
carcassonne-uct225-vs-uct110-1000its,907,803,2212.881489809,2197.414813831,104
carcassonne-boltzmann125-vs-boltzmann395-1000its,922,818,2207.463768592,2178.246429374,104
carcassonne-uct450-vs-uct475-1000its,931,827,2217.442811582,2173.497182751,104
carcassonne-uct480-vs-uct260-1000its,938,834,2253.567972886,2170.911567632,104
carcassonne-boltzmann280-vs-boltzmann370-1000its,946,842,2155.086925096,2109.362286357,104
carcassonne-ucttuned145-vs-ucttuned45-1000its,949,845,2256.184056042,2193.328297287,104
carcassonne-uct70-vs-uct40-1000its,952,848,2250.261632721,2176.627486952,104
carcassonne-ucttuned20-vs-ucttuned250-1000its,956,852,2272.223014512,2203.196826626,104
carcassonne-boltzmann70-vs-boltzmann450-1000its,958,854,2170.405645256,2108.570275915,104
carcassonne-ucttuned475-vs-ucttuned55-1000its,958,854,2188.526169014,2088.852965015,104
carcassonne-uct65-vs-uct20-1000its,797,692,2191.834320744,2140.902764342,105
carcassonne-boltzmann40-vs-boltzmann215-1000its,807,702,2176.452784743,2154.076454581,105
carcassonne-uct20-vs-uct270-1000its,808,703,2207.948810385,2159.225592125,105
carcassonne-ucttuned215-vs-ucttuned455-1000its,808,703,2164.606743377,2151.567733836,105
carcassonne-uct360-vs-uct305-1000its,815,710,2260.548888726,2193.195123706,105
carcassonne-ucttuned465-vs-ucttuned350-1000its,820,715,2220.005074455,2130.446356728,105
carcassonne-uct470-vs-uct265-1000its,823,718,2171.797650581,2148.011342145,105
carcassonne-ucttuned40-vs-ucttuned290-1000its,826,721,2284.209160324,2248.683499158,105
carcassonne-uct125-vs-uct460-1000its,828,723,2167.882235511,2091.096335547,105
carcassonne-ucttuned55-vs-ucttuned295-1000its,831,726,2251.292628113,2161.670688552,105
carcassonne-uct380-vs-uct390-1000its,835,730,2179.027642187,2176.588004027,105
carcassonne-ucttuned465-vs-ucttuned340-1000its,835,730,2234.339742068,2165.473224223,105
carcassonne-boltzmann490-vs-boltzmann405-1000its,836,731,2223.815138922,2176.156242838,105
carcassonne-ucttuned160-vs-ucttuned65-1000its,841,736,2208.077146584,2142.903010228,105
carcassonne-boltzmann445-vs-boltzmann310-1000its,842,737,2221.738498944,2199.953555044,105
carcassonne-uct415-vs-uct175-1000its,843,738,2142.683214349,2125.276743281,105
carcassonne-boltzmann95-vs-boltzmann40-1000its,847,742,2207.544815002,2125.128072896,105
carcassonne-uct245-vs-uct450-1000its,848,743,2160.428161189,2166.939042458,105
carcassonne-uct75-vs-uct245-1000its,848,743,2215.768199681,2233.439137218,105
carcassonne-boltzmann255-vs-boltzmann30-1000its,849,744,2252.314963324,2222.78065205,105
carcassonne-ucttuned410-vs-ucttuned45-1000its,849,744,2194.572729516,2158.19763191,105
carcassonne-uct10-vs-uct260-1000its,852,747,2166.915383003,2119.675658892,105
carcassonne-uct370-vs-uct345-1000its,853,748,2214.596141737,2171.33571314,105
carcassonne-boltzmann110-vs-boltzmann290-1000its,855,750,2234.064980779,2225.616466275,105
carcassonne-ucttuned350-vs-ucttuned450-1000its,855,750,2151.346988126,2108.494054616,105
carcassonne-uct485-vs-uct125-1000its,856,751,2157.517626744,2117.171632893,105
carcassonne-uct120-vs-uct375-1000its,858,753,2259.456482508,2252.976945797,105
carcassonne-boltzmann320-vs-boltzmann345-1000its,859,754,2131.981428517,2099.423155255,105
carcassonne-boltzmann415-vs-boltzmann65-1000its,860,755,2173.250561973,2150.706886221,105
carcassonne-boltzmann315-vs-boltzmann20-1000its,862,757,2175.347769854,2181.231468295,105
carcassonne-boltzmann95-vs-boltzmann415-1000its,862,757,2269.312895639,2224.84284054,105
carcassonne-uct215-vs-uct360-1000its,863,758,2108.05005068,2080.177922169,105
carcassonne-boltzmann100-vs-boltzmann350-1000its,865,760,2249.240990287,2189.455689566,105
carcassonne-ucttuned285-vs-ucttuned465-1000its,866,761,2251.580366486,2223.540775211,105
carcassonne-ucttuned250-vs-ucttuned5-1000its,870,765,2225.506146098,2159.886247736,105
carcassonne-uct495-vs-uct360-1000its,873,768,2234.611561285,2178.924042312,105
carcassonne-ucttuned5-vs-ucttuned200-1000its,873,768,2160.264074568,2123.819038837,105
carcassonne-uct45-vs-uct135-1000its,877,772,2140.64322916,2097.303709794,105
carcassonne-boltzmann250-vs-boltzmann65-1000its,879,774,2209.738132551,2132.945100658,105
carcassonne-boltzmann330-vs-boltzmann440-1000its,881,776,2158.58171576,2136.659791088,105
carcassonne-boltzmann250-vs-boltzmann270-1000its,883,778,2194.708796789,2090.689085455,105
carcassonne-uct205-vs-uct75-1000its,884,779,2280.756551772,2272.158443888,105
carcassonne-boltzmann125-vs-boltzmann115-1000its,885,780,2155.871932466,2154.340697504,105
carcassonne-boltzmann230-vs-boltzmann85-1000its,886,781,2230.796494053,2166.835401883,105
carcassonne-ucttuned415-vs-ucttuned350-1000its,890,785,2252.625547268,2201.57672564,105
carcassonne-ucttuned170-vs-ucttuned300-1000its,891,786,2279.029212257,2207.44169016,105
carcassonne-uct15-vs-uct350-1000its,893,788,2178.679446016,2096.313024233,105
carcassonne-uct345-vs-uct260-1000its,897,792,2208.29866889,2177.905185811,105
carcassonne-ucttuned10-vs-ucttuned460-1000its,908,803,2202.987677344,2135.730096292,105
carcassonne-ucttuned250-vs-ucttuned385-1000its,912,807,2218.895739672,2172.865923553,105
carcassonne-ucttuned5-vs-ucttuned105-1000its,915,810,2181.504293726,2187.203580731,105
carcassonne-boltzmann75-vs-boltzmann95-1000its,916,811,2157.767918661,2077.021085546,105
carcassonne-ucttuned105-vs-ucttuned385-1000its,917,812,2179.665136314,2102.535340419,105
carcassonne-ucttuned345-vs-ucttuned355-1000its,918,813,2181.257400213,2125.350875175,105
carcassonne-ucttuned10-vs-ucttuned150-1000its,923,818,2242.040393877,2180.55024573,105
carcassonne-ucttuned75-vs-ucttuned380-1000its,934,829,2205.696794534,2179.704319156,105
carcassonne-ucttuned295-vs-ucttuned165-1000its,940,835,2162.201862177,2160.731077271,105
carcassonne-ucttuned50-vs-ucttuned475-1000its,946,841,2117.941030253,2103.162170873,105
carcassonne-uct15-vs-uct380-1000its,978,873,2153.064611693,2089.039984608,105
carcassonne-ucttuned65-vs-ucttuned450-1000its,1015,910,2269.06356432,2210.700184627,105
carcassonne-boltzmann30-vs-boltzmann100-1000its,774,668,2153.953390974,2119.398564247,106
carcassonne-uct225-vs-uct425-1000its,790,684,2192.442325305,2134.290429601,106
carcassonne-boltzmann470-vs-boltzmann210-1000its,805,699,2245.723061463,2191.139742615,106
carcassonne-ucttuned30-vs-ucttuned115-1000its,805,699,2219.198048999,2128.736044084,106
carcassonne-uct175-vs-uct265-1000its,808,702,2182.577994001,2156.614067349,106
carcassonne-boltzmann185-vs-boltzmann55-1000its,809,703,2253.868061545,2233.922547132,106
carcassonne-ucttuned225-vs-ucttuned110-1000its,810,704,2190.88802421,2161.990100437,106
carcassonne-ucttuned85-vs-ucttuned340-1000its,811,705,2243.664806944,2195.716296793,106
carcassonne-boltzmann275-vs-boltzmann475-1000its,812,706,2196.056322837,2125.936694317,106
carcassonne-boltzmann285-vs-boltzmann170-1000its,812,706,2162.985595007,2137.213083019,106
carcassonne-uct495-vs-uct245-1000its,813,707,2196.901839055,2152.2558082,106
carcassonne-boltzmann175-vs-boltzmann455-1000its,816,710,2190.325960315,2149.335725062,106
carcassonne-uct185-vs-uct180-1000its,816,710,2278.269072266,2223.387867578,106
carcassonne-uct345-vs-uct465-1000its,817,711,2311.045842856,2261.215771647,106
carcassonne-boltzmann85-vs-boltzmann425-1000its,818,712,2180.708125915,2162.450855263,106
carcassonne-boltzmann295-vs-boltzmann365-1000its,819,713,2134.209525626,2048.833702511,106
carcassonne-uct190-vs-uct45-1000its,821,715,2234.618867872,2172.505108821,106
carcassonne-boltzmann315-vs-boltzmann400-1000its,829,723,2144.734706369,2124.438703721,106
carcassonne-ucttuned155-vs-ucttuned180-1000its,840,734,2223.191302437,2198.033103632,106
carcassonne-uct415-vs-uct370-1000its,844,738,2249.867511322,2207.299943785,106
carcassonne-boltzmann75-vs-boltzmann255-1000its,846,740,2215.485828344,2185.899034101,106
carcassonne-boltzmann265-vs-boltzmann375-1000its,847,741,2221.38546984,2145.625014891,106
carcassonne-boltzmann450-vs-boltzmann285-1000its,847,741,2172.277868542,2089.462973059,106
carcassonne-uct390-vs-uct495-1000its,847,741,2148.888256579,2130.65436199,106
carcassonne-boltzmann400-vs-boltzmann240-1000its,848,742,2221.471801416,2200.835668417,106
carcassonne-boltzmann165-vs-boltzmann200-1000its,850,744,2244.023592723,2187.993501031,106
carcassonne-ucttuned285-vs-ucttuned475-1000its,853,747,2299.45535561,2251.015689191,106
carcassonne-uct305-vs-uct80-1000its,854,748,2197.130321259,2135.309999077,106
carcassonne-uct100-vs-uct160-1000its,859,753,2219.151666856,2174.526709849,106
carcassonne-uct495-vs-uct60-1000its,859,753,2213.019296024,2163.77871068,106
carcassonne-uct430-vs-uct355-1000its,861,755,2191.748901133,2138.009834434,106
carcassonne-boltzmann370-vs-boltzmann100-1000its,862,756,2242.540459877,2180.166592729,106
carcassonne-boltzmann490-vs-boltzmann480-1000its,862,756,2161.604254754,2086.792510732,106
carcassonne-uct180-vs-uct140-1000its,862,756,2138.093429135,2125.457661154,106
carcassonne-ucttuned320-vs-ucttuned300-1000its,869,763,2147.446852838,2110.626870284,106
carcassonne-uct350-vs-uct440-1000its,872,766,2257.252611339,2207.304426003,106
carcassonne-uct365-vs-uct380-1000its,874,768,2172.506772141,2131.305188294,106
carcassonne-uct385-vs-uct410-1000its,875,769,2194.199246733,2152.97498038,106
carcassonne-boltzmann315-vs-boltzmann250-1000its,876,770,2232.573420733,2229.128774962,106
carcassonne-uct60-vs-uct245-1000its,877,771,2238.894035583,2195.786528771,106
carcassonne-uct300-vs-uct290-1000its,884,778,2259.054595674,2216.804148532,106
carcassonne-boltzmann10-vs-boltzmann215-1000its,886,780,2112.830258644,2062.817525136,106
carcassonne-ucttuned25-vs-ucttuned195-1000its,886,780,2235.344050026,2214.040570278,106
carcassonne-boltzmann125-vs-boltzmann165-1000its,889,783,2137.422448415,2094.701258596,106
carcassonne-uct290-vs-uct240-1000its,898,792,2166.031520017,2129.100272893,106
carcassonne-boltzmann155-vs-boltzmann445-1000its,906,800,2140.603272821,2159.669309151,106
carcassonne-boltzmann10-vs-boltzmann275-1000its,908,802,2172.740364552,2123.838832712,106
carcassonne-boltzmann345-vs-boltzmann385-1000its,908,802,2260.71271862,2197.035440075,106
carcassonne-boltzmann65-vs-boltzmann430-1000its,908,802,2247.676795079,2222.056851494,106
carcassonne-uct145-vs-uct10-1000its,910,804,2173.132978873,2201.224446125,106
carcassonne-ucttuned65-vs-ucttuned250-1000its,914,808,2131.331570263,2085.033276541,106
carcassonne-boltzmann130-vs-boltzmann40-1000its,919,813,2187.617039001,2134.289572134,106
carcassonne-ucttuned55-vs-ucttuned250-1000its,935,829,2184.258244146,2101.738571013,106
carcassonne-boltzmann395-vs-boltzmann65-1000its,940,834,2164.162309821,2107.654177652,106
carcassonne-uct120-vs-uct245-1000its,760,653,2136.248250944,2095.540338709,107
carcassonne-boltzmann125-vs-boltzmann105-1000its,780,673,2227.161365153,2153.436009882,107
carcassonne-boltzmann380-vs-boltzmann360-1000its,782,675,2175.561317043,2105.32373261,107
carcassonne-boltzmann160-vs-boltzmann365-1000its,800,693,2153.892446644,2089.613341658,107
carcassonne-ucttuned205-vs-ucttuned255-1000its,811,704,2161.453817965,2105.763116573,107
carcassonne-uct130-vs-uct250-1000its,813,706,2175.596684436,2130.352814847,107
carcassonne-boltzmann480-vs-boltzmann35-1000its,820,713,2171.043964962,2119.493099992,107
carcassonne-boltzmann185-vs-boltzmann435-1000its,822,715,2282.52719969,2227.496230521,107
carcassonne-boltzmann335-vs-boltzmann400-1000its,824,717,2200.189656309,2177.319177626,107
carcassonne-ucttuned65-vs-ucttuned265-1000its,825,718,2206.044271118,2146.84541945,107
carcassonne-uct395-vs-uct50-1000its,826,719,2234.559013129,2195.458671107,107
carcassonne-uct55-vs-uct205-1000its,827,720,2182.445449438,2120.575126537,107
carcassonne-boltzmann190-vs-boltzmann230-1000its,833,726,2203.1995217,2160.150414383,107
carcassonne-boltzmann400-vs-boltzmann480-1000its,834,727,2196.388059915,2140.477255693,107
carcassonne-boltzmann440-vs-boltzmann405-1000its,839,732,2195.363555653,2177.52470174,107
carcassonne-ucttuned120-vs-ucttuned240-1000its,842,735,2195.413471426,2159.3841534,107
carcassonne-ucttuned430-vs-ucttuned405-1000its,842,735,2234.837904185,2192.316644906,107
carcassonne-ucttuned245-vs-ucttuned470-1000its,846,739,2187.336844114,2159.916278882,107
carcassonne-uct470-vs-uct140-1000its,849,742,2180.411901728,2098.481178148,107
carcassonne-ucttuned275-vs-ucttuned450-1000its,849,742,2282.891553297,2173.965586038,107
carcassonne-ucttuned250-vs-ucttuned495-1000its,850,743,2233.281822818,2169.92881393,107
carcassonne-uct195-vs-uct385-1000its,853,746,2274.906008415,2193.655362216,107
carcassonne-uct485-vs-uct445-1000its,853,746,2195.577490325,2131.747787457,107
carcassonne-uct220-vs-uct455-1000its,854,747,2196.758610673,2182.157709374,107
carcassonne-ucttuned465-vs-ucttuned260-1000its,854,747,2261.440782871,2284.491940767,107
carcassonne-ucttuned375-vs-ucttuned165-1000its,855,748,2145.9075773,2101.692244165,107
carcassonne-boltzmann240-vs-boltzmann110-1000its,856,749,2280.443842339,2242.799528865,107
carcassonne-uct375-vs-uct100-1000its,857,750,2168.451492664,2152.502468433,107
carcassonne-boltzmann80-vs-boltzmann345-1000its,858,751,2217.161795073,2139.89544579,107
carcassonne-uct275-vs-uct430-1000its,858,751,2128.186892668,2093.569132524,107
carcassonne-ucttuned200-vs-ucttuned335-1000its,858,751,2262.292009718,2187.418240165,107
carcassonne-boltzmann455-vs-boltzmann400-1000its,863,756,2319.516305921,2298.077446889,107
carcassonne-ucttuned240-vs-ucttuned100-1000its,863,756,2194.827147729,2183.671201793,107
carcassonne-boltzmann355-vs-boltzmann90-1000its,865,758,2177.293446135,2090.655870303,107
carcassonne-boltzmann480-vs-boltzmann220-1000its,868,761,2149.675478135,2136.301227925,107
carcassonne-ucttuned5-vs-ucttuned335-1000its,868,761,2266.210311943,2193.120496281,107
carcassonne-ucttuned50-vs-ucttuned345-1000its,869,762,2151.846720933,2126.043361636,107
carcassonne-ucttuned315-vs-ucttuned160-1000its,871,764,2272.695838316,2192.924685363,107
carcassonne-boltzmann290-vs-boltzmann130-1000its,874,767,2144.942726764,2110.467687395,107
carcassonne-uct115-vs-uct390-1000its,880,773,2184.049966254,2137.269408046,107
carcassonne-boltzmann55-vs-boltzmann370-1000its,882,775,2137.895266298,2081.39694637,107
carcassonne-uct290-vs-uct310-1000its,883,776,2239.310856195,2181.147707883,107
carcassonne-uct210-vs-uct95-1000its,885,778,2172.144795873,2101.889180051,107
carcassonne-uct400-vs-uct155-1000its,888,781,2166.892689344,2122.961022184,107
carcassonne-boltzmann160-vs-boltzmann320-1000its,891,784,2220.786949488,2201.715813938,107
carcassonne-boltzmann345-vs-boltzmann95-1000its,893,786,2216.189316387,2199.122879272,107
carcassonne-ucttuned110-vs-ucttuned105-1000its,893,786,2224.499065682,2098.669046445,107
carcassonne-ucttuned365-vs-ucttuned170-1000its,893,786,2134.193743088,2106.796467424,107
carcassonne-ucttuned420-vs-ucttuned405-1000its,899,792,2193.093938746,2107.746721877,107
carcassonne-ucttuned440-vs-ucttuned310-1000its,900,793,2144.222395169,2116.634256395,107
carcassonne-boltzmann290-vs-boltzmann405-1000its,903,796,2175.52907819,2119.646638661,107
carcassonne-ucttuned290-vs-ucttuned395-1000its,906,799,2187.327157993,2170.294045271,107
carcassonne-ucttuned475-vs-ucttuned440-1000its,908,801,2169.265628089,2107.644100255,107
carcassonne-boltzmann140-vs-boltzmann65-1000its,917,810,2213.540082628,2163.60525652,107
carcassonne-uct135-vs-uct465-1000its,918,811,2185.576491244,2166.626082431,107
carcassonne-uct275-vs-uct15-1000its,920,813,2238.767226741,2208.615924857,107
carcassonne-uct435-vs-uct125-1000its,922,815,2252.663795707,2193.914803685,107
carcassonne-boltzmann40-vs-boltzmann295-1000its,926,819,2212.067582526,2126.329278227,107
carcassonne-uct340-vs-uct95-1000its,929,822,2260.722528649,2181.530936202,107
carcassonne-ucttuned275-vs-ucttuned435-1000its,931,824,2244.962157095,2155.397341836,107
carcassonne-ucttuned270-vs-ucttuned35-1000its,933,826,2243.417397311,2224.119974713,107
carcassonne-uct25-vs-uct215-1000its,949,842,2156.788934514,2113.673844411,107
carcassonne-uct235-vs-uct430-1000its,960,853,2195.288275507,2162.499501295,107
carcassonne-uct70-vs-uct10-1000its,996,889,2246.531389715,2203.874630398,107
carcassonne-boltzmann450-vs-boltzmann355-1000its,704,596,1732.278046851,1705.638214611,108
carcassonne-uct240-vs-uct45-1000its,781,673,2223.922627243,2177.780438453,108
carcassonne-ucttuned335-vs-ucttuned415-1000its,797,689,2290.033315478,2220.517991119,108
carcassonne-boltzmann405-vs-boltzmann355-1000its,799,691,2131.271016047,2069.921560872,108
carcassonne-boltzmann455-vs-boltzmann485-1000its,805,697,2177.764462851,2141.235723882,108
carcassonne-ucttuned110-vs-ucttuned90-1000its,809,701,2181.426404886,2115.84189014,108
carcassonne-ucttuned210-vs-ucttuned175-1000its,816,708,2265.118692072,2230.50337261,108
carcassonne-uct100-vs-uct375-1000its,818,710,2140.561561456,2092.321798826,108
carcassonne-boltzmann210-vs-boltzmann185-1000its,822,714,2247.4077348,2207.461793447,108
carcassonne-boltzmann295-vs-boltzmann425-1000its,823,715,2122.726618251,2095.829787001,108
carcassonne-boltzmann45-vs-boltzmann270-1000its,825,717,2231.670295194,2185.996306825,108
carcassonne-boltzmann255-vs-boltzmann95-1000its,827,719,2246.127718173,2215.203635367,108
carcassonne-ucttuned135-vs-ucttuned485-1000its,828,720,2200.188924515,2146.146076551,108
carcassonne-ucttuned215-vs-ucttuned225-1000its,828,720,2235.182280122,2171.544399573,108
carcassonne-ucttuned470-vs-ucttuned440-1000its,829,721,2185.013578031,2116.566266775,108
carcassonne-boltzmann435-vs-boltzmann330-1000its,831,723,2228.373215748,2155.611338043,108
carcassonne-ucttuned195-vs-ucttuned390-1000its,831,723,2138.320539231,2099.511685316,108
carcassonne-boltzmann20-vs-boltzmann55-1000its,834,726,2199.271200926,2115.978074968,108
carcassonne-ucttuned325-vs-ucttuned180-1000its,835,727,2255.779187986,2225.465857849,108
carcassonne-uct285-vs-uct240-1000its,837,729,2208.774469959,2197.542187994,108
carcassonne-ucttuned480-vs-ucttuned395-1000its,837,729,2203.926305218,2167.115415536,108
carcassonne-uct450-vs-uct435-1000its,839,731,2177.890216526,2100.976672599,108
carcassonne-uct390-vs-uct425-1000its,840,732,2209.018683624,2136.174678812,108
carcassonne-uct395-vs-uct485-1000its,840,732,2221.68215088,2164.854393102,108
carcassonne-ucttuned290-vs-ucttuned375-1000its,844,736,2309.677065693,2237.523004134,108
carcassonne-boltzmann55-vs-boltzmann320-1000its,845,737,2257.585116612,2229.991023443,108
carcassonne-uct205-vs-uct370-1000its,845,737,2238.872613928,2195.343867378,108
carcassonne-uct495-vs-uct30-1000its,850,742,2279.674268367,2225.719822775,108
carcassonne-ucttuned440-vs-ucttuned285-1000its,852,744,2240.418299341,2170.616835516,108
carcassonne-uct110-vs-uct205-1000its,853,745,2177.468656855,2110.266731769,108
carcassonne-boltzmann200-vs-boltzmann420-1000its,854,746,2138.002137448,2089.966585216,108
carcassonne-ucttuned495-vs-ucttuned345-1000its,856,748,2219.189997007,2151.046455654,108
carcassonne-boltzmann215-vs-boltzmann95-1000its,857,749,2206.438213225,2135.170818361,108
carcassonne-ucttuned130-vs-ucttuned355-1000its,858,750,2180.57203893,2129.249312833,108
carcassonne-ucttuned220-vs-ucttuned160-1000its,863,755,2157.817398553,2112.575445225,108
carcassonne-ucttuned395-vs-ucttuned145-1000its,867,759,2230.625320066,2208.776372173,108
carcassonne-ucttuned350-vs-ucttuned495-1000its,868,760,2203.160727083,2166.351571168,108
carcassonne-uct245-vs-uct340-1000its,870,762,2193.350102894,2118.280432052,108
carcassonne-uct475-vs-uct215-1000its,870,762,2234.070620281,2212.999002175,108
carcassonne-boltzmann350-vs-boltzmann390-1000its,871,763,2156.658730116,2130.451226697,108
carcassonne-uct110-vs-uct50-1000its,874,766,2123.30248042,2114.378954426,108
carcassonne-ucttuned255-vs-ucttuned55-1000its,874,766,2216.142887772,2126.011980254,108
carcassonne-ucttuned35-vs-ucttuned175-1000its,874,766,2189.934614887,2180.217581779,108
carcassonne-boltzmann310-vs-boltzmann470-1000its,878,770,2234.896572738,2181.203508765,108
carcassonne-uct395-vs-uct105-1000its,881,773,2245.132194889,2196.68893817,108
carcassonne-ucttuned195-vs-ucttuned105-1000its,883,775,2262.379963514,2213.782961055,108
carcassonne-ucttuned150-vs-ucttuned375-1000its,886,778,2223.014737539,2219.748822037,108
carcassonne-uct495-vs-uct170-1000its,888,780,2168.129971274,2078.770533912,108
carcassonne-uct55-vs-uct115-1000its,889,781,2258.341389835,2225.806999374,108
carcassonne-boltzmann160-vs-boltzmann140-1000its,890,782,2255.11991711,2176.937380258,108
carcassonne-ucttuned220-vs-ucttuned460-1000its,890,782,2197.02231822,2167.503599594,108
carcassonne-boltzmann5-vs-boltzmann100-1000its,891,783,2198.265409583,2143.411864202,108
carcassonne-boltzmann405-vs-boltzmann375-1000its,894,786,2199.547983013,2148.700126565,108
carcassonne-ucttuned10-vs-ucttuned300-1000its,894,786,2232.46341711,2208.517439348,108
carcassonne-ucttuned310-vs-ucttuned480-1000its,895,787,2140.946737625,2105.249286825,108
carcassonne-ucttuned290-vs-ucttuned430-1000its,896,788,2110.899581364,2063.364184583,108
carcassonne-ucttuned60-vs-ucttuned215-1000its,897,789,2195.821366955,2114.868176372,108
carcassonne-boltzmann460-vs-boltzmann25-1000its,901,793,2282.345989063,2215.45448868,108
carcassonne-uct40-vs-uct470-1000its,907,799,2138.821678416,2128.960287568,108
carcassonne-uct440-vs-uct395-1000its,910,802,2245.76528381,2190.266215063,108
carcassonne-ucttuned265-vs-ucttuned305-1000its,922,814,2151.540967525,2163.870183284,108
carcassonne-uct305-vs-uct350-1000its,925,817,2171.539165062,2210.941670877,108
carcassonne-uct395-vs-uct460-1000its,927,819,2236.773220275,2214.749651963,108
carcassonne-boltzmann425-vs-boltzmann200-1000its,930,822,2237.953727048,2214.642197806,108
carcassonne-ucttuned305-vs-ucttuned195-1000its,933,825,2171.201207368,2122.105362481,108
carcassonne-uct45-vs-uct450-1000its,938,830,2235.632997063,2161.817697458,108
carcassonne-ucttuned130-vs-ucttuned340-1000its,938,830,2153.479174429,2093.304147746,108
carcassonne-ucttuned315-vs-ucttuned130-1000its,942,834,2250.791678595,2180.733607167,108
carcassonne-ucttuned205-vs-ucttuned295-1000its,983,875,2274.067277781,2250.75715182,108
carcassonne-boltzmann410-vs-boltzmann125-1000its,788,679,2229.516696719,2168.084338296,109
carcassonne-uct280-vs-uct170-1000its,788,679,2191.428881398,2170.351928192,109
carcassonne-uct320-vs-uct415-1000its,788,679,2258.470748099,2193.984282137,109
carcassonne-ucttuned15-vs-ucttuned145-1000its,794,685,2192.407617915,2155.039000534,109
carcassonne-boltzmann120-vs-boltzmann420-1000its,798,689,2223.380007946,2154.792332911,109
carcassonne-boltzmann70-vs-boltzmann445-1000its,799,690,2188.656238677,2128.837775036,109
carcassonne-uct165-vs-uct155-1000its,810,701,2162.65100896,2112.301159951,109
carcassonne-uct290-vs-uct65-1000its,812,703,2213.770897434,2144.477718918,109
carcassonne-ucttuned145-vs-ucttuned310-1000its,818,709,2239.677355817,2193.753528793,109
carcassonne-boltzmann75-vs-boltzmann210-1000its,819,710,2102.347986154,2111.667952139,109
carcassonne-uct480-vs-uct140-1000its,824,715,2244.910342454,2191.340590229,109
carcassonne-boltzmann430-vs-boltzmann330-1000its,828,719,2199.033064698,2124.313435432,109
carcassonne-uct215-vs-uct385-1000its,829,720,2205.904379944,2133.598481451,109
carcassonne-boltzmann350-vs-boltzmann135-1000its,830,721,2273.549663854,2208.971703808,109
carcassonne-boltzmann305-vs-boltzmann75-1000its,832,723,2152.975703063,2129.626115335,109
carcassonne-boltzmann200-vs-boltzmann400-1000its,835,726,2210.032126471,2172.92589834,109
carcassonne-boltzmann320-vs-boltzmann370-1000its,839,730,2183.385140329,2130.743696679,109
carcassonne-boltzmann140-vs-boltzmann430-1000its,840,731,2136.034648958,2081.978894812,109
carcassonne-boltzmann25-vs-boltzmann130-1000its,841,732,2154.623127218,2147.460300908,109
carcassonne-boltzmann410-vs-boltzmann35-1000its,841,732,2172.176177899,2149.894237759,109
carcassonne-ucttuned440-vs-ucttuned490-1000its,843,734,2168.33312566,2104.233369891,109
carcassonne-boltzmann150-vs-boltzmann240-1000its,844,735,2203.765984431,2145.937479979,109
carcassonne-boltzmann65-vs-boltzmann435-1000its,848,739,2170.183545108,2098.72620797,109
carcassonne-boltzmann280-vs-boltzmann265-1000its,850,741,2194.084241867,2140.287305276,109
carcassonne-uct315-vs-uct470-1000its,851,742,2139.866799177,2137.04544924,109
carcassonne-ucttuned400-vs-ucttuned60-1000its,852,743,2146.025251449,2099.883748646,109
carcassonne-ucttuned465-vs-ucttuned480-1000its,853,744,2209.006024358,2197.09860757,109
carcassonne-ucttuned90-vs-ucttuned495-1000its,853,744,2225.630838632,2161.535327567,109
carcassonne-ucttuned495-vs-ucttuned30-1000its,854,745,2204.523191615,2131.039039351,109
carcassonne-ucttuned345-vs-ucttuned150-1000its,855,746,2252.530408159,2205.289673127,109
carcassonne-boltzmann165-vs-boltzmann15-1000its,860,751,2205.294672271,2154.564810326,109
carcassonne-uct465-vs-uct430-1000its,860,751,2217.87076921,2142.792429857,109
carcassonne-boltzmann155-vs-boltzmann180-1000its,861,752,2180.554325,2138.234530819,109
carcassonne-uct15-vs-uct255-1000its,861,752,2226.527523015,2165.046627124,109
carcassonne-ucttuned245-vs-ucttuned215-1000its,861,752,2171.997323119,2148.808566114,109
carcassonne-boltzmann95-vs-boltzmann80-1000its,863,754,2164.728908048,2143.506005888,109
carcassonne-ucttuned410-vs-ucttuned195-1000its,864,755,2283.081070079,2239.766434617,109
carcassonne-boltzmann365-vs-boltzmann155-1000its,866,757,2203.279793947,2198.022461891,109
carcassonne-uct80-vs-uct380-1000its,866,757,2186.666747462,2145.426505251,109
carcassonne-boltzmann20-vs-boltzmann305-1000its,868,759,2284.207469445,2234.927983544,109
carcassonne-ucttuned435-vs-ucttuned195-1000its,868,759,2236.552107261,2180.026840754,109
carcassonne-boltzmann160-vs-boltzmann465-1000its,872,763,2241.969408167,2136.884184238,109
carcassonne-uct460-vs-uct245-1000its,873,764,2223.597313308,2156.895933385,109
carcassonne-boltzmann15-vs-boltzmann385-1000its,876,767,2165.920251821,2132.367113006,109
carcassonne-ucttuned10-vs-ucttuned65-1000its,880,771,2203.173003034,2148.936623398,109
carcassonne-ucttuned330-vs-ucttuned15-1000its,886,777,2222.032459065,2141.158414548,109
carcassonne-boltzmann345-vs-boltzmann460-1000its,890,781,2257.321610286,2192.888864176,109
carcassonne-ucttuned105-vs-ucttuned75-1000its,890,781,2230.141739139,2202.880650392,109
carcassonne-ucttuned410-vs-ucttuned440-1000its,892,783,2270.740289963,2224.498382076,109
carcassonne-uct105-vs-uct300-1000its,894,785,2236.543872852,2155.290228441,109
carcassonne-uct375-vs-uct70-1000its,897,788,2189.803449355,2112.293762045,109
carcassonne-ucttuned30-vs-ucttuned305-1000its,906,797,2205.201249515,2171.209138674,109
carcassonne-ucttuned85-vs-ucttuned125-1000its,906,797,2152.642564235,2118.940762197,109
carcassonne-uct65-vs-uct70-1000its,908,799,2197.620328832,2112.32126922,109
carcassonne-ucttuned115-vs-ucttuned75-1000its,908,799,2303.102002272,2187.921475494,109
carcassonne-uct300-vs-uct455-1000its,909,800,2211.230036358,2153.754132976,109
carcassonne-ucttuned210-vs-ucttuned165-1000its,910,801,2236.198645901,2202.942436147,109
carcassonne-uct335-vs-uct345-1000its,911,802,2156.271711222,2095.301435526,109
carcassonne-ucttuned75-vs-ucttuned410-1000its,921,812,2185.728017921,2177.885846153,109
carcassonne-uct460-vs-uct10-1000its,923,814,2176.976233929,2164.105448321,109
carcassonne-ucttuned210-vs-ucttuned490-1000its,925,816,2204.276520913,2179.290763031,109
carcassonne-boltzmann55-vs-boltzmann40-1000its,930,821,2243.436002159,2132.982485159,109
carcassonne-ucttuned45-vs-ucttuned90-1000its,954,845,2159.999417608,2082.942075033,109
carcassonne-uct350-vs-uct150-1000its,959,850,2249.558840864,2162.206575566,109
carcassonne-ucttuned130-vs-ucttuned265-1000its,973,864,2195.186844607,2162.300813314,109
carcassonne-ucttuned135-vs-ucttuned160-1000its,758,648,2195.717707344,2157.449807387,110
carcassonne-uct195-vs-uct135-1000its,786,676,2197.277751952,2136.897842633,110
carcassonne-boltzmann435-vs-boltzmann280-1000its,787,677,2117.205757167,2044.302795433,110
carcassonne-uct365-vs-uct65-1000its,787,677,2175.022145095,2093.483552618,110
carcassonne-uct275-vs-uct185-1000its,795,685,2204.993056884,2141.588595539,110
carcassonne-uct170-vs-uct330-1000its,796,686,2289.968513502,2224.039461487,110
carcassonne-boltzmann475-vs-boltzmann100-1000its,803,693,2154.857507982,2150.832471493,110
carcassonne-uct285-vs-uct70-1000its,809,699,2139.67746243,2157.020814694,110
carcassonne-uct180-vs-uct105-1000its,810,700,2179.393423468,2108.823788884,110
carcassonne-uct365-vs-uct320-1000its,823,713,2186.26825023,2121.835109868,110
carcassonne-uct75-vs-uct340-1000its,826,716,2226.818142421,2166.772365966,110
carcassonne-boltzmann405-vs-boltzmann75-1000its,830,720,2209.068379839,2128.499596835,110
carcassonne-ucttuned260-vs-ucttuned140-1000its,830,720,2218.589966744,2166.35987233,110
carcassonne-uct180-vs-uct400-1000its,832,722,2236.59295095,2186.958589947,110
carcassonne-ucttuned185-vs-ucttuned150-1000its,837,727,2131.793806092,2118.884714489,110
carcassonne-ucttuned475-vs-ucttuned205-1000its,838,728,2190.205498874,2122.150268462,110
carcassonne-boltzmann335-vs-boltzmann105-1000its,840,730,2179.673601788,2166.447416477,110
carcassonne-uct215-vs-uct235-1000its,843,733,2227.092612738,2195.546367741,110
carcassonne-uct330-vs-uct185-1000its,843,733,2200.460555921,2142.344499422,110
carcassonne-boltzmann205-vs-boltzmann385-1000its,845,735,2214.79601033,2164.405535796,110
carcassonne-boltzmann105-vs-boltzmann230-1000its,848,738,2199.483767829,2160.758703202,110
carcassonne-uct35-vs-uct495-1000its,848,738,2104.607792401,2120.110818786,110
carcassonne-boltzmann315-vs-boltzmann140-1000its,850,740,2190.262020799,2133.237245343,110
carcassonne-boltzmann75-vs-boltzmann325-1000its,850,740,2197.321919819,2138.267905603,110
carcassonne-uct400-vs-uct440-1000its,851,741,2137.171206199,2111.875976522,110
carcassonne-boltzmann370-vs-boltzmann260-1000its,852,742,2206.048398477,2163.336491001,110
carcassonne-uct5-vs-uct265-1000its,853,743,2173.471211795,2114.995469458,110
carcassonne-boltzmann175-vs-boltzmann255-1000its,854,744,2190.460776467,2145.588531374,110
carcassonne-uct10-vs-uct165-1000its,858,748,2236.800419877,2163.05949493,110
carcassonne-uct95-vs-uct65-1000its,863,753,2239.744926915,2206.935826311,110
carcassonne-boltzmann25-vs-boltzmann30-1000its,865,755,2166.877738401,2134.715009594,110
carcassonne-ucttuned300-vs-ucttuned475-1000its,865,755,2175.413142038,2120.806668141,110
carcassonne-uct435-vs-uct140-1000its,870,760,2195.068063567,2136.688924026,110
carcassonne-ucttuned415-vs-ucttuned340-1000its,872,762,2167.57275061,2115.977725955,110
carcassonne-boltzmann450-vs-boltzmann370-1000its,873,763,2192.647905969,2140.667573672,110
carcassonne-uct320-vs-uct430-1000its,874,764,2159.871455369,2142.348953892,110
carcassonne-uct190-vs-uct425-1000its,880,770,2165.27275545,2146.46483347,110
carcassonne-uct405-vs-uct130-1000its,881,771,2227.474055105,2194.598264514,110
carcassonne-ucttuned5-vs-ucttuned245-1000its,881,771,2177.166726138,2139.142468512,110
carcassonne-ucttuned305-vs-ucttuned90-1000its,882,772,2155.497343076,2110.003672665,110
carcassonne-ucttuned315-vs-ucttuned100-1000its,882,772,2221.678755234,2179.89239874,110
carcassonne-uct425-vs-uct310-1000its,884,774,2198.463959078,2182.148549411,110
carcassonne-ucttuned490-vs-ucttuned390-1000its,884,774,2167.49196851,2156.397968906,110
carcassonne-ucttuned105-vs-ucttuned65-1000its,887,777,2201.005968018,2176.295045136,110
carcassonne-uct300-vs-uct305-1000its,889,779,2218.835284113,2173.017725554,110
carcassonne-boltzmann75-vs-boltzmann300-1000its,892,782,2241.385011466,2232.079153731,110
carcassonne-uct195-vs-uct305-1000its,898,788,2194.458823846,2146.881492871,110
carcassonne-ucttuned250-vs-ucttuned410-1000its,903,793,2217.544711986,2149.558179,110
carcassonne-boltzmann400-vs-boltzmann490-1000its,904,794,2131.262708025,2073.694363936,110
carcassonne-ucttuned55-vs-ucttuned90-1000its,906,796,2180.85037915,2130.3334244,110
carcassonne-ucttuned30-vs-ucttuned70-1000its,911,801,2148.864982204,2109.723239925,110
carcassonne-ucttuned280-vs-ucttuned410-1000its,916,806,2189.418483239,2141.880608074,110
carcassonne-boltzmann425-vs-boltzmann265-1000its,948,838,2203.906251221,2134.003693708,110
carcassonne-boltzmann490-vs-boltzmann55-1000its,968,858,2150.644971507,2105.406150575,110
carcassonne-uct365-vs-uct375-1000its,648,537,1803.106187984,1759.121939222,111
carcassonne-boltzmann105-vs-boltzmann400-1000its,781,670,2175.641508775,2124.349180968,111
carcassonne-boltzmann315-vs-boltzmann5-1000its,800,689,2189.959331664,2149.181944214,111
carcassonne-boltzmann150-vs-boltzmann375-1000its,802,691,2166.608607069,2128.11710749,111
carcassonne-ucttuned470-vs-ucttuned385-1000its,810,699,2188.604302218,2138.955798988,111
carcassonne-boltzmann205-vs-boltzmann130-1000its,812,701,2217.227369996,2197.234475066,111
carcassonne-uct320-vs-uct460-1000its,819,708,2145.420745148,2150.744647677,111
carcassonne-ucttuned265-vs-ucttuned260-1000its,820,709,2152.687785747,2136.867382753,111
carcassonne-ucttuned335-vs-ucttuned165-1000its,820,709,2209.655573515,2144.472280364,111
carcassonne-ucttuned265-vs-ucttuned490-1000its,825,714,2171.230108496,2111.313973344,111
carcassonne-boltzmann260-vs-boltzmann380-1000its,827,716,2210.946710012,2182.290754234,111
carcassonne-uct320-vs-uct80-1000its,827,716,2247.331658466,2176.325623263,111
carcassonne-ucttuned200-vs-ucttuned460-1000its,830,719,2123.789724293,2116.999800945,111
carcassonne-uct335-vs-uct485-1000its,831,720,2245.78820414,2176.779968752,111
carcassonne-ucttuned110-vs-ucttuned495-1000its,837,726,2261.728984463,2194.714220632,111
carcassonne-ucttuned240-vs-ucttuned360-1000its,837,726,2150.134830314,2116.990701153,111
carcassonne-boltzmann190-vs-boltzmann165-1000its,839,728,2225.843574858,2187.095729066,111
carcassonne-uct300-vs-uct35-1000its,839,728,2244.761175494,2211.431021007,111
carcassonne-ucttuned435-vs-ucttuned460-1000its,842,731,2198.106982787,2162.864376652,111
carcassonne-uct305-vs-uct415-1000its,843,732,2200.304643143,2131.105485735,111
carcassonne-ucttuned205-vs-ucttuned435-1000its,845,734,2179.654892513,2123.142560964,111
carcassonne-uct490-vs-uct405-1000its,847,736,2198.159052193,2215.586696327,111
carcassonne-boltzmann275-vs-boltzmann185-1000its,852,741,2214.142371921,2183.642794701,111
carcassonne-boltzmann400-vs-boltzmann140-1000its,853,742,2172.672445021,2166.614004231,111
carcassonne-uct75-vs-uct265-1000its,853,742,2173.280338618,2141.640166271,111
carcassonne-uct85-vs-uct285-1000its,853,742,2214.238730083,2173.301605519,111
carcassonne-uct365-vs-uct490-1000its,854,743,2172.432492979,2165.575592072,111
carcassonne-boltzmann335-vs-boltzmann495-1000its,855,744,2183.684282646,2100.970893433,111
carcassonne-uct65-vs-uct95-1000its,855,744,2218.471189051,2207.180024015,111
carcassonne-boltzmann20-vs-boltzmann260-1000its,857,746,2231.016138527,2221.167515734,111
carcassonne-boltzmann25-vs-boltzmann50-1000its,857,746,2240.771336278,2194.452241591,111
carcassonne-boltzmann235-vs-boltzmann250-1000its,858,747,2234.898992197,2238.038377948,111
carcassonne-ucttuned450-vs-ucttuned185-1000its,860,749,2221.565519812,2139.524767274,111
carcassonne-boltzmann110-vs-boltzmann200-1000its,863,752,2166.019272384,2180.093847106,111
carcassonne-boltzmann350-vs-boltzmann70-1000its,863,752,2212.2156029,2134.557342063,111
carcassonne-uct240-vs-uct55-1000its,863,752,2124.925608043,2094.730613245,111
carcassonne-uct5-vs-uct305-1000its,863,752,2211.529546011,2180.045622566,111
carcassonne-boltzmann110-vs-boltzmann40-1000its,865,754,2167.406090436,2106.893594953,111
carcassonne-boltzmann380-vs-boltzmann170-1000its,865,754,2232.871580245,2167.615598989,111
carcassonne-ucttuned355-vs-ucttuned65-1000its,865,754,2153.015938937,2051.687184297,111
carcassonne-ucttuned475-vs-ucttuned290-1000its,865,754,2242.496130699,2161.397356234,111
carcassonne-boltzmann415-vs-boltzmann235-1000its,866,755,2226.037041126,2231.715230436,111
carcassonne-boltzmann85-vs-boltzmann225-1000its,867,756,2231.607018719,2171.818310076,111
carcassonne-uct430-vs-uct350-1000its,869,758,2226.893046376,2199.91555926,111
carcassonne-ucttuned445-vs-ucttuned415-1000its,870,759,2180.201350371,2157.388754829,111
carcassonne-uct10-vs-uct400-1000its,874,763,2182.665200304,2134.222030424,111
carcassonne-ucttuned25-vs-ucttuned440-1000its,874,763,2199.845192927,2191.753848523,111
carcassonne-uct25-vs-uct385-1000its,876,765,2255.709818992,2178.160765889,111
carcassonne-boltzmann495-vs-boltzmann20-1000its,877,766,2315.268681281,2296.016626619,111
carcassonne-uct465-vs-uct260-1000its,878,767,2213.710681332,2161.906718519,111
carcassonne-uct165-vs-uct260-1000its,880,769,2214.421521325,2181.787656858,111
carcassonne-ucttuned245-vs-ucttuned330-1000its,885,774,2283.884762199,2187.573262332,111
carcassonne-ucttuned335-vs-ucttuned480-1000its,885,774,2219.508079085,2211.517734406,111
carcassonne-uct490-vs-uct380-1000its,887,776,2198.16803536,2169.110746796,111
carcassonne-uct485-vs-uct145-1000its,888,777,2146.490932269,2086.355108256,111
carcassonne-ucttuned200-vs-ucttuned55-1000its,891,780,2188.390257394,2134.375658265,111
carcassonne-ucttuned205-vs-ucttuned285-1000its,898,787,2198.727621098,2170.923204322,111
carcassonne-ucttuned220-vs-ucttuned295-1000its,901,790,2259.363016033,2195.528709912,111
carcassonne-boltzmann130-vs-boltzmann485-1000its,903,792,2264.814372909,2192.764708862,111
carcassonne-boltzmann70-vs-boltzmann170-1000its,903,792,2203.766093479,2160.743475834,111
carcassonne-boltzmann420-vs-boltzmann60-1000its,905,794,2181.03182589,2157.197089457,111
carcassonne-ucttuned430-vs-ucttuned20-1000its,911,800,2190.103602368,2163.08275107,111
carcassonne-uct270-vs-uct475-1000its,912,801,2191.640625068,2112.437462413,111
carcassonne-boltzmann205-vs-boltzmann190-1000its,917,806,2303.909688329,2199.329382828,111
carcassonne-uct155-vs-uct345-1000its,921,810,2187.594580828,2142.944109898,111
carcassonne-uct35-vs-uct210-1000its,922,811,2220.633738333,2194.349149604,111
carcassonne-uct395-vs-uct420-1000its,926,815,2147.072844673,2153.814395428,111
carcassonne-boltzmann5-vs-boltzmann305-1000its,930,819,2137.780256147,2063.939423964,111
carcassonne-ucttuned295-vs-ucttuned230-1000its,940,829,2264.36640729,2207.407033569,111
carcassonne-uct115-vs-uct405-1000its,961,850,2204.176236615,2137.055820708,111
carcassonne-uct490-vs-uct95-1000its,962,851,2239.85572103,2174.362458456,111
carcassonne-boltzmann180-vs-boltzmann435-1000its,984,873,2275.414592178,2247.201919516,111
carcassonne-ucttuned60-vs-ucttuned75-1000its,996,885,2226.930070555,2156.362740739,111
carcassonne-uct300-vs-uct75-1000its,776,664,2168.460176502,2126.628883281,112
carcassonne-boltzmann350-vs-boltzmann445-1000its,794,682,2183.038122556,2147.738435537,112
carcassonne-ucttuned75-vs-ucttuned175-1000its,796,684,2112.730544572,2094.234074765,112
carcassonne-uct205-vs-uct200-1000its,801,689,2181.376080007,2078.607168201,112
carcassonne-boltzmann310-vs-boltzmann395-1000its,808,696,2206.723480727,2156.457833907,112
carcassonne-ucttuned170-vs-ucttuned290-1000its,809,697,2223.87183478,2183.80482103,112
carcassonne-boltzmann465-vs-boltzmann355-1000its,817,705,2151.102047886,2122.117710696,112
carcassonne-uct95-vs-uct355-1000its,817,705,2145.648182277,2083.714457464,112
carcassonne-uct95-vs-uct245-1000its,819,707,2223.811856858,2172.061367981,112
carcassonne-ucttuned175-vs-ucttuned300-1000its,824,712,2238.867823355,2161.945656307,112
carcassonne-boltzmann90-vs-boltzmann315-1000its,826,714,2157.206743957,2135.410280147,112
carcassonne-boltzmann30-vs-boltzmann115-1000its,830,718,2174.285550116,2121.03952541,112
carcassonne-ucttuned165-vs-ucttuned495-1000its,837,725,2181.079923668,2085.602059485,112
carcassonne-uct420-vs-uct265-1000its,848,736,2106.837334312,2117.976565117,112
carcassonne-uct475-vs-uct415-1000its,849,737,2226.982939169,2160.96411842,112
carcassonne-uct25-vs-uct130-1000its,855,743,2152.727165697,2077.202472736,112
carcassonne-uct445-vs-uct150-1000its,860,748,2178.268352504,2163.932152325,112
carcassonne-uct15-vs-uct315-1000its,869,757,2175.402583232,2143.371391857,112
carcassonne-ucttuned60-vs-ucttuned235-1000its,870,758,2210.428972716,2163.760351195,112
carcassonne-boltzmann80-vs-boltzmann25-1000its,874,762,2137.479455508,2108.290085833,112
carcassonne-ucttuned20-vs-ucttuned85-1000its,875,763,2193.194411852,2117.007233549,112
carcassonne-uct160-vs-uct475-1000its,876,764,2149.851738565,2157.179647233,112
carcassonne-boltzmann425-vs-boltzmann435-1000its,877,765,2213.526315936,2147.500951198,112
carcassonne-ucttuned5-vs-ucttuned180-1000its,880,768,2180.511342816,2116.378414712,112
carcassonne-boltzmann205-vs-boltzmann215-1000its,881,769,2171.35119803,2153.70755809,112
carcassonne-uct175-vs-uct55-1000its,881,769,2317.874266479,2224.260923681,112
carcassonne-uct380-vs-uct170-1000its,883,771,2266.740572146,2217.040860728,112
carcassonne-boltzmann205-vs-boltzmann315-1000its,885,773,2203.696082316,2152.354626691,112
carcassonne-uct330-vs-uct175-1000its,890,778,2212.530290117,2155.400819973,112
carcassonne-ucttuned300-vs-ucttuned165-1000its,890,778,2212.747877165,2148.780106427,112
carcassonne-ucttuned105-vs-ucttuned265-1000its,891,779,2163.81578137,2088.47414902,112
carcassonne-uct385-vs-uct70-1000its,893,781,2119.694373381,2058.419425554,112
carcassonne-boltzmann445-vs-boltzmann425-1000its,895,783,2180.34785121,2139.004123788,112
carcassonne-uct215-vs-uct140-1000its,896,784,2242.164262716,2153.129607838,112
carcassonne-uct435-vs-uct205-1000its,903,791,2202.877297325,2130.300378188,112
carcassonne-uct435-vs-uct480-1000its,904,792,2183.185808362,2133.329679809,112
carcassonne-uct330-vs-uct465-1000its,910,798,2205.966931037,2129.214353331,112
carcassonne-uct95-vs-uct495-1000its,910,798,2162.349598086,2126.295569375,112
carcassonne-boltzmann120-vs-boltzmann355-1000its,918,806,2208.486955819,2173.810271866,112
carcassonne-ucttuned105-vs-ucttuned450-1000its,921,809,2196.188257244,2190.800505042,112
carcassonne-uct185-vs-uct205-1000its,927,815,2223.848688791,2171.80714244,112
carcassonne-uct10-vs-uct205-1000its,949,837,2208.743343289,2166.674346057,112
carcassonne-boltzmann190-vs-boltzmann360-1000its,963,851,2159.25951142,2144.688237458,112
carcassonne-uct305-vs-uct140-1000its,1027,915,2127.550485032,2074.622450122,112
carcassonne-boltzmann205-vs-boltzmann320-1000its,769,656,2249.767733359,2191.808943066,113
carcassonne-boltzmann205-vs-boltzmann375-1000its,772,659,2223.759168666,2176.288234974,113
carcassonne-ucttuned215-vs-ucttuned260-1000its,775,662,2187.389568466,2138.209183322,113
carcassonne-uct420-vs-uct270-1000its,789,676,2159.121393942,2166.194467323,113
carcassonne-boltzmann350-vs-boltzmann310-1000its,803,690,2180.167215903,2153.932857228,113
carcassonne-boltzmann185-vs-boltzmann235-1000its,821,708,2196.61849976,2154.89077945,113
carcassonne-uct485-vs-uct80-1000its,821,708,2156.152711872,2065.037433223,113
carcassonne-uct265-vs-uct350-1000its,822,709,2187.323768259,2178.419467373,113
carcassonne-boltzmann285-vs-boltzmann440-1000its,823,710,2212.940762767,2165.307981186,113
carcassonne-uct495-vs-uct390-1000its,825,712,2163.263656391,2077.856640244,113
carcassonne-ucttuned400-vs-ucttuned405-1000its,829,716,2284.988391958,2253.521298788,113
carcassonne-boltzmann135-vs-boltzmann445-1000its,830,717,2231.628776773,2187.236514055,113
carcassonne-uct35-vs-uct185-1000its,830,717,2288.410709026,2242.707661061,113
carcassonne-uct325-vs-uct145-1000its,836,723,2140.559655167,2075.717673449,113
carcassonne-uct310-vs-uct290-1000its,838,725,2199.663389404,2129.522361862,113
carcassonne-uct155-vs-uct280-1000its,840,727,2159.250417036,2124.616694281,113
carcassonne-boltzmann420-vs-boltzmann165-1000its,847,734,2223.925671662,2165.934266026,113
carcassonne-ucttuned100-vs-ucttuned85-1000its,850,737,2220.111278439,2174.468985594,113
carcassonne-uct90-vs-uct275-1000its,852,739,2275.255181711,2224.394264051,113
carcassonne-boltzmann415-vs-boltzmann170-1000its,853,740,2195.075093608,2180.824524208,113
carcassonne-boltzmann305-vs-boltzmann315-1000its,856,743,2275.955465232,2202.780642178,113
carcassonne-ucttuned230-vs-ucttuned430-1000its,856,743,2168.027674642,2176.551048023,113
carcassonne-boltzmann320-vs-boltzmann90-1000its,857,744,2145.045903614,2146.487606726,113
carcassonne-ucttuned65-vs-ucttuned40-1000its,857,744,2155.598340431,2139.72547809,113
carcassonne-uct405-vs-uct430-1000its,858,745,2219.264864678,2166.895733053,113
carcassonne-ucttuned340-vs-ucttuned345-1000its,858,745,2193.544895717,2119.752800974,113
carcassonne-ucttuned485-vs-ucttuned385-1000its,862,749,2212.980393124,2179.639122878,113
carcassonne-uct30-vs-uct490-1000its,865,752,2204.065528147,2155.510488769,113
carcassonne-ucttuned35-vs-ucttuned315-1000its,869,756,2221.416780374,2162.649451696,113
carcassonne-uct315-vs-uct260-1000its,871,758,2218.399853125,2178.381884169,113
carcassonne-uct120-vs-uct290-1000its,872,759,2194.11219371,2125.05197332,113
carcassonne-ucttuned250-vs-ucttuned95-1000its,874,761,2235.967717323,2215.40525068,113
carcassonne-ucttuned360-vs-ucttuned485-1000its,874,761,2209.649297695,2186.756525127,113
carcassonne-boltzmann495-vs-boltzmann210-1000its,876,763,2180.926907309,2106.419028559,113
carcassonne-boltzmann250-vs-boltzmann25-1000its,878,765,2181.805798918,2116.4862341,113
carcassonne-ucttuned430-vs-ucttuned145-1000its,879,766,2201.757395768,2117.680607128,113
carcassonne-boltzmann225-vs-boltzmann235-1000its,881,768,2228.715521668,2159.255640383,113
carcassonne-boltzmann70-vs-boltzmann380-1000its,888,775,2213.761760966,2161.819207042,113
carcassonne-ucttuned30-vs-ucttuned40-1000its,890,777,2193.032635463,2143.128841777,113
carcassonne-ucttuned185-vs-ucttuned425-1000its,891,778,2185.087352136,2116.285541638,113
carcassonne-uct375-vs-uct25-1000its,895,782,2182.284035813,2174.253255354,113
carcassonne-ucttuned20-vs-ucttuned295-1000its,895,782,2203.993021723,2142.208684378,113
carcassonne-ucttuned275-vs-ucttuned325-1000its,899,786,2168.226376596,2120.644926218,113
carcassonne-ucttuned15-vs-ucttuned395-1000its,902,789,2200.362922827,2169.826886876,113
carcassonne-uct440-vs-uct280-1000its,911,798,2295.365719532,2249.070945491,113
carcassonne-uct255-vs-uct210-1000its,913,800,2140.036810529,2092.230220537,113
carcassonne-ucttuned15-vs-ucttuned95-1000its,922,809,2197.927156719,2133.250713141,113
carcassonne-uct285-vs-uct130-1000its,923,810,2238.472982479,2198.063280879,113
carcassonne-boltzmann195-vs-boltzmann275-1000its,940,827,2265.371735884,2212.22623552,113
carcassonne-uct390-vs-uct45-1000its,942,829,2153.916812435,2162.424473507,113
carcassonne-uct200-vs-uct455-1000its,803,689,2167.424605185,2127.004993648,114
carcassonne-uct455-vs-uct300-1000its,816,702,2179.4011413,2152.259654874,114
carcassonne-ucttuned275-vs-ucttuned320-1000its,823,709,2150.83042057,2102.247214823,114
carcassonne-boltzmann235-vs-boltzmann360-1000its,827,713,2177.09372975,2142.604396678,114
carcassonne-uct405-vs-uct420-1000its,829,715,2202.643218273,2141.147777134,114
carcassonne-ucttuned170-vs-ucttuned420-1000its,829,715,2182.93433913,2138.100210325,114
carcassonne-uct405-vs-uct185-1000its,831,717,2191.828740536,2108.232445807,114
carcassonne-boltzmann440-vs-boltzmann470-1000its,832,718,2148.714908135,2124.607580492,114
carcassonne-boltzmann460-vs-boltzmann145-1000its,832,718,2202.933376271,2175.909436045,114
carcassonne-uct30-vs-uct135-1000its,833,719,2188.661524837,2116.17842129,114
carcassonne-uct235-vs-uct200-1000its,834,720,2221.082744226,2129.34967128,114
carcassonne-boltzmann310-vs-boltzmann110-1000its,840,726,2209.020285757,2121.58821944,114
carcassonne-ucttuned185-vs-ucttuned110-1000its,841,727,2158.604205792,2120.468311413,114
carcassonne-boltzmann45-vs-boltzmann235-1000its,844,730,2159.458582343,2100.454815421,114
carcassonne-boltzmann245-vs-boltzmann415-1000its,847,733,2129.060260112,2130.694392943,114
carcassonne-uct450-vs-uct60-1000its,850,736,2178.922234996,2126.653388875,114
carcassonne-uct295-vs-uct135-1000its,852,738,2175.439699073,2126.858937722,114
carcassonne-uct375-vs-uct480-1000its,853,739,2203.411799647,2156.685242399,114
carcassonne-ucttuned75-vs-ucttuned310-1000its,856,742,2299.765779153,2231.042448508,114
carcassonne-ucttuned175-vs-ucttuned440-1000its,860,746,2141.783645613,2073.182268833,114
carcassonne-boltzmann30-vs-boltzmann245-1000its,864,750,2218.100137534,2162.160787669,114
carcassonne-ucttuned290-vs-ucttuned450-1000its,865,751,2194.240045972,2180.187519815,114
carcassonne-ucttuned50-vs-ucttuned190-1000its,868,754,2247.808600152,2248.297743145,114
carcassonne-boltzmann190-vs-boltzmann305-1000its,872,758,2282.872019786,2212.880133504,114
carcassonne-uct70-vs-uct20-1000its,872,758,2147.949103762,2123.576992706,114
carcassonne-boltzmann205-vs-boltzmann350-1000its,875,761,2125.773113654,2077.225752691,114
carcassonne-ucttuned350-vs-ucttuned375-1000its,876,762,2134.326286879,2101.880426604,114
carcassonne-uct335-vs-uct75-1000its,878,764,2174.345740012,2140.636105204,114
carcassonne-ucttuned495-vs-ucttuned25-1000its,879,765,2186.689303888,2095.919557364,114
carcassonne-ucttuned100-vs-ucttuned415-1000its,880,766,2242.09500142,2207.653697094,114
carcassonne-uct335-vs-uct5-1000its,882,768,2143.039040309,2130.887074869,114
carcassonne-boltzmann265-vs-boltzmann430-1000its,883,769,2171.645527328,2151.462703169,114
carcassonne-uct235-vs-uct35-1000its,887,773,2161.39059384,2110.3719337,114
carcassonne-uct225-vs-uct480-1000its,898,784,2234.079737099,2183.133253674,114
carcassonne-uct320-vs-uct115-1000its,903,789,2184.039016266,2181.184362063,114
carcassonne-ucttuned350-vs-ucttuned70-1000its,906,792,2204.504183581,2157.08830514,114
carcassonne-uct5-vs-uct315-1000its,907,793,2165.540790535,2116.888782923,114
carcassonne-ucttuned335-vs-ucttuned60-1000its,913,799,2185.941924751,2128.77815142,114
carcassonne-ucttuned5-vs-ucttuned40-1000its,913,799,2191.267518357,2164.739975101,114
carcassonne-ucttuned75-vs-ucttuned80-1000its,914,800,2155.662242394,2109.657492666,114
carcassonne-uct235-vs-uct400-1000its,915,801,2268.83875463,2233.342142954,114
carcassonne-ucttuned250-vs-ucttuned380-1000its,916,802,2221.668714823,2174.716879718,114
carcassonne-uct70-vs-uct75-1000its,918,804,2168.14495278,2153.174100342,114
carcassonne-boltzmann245-vs-boltzmann360-1000its,927,813,2233.140628741,2145.932604855,114
carcassonne-ucttuned120-vs-ucttuned230-1000its,929,815,2306.122762462,2222.753789926,114
carcassonne-uct345-vs-uct230-1000its,930,816,2162.29357815,2091.542751759,114
carcassonne-ucttuned210-vs-ucttuned130-1000its,938,824,2182.664678173,2120.325377401,114
carcassonne-ucttuned440-vs-ucttuned190-1000its,977,863,2239.016214129,2180.119415627,114
carcassonne-ucttuned15-vs-ucttuned40-1000its,999,885,2190.527688591,2169.417109192,114
carcassonne-boltzmann405-vs-boltzmann380-1000its,775,660,2152.921378435,2105.994906276,115
carcassonne-boltzmann265-vs-boltzmann120-1000its,776,661,2122.113065561,2119.20052115,115
carcassonne-boltzmann350-vs-boltzmann375-1000its,794,679,2169.48946495,2159.105190809,115
carcassonne-ucttuned275-vs-ucttuned405-1000its,799,684,2219.51718623,2174.921567692,115
carcassonne-uct475-vs-uct470-1000its,804,689,2236.123160287,2193.229006814,115
carcassonne-ucttuned100-vs-ucttuned370-1000its,810,695,2189.802093803,2140.972792519,115
carcassonne-boltzmann175-vs-boltzmann415-1000its,819,704,2213.623028147,2162.394847411,115
carcassonne-ucttuned255-vs-ucttuned405-1000its,824,709,2155.109236322,2108.736075203,115
carcassonne-uct175-vs-uct350-1000its,827,712,2219.244666972,2152.290448394,115
carcassonne-ucttuned340-vs-ucttuned235-1000its,829,714,2184.805791798,2173.873235195,115
carcassonne-boltzmann445-vs-boltzmann85-1000its,831,716,2272.59429615,2198.343137898,115
carcassonne-ucttuned200-vs-ucttuned445-1000its,831,716,2217.530948184,2183.979703507,115
carcassonne-boltzmann320-vs-boltzmann185-1000its,834,719,2219.02781185,2226.592078425,115
carcassonne-boltzmann15-vs-boltzmann130-1000its,835,720,2216.944236783,2184.482139541,115
carcassonne-uct270-vs-uct75-1000its,835,720,2203.758964911,2142.852894677,115
carcassonne-uct265-vs-uct140-1000its,836,721,2177.972934838,2135.313058181,115
carcassonne-boltzmann405-vs-boltzmann485-1000its,847,732,2189.359094522,2128.231850742,115
carcassonne-ucttuned255-vs-ucttuned210-1000its,847,732,2257.343554538,2213.502896254,115
carcassonne-boltzmann475-vs-boltzmann320-1000its,848,733,2199.778702449,2199.864350584,115
carcassonne-boltzmann95-vs-boltzmann235-1000its,849,734,2270.181559663,2243.481252802,115
carcassonne-uct420-vs-uct185-1000its,851,736,2198.329146006,2150.726158171,115
carcassonne-uct290-vs-uct270-1000its,853,738,2305.647195953,2279.296305419,115
carcassonne-uct290-vs-uct50-1000its,855,740,2227.5516407,2209.901766168,115
carcassonne-boltzmann425-vs-boltzmann365-1000its,856,741,2168.335219317,2120.359789977,115
carcassonne-uct225-vs-uct460-1000its,856,741,2298.644916248,2212.135802778,115
carcassonne-ucttuned100-vs-ucttuned300-1000its,857,742,2162.64425035,2096.805505152,115
carcassonne-ucttuned285-vs-ucttuned115-1000its,860,745,2220.241050555,2151.137030057,115
carcassonne-ucttuned5-vs-ucttuned490-1000its,861,746,2235.034344739,2202.425934756,115
carcassonne-uct110-vs-uct310-1000its,864,749,2201.789901409,2126.940997565,115
carcassonne-ucttuned105-vs-ucttuned100-1000its,864,749,2256.789774536,2229.125888905,115
carcassonne-uct145-vs-uct210-1000its,865,750,2173.830537472,2101.61565962,115
carcassonne-uct215-vs-uct55-1000its,869,754,2258.167595289,2196.817249602,115
carcassonne-boltzmann440-vs-boltzmann45-1000its,870,755,2257.594593048,2208.613254874,115
carcassonne-ucttuned175-vs-ucttuned445-1000its,870,755,2169.27047938,2125.672459189,115
carcassonne-uct375-vs-uct265-1000its,871,756,2170.159658311,2130.79365899,115
carcassonne-ucttuned110-vs-ucttuned70-1000its,878,763,2194.802349743,2171.073246854,115
carcassonne-boltzmann80-vs-boltzmann245-1000its,879,764,2269.795562758,2199.624828173,115
carcassonne-boltzmann460-vs-boltzmann60-1000its,883,768,2142.036634008,2081.797469199,115
carcassonne-uct260-vs-uct255-1000its,883,768,2231.634978151,2203.449552133,115
carcassonne-ucttuned370-vs-ucttuned70-1000its,887,772,2241.698691128,2198.815905327,115
carcassonne-ucttuned425-vs-ucttuned385-1000its,887,772,2108.52060383,2050.90592062,115
carcassonne-uct175-vs-uct90-1000its,889,774,2213.697139096,2178.483779212,115
carcassonne-ucttuned190-vs-ucttuned110-1000its,889,774,2266.476913482,2221.691677475,115
carcassonne-uct125-vs-uct340-1000its,895,780,2181.784686802,2111.46170609,115
carcassonne-uct430-vs-uct35-1000its,899,784,2274.005326754,2200.56169498,115
carcassonne-boltzmann415-vs-boltzmann230-1000its,900,785,2147.568880859,2135.973254769,115
carcassonne-uct250-vs-uct200-1000its,900,785,2236.7364945,2132.616332365,115
carcassonne-uct295-vs-uct240-1000its,906,791,2255.131351534,2209.620997878,115
carcassonne-ucttuned435-vs-ucttuned445-1000its,907,792,2203.919181672,2127.436525419,115
carcassonne-uct295-vs-uct470-1000its,914,799,2142.70711892,2117.100993034,115
carcassonne-boltzmann225-vs-boltzmann230-1000its,917,802,2154.849110756,2115.099967969,115
carcassonne-ucttuned325-vs-ucttuned100-1000its,926,811,2284.770114816,2249.319953029,115
carcassonne-ucttuned280-vs-ucttuned310-1000its,937,822,2224.876143026,2178.736135148,115
carcassonne-ucttuned220-vs-ucttuned340-1000its,938,823,2162.979532576,2080.737817223,115
carcassonne-uct45-vs-uct370-1000its,945,830,2146.84712028,2087.634178463,115
carcassonne-boltzmann460-vs-boltzmann265-1000its,946,831,2170.599655595,2123.691158276,115
carcassonne-boltzmann55-vs-boltzmann250-1000its,767,651,2217.370941293,2159.585276738,116
carcassonne-ucttuned225-vs-ucttuned495-1000its,798,682,2173.177952412,2140.463854621,116
carcassonne-ucttuned460-vs-ucttuned290-1000its,809,693,2170.658905675,2154.676624727,116
carcassonne-boltzmann255-vs-boltzmann380-1000its,817,701,2161.656982599,2128.743557949,116
carcassonne-boltzmann445-vs-boltzmann330-1000its,818,702,2184.660543779,2129.541988952,116
carcassonne-uct215-vs-uct445-1000its,823,707,2209.656802264,2130.218161078,116
carcassonne-uct345-vs-uct210-1000its,826,710,2228.285761203,2155.474363628,116
carcassonne-ucttuned170-vs-ucttuned325-1000its,830,714,2112.001907292,2062.145829863,116
carcassonne-boltzmann435-vs-boltzmann80-1000its,834,718,2185.010823069,2143.898803606,116
carcassonne-uct100-vs-uct175-1000its,836,720,2183.232741626,2138.322794115,116
carcassonne-boltzmann35-vs-boltzmann315-1000its,838,722,2214.168962134,2198.689246172,116
carcassonne-boltzmann415-vs-boltzmann445-1000its,840,724,2260.549012257,2203.258420796,116
carcassonne-uct495-vs-uct285-1000its,842,726,2224.061937984,2169.710531799,116
carcassonne-ucttuned460-vs-ucttuned145-1000its,843,727,2163.067249043,2118.52262343,116
carcassonne-ucttuned95-vs-ucttuned195-1000its,851,735,2114.780950436,2092.294508607,116
carcassonne-uct420-vs-uct255-1000its,864,748,2178.44926016,2122.935153794,116
carcassonne-uct490-vs-uct145-1000its,865,749,2135.68793247,2142.300594613,116
carcassonne-boltzmann170-vs-boltzmann205-1000its,867,751,2176.238150877,2128.830021436,116
carcassonne-boltzmann190-vs-boltzmann355-1000its,868,752,2260.685702912,2183.541203315,116
carcassonne-ucttuned30-vs-ucttuned155-1000its,869,753,2210.630871529,2142.723264319,116
carcassonne-boltzmann475-vs-boltzmann250-1000its,870,754,2232.473074211,2153.674368839,116
carcassonne-ucttuned460-vs-ucttuned270-1000its,871,755,2204.115659065,2142.118051187,116
carcassonne-ucttuned335-vs-ucttuned30-1000its,873,757,2178.0551428,2145.57099731,116
carcassonne-boltzmann20-vs-boltzmann120-1000its,874,758,2210.141483165,2131.498349865,116
carcassonne-uct480-vs-uct175-1000its,874,758,2176.040444946,2161.551967122,116
carcassonne-ucttuned295-vs-ucttuned450-1000its,877,761,2168.471018587,2116.002475319,116
carcassonne-uct270-vs-uct295-1000its,878,762,2205.795183832,2144.240139731,116
carcassonne-boltzmann355-vs-boltzmann450-1000its,879,763,2198.610748832,2183.476149996,116
carcassonne-uct410-vs-uct260-1000its,880,764,2227.723981015,2199.266640044,116
carcassonne-boltzmann390-vs-boltzmann350-1000its,883,767,2201.188763034,2166.923851812,116
carcassonne-ucttuned35-vs-ucttuned170-1000its,889,773,2192.245557816,2142.153842784,116
carcassonne-ucttuned15-vs-ucttuned470-1000its,893,777,2273.380287985,2175.790817751,116
carcassonne-ucttuned310-vs-ucttuned435-1000its,898,782,2190.434826085,2182.372916826,116
carcassonne-ucttuned485-vs-ucttuned235-1000its,906,790,2241.626181693,2173.098689147,116
carcassonne-boltzmann330-vs-boltzmann320-1000its,917,801,2179.737171392,2146.082932703,116
carcassonne-boltzmann485-vs-boltzmann75-1000its,921,805,2214.401236367,2173.756142442,116
carcassonne-ucttuned325-vs-ucttuned215-1000its,928,812,2137.62317695,2081.850398555,116
carcassonne-uct245-vs-uct435-1000its,934,818,2214.338620317,2162.853491475,116
carcassonne-ucttuned15-vs-ucttuned200-1000its,951,835,2295.215316746,2215.93831865,116
carcassonne-boltzmann100-vs-boltzmann310-1000its,963,847,2215.407562615,2202.519507372,116
carcassonne-ucttuned100-vs-ucttuned450-1000its,967,851,2196.217828967,2117.365391788,116
carcassonne-boltzmann220-vs-boltzmann45-1000its,985,869,2214.601482017,2169.981596722,116
carcassonne-ucttuned380-vs-ucttuned130-1000its,990,874,2175.821088811,2131.881112189,116
carcassonne-ucttuned465-vs-ucttuned425-1000its,798,681,2198.521535146,2153.707785246,117
carcassonne-ucttuned145-vs-ucttuned165-1000its,810,693,2206.798736196,2155.126906073,117
carcassonne-uct115-vs-uct395-1000its,812,695,2190.188618438,2142.92244997,117
carcassonne-boltzmann280-vs-boltzmann290-1000its,814,697,2222.521237616,2121.798051764,117
carcassonne-boltzmann30-vs-boltzmann240-1000its,814,697,2185.507479428,2147.933521418,117
carcassonne-boltzmann190-vs-boltzmann40-1000its,833,716,2209.16247639,2178.343711416,117
carcassonne-uct290-vs-uct435-1000its,833,716,2195.426032826,2153.453550651,117
carcassonne-boltzmann240-vs-boltzmann215-1000its,836,719,2179.08821104,2133.683999531,117
carcassonne-boltzmann375-vs-boltzmann470-1000its,838,721,2175.489979591,2172.349646866,117
carcassonne-boltzmann135-vs-boltzmann55-1000its,839,722,2165.620660076,2125.329927115,117
carcassonne-uct480-vs-uct450-1000its,839,722,2249.121095287,2198.173691178,117
carcassonne-uct85-vs-uct195-1000its,839,722,2260.697844198,2233.237610645,117
carcassonne-uct15-vs-uct165-1000its,840,723,2217.695256771,2128.666603501,117
carcassonne-uct290-vs-uct360-1000its,840,723,2177.072232911,2160.109015741,117
carcassonne-ucttuned170-vs-ucttuned35-1000its,840,723,2210.568172448,2201.084126423,117
carcassonne-boltzmann395-vs-boltzmann105-1000its,841,724,2168.234933501,2156.690326813,117
carcassonne-uct385-vs-uct340-1000its,844,727,2210.647402825,2154.017586591,117
carcassonne-ucttuned320-vs-ucttuned110-1000its,844,727,2184.875149171,2161.045644204,117
carcassonne-ucttuned70-vs-ucttuned460-1000its,844,727,2159.689242448,2110.369984861,117
carcassonne-ucttuned210-vs-ucttuned205-1000its,845,728,2236.684085907,2119.632498845,117
carcassonne-boltzmann260-vs-boltzmann95-1000its,848,731,2212.567246254,2172.277212607,117
carcassonne-uct110-vs-uct200-1000its,851,734,2239.554962978,2197.580710863,117
carcassonne-boltzmann135-vs-boltzmann320-1000its,852,735,2164.792455717,2143.583535905,117
carcassonne-boltzmann5-vs-boltzmann320-1000its,859,742,2300.547435163,2212.393480267,117
carcassonne-uct440-vs-uct80-1000its,866,749,2176.492870497,2117.304765342,117
carcassonne-boltzmann125-vs-boltzmann345-1000its,868,751,2172.321268392,2081.597163454,117
carcassonne-ucttuned20-vs-ucttuned415-1000its,868,751,2184.140683145,2132.072165638,117
carcassonne-uct130-vs-uct85-1000its,869,752,2161.164242157,2135.022187763,117
carcassonne-uct310-vs-uct435-1000its,869,752,2176.005545358,2152.684714788,117
carcassonne-uct405-vs-uct285-1000its,871,754,2211.409020824,2147.467823165,117
carcassonne-ucttuned480-vs-ucttuned80-1000its,873,756,2170.471493393,2108.597416627,117
carcassonne-boltzmann480-vs-boltzmann210-1000its,883,766,2280.164648033,2272.343117663,117
carcassonne-uct280-vs-uct390-1000its,886,769,2223.800407516,2175.514680058,117
carcassonne-uct360-vs-uct410-1000its,887,770,2193.334160481,2135.013708407,117
carcassonne-uct325-vs-uct375-1000its,888,771,2177.629771805,2160.136204233,117
carcassonne-ucttuned60-vs-ucttuned45-1000its,890,773,2128.443851444,2121.993559613,117
carcassonne-uct395-vs-uct360-1000its,895,778,2190.516940927,2125.099963743,117
carcassonne-ucttuned110-vs-ucttuned180-1000its,895,778,2145.141782544,2086.861720656,117
carcassonne-boltzmann475-vs-boltzmann95-1000its,900,783,2157.309632463,2139.419205645,117
carcassonne-ucttuned15-vs-ucttuned75-1000its,901,784,2159.662432646,2092.628379556,117
carcassonne-ucttuned480-vs-ucttuned315-1000its,924,807,2156.246730445,2099.390684119,117
carcassonne-uct315-vs-uct290-1000its,932,815,2182.112642568,2152.947181334,117
carcassonne-boltzmann390-vs-boltzmann240-1000its,935,818,2282.415029661,2253.833477795,117
carcassonne-boltzmann320-vs-boltzmann110-1000its,951,834,2213.64676413,2173.928300174,117
carcassonne-ucttuned15-vs-ucttuned55-1000its,956,839,2197.358169168,2176.049760932,117
carcassonne-uct310-vs-uct20-1000its,960,843,2122.51368743,2094.075937225,117
carcassonne-ucttuned20-vs-ucttuned365-1000its,974,857,2179.247503724,2126.295194231,117
carcassonne-ucttuned190-vs-ucttuned65-1000its,979,862,2262.387982401,2192.342052934,117
carcassonne-boltzmann260-vs-boltzmann355-1000its,760,642,2190.231488313,2152.177573229,118
carcassonne-uct200-vs-uct30-1000its,800,682,2117.338524866,2078.888167107,118
carcassonne-boltzmann435-vs-boltzmann25-1000its,802,684,2141.352427739,2112.619509451,118
carcassonne-boltzmann275-vs-boltzmann130-1000its,804,686,2238.487346741,2193.08166275,118
carcassonne-uct470-vs-uct465-1000its,806,688,2158.598762618,2088.250088358,118
carcassonne-boltzmann380-vs-boltzmann310-1000its,809,691,2143.621965601,2084.468724145,118
carcassonne-boltzmann20-vs-boltzmann455-1000its,812,694,2149.341579893,2121.760124751,118
carcassonne-ucttuned100-vs-ucttuned440-1000its,816,698,2257.363664412,2188.980744484,118
carcassonne-ucttuned390-vs-ucttuned405-1000its,818,700,2181.77327982,2101.143143365,118
carcassonne-uct160-vs-uct40-1000its,824,706,2162.955744416,2134.852594417,118
carcassonne-ucttuned140-vs-ucttuned25-1000its,827,709,2144.265734544,2126.577731916,118
carcassonne-uct295-vs-uct490-1000its,828,710,2203.149290345,2180.166187254,118
carcassonne-boltzmann455-vs-boltzmann135-1000its,833,715,2188.385223415,2137.579014689,118
carcassonne-uct190-vs-uct70-1000its,834,716,2189.320951135,2200.997105723,118
carcassonne-boltzmann100-vs-boltzmann120-1000its,836,718,2131.887467469,2088.865787297,118
carcassonne-ucttuned30-vs-ucttuned180-1000its,836,718,2151.116151459,2144.58511166,118
carcassonne-uct245-vs-uct95-1000its,837,719,2231.586251621,2176.388842061,118
carcassonne-boltzmann385-vs-boltzmann335-1000its,843,725,2198.85486328,2151.096990457,118
carcassonne-boltzmann95-vs-boltzmann240-1000its,843,725,2312.148626613,2255.25622833,118
carcassonne-ucttuned285-vs-ucttuned255-1000its,851,733,2222.677402799,2172.914939206,118
carcassonne-boltzmann260-vs-boltzmann35-1000its,854,736,2229.173446876,2176.432759384,118
carcassonne-boltzmann300-vs-boltzmann240-1000its,858,740,2171.409136517,2135.459918998,118
carcassonne-boltzmann55-vs-boltzmann415-1000its,864,746,2197.091788708,2149.704543489,118
carcassonne-ucttuned340-vs-ucttuned420-1000its,864,746,2215.059264628,2153.109099507,118
carcassonne-uct110-vs-uct480-1000its,868,750,2225.5643086,2181.418246862,118
carcassonne-ucttuned35-vs-ucttuned265-1000its,872,754,2187.447905277,2101.674510144,118
carcassonne-uct65-vs-uct150-1000its,874,756,2191.122099452,2170.290919617,118
carcassonne-boltzmann315-vs-boltzmann385-1000its,877,759,2117.216753533,2101.626853275,118
carcassonne-ucttuned225-vs-ucttuned435-1000its,878,760,2171.36843276,2109.927611355,118
carcassonne-boltzmann20-vs-boltzmann385-1000its,880,762,2242.573530699,2252.536035148,118
carcassonne-uct270-vs-uct420-1000its,886,768,2248.239076368,2175.882016248,118
carcassonne-ucttuned30-vs-ucttuned270-1000its,892,774,2120.834817935,2099.758284056,118
carcassonne-boltzmann165-vs-boltzmann475-1000its,895,777,2134.777953006,2094.075192592,118
carcassonne-uct420-vs-uct160-1000its,906,788,2232.507530893,2186.034096503,118
carcassonne-ucttuned125-vs-ucttuned15-1000its,906,788,2170.872433228,2115.887291131,118
carcassonne-uct380-vs-uct185-1000its,907,789,2210.001302665,2179.645295146,118
carcassonne-ucttuned420-vs-ucttuned265-1000its,909,791,2202.84612408,2209.519470904,118
carcassonne-uct325-vs-uct405-1000its,916,798,2183.006511662,2142.738982957,118
carcassonne-boltzmann15-vs-boltzmann35-1000its,918,800,2136.293186487,2135.139171409,118
carcassonne-ucttuned155-vs-ucttuned350-1000its,918,800,2181.334869133,2187.262213919,118
carcassonne-uct480-vs-uct160-1000its,926,808,2161.490079463,2126.841957747,118
carcassonne-boltzmann95-vs-boltzmann445-1000its,928,810,2183.313541893,2106.099779348,118
carcassonne-ucttuned35-vs-ucttuned100-1000its,933,815,2248.670269547,2187.194114526,118
carcassonne-boltzmann390-vs-boltzmann10-1000its,939,821,2219.790651449,2179.753625779,118
carcassonne-uct10-vs-uct225-1000its,940,822,2139.114094391,2061.105157555,118
carcassonne-ucttuned40-vs-ucttuned310-1000its,974,856,2199.500688508,2130.501205803,118
carcassonne-boltzmann275-vs-boltzmann40-1000its,769,650,2206.864445813,2131.101948903,119
carcassonne-uct345-vs-uct390-1000its,794,675,1770.638421649,1702.225530025,119
carcassonne-ucttuned225-vs-ucttuned400-1000its,813,694,2153.84529755,2066.830696046,119
carcassonne-ucttuned445-vs-ucttuned170-1000its,819,700,2164.021827755,2116.95744166,119
carcassonne-boltzmann260-vs-boltzmann60-1000its,828,709,2296.584157855,2236.668543633,119
carcassonne-boltzmann45-vs-boltzmann60-1000its,833,714,2158.778114282,2072.25469735,119
carcassonne-boltzmann385-vs-boltzmann295-1000its,836,717,2236.680429893,2198.743604137,119
carcassonne-boltzmann405-vs-boltzmann185-1000its,838,719,2146.320239662,2069.971337673,119
carcassonne-boltzmann450-vs-boltzmann110-1000its,840,721,2204.216679054,2230.550543238,119
carcassonne-ucttuned75-vs-ucttuned285-1000its,841,722,2210.822930283,2164.487259579,119
carcassonne-boltzmann20-vs-boltzmann425-1000its,842,723,2183.724193708,2128.486596738,119
carcassonne-boltzmann110-vs-boltzmann340-1000its,845,726,2199.592832539,2144.602574211,119
carcassonne-uct185-vs-uct75-1000its,848,729,2179.217942785,2097.414288183,119
carcassonne-ucttuned305-vs-ucttuned250-1000its,850,731,2144.706580315,2129.429523398,119
carcassonne-ucttuned215-vs-ucttuned305-1000its,854,735,2128.026084895,2072.031247565,119
carcassonne-boltzmann390-vs-boltzmann65-1000its,856,737,2195.887395929,2126.945105752,119
carcassonne-boltzmann15-vs-boltzmann275-1000its,857,738,2223.203653153,2128.861916683,119
carcassonne-uct290-vs-uct415-1000its,857,738,2260.303459189,2212.258528564,119
carcassonne-boltzmann35-vs-boltzmann280-1000its,858,739,2178.091007503,2148.097108498,119
carcassonne-boltzmann420-vs-boltzmann350-1000its,861,742,2220.050928495,2187.024685736,119
carcassonne-uct140-vs-uct170-1000its,861,742,2213.935704723,2148.989395329,119
carcassonne-boltzmann140-vs-boltzmann315-1000its,866,747,2251.09429741,2202.658736212,119
carcassonne-ucttuned435-vs-ucttuned90-1000its,866,747,2203.551568832,2152.315940271,119
carcassonne-ucttuned335-vs-ucttuned305-1000its,869,750,2287.069049951,2188.128176059,119
carcassonne-ucttuned410-vs-ucttuned465-1000its,869,750,2230.695314559,2199.68222887,119
carcassonne-ucttuned250-vs-ucttuned325-1000its,872,753,2117.011407961,2084.041889802,119
carcassonne-boltzmann115-vs-boltzmann285-1000its,873,754,2298.973078234,2228.03885902,119
carcassonne-ucttuned235-vs-ucttuned125-1000its,873,754,2214.05707108,2190.810345894,119
carcassonne-ucttuned80-vs-ucttuned270-1000its,875,756,2226.25509737,2156.482011843,119
carcassonne-uct25-vs-uct425-1000its,876,757,2258.41703667,2170.845672878,119
carcassonne-ucttuned400-vs-ucttuned200-1000its,877,758,2192.139703479,2134.035663874,119
carcassonne-ucttuned155-vs-ucttuned245-1000its,880,761,2170.16398707,2111.594926348,119
carcassonne-uct275-vs-uct130-1000its,883,764,2210.361439581,2192.092374988,119
carcassonne-boltzmann145-vs-boltzmann285-1000its,887,768,2237.83042856,2174.425610753,119
carcassonne-ucttuned10-vs-ucttuned385-1000its,888,769,2155.689665712,2128.283506113,119
carcassonne-ucttuned420-vs-ucttuned470-1000its,888,769,2187.806700925,2115.081535199,119
carcassonne-boltzmann330-vs-boltzmann420-1000its,890,771,2198.999820756,2178.141089452,119
carcassonne-uct400-vs-uct335-1000its,893,774,2227.091986839,2154.019874266,119
carcassonne-uct350-vs-uct400-1000its,896,777,2206.305446342,2134.524068075,119
carcassonne-ucttuned495-vs-ucttuned130-1000its,896,777,2269.808822304,2260.202638921,119
carcassonne-ucttuned420-vs-ucttuned155-1000its,898,779,2289.082163184,2257.078079222,119
carcassonne-ucttuned45-vs-ucttuned390-1000its,898,779,2238.816066183,2232.682507219,119
carcassonne-uct100-vs-uct85-1000its,901,782,2193.619654506,2178.616260955,119
carcassonne-ucttuned40-vs-ucttuned85-1000its,914,795,2257.213510692,2179.945062361,119
carcassonne-boltzmann335-vs-boltzmann280-1000its,925,806,2114.761698187,2107.747090756,119
carcassonne-uct355-vs-uct190-1000its,927,808,2184.909854309,2121.573547995,119
carcassonne-uct300-vs-uct250-1000its,939,820,2192.774833357,2128.84532602,119
carcassonne-ucttuned40-vs-ucttuned425-1000its,946,827,2172.091966726,2149.729989087,119
carcassonne-ucttuned60-vs-ucttuned195-1000its,949,830,2203.561040534,2141.444245237,119
carcassonne-boltzmann60-vs-boltzmann435-1000its,953,834,2210.014372364,2188.949905946,119
carcassonne-uct440-vs-uct90-1000its,969,850,2150.358922889,2134.726678719,119
carcassonne-boltzmann380-vs-boltzmann370-1000its,990,871,2216.285038337,2150.299790099,119
carcassonne-ucttuned380-vs-ucttuned10-1000its,1032,913,2248.724197686,2216.435319518,119
carcassonne-uct385-vs-uct10-1000its,1070,951,2204.323625442,2208.95437942,119
carcassonne-ucttuned105-vs-ucttuned365-1000its,782,662,2192.30761406,2126.689770612,120
carcassonne-boltzmann345-vs-boltzmann340-1000its,799,679,2220.215822097,2170.134642325,120
carcassonne-ucttuned350-vs-ucttuned300-1000its,807,687,2230.76014401,2211.277699072,120
carcassonne-ucttuned375-vs-ucttuned250-1000its,809,689,2224.472634857,2170.902550314,120
carcassonne-boltzmann140-vs-boltzmann370-1000its,822,702,2171.004687024,2121.986861991,120
carcassonne-uct215-vs-uct435-1000its,827,707,2243.951536403,2144.037776933,120
carcassonne-ucttuned265-vs-ucttuned370-1000its,828,708,2214.431056448,2165.114020218,120
carcassonne-uct355-vs-uct40-1000its,832,712,2284.763431835,2285.450552939,120
carcassonne-ucttuned140-vs-ucttuned270-1000its,834,714,2273.656760798,2267.17415665,120
carcassonne-ucttuned350-vs-ucttuned215-1000its,834,714,2152.314837181,2149.031296913,120
carcassonne-boltzmann105-vs-boltzmann95-1000its,836,716,2234.156786331,2179.46616771,120
carcassonne-ucttuned235-vs-ucttuned450-1000its,839,719,2184.980602706,2144.291666029,120
carcassonne-ucttuned335-vs-ucttuned365-1000its,839,719,2209.490794362,2166.632144523,120
carcassonne-uct490-vs-uct495-1000its,843,723,2167.133154366,2086.834058359,120
carcassonne-ucttuned405-vs-ucttuned465-1000its,843,723,2134.305520374,2093.504030888,120
carcassonne-ucttuned360-vs-ucttuned420-1000its,846,726,2121.578085822,2071.814643258,120
carcassonne-ucttuned50-vs-ucttuned435-1000its,846,726,2137.610535423,2102.271548991,120
carcassonne-boltzmann190-vs-boltzmann235-1000its,847,727,2148.942333612,2102.444698702,120
carcassonne-ucttuned205-vs-ucttuned240-1000its,848,728,2235.93830345,2204.275341275,120
carcassonne-ucttuned130-vs-ucttuned160-1000its,850,730,2163.547494443,2119.972727543,120
carcassonne-uct220-vs-uct285-1000its,852,732,2165.126976175,2156.876732457,120
carcassonne-boltzmann255-vs-boltzmann360-1000its,857,737,2232.13387602,2196.657442949,120
carcassonne-uct145-vs-uct240-1000its,857,737,2258.877360574,2210.679684605,120
carcassonne-ucttuned10-vs-ucttuned190-1000its,857,737,2147.769329323,2108.253664154,120
carcassonne-uct380-vs-uct315-1000its,860,740,2209.041281242,2143.937222781,120
carcassonne-ucttuned180-vs-ucttuned80-1000its,860,740,2180.074835212,2141.101168411,120
carcassonne-ucttuned375-vs-ucttuned240-1000its,860,740,2188.690193798,2175.051417226,120
carcassonne-boltzmann210-vs-boltzmann280-1000its,861,741,2269.214595745,2197.713722498,120
carcassonne-boltzmann215-vs-boltzmann485-1000its,861,741,2218.02608087,2148.081255856,120
carcassonne-boltzmann95-vs-boltzmann470-1000its,865,745,2133.680576102,2123.19406839,120
carcassonne-ucttuned85-vs-ucttuned315-1000its,865,745,2229.775523148,2128.717380698,120
carcassonne-uct100-vs-uct365-1000its,867,747,2167.201437096,2152.610943947,120
carcassonne-ucttuned130-vs-ucttuned375-1000its,867,747,2188.942888421,2167.743769517,120
carcassonne-ucttuned380-vs-ucttuned200-1000its,867,747,2200.52510345,2158.151558261,120
carcassonne-boltzmann495-vs-boltzmann30-1000its,869,749,2170.03767737,2116.89714824,120
carcassonne-uct75-vs-uct395-1000its,872,752,2230.634686696,2180.495571135,120
carcassonne-uct75-vs-uct485-1000its,876,756,2130.129916945,2139.768589105,120
carcassonne-ucttuned275-vs-ucttuned245-1000its,879,759,2211.903087245,2127.297475745,120
carcassonne-ucttuned250-vs-ucttuned170-1000its,880,760,2126.947974702,2075.782621484,120
carcassonne-boltzmann70-vs-boltzmann35-1000its,882,762,2117.3552064,2098.052085775,120
carcassonne-uct255-vs-uct465-1000its,889,769,2185.67821108,2125.67565186,120
carcassonne-ucttuned345-vs-ucttuned440-1000its,891,771,2166.600836893,2145.120845307,120
carcassonne-boltzmann475-vs-boltzmann165-1000its,892,772,2161.923658754,2163.084927831,120
carcassonne-uct60-vs-uct200-1000its,892,772,2210.20280542,2169.879842719,120
carcassonne-ucttuned290-vs-ucttuned380-1000its,900,780,2287.649869487,2234.420760479,120
carcassonne-boltzmann235-vs-boltzmann290-1000its,903,783,2168.090636726,2131.655984093,120
carcassonne-boltzmann280-vs-boltzmann475-1000its,905,785,2208.018009248,2159.949529615,120
carcassonne-uct115-vs-uct190-1000its,907,787,2205.116639464,2180.365109377,120
carcassonne-boltzmann455-vs-boltzmann255-1000its,911,791,2138.321243861,2100.619163571,120
carcassonne-uct5-vs-uct75-1000its,928,808,2253.43435166,2232.476080734,120
carcassonne-uct455-vs-uct95-1000its,930,810,2252.735355078,2210.554650046,120
carcassonne-uct60-vs-uct20-1000its,931,811,2190.400777753,2183.12552404,120
carcassonne-uct200-vs-uct400-1000its,934,814,2177.153815365,2110.741248848,120
carcassonne-ucttuned430-vs-ucttuned480-1000its,943,823,2192.392298618,2109.024928012,120
carcassonne-ucttuned20-vs-ucttuned120-1000its,944,824,2225.188941352,2165.297509787,120
carcassonne-uct445-vs-uct330-1000its,972,852,2267.162761148,2228.842320402,120
carcassonne-uct195-vs-uct110-1000its,1008,888,2190.945162966,2152.826004843,120
carcassonne-boltzmann370-vs-boltzmann240-1000its,798,677,2216.955521534,2105.852547932,121
carcassonne-ucttuned190-vs-ucttuned40-1000its,805,684,2153.274164926,2129.224961981,121
carcassonne-ucttuned40-vs-ucttuned180-1000its,810,689,2224.310177868,2137.946907273,121
carcassonne-boltzmann345-vs-boltzmann155-1000its,812,691,2209.008439286,2189.834853735,121
carcassonne-ucttuned80-vs-ucttuned185-1000its,816,695,2238.9790632,2167.245898731,121
carcassonne-uct30-vs-uct105-1000its,820,699,2170.924508904,2092.327359798,121
carcassonne-ucttuned400-vs-ucttuned130-1000its,829,708,2255.860314007,2200.507897793,121
carcassonne-uct225-vs-uct455-1000its,832,711,2152.281228303,2113.892500554,121
carcassonne-boltzmann340-vs-boltzmann270-1000its,834,713,2206.490039331,2148.755660295,121
carcassonne-boltzmann480-vs-boltzmann85-1000its,839,718,2214.768740166,2185.687925783,121
carcassonne-uct370-vs-uct450-1000its,839,718,2217.138912836,2129.147871177,121
carcassonne-ucttuned345-vs-ucttuned200-1000its,839,718,2209.657765254,2179.289150533,121
carcassonne-boltzmann325-vs-boltzmann345-1000its,842,721,2186.710262332,2110.248124502,121
carcassonne-ucttuned420-vs-ucttuned325-1000its,845,724,2172.299187619,2122.892448728,121
carcassonne-ucttuned100-vs-ucttuned455-1000its,849,728,2220.274360979,2153.622190301,121
carcassonne-boltzmann320-vs-boltzmann80-1000its,850,729,2213.085279908,2166.939881717,121
carcassonne-uct10-vs-uct250-1000its,851,730,2202.337037984,2157.996191616,121
carcassonne-ucttuned300-vs-ucttuned335-1000its,851,730,2178.409260458,2181.44696359,121
carcassonne-uct335-vs-uct390-1000its,852,731,2245.307028275,2188.476153693,121
carcassonne-ucttuned90-vs-ucttuned155-1000its,853,732,2238.119581915,2145.791355672,121
carcassonne-uct195-vs-uct465-1000its,857,736,2208.161148609,2139.718375658,121
carcassonne-boltzmann465-vs-boltzmann480-1000its,860,739,2208.995913692,2155.502482929,121
carcassonne-ucttuned235-vs-ucttuned175-1000its,868,747,2177.635716997,2197.708508947,121
carcassonne-ucttuned400-vs-ucttuned150-1000its,872,751,2194.169537751,2171.231648995,121
carcassonne-boltzmann440-vs-boltzmann390-1000its,873,752,2197.641933675,2123.977154987,121
carcassonne-ucttuned435-vs-ucttuned290-1000its,881,760,2167.487390905,2129.264616892,121
carcassonne-ucttuned125-vs-ucttuned265-1000its,882,761,2222.854321912,2164.272469483,121
carcassonne-boltzmann40-vs-boltzmann50-1000its,885,764,2247.395418649,2199.443797451,121
carcassonne-ucttuned120-vs-ucttuned365-1000its,886,765,2219.899583837,2163.69568431,121
carcassonne-boltzmann440-vs-boltzmann180-1000its,887,766,2210.060912589,2199.281387611,121
carcassonne-uct75-vs-uct165-1000its,897,776,2176.50181221,2141.842011484,121
carcassonne-boltzmann475-vs-boltzmann465-1000its,898,777,2140.218085428,2062.187790139,121
carcassonne-ucttuned415-vs-ucttuned40-1000its,905,784,2149.321612929,2133.36015484,121
carcassonne-uct55-vs-uct175-1000its,912,791,2212.830969304,2179.195778049,121
carcassonne-boltzmann85-vs-boltzmann325-1000its,923,802,2227.723298882,2175.874779365,121
carcassonne-uct245-vs-uct30-1000its,931,810,2174.544649296,2149.399750955,121
carcassonne-ucttuned465-vs-ucttuned420-1000its,931,810,2217.87201946,2134.010180698,121
carcassonne-uct120-vs-uct345-1000its,932,811,2173.048435371,2134.098575775,121
carcassonne-ucttuned410-vs-ucttuned150-1000its,933,812,2293.969703522,2238.138141634,121
carcassonne-boltzmann355-vs-boltzmann120-1000its,956,835,2175.491215912,2183.61848514,121
carcassonne-ucttuned60-vs-ucttuned280-1000its,960,839,2165.247094136,2121.993450689,121
carcassonne-boltzmann75-vs-boltzmann320-1000its,766,644,2140.812316039,2115.751404369,122
carcassonne-ucttuned205-vs-ucttuned145-1000its,785,663,2178.816055588,2137.897523057,122
carcassonne-boltzmann480-vs-boltzmann320-1000its,791,669,2183.598134762,2123.68412777,122
carcassonne-boltzmann385-vs-boltzmann270-1000its,803,681,2179.668422566,2142.969908645,122
carcassonne-boltzmann165-vs-boltzmann385-1000its,804,682,2151.908235082,2106.458332336,122
carcassonne-uct65-vs-uct175-1000its,815,693,2199.335404025,2144.486431239,122
carcassonne-boltzmann205-vs-boltzmann45-1000its,816,694,2195.277180359,2101.63538656,122
carcassonne-uct190-vs-uct415-1000its,822,700,2213.36611206,2170.239860478,122
carcassonne-uct40-vs-uct395-1000its,822,700,2159.364814539,2126.347901436,122
carcassonne-boltzmann285-vs-boltzmann55-1000its,824,702,2190.973354563,2117.313533334,122
carcassonne-boltzmann5-vs-boltzmann30-1000its,828,706,2235.378891486,2171.389689792,122
carcassonne-boltzmann440-vs-boltzmann230-1000its,833,711,2338.363644806,2305.244521242,122
carcassonne-ucttuned235-vs-ucttuned185-1000its,841,719,2233.94032508,2194.208902569,122
carcassonne-boltzmann10-vs-boltzmann320-1000its,843,721,2269.279519146,2206.659715899,122
carcassonne-ucttuned65-vs-ucttuned360-1000its,845,723,2128.007954477,2101.165862886,122
carcassonne-ucttuned5-vs-ucttuned390-1000its,848,726,2288.073210942,2243.624248624,122
carcassonne-uct335-vs-uct15-1000its,851,729,2235.066592246,2240.683236133,122
carcassonne-uct300-vs-uct215-1000its,852,730,2171.466037742,2143.110093563,122
carcassonne-uct355-vs-uct240-1000its,858,736,2185.727501226,2146.941835656,122
carcassonne-boltzmann120-vs-boltzmann155-1000its,863,741,2143.734581399,2100.890034088,122
carcassonne-uct90-vs-uct395-1000its,865,743,2175.425394597,2124.285417324,122
carcassonne-boltzmann395-vs-boltzmann15-1000its,869,747,2189.061708816,2164.202646326,122
carcassonne-ucttuned300-vs-ucttuned100-1000its,869,747,2188.682937596,2157.184892219,122
carcassonne-boltzmann5-vs-boltzmann185-1000its,874,752,2189.569420402,2114.218310527,122
carcassonne-ucttuned55-vs-ucttuned60-1000its,874,752,2223.334299844,2164.482379869,122
carcassonne-ucttuned15-vs-ucttuned330-1000its,879,757,2204.305074234,2146.668038017,122
carcassonne-uct450-vs-uct275-1000its,887,765,2228.48667543,2167.210499507,122
carcassonne-boltzmann205-vs-boltzmann435-1000its,895,773,2169.125222492,2156.977729675,122
carcassonne-uct180-vs-uct185-1000its,900,778,2188.859134927,2148.489160554,122
carcassonne-uct400-vs-uct355-1000its,901,779,2150.296238196,2092.738977531,122
carcassonne-ucttuned425-vs-ucttuned390-1000its,907,785,2188.171430552,2115.748762975,122
carcassonne-uct290-vs-uct105-1000its,911,789,2240.29974238,2202.60490586,122
carcassonne-boltzmann120-vs-boltzmann385-1000its,917,795,2239.593381554,2190.330380636,122
carcassonne-uct420-vs-uct105-1000its,918,796,2185.263595639,2168.866460145,122
carcassonne-ucttuned260-vs-ucttuned440-1000its,919,797,2110.994144307,2096.801995859,122
carcassonne-uct210-vs-uct485-1000its,921,799,2241.644974739,2164.771889892,122
carcassonne-uct135-vs-uct350-1000its,926,804,2149.86779967,2084.7110419,122
carcassonne-uct140-vs-uct100-1000its,956,834,2202.029885888,2156.066451353,122
carcassonne-uct370-vs-uct420-1000its,958,836,2189.257400758,2119.190375002,122
carcassonne-uct155-vs-uct10-1000its,974,852,2202.595806463,2186.392862815,122
carcassonne-boltzmann105-vs-boltzmann210-1000its,812,689,2204.321818487,2135.793635137,123
carcassonne-boltzmann405-vs-boltzmann445-1000its,818,695,2239.380638211,2161.553784115,123
carcassonne-uct85-vs-uct250-1000its,819,696,2177.124951633,2091.576795459,123
carcassonne-boltzmann465-vs-boltzmann295-1000its,832,709,2183.336221913,2161.206915116,123
carcassonne-ucttuned395-vs-ucttuned220-1000its,837,714,2129.429583438,2113.839762062,123
carcassonne-boltzmann225-vs-boltzmann245-1000its,838,715,2187.863653412,2182.757291966,123
carcassonne-boltzmann430-vs-boltzmann140-1000its,842,719,2189.143849464,2141.304171316,123
carcassonne-ucttuned385-vs-ucttuned250-1000its,844,721,2251.513276981,2225.416896912,123
carcassonne-boltzmann425-vs-boltzmann80-1000its,845,722,2211.442542835,2146.00656586,123
carcassonne-boltzmann135-vs-boltzmann345-1000its,848,725,2250.759455972,2202.390617762,123
carcassonne-boltzmann130-vs-boltzmann425-1000its,849,726,2226.226576832,2151.353565464,123
carcassonne-uct255-vs-uct460-1000its,857,734,2165.451764541,2160.413854126,123
carcassonne-boltzmann305-vs-boltzmann220-1000its,859,736,2156.351742796,2093.889720989,123
carcassonne-ucttuned360-vs-ucttuned60-1000its,864,741,2191.226730189,2132.449335043,123
carcassonne-uct390-vs-uct250-1000its,865,742,2174.810943129,2083.372539081,123
carcassonne-ucttuned355-vs-ucttuned85-1000its,870,747,2254.560188869,2198.548217438,123
carcassonne-ucttuned250-vs-ucttuned290-1000its,872,749,2203.104486097,2140.710561152,123
carcassonne-uct100-vs-uct130-1000its,873,750,2312.653287277,2246.68414277,123
carcassonne-uct490-vs-uct135-1000its,873,750,2257.72559372,2136.61845893,123
carcassonne-boltzmann210-vs-boltzmann385-1000its,876,753,2189.404342038,2130.03208146,123
carcassonne-ucttuned120-vs-ucttuned190-1000its,876,753,2153.526188283,2108.790274116,123
carcassonne-ucttuned260-vs-ucttuned355-1000its,878,755,2230.284168313,2186.342998908,123
carcassonne-ucttuned475-vs-ucttuned255-1000its,879,756,2170.991054269,2107.255444569,123
carcassonne-boltzmann195-vs-boltzmann25-1000its,880,757,2175.673338867,2117.849211749,123
carcassonne-boltzmann210-vs-boltzmann95-1000its,880,757,2205.019689509,2142.914663847,123
carcassonne-boltzmann235-vs-boltzmann215-1000its,881,758,2187.55770782,2186.488231248,123
carcassonne-boltzmann75-vs-boltzmann450-1000its,882,759,2227.378923542,2211.927130246,123
carcassonne-uct205-vs-uct315-1000its,882,759,2208.218407792,2127.276942872,123
carcassonne-boltzmann185-vs-boltzmann220-1000its,892,769,2210.074959261,2140.294526022,123
carcassonne-boltzmann335-vs-boltzmann55-1000its,895,772,2150.958643155,2121.761439621,123
carcassonne-uct20-vs-uct50-1000its,907,784,2176.276341263,2148.943972531,123
carcassonne-uct265-vs-uct125-1000its,917,794,2186.735514208,2138.201694393,123
carcassonne-ucttuned160-vs-ucttuned130-1000its,920,797,2205.193825618,2125.915650431,123
carcassonne-ucttuned140-vs-ucttuned355-1000its,921,798,2196.945299822,2106.71166814,123
carcassonne-uct210-vs-uct215-1000its,924,801,2229.981053924,2150.346921943,123
carcassonne-uct455-vs-uct495-1000its,931,808,2149.693090197,2109.373332868,123
carcassonne-ucttuned90-vs-ucttuned395-1000its,935,812,2238.394735377,2208.012598251,123
carcassonne-ucttuned25-vs-ucttuned300-1000its,937,814,2233.68777569,2185.350444288,123
carcassonne-uct165-vs-uct240-1000its,939,816,2153.436543661,2066.585983954,123
carcassonne-uct20-vs-uct320-1000its,949,826,2238.098832807,2173.123074984,123
carcassonne-ucttuned340-vs-ucttuned265-1000its,965,842,2203.285047252,2176.19017526,123
carcassonne-uct70-vs-uct290-1000its,783,659,2190.664164045,2156.674946981,124
carcassonne-boltzmann40-vs-boltzmann130-1000its,784,660,2200.479858867,2202.883256557,124
carcassonne-ucttuned220-vs-ucttuned375-1000its,787,663,2196.935787334,2168.450868724,124
carcassonne-boltzmann310-vs-boltzmann20-1000its,804,680,2226.585534711,2169.418724822,124
carcassonne-ucttuned270-vs-ucttuned70-1000its,813,689,2176.023411459,2142.872496185,124
carcassonne-boltzmann160-vs-boltzmann440-1000its,814,690,2233.148023193,2201.523993427,124
carcassonne-boltzmann35-vs-boltzmann255-1000its,816,692,2142.358622622,2123.410264888,124
carcassonne-boltzmann215-vs-boltzmann440-1000its,817,693,2190.751993553,2133.337079217,124
carcassonne-ucttuned5-vs-ucttuned160-1000its,828,704,2201.402579405,2135.696434994,124
carcassonne-boltzmann40-vs-boltzmann495-1000its,833,709,2231.669537699,2166.658938467,124
carcassonne-boltzmann485-vs-boltzmann285-1000its,833,709,2189.755452517,2083.225893763,124
carcassonne-uct285-vs-uct195-1000its,838,714,2159.238397102,2135.229798661,124
carcassonne-uct295-vs-uct400-1000its,839,715,2297.318220079,2249.538898144,124
carcassonne-boltzmann280-vs-boltzmann430-1000its,841,717,2268.265905277,2230.767628218,124
carcassonne-boltzmann125-vs-boltzmann285-1000its,846,722,2209.605230879,2154.397758758,124
carcassonne-ucttuned405-vs-ucttuned425-1000its,847,723,2204.05205795,2143.43242767,124
carcassonne-ucttuned435-vs-ucttuned300-1000its,853,729,2251.293451833,2187.815959923,124
carcassonne-uct345-vs-uct385-1000its,859,735,2230.106679879,2181.620547533,124
carcassonne-ucttuned55-vs-ucttuned120-1000its,859,735,2299.776206561,2187.066059273,124
carcassonne-ucttuned25-vs-ucttuned190-1000its,861,737,2118.335478083,2046.828916474,124
carcassonne-ucttuned440-vs-ucttuned145-1000its,866,742,2246.975990859,2185.958903852,124
carcassonne-uct250-vs-uct475-1000its,867,743,2200.584766597,2121.686581518,124
carcassonne-uct365-vs-uct150-1000its,867,743,2220.749921611,2179.110679953,124
carcassonne-uct415-vs-uct110-1000its,869,745,2171.573752332,2153.342319083,124
carcassonne-ucttuned435-vs-ucttuned455-1000its,875,751,2165.107199529,2147.849773818,124
carcassonne-ucttuned165-vs-ucttuned250-1000its,878,754,2189.588074544,2111.917678212,124
carcassonne-uct60-vs-uct120-1000its,883,759,2228.777789485,2190.881432198,124
carcassonne-uct10-vs-uct480-1000its,884,760,2225.382287061,2221.259240495,124
carcassonne-uct485-vs-uct200-1000its,893,769,2197.273273462,2162.770371213,124
carcassonne-ucttuned380-vs-ucttuned485-1000its,894,770,2212.610501911,2171.852049813,124
carcassonne-uct195-vs-uct235-1000its,898,774,2228.004914691,2179.959697495,124
carcassonne-ucttuned165-vs-ucttuned105-1000its,900,776,2231.259645769,2182.102348265,124
carcassonne-uct180-vs-uct75-1000its,904,780,2247.993972472,2165.796478981,124
carcassonne-boltzmann315-vs-boltzmann380-1000its,910,786,2267.927179838,2190.863048016,124
carcassonne-ucttuned120-vs-ucttuned55-1000its,912,788,2151.232286612,2120.436907473,124
carcassonne-ucttuned70-vs-ucttuned150-1000its,915,791,2202.083381148,2147.474579813,124
carcassonne-uct235-vs-uct250-1000its,926,802,2275.596920488,2202.77479161,124
carcassonne-uct405-vs-uct125-1000its,933,809,2260.145628394,2196.44727485,124
carcassonne-uct380-vs-uct305-1000its,934,810,2211.47437659,2141.039542866,124
carcassonne-boltzmann455-vs-boltzmann260-1000its,935,811,2201.787874893,2100.825799711,124
carcassonne-boltzmann410-vs-boltzmann135-1000its,953,829,2236.659613061,2193.445140343,124
carcassonne-ucttuned20-vs-ucttuned235-1000its,955,831,2233.473904697,2142.606146997,124
carcassonne-boltzmann455-vs-boltzmann105-1000its,957,833,2198.88334302,2103.541812108,124
carcassonne-boltzmann300-vs-boltzmann165-1000its,750,625,2276.92250159,2229.822163021,125
carcassonne-boltzmann480-vs-boltzmann350-1000its,769,644,2235.364926834,2161.19229849,125
carcassonne-ucttuned485-vs-ucttuned240-1000its,793,668,2196.791394684,2084.464853515,125
carcassonne-boltzmann10-vs-boltzmann250-1000its,795,670,2172.062343358,2119.503174054,125
carcassonne-uct360-vs-uct430-1000its,799,674,2228.185112201,2139.538472822,125
carcassonne-boltzmann395-vs-boltzmann255-1000its,801,676,2183.99444093,2165.933309504,125
carcassonne-boltzmann150-vs-boltzmann145-1000its,817,692,2212.988639855,2129.177057858,125
carcassonne-boltzmann90-vs-boltzmann410-1000its,818,693,2274.556766372,2214.28428497,125
carcassonne-boltzmann465-vs-boltzmann280-1000its,819,694,2274.005723698,2222.849796654,125
carcassonne-uct385-vs-uct115-1000its,821,696,2263.971970605,2158.682997184,125
carcassonne-uct180-vs-uct405-1000its,829,704,2158.313078704,2126.696702137,125
carcassonne-ucttuned215-vs-ucttuned295-1000its,831,706,2234.99286544,2177.973981931,125
carcassonne-ucttuned320-vs-ucttuned255-1000its,832,707,2220.285174414,2183.306232069,125
carcassonne-uct480-vs-uct170-1000its,834,709,2190.926108516,2122.634189529,125
carcassonne-uct240-vs-uct460-1000its,842,717,2223.447032849,2135.736437333,125
carcassonne-ucttuned160-vs-ucttuned410-1000its,850,725,2286.901554384,2293.767015922,125
carcassonne-boltzmann200-vs-boltzmann80-1000its,852,727,2116.312413462,2120.408828799,125
carcassonne-boltzmann485-vs-boltzmann170-1000its,853,728,2197.385024855,2187.53063721,125
carcassonne-ucttuned225-vs-ucttuned165-1000its,853,728,2176.569382243,2128.320225173,125
carcassonne-uct140-vs-uct40-1000its,854,729,2183.464790619,2168.341733979,125
carcassonne-boltzmann400-vs-boltzmann370-1000its,857,732,2181.140445229,2129.877122892,125
carcassonne-boltzmann335-vs-boltzmann260-1000its,858,733,2172.08016936,2134.744630719,125
carcassonne-uct155-vs-uct340-1000its,858,733,2198.343572333,2163.384403722,125
carcassonne-boltzmann225-vs-boltzmann110-1000its,860,735,2213.128303293,2173.748072395,125
carcassonne-boltzmann60-vs-boltzmann355-1000its,860,735,2205.565851461,2186.594915881,125
carcassonne-boltzmann290-vs-boltzmann365-1000its,862,737,2233.871046326,2161.22780882,125
carcassonne-uct290-vs-uct70-1000its,863,738,2239.557560839,2253.703586385,125
carcassonne-uct325-vs-uct140-1000its,865,740,2190.75522708,2148.956535149,125
carcassonne-uct120-vs-uct440-1000its,866,741,2213.981903911,2140.280882572,125
carcassonne-uct320-vs-uct290-1000its,866,741,2266.695724292,2219.546394217,125
carcassonne-ucttuned15-vs-ucttuned125-1000its,866,741,2219.621912652,2147.457259692,125
carcassonne-boltzmann350-vs-boltzmann255-1000its,871,746,2161.297427747,2071.335545592,125
carcassonne-ucttuned55-vs-ucttuned290-1000its,871,746,2207.286657066,2150.153406622,125
carcassonne-boltzmann110-vs-boltzmann215-1000its,872,747,2209.63252811,2193.980943211,125
carcassonne-ucttuned50-vs-ucttuned385-1000its,872,747,2168.805069284,2119.430307297,125
carcassonne-ucttuned20-vs-ucttuned435-1000its,886,761,2186.876426079,2133.53582132,125
carcassonne-ucttuned15-vs-ucttuned300-1000its,887,762,2154.583263168,2107.712445339,125
carcassonne-ucttuned270-vs-ucttuned190-1000its,887,762,2225.604893596,2182.455155925,125
carcassonne-ucttuned125-vs-ucttuned270-1000its,888,763,2171.141176228,2157.362446767,125
carcassonne-boltzmann490-vs-boltzmann70-1000its,889,764,2112.0204893,2077.212936819,125
carcassonne-boltzmann230-vs-boltzmann165-1000its,894,769,2239.654660326,2218.56183031,125
carcassonne-uct350-vs-uct190-1000its,897,772,2174.732418373,2105.26600078,125
carcassonne-uct250-vs-uct445-1000its,899,774,2161.696855314,2146.362651076,125
carcassonne-uct95-vs-uct5-1000its,903,778,2164.673942282,2116.027813749,125
carcassonne-boltzmann10-vs-boltzmann35-1000its,906,781,2252.945171768,2206.109253019,125
carcassonne-ucttuned80-vs-ucttuned490-1000its,917,792,2229.647369782,2141.769396509,125
carcassonne-ucttuned400-vs-ucttuned345-1000its,918,793,2139.320088287,2057.333194506,125
carcassonne-uct270-vs-uct120-1000its,919,794,2216.014179114,2182.434024991,125
carcassonne-ucttuned175-vs-ucttuned55-1000its,919,794,2193.524143223,2177.750730253,125
carcassonne-uct5-vs-uct310-1000its,920,795,2193.566333354,2148.1501976,125
carcassonne-boltzmann200-vs-boltzmann495-1000its,923,798,2301.44082545,2239.901427382,125
carcassonne-ucttuned275-vs-ucttuned485-1000its,923,798,2133.673412005,2066.740702669,125
carcassonne-boltzmann470-vs-boltzmann40-1000its,925,800,2119.246285688,2100.53357924,125
carcassonne-ucttuned335-vs-ucttuned435-1000its,930,805,2174.842611998,2129.187586979,125
carcassonne-boltzmann50-vs-boltzmann460-1000its,943,818,2170.845846372,2119.609634266,125
carcassonne-uct120-vs-uct385-1000its,963,838,2155.200390766,2070.106035959,125
carcassonne-boltzmann5-vs-boltzmann405-1000its,796,670,2284.164307678,2256.252878159,126
carcassonne-boltzmann120-vs-boltzmann390-1000its,805,679,2270.980618242,2198.099519334,126
carcassonne-uct280-vs-uct175-1000its,813,687,2247.942438426,2201.806964818,126
carcassonne-boltzmann95-vs-boltzmann270-1000its,815,689,2215.813386954,2153.739512994,126
carcassonne-boltzmann285-vs-boltzmann130-1000its,825,699,2197.728300889,2139.450515005,126
carcassonne-boltzmann320-vs-boltzmann30-1000its,827,701,2152.458952813,2107.162038134,126
carcassonne-boltzmann490-vs-boltzmann430-1000its,832,706,2228.291205705,2158.4972084,126
carcassonne-boltzmann360-vs-boltzmann485-1000its,834,708,2225.698959264,2206.062421939,126
carcassonne-uct200-vs-uct120-1000its,834,708,2182.182905099,2166.335881554,126
carcassonne-uct355-vs-uct140-1000its,839,713,2212.539404407,2168.056618651,126
carcassonne-uct305-vs-uct105-1000its,841,715,2173.410042931,2161.255857249,126
carcassonne-boltzmann20-vs-boltzmann25-1000its,845,719,2130.690751275,2082.512314198,126
carcassonne-boltzmann390-vs-boltzmann60-1000its,845,719,2190.193207541,2148.937608906,126
carcassonne-uct125-vs-uct305-1000its,846,720,2171.479878199,2147.586535251,126
carcassonne-uct325-vs-uct100-1000its,847,721,2190.500383534,2202.627057538,126
carcassonne-ucttuned240-vs-ucttuned245-1000its,848,722,2230.136838564,2162.642641814,126
carcassonne-boltzmann155-vs-boltzmann460-1000its,849,723,2154.551183639,2114.568228993,126
carcassonne-uct205-vs-uct175-1000its,849,723,2191.729698808,2164.932427583,126
carcassonne-boltzmann90-vs-boltzmann375-1000its,852,726,2238.036696561,2184.554706217,126
carcassonne-ucttuned385-vs-ucttuned225-1000its,863,737,2194.920553519,2166.54030205,126
carcassonne-boltzmann445-vs-boltzmann340-1000its,865,739,2251.870945504,2226.41733059,126
carcassonne-uct175-vs-uct380-1000its,867,741,2231.114753255,2169.450531597,126
carcassonne-uct305-vs-uct295-1000its,868,742,2188.473083814,2169.861184254,126
carcassonne-ucttuned270-vs-ucttuned335-1000its,869,743,2161.2574531,2143.916382702,126
carcassonne-uct400-vs-uct215-1000its,870,744,2196.214794679,2139.488921753,126
carcassonne-boltzmann60-vs-boltzmann245-1000its,872,746,2195.778345849,2176.347516922,126
carcassonne-uct345-vs-uct330-1000its,873,747,2196.482972364,2154.100488357,126
carcassonne-ucttuned90-vs-ucttuned340-1000its,877,751,2179.496198237,2150.485091513,126
carcassonne-boltzmann10-vs-boltzmann170-1000its,878,752,2157.729565117,2173.009398728,126
carcassonne-ucttuned25-vs-ucttuned250-1000its,879,753,2272.286580065,2236.954842396,126
carcassonne-ucttuned490-vs-ucttuned295-1000its,879,753,2188.257276806,2164.910051333,126
carcassonne-uct210-vs-uct70-1000its,885,759,2191.867589124,2163.202374712,126
carcassonne-uct45-vs-uct385-1000its,888,762,2210.89469734,2160.592852961,126
carcassonne-boltzmann425-vs-boltzmann295-1000its,893,767,2251.000888858,2181.222873844,126
carcassonne-ucttuned285-vs-ucttuned155-1000its,894,768,2119.567604959,2100.826148532,126
carcassonne-uct440-vs-uct355-1000its,897,771,2205.138047678,2140.449497294,126
carcassonne-ucttuned155-vs-ucttuned250-1000its,897,771,2154.687454597,2121.252891574,126
carcassonne-boltzmann305-vs-boltzmann440-1000its,900,774,2242.077663187,2180.179413781,126
carcassonne-boltzmann170-vs-boltzmann35-1000its,905,779,2160.197553254,2107.170658811,126
carcassonne-uct465-vs-uct410-1000its,905,779,2214.606086041,2230.053345977,126
carcassonne-ucttuned390-vs-ucttuned160-1000its,907,781,2176.863572701,2093.152496321,126
carcassonne-uct95-vs-uct445-1000its,912,786,2218.633611603,2185.939668336,126
carcassonne-boltzmann110-vs-boltzmann90-1000its,914,788,2184.280288851,2157.615688128,126
carcassonne-uct90-vs-uct35-1000its,916,790,2181.551322915,2139.41510915,126
carcassonne-ucttuned155-vs-ucttuned50-1000its,918,792,2312.894334256,2301.103569046,126
carcassonne-boltzmann170-vs-boltzmann320-1000its,921,795,2182.199783577,2156.667226383,126
carcassonne-boltzmann115-vs-boltzmann25-1000its,922,796,2169.383669217,2131.678145677,126
carcassonne-uct95-vs-uct255-1000its,926,800,2199.590921427,2213.53566988,126
carcassonne-uct340-vs-uct365-1000its,928,802,2167.795376827,2175.890745883,126
carcassonne-ucttuned250-vs-ucttuned480-1000its,943,817,2210.159953103,2151.268214326,126
carcassonne-boltzmann420-vs-boltzmann115-1000its,946,820,2197.326580781,2189.814726907,126
carcassonne-ucttuned15-vs-ucttuned65-1000its,964,838,2205.518157769,2118.874537514,126
carcassonne-ucttuned25-vs-ucttuned230-1000its,972,846,2144.595465976,2120.100661051,126
carcassonne-boltzmann335-vs-boltzmann430-1000its,997,871,2177.595496213,2137.43549604,126
carcassonne-ucttuned210-vs-ucttuned85-1000its,797,670,2188.068398683,2115.385748428,127
carcassonne-ucttuned75-vs-ucttuned145-1000its,808,681,2232.538943755,2146.79010399,127
carcassonne-ucttuned50-vs-ucttuned265-1000its,815,688,2183.971245057,2079.022907811,127
carcassonne-ucttuned50-vs-ucttuned295-1000its,817,690,2211.364451052,2141.278811185,127
carcassonne-boltzmann55-vs-boltzmann195-1000its,819,692,2179.92305578,2177.225002906,127
carcassonne-ucttuned315-vs-ucttuned360-1000its,825,698,2234.184507304,2223.767848361,127
carcassonne-boltzmann445-vs-boltzmann140-1000its,826,699,2229.510534575,2172.637879741,127
carcassonne-boltzmann400-vs-boltzmann225-1000its,838,711,2229.51156,2188.023550249,127
carcassonne-ucttuned35-vs-ucttuned425-1000its,843,716,2114.515219968,2087.847229376,127
carcassonne-ucttuned365-vs-ucttuned345-1000its,843,716,2282.043397587,2245.33067482,127
carcassonne-boltzmann350-vs-boltzmann330-1000its,846,719,2214.950948653,2140.212680369,127
carcassonne-boltzmann490-vs-boltzmann205-1000its,851,724,2266.925002713,2204.468286035,127
carcassonne-uct260-vs-uct435-1000its,854,727,2178.028793679,2165.354377618,127
carcassonne-boltzmann95-vs-boltzmann385-1000its,859,732,2142.7428086,2128.983025857,127
carcassonne-ucttuned405-vs-ucttuned415-1000its,860,733,2255.512646264,2212.76668947,127
carcassonne-boltzmann445-vs-boltzmann300-1000its,865,738,2215.468696485,2151.93528144,127
carcassonne-ucttuned385-vs-ucttuned260-1000its,865,738,2167.250672254,2109.512870846,127
carcassonne-boltzmann235-vs-boltzmann315-1000its,869,742,2175.218621121,2086.127912827,127
carcassonne-ucttuned160-vs-ucttuned460-1000its,870,743,2199.223027614,2152.045037872,127
carcassonne-boltzmann345-vs-boltzmann400-1000its,874,747,2150.164233659,2103.932766967,127
carcassonne-uct445-vs-uct285-1000its,875,748,2262.779803166,2183.93426711,127
carcassonne-boltzmann150-vs-boltzmann215-1000its,876,749,2180.646090586,2141.138779167,127
carcassonne-boltzmann50-vs-boltzmann290-1000its,878,751,2205.377307478,2175.062510675,127
carcassonne-boltzmann70-vs-boltzmann295-1000its,878,751,2163.19308548,2117.490764253,127
carcassonne-ucttuned180-vs-ucttuned185-1000its,882,755,2247.173040532,2212.096901225,127
carcassonne-ucttuned90-vs-ucttuned45-1000its,888,761,2231.517178268,2196.005481634,127
carcassonne-boltzmann85-vs-boltzmann185-1000its,890,763,2157.437205253,2145.17532114,127
carcassonne-uct5-vs-uct435-1000its,890,763,2205.893095617,2124.201181123,127
carcassonne-boltzmann340-vs-boltzmann310-1000its,899,772,2106.731202023,2083.125239308,127
carcassonne-ucttuned260-vs-ucttuned290-1000its,902,775,2131.04247005,2096.79928113,127
carcassonne-boltzmann295-vs-boltzmann490-1000its,905,778,2227.571732126,2152.927485101,127
carcassonne-ucttuned375-vs-ucttuned15-1000its,914,787,2193.845104573,2146.686960582,127
carcassonne-ucttuned495-vs-ucttuned245-1000its,915,788,2122.079557785,2057.278460208,127
carcassonne-boltzmann95-vs-boltzmann420-1000its,926,799,2141.740926403,2130.824157116,127
carcassonne-uct85-vs-uct100-1000its,926,799,2204.971386931,2156.443621448,127
carcassonne-ucttuned410-vs-ucttuned105-1000its,926,799,2155.182109663,2102.703118525,127
carcassonne-ucttuned5-vs-ucttuned230-1000its,927,800,2251.567942954,2202.944157374,127
carcassonne-uct420-vs-uct305-1000its,928,801,2177.297178433,2121.20177564,127
carcassonne-uct390-vs-uct50-1000its,951,824,2200.956934368,2164.05128307,127
carcassonne-boltzmann390-vs-boltzmann490-1000its,956,829,2250.983692644,2209.453097595,127
carcassonne-boltzmann100-vs-boltzmann470-1000its,965,838,2173.444375033,2152.74116604,127
carcassonne-ucttuned60-vs-ucttuned40-1000its,974,847,2198.111468537,2142.242002611,127
carcassonne-boltzmann245-vs-boltzmann170-1000its,1001,874,2261.388094274,2213.003523764,127
carcassonne-ucttuned455-vs-ucttuned280-1000its,757,629,2173.244428645,2150.697846789,128
carcassonne-ucttuned250-vs-ucttuned455-1000its,765,637,2181.732550321,2151.307718938,128
carcassonne-boltzmann385-vs-boltzmann20-1000its,809,681,2108.345040252,2055.862810997,128
carcassonne-ucttuned320-vs-ucttuned430-1000its,815,687,2184.307268258,2153.58337253,128
carcassonne-uct385-vs-uct190-1000its,817,689,2231.832169612,2136.994120632,128
carcassonne-uct335-vs-uct275-1000its,825,697,2136.273118663,2105.2259949,128
carcassonne-ucttuned460-vs-ucttuned350-1000its,829,701,2244.440177388,2172.342296631,128
carcassonne-ucttuned15-vs-ucttuned245-1000its,833,705,2268.896375204,2187.280101822,128
carcassonne-ucttuned420-vs-ucttuned100-1000its,834,706,2191.368092053,2203.753637282,128
carcassonne-uct195-vs-uct160-1000its,835,707,2179.387704183,2134.79808244,128
carcassonne-boltzmann70-vs-boltzmann270-1000its,839,711,2266.312577139,2214.45122278,128
carcassonne-boltzmann325-vs-boltzmann485-1000its,845,717,2213.910974251,2163.996221415,128
carcassonne-uct25-vs-uct410-1000its,846,718,2199.158374509,2139.024782182,128
carcassonne-boltzmann235-vs-boltzmann185-1000its,849,721,2095.188643059,2073.094455895,128
carcassonne-ucttuned435-vs-ucttuned285-1000its,853,725,2284.053746018,2229.861339802,128
carcassonne-boltzmann230-vs-boltzmann30-1000its,855,727,2257.860409733,2195.573825417,128
carcassonne-boltzmann5-vs-boltzmann210-1000its,855,727,2167.275174358,2119.899973914,128
carcassonne-uct375-vs-uct400-1000its,860,732,2282.952029666,2239.979168684,128
carcassonne-ucttuned430-vs-ucttuned245-1000its,862,734,2212.448060998,2179.572419917,128
carcassonne-boltzmann330-vs-boltzmann360-1000its,863,735,2148.043083304,2110.61588734,128
carcassonne-uct190-vs-uct375-1000its,863,735,2279.721319412,2217.003997274,128
carcassonne-boltzmann475-vs-boltzmann440-1000its,865,737,2204.572657508,2149.690585341,128
carcassonne-boltzmann55-vs-boltzmann410-1000its,869,741,2157.402143079,2094.160079893,128
carcassonne-boltzmann5-vs-boltzmann495-1000its,870,742,2239.592332874,2168.340607298,128
carcassonne-boltzmann190-vs-boltzmann415-1000its,871,743,2259.088790608,2198.508763526,128
carcassonne-uct350-vs-uct405-1000its,871,743,2207.980529746,2124.989882573,128
carcassonne-ucttuned15-vs-ucttuned205-1000its,871,743,2256.971324802,2233.971902667,128
carcassonne-ucttuned380-vs-ucttuned375-1000its,872,744,2242.951142785,2156.454540954,128
carcassonne-uct170-vs-uct155-1000its,879,751,2144.08267191,2108.780847615,128
carcassonne-uct370-vs-uct210-1000its,882,754,2198.735438242,2168.672313031,128
carcassonne-ucttuned425-vs-ucttuned430-1000its,882,754,2186.189331048,2169.253397542,128
carcassonne-uct70-vs-uct195-1000its,890,762,2125.752516195,2108.01940947,128
carcassonne-boltzmann430-vs-boltzmann205-1000its,894,766,2279.213505317,2236.867142699,128
carcassonne-uct205-vs-uct95-1000its,894,766,2194.052762939,2145.51958141,128
carcassonne-boltzmann385-vs-boltzmann265-1000its,895,767,2172.595053438,2159.299008258,128
carcassonne-boltzmann125-vs-boltzmann485-1000its,897,769,2151.938054233,2128.805779466,128
carcassonne-boltzmann85-vs-boltzmann200-1000its,901,773,2203.425893035,2151.192224783,128
carcassonne-uct20-vs-uct160-1000its,902,774,2270.690428261,2265.543927469,128
carcassonne-uct470-vs-uct395-1000its,904,776,2176.964269468,2132.020736285,128
carcassonne-uct165-vs-uct420-1000its,909,781,2225.567532719,2143.161719644,128
carcassonne-boltzmann200-vs-boltzmann45-1000its,910,782,2192.265953245,2144.393409661,128
carcassonne-uct155-vs-uct230-1000its,910,782,2160.131809758,2136.506087705,128
carcassonne-boltzmann230-vs-boltzmann270-1000its,916,788,2136.290341291,2068.35402838,128
carcassonne-boltzmann375-vs-boltzmann50-1000its,920,792,2200.02126703,2117.844749042,128
carcassonne-uct225-vs-uct185-1000its,963,835,2144.278291109,2141.189434607,128
carcassonne-boltzmann60-vs-boltzmann365-1000its,731,602,1730.684842561,1662.295098464,129
carcassonne-boltzmann85-vs-boltzmann250-1000its,797,668,2198.651499434,2133.586683101,129
carcassonne-uct205-vs-uct115-1000its,798,669,2164.395398392,2177.948229088,129
carcassonne-uct330-vs-uct225-1000its,820,691,2330.837356624,2225.000028997,129
carcassonne-boltzmann295-vs-boltzmann345-1000its,821,692,2210.389630225,2129.945131367,129
carcassonne-uct430-vs-uct65-1000its,821,692,2180.164316507,2147.566624122,129
carcassonne-boltzmann480-vs-boltzmann455-1000its,831,702,2282.861186917,2190.163939031,129
carcassonne-uct275-vs-uct325-1000its,841,712,2150.343936633,2136.006543708,129
carcassonne-uct100-vs-uct415-1000its,842,713,2191.359398263,2150.302322452,129
carcassonne-ucttuned90-vs-ucttuned60-1000its,843,714,2192.690708313,2136.295829569,129
carcassonne-uct255-vs-uct60-1000its,855,726,2228.14959803,2185.495960157,129
carcassonne-boltzmann340-vs-boltzmann470-1000its,856,727,2214.00383976,2171.931106473,129
carcassonne-ucttuned135-vs-ucttuned220-1000its,856,727,2188.052113314,2151.934962355,129
carcassonne-ucttuned255-vs-ucttuned315-1000its,856,727,2234.44857736,2152.5133931,129
carcassonne-uct130-vs-uct245-1000its,861,732,2204.640176106,2146.259085319,129
carcassonne-uct185-vs-uct165-1000its,862,733,2218.755509341,2209.992916827,129
carcassonne-uct145-vs-uct270-1000its,863,734,2110.6924463,2070.668493938,129
carcassonne-ucttuned140-vs-ucttuned285-1000its,863,734,2169.514709028,2153.399148571,129
carcassonne-uct400-vs-uct200-1000its,866,737,2264.100570326,2255.81036371,129
carcassonne-ucttuned490-vs-ucttuned200-1000its,866,737,2169.137571113,2161.204486826,129
carcassonne-ucttuned5-vs-ucttuned310-1000its,868,739,2190.7852551,2121.349554317,129
carcassonne-uct325-vs-uct95-1000its,875,746,2232.057991137,2144.721928304,129
carcassonne-boltzmann270-vs-boltzmann440-1000its,879,750,2230.884346804,2204.252356134,129
carcassonne-boltzmann495-vs-boltzmann410-1000its,879,750,2211.273146142,2147.049781671,129
carcassonne-ucttuned135-vs-ucttuned185-1000its,879,750,2102.518023354,2113.93679276,129
carcassonne-ucttuned15-vs-ucttuned345-1000its,879,750,2214.418222553,2116.704143041,129
carcassonne-ucttuned290-vs-ucttuned340-1000its,881,752,2183.409879059,2110.924859549,129
carcassonne-ucttuned265-vs-ucttuned390-1000its,885,756,2214.578486301,2178.713650426,129
carcassonne-ucttuned175-vs-ucttuned185-1000its,887,758,2194.217806176,2154.215313902,129
carcassonne-boltzmann405-vs-boltzmann280-1000its,889,760,2184.305759549,2096.890399977,129
carcassonne-uct330-vs-uct450-1000its,889,760,2220.521152914,2132.967159092,129
carcassonne-boltzmann220-vs-boltzmann470-1000its,891,762,2135.421329417,2087.307238036,129
carcassonne-boltzmann225-vs-boltzmann210-1000its,891,762,2210.721366514,2164.220867463,129
carcassonne-ucttuned115-vs-ucttuned145-1000its,891,762,2176.432860092,2140.196617482,129
carcassonne-boltzmann130-vs-boltzmann420-1000its,894,765,2110.848681936,2071.643546385,129
carcassonne-ucttuned15-vs-ucttuned360-1000its,897,768,2191.270039147,2141.586953326,129
carcassonne-uct400-vs-uct65-1000its,901,772,2194.58499851,2158.167262122,129
carcassonne-uct485-vs-uct255-1000its,901,772,2160.604848563,2144.959753432,129
carcassonne-boltzmann375-vs-boltzmann65-1000its,914,785,2229.198457291,2124.529452961,129
carcassonne-uct5-vs-uct140-1000its,919,790,2237.312979386,2191.927485728,129
carcassonne-ucttuned65-vs-ucttuned80-1000its,919,790,2148.551898471,2105.359932555,129
carcassonne-uct120-vs-uct60-1000its,932,803,2270.270009522,2199.339420609,129
carcassonne-ucttuned365-vs-ucttuned225-1000its,938,809,2186.98075612,2150.634839621,129
carcassonne-ucttuned270-vs-ucttuned80-1000its,939,810,2094.897425162,2104.048353151,129
carcassonne-ucttuned295-vs-ucttuned155-1000its,939,810,2181.555531774,2123.097424944,129
carcassonne-uct180-vs-uct10-1000its,944,815,2123.965690914,2091.7735054,129
carcassonne-uct25-vs-uct110-1000its,957,828,2233.426984631,2186.468791433,129
carcassonne-boltzmann315-vs-boltzmann290-1000its,785,655,2145.331263132,2081.017188051,130
carcassonne-uct245-vs-uct350-1000its,810,680,2260.300252019,2198.681897585,130
carcassonne-ucttuned285-vs-ucttuned340-1000its,825,695,2210.015208054,2136.177462773,130
carcassonne-boltzmann70-vs-boltzmann325-1000its,832,702,2190.879360345,2152.384511278,130
carcassonne-ucttuned240-vs-ucttuned430-1000its,832,702,2175.332680482,2124.712784723,130
carcassonne-ucttuned245-vs-ucttuned380-1000its,832,702,2168.122004313,2107.619731632,130
carcassonne-ucttuned195-vs-ucttuned305-1000its,833,703,2194.729520668,2134.93204328,130
carcassonne-boltzmann315-vs-boltzmann485-1000its,838,708,2183.200939436,2099.610974753,130
carcassonne-uct180-vs-uct375-1000its,839,709,2263.641809871,2249.286195357,130
carcassonne-boltzmann445-vs-boltzmann270-1000its,842,712,2162.238366549,2129.662171227,130
carcassonne-uct205-vs-uct290-1000its,842,712,2210.814846682,2213.904759314,130
carcassonne-uct5-vs-uct445-1000its,845,715,2133.907341753,2035.754018431,130
carcassonne-boltzmann325-vs-boltzmann185-1000its,846,716,2211.940471693,2156.441261474,130
carcassonne-ucttuned325-vs-ucttuned335-1000its,847,717,2222.676554526,2142.467924812,130
carcassonne-uct85-vs-uct350-1000its,853,723,2233.999155918,2162.181091125,130
carcassonne-ucttuned365-vs-ucttuned15-1000its,853,723,2163.295453645,2137.662510441,130
carcassonne-uct65-vs-uct240-1000its,865,735,2193.198248986,2192.245930739,130
carcassonne-ucttuned170-vs-ucttuned275-1000its,865,735,2162.075020729,2128.027464809,130
carcassonne-ucttuned255-vs-ucttuned455-1000its,869,739,2207.540997959,2172.701186839,130
carcassonne-ucttuned355-vs-ucttuned495-1000its,869,739,2296.228879666,2226.250117683,130
carcassonne-boltzmann350-vs-boltzmann165-1000its,878,748,2266.736341161,2180.61693384,130
carcassonne-ucttuned360-vs-ucttuned480-1000its,879,749,2184.243717981,2167.699340166,130
carcassonne-boltzmann305-vs-boltzmann450-1000its,885,755,2231.943263625,2139.240539377,130
carcassonne-ucttuned430-vs-ucttuned150-1000its,885,755,2162.319973778,2094.288244149,130
carcassonne-uct405-vs-uct300-1000its,888,758,2178.48219302,2142.058744081,130
carcassonne-ucttuned50-vs-ucttuned140-1000its,890,760,2208.362332538,2134.803643251,130
carcassonne-ucttuned70-vs-ucttuned300-1000its,896,766,2246.770336863,2230.916257036,130
carcassonne-boltzmann40-vs-boltzmann160-1000its,900,770,2236.788524164,2242.371425079,130
carcassonne-ucttuned170-vs-ucttuned295-1000its,903,773,2185.837493543,2118.596041256,130
carcassonne-uct380-vs-uct240-1000its,906,776,2229.593182851,2197.573513213,130
carcassonne-ucttuned340-vs-ucttuned165-1000its,911,781,2181.102868215,2183.731346869,130
carcassonne-uct100-vs-uct215-1000its,922,792,2158.477719101,2083.878907821,130
carcassonne-boltzmann205-vs-boltzmann90-1000its,933,803,2233.281999622,2140.131205954,130
carcassonne-uct5-vs-uct165-1000its,934,804,2187.07853633,2131.726187429,130
carcassonne-uct50-vs-uct225-1000its,935,805,2193.643915481,2197.751543639,130
carcassonne-uct120-vs-uct10-1000its,936,806,2151.463313412,2119.339506789,130
carcassonne-boltzmann340-vs-boltzmann50-1000its,945,815,2166.606044935,2130.641044016,130
carcassonne-uct320-vs-uct150-1000its,947,817,2227.726275084,2175.175867558,130
carcassonne-boltzmann25-vs-boltzmann425-1000its,770,639,2183.318473794,2109.369152085,131
carcassonne-boltzmann370-vs-boltzmann305-1000its,803,672,2214.657127082,2171.659247263,131
carcassonne-boltzmann140-vs-boltzmann195-1000its,807,676,2217.768874237,2143.182285315,131
carcassonne-boltzmann120-vs-boltzmann185-1000its,815,684,2192.953218342,2133.010907645,131
carcassonne-uct315-vs-uct250-1000its,819,688,2150.838515804,2136.820778525,131
carcassonne-boltzmann230-vs-boltzmann125-1000its,823,692,2300.396716837,2171.856457747,131
carcassonne-boltzmann405-vs-boltzmann395-1000its,838,707,2102.251001443,2065.5873063,131
carcassonne-ucttuned20-vs-ucttuned105-1000its,842,711,2218.015194626,2209.20015877,131
carcassonne-ucttuned185-vs-ucttuned215-1000its,843,712,2185.533140742,2127.013534357,131
carcassonne-uct380-vs-uct265-1000its,852,721,2258.787462722,2219.441287404,131
carcassonne-ucttuned15-vs-ucttuned425-1000its,853,722,2238.69000995,2163.680712918,131
carcassonne-boltzmann440-vs-boltzmann330-1000its,854,723,2237.201793544,2195.407659546,131
carcassonne-boltzmann455-vs-boltzmann390-1000its,859,728,2264.238150332,2249.420861151,131
carcassonne-boltzmann170-vs-boltzmann450-1000its,864,733,2253.459370974,2160.421427253,131
carcassonne-uct90-vs-uct285-1000its,868,737,2260.603246545,2199.570106387,131
carcassonne-ucttuned260-vs-ucttuned495-1000its,875,744,2205.798664948,2155.657423188,131
carcassonne-boltzmann25-vs-boltzmann165-1000its,879,748,2170.43289161,2141.967658435,131
carcassonne-uct165-vs-uct455-1000its,890,759,2217.890053031,2144.787308145,131
carcassonne-boltzmann80-vs-boltzmann280-1000its,893,762,2189.236904564,2137.086746654,131
carcassonne-ucttuned245-vs-ucttuned185-1000its,893,762,2259.934996435,2199.911302431,131
carcassonne-ucttuned30-vs-ucttuned165-1000its,895,764,2217.559768587,2192.869238858,131
carcassonne-ucttuned365-vs-ucttuned385-1000its,899,768,2166.113010056,2147.728091277,131
carcassonne-ucttuned310-vs-ucttuned325-1000its,907,776,2148.097224807,2144.0874401,131
carcassonne-ucttuned250-vs-ucttuned465-1000its,921,790,2138.052295773,2095.771459185,131
carcassonne-uct60-vs-uct345-1000its,925,794,2163.853598199,2132.160279044,131
carcassonne-boltzmann10-vs-boltzmann70-1000its,939,808,2229.312106448,2144.249313469,131
carcassonne-ucttuned20-vs-ucttuned45-1000its,954,823,2191.852839937,2142.028845875,131
carcassonne-boltzmann275-vs-boltzmann10-1000its,955,824,2261.503124432,2155.141219397,131
carcassonne-uct85-vs-uct305-1000its,955,824,2200.398899014,2165.061682808,131
carcassonne-uct155-vs-uct400-1000its,794,662,2189.81883454,2138.823961471,132
carcassonne-boltzmann290-vs-boltzmann335-1000its,797,665,2260.856364734,2234.192151597,132
carcassonne-uct350-vs-uct355-1000its,804,672,2202.624881998,2185.416596036,132
carcassonne-uct275-vs-uct345-1000its,805,673,2171.584584928,2087.216454836,132
carcassonne-ucttuned160-vs-ucttuned280-1000its,828,696,2155.045895444,2103.384208075,132
carcassonne-boltzmann480-vs-boltzmann15-1000its,831,699,2193.731761883,2146.35759238,132
carcassonne-uct490-vs-uct285-1000its,833,701,2235.387176911,2149.518859232,132
carcassonne-ucttuned405-vs-ucttuned165-1000its,845,713,2189.898121903,2129.044263332,132
carcassonne-boltzmann215-vs-boltzmann430-1000its,848,716,2211.49429345,2197.663007944,132
carcassonne-ucttuned195-vs-ucttuned365-1000its,850,718,2215.079331263,2168.583837514,132
carcassonne-boltzmann305-vs-boltzmann155-1000its,854,722,2125.395723142,2106.794106033,132
carcassonne-uct90-vs-uct185-1000its,865,733,2259.150623806,2218.070076281,132
carcassonne-ucttuned385-vs-ucttuned480-1000its,866,734,2208.273960725,2153.746486851,132
carcassonne-ucttuned125-vs-ucttuned100-1000its,868,736,2127.629110328,2121.83458404,132
carcassonne-boltzmann170-vs-boltzmann270-1000its,869,737,2196.248825505,2190.324322476,132
carcassonne-uct265-vs-uct250-1000its,873,741,2229.791357838,2180.423860614,132
carcassonne-uct5-vs-uct230-1000its,874,742,2253.323827528,2166.898656952,132
carcassonne-boltzmann350-vs-boltzmann275-1000its,883,751,2166.245320003,2104.302150526,132
carcassonne-boltzmann140-vs-boltzmann460-1000its,884,752,2205.634993906,2149.94553267,132
carcassonne-uct350-vs-uct475-1000its,886,754,2185.939283749,2142.520597659,132
carcassonne-ucttuned70-vs-ucttuned205-1000its,886,754,2179.858136857,2135.994844081,132
carcassonne-boltzmann245-vs-boltzmann190-1000its,887,755,2249.190821694,2249.587096912,132
carcassonne-boltzmann325-vs-boltzmann250-1000its,897,765,2190.272640923,2112.109047811,132
carcassonne-boltzmann425-vs-boltzmann445-1000its,898,766,2208.538613496,2157.756743545,132
carcassonne-ucttuned440-vs-ucttuned475-1000its,898,766,2211.383649988,2150.94578281,132
carcassonne-uct170-vs-uct270-1000its,908,776,2185.521913478,2162.987263774,132
carcassonne-boltzmann150-vs-boltzmann345-1000its,912,780,2217.350816406,2147.753659203,132
carcassonne-ucttuned350-vs-ucttuned260-1000its,913,781,2158.00121728,2111.281623713,132
carcassonne-ucttuned40-vs-ucttuned330-1000its,913,781,2188.112080225,2171.784517259,132
carcassonne-uct5-vs-uct45-1000its,919,787,2221.85999921,2209.497923529,132
carcassonne-boltzmann5-vs-boltzmann255-1000its,921,789,2202.55287221,2131.707884754,132
carcassonne-uct300-vs-uct280-1000its,928,796,2200.191332324,2201.692083154,132
carcassonne-uct15-vs-uct45-1000its,936,804,2179.583945828,2169.66385511,132
carcassonne-ucttuned370-vs-ucttuned125-1000its,775,642,2217.3231065,2196.090791992,133
carcassonne-uct170-vs-uct365-1000its,784,651,2111.180342625,2068.412220942,133
carcassonne-boltzmann375-vs-boltzmann355-1000its,791,658,2180.007401694,2155.408000056,133
carcassonne-boltzmann60-vs-boltzmann210-1000its,796,663,2245.6625891,2186.834345365,133
carcassonne-boltzmann400-vs-boltzmann80-1000its,834,701,2147.54677491,2107.087239816,133
carcassonne-ucttuned475-vs-ucttuned120-1000its,837,704,2193.259404019,2146.114181233,133
carcassonne-ucttuned395-vs-ucttuned410-1000its,843,710,2241.699125507,2207.920064515,133
carcassonne-ucttuned345-vs-ucttuned165-1000its,845,712,2172.785394842,2177.891431403,133
carcassonne-uct25-vs-uct195-1000its,846,713,2151.526698698,2126.785193181,133
carcassonne-uct120-vs-uct225-1000its,850,717,2257.304926989,2197.250586208,133
carcassonne-uct215-vs-uct60-1000its,853,720,2208.460176804,2128.360291736,133
carcassonne-ucttuned175-vs-ucttuned50-1000its,856,723,2164.888454982,2144.071181236,133
carcassonne-ucttuned400-vs-ucttuned480-1000its,859,726,2109.976307204,2068.193879357,133
carcassonne-uct400-vs-uct390-1000its,862,729,2205.299679507,2192.819268094,133
carcassonne-boltzmann75-vs-boltzmann440-1000its,865,732,2233.987177106,2160.189701427,133
carcassonne-uct50-vs-uct455-1000its,865,732,2223.511952107,2157.283813852,133
carcassonne-ucttuned435-vs-ucttuned115-1000its,867,734,2175.912647081,2150.501760947,133
carcassonne-ucttuned45-vs-ucttuned60-1000its,869,736,2218.844863743,2141.895903061,133
carcassonne-ucttuned70-vs-ucttuned350-1000its,869,736,2182.693793046,2149.335362054,133
carcassonne-ucttuned295-vs-ucttuned405-1000its,871,738,2280.076375306,2191.718255787,133
carcassonne-boltzmann275-vs-boltzmann260-1000its,872,739,2238.863642409,2159.472290217,133
carcassonne-boltzmann325-vs-boltzmann380-1000its,873,740,2178.846673505,2150.666236331,133
carcassonne-uct350-vs-uct495-1000its,876,743,2150.451726364,2104.864119124,133
carcassonne-uct415-vs-uct350-1000its,876,743,2140.58142393,2098.634577139,133
carcassonne-boltzmann390-vs-boltzmann115-1000its,880,747,2227.398874999,2176.205046074,133
carcassonne-boltzmann5-vs-boltzmann490-1000its,880,747,2216.50955086,2138.902688834,133
carcassonne-ucttuned315-vs-ucttuned85-1000its,880,747,2148.517824749,2092.634231929,133
carcassonne-uct360-vs-uct465-1000its,887,754,2239.998530602,2177.256922059,133
carcassonne-ucttuned345-vs-ucttuned295-1000its,887,754,2218.08948784,2117.159491835,133
carcassonne-boltzmann155-vs-boltzmann450-1000its,888,755,2157.967773633,2114.911868313,133
carcassonne-uct295-vs-uct430-1000its,893,760,2237.846178712,2231.186927318,133
carcassonne-uct300-vs-uct85-1000its,895,762,2225.928908825,2198.077553193,133
carcassonne-boltzmann355-vs-boltzmann240-1000its,897,764,2194.501457481,2145.051228889,133
carcassonne-ucttuned145-vs-ucttuned90-1000its,900,767,2200.527001513,2144.685530445,133
carcassonne-uct95-vs-uct250-1000its,918,785,2177.843399002,2158.100122325,133
carcassonne-ucttuned60-vs-ucttuned275-1000its,938,805,2144.911160609,2096.163251984,133
carcassonne-uct130-vs-uct365-1000its,939,806,2238.779367849,2176.2535283,133
carcassonne-uct10-vs-uct440-1000its,941,808,2176.729383013,2101.963971509,133
carcassonne-uct400-vs-uct150-1000its,955,822,2232.111869262,2169.933056219,133
carcassonne-ucttuned10-vs-ucttuned335-1000its,979,846,2204.582411182,2161.293418175,133
carcassonne-ucttuned310-vs-ucttuned90-1000its,809,675,2140.462672877,2084.821640389,134
carcassonne-uct35-vs-uct95-1000its,819,685,2157.200276138,2121.285069601,134
carcassonne-ucttuned210-vs-ucttuned195-1000its,827,693,2212.372341943,2143.451071493,134
carcassonne-ucttuned65-vs-ucttuned355-1000its,829,695,2170.594397951,2113.267210873,134
carcassonne-boltzmann50-vs-boltzmann265-1000its,831,697,2318.414479132,2243.5035848,134
carcassonne-ucttuned315-vs-ucttuned215-1000its,835,701,2215.348741417,2165.843329065,134
carcassonne-boltzmann30-vs-boltzmann135-1000its,837,703,2212.319331222,2124.745635732,134
carcassonne-ucttuned395-vs-ucttuned215-1000its,837,703,2134.106750313,2084.412610842,134
carcassonne-ucttuned330-vs-ucttuned390-1000its,839,705,2224.250293094,2234.805492606,134
carcassonne-ucttuned20-vs-ucttuned100-1000its,849,715,2268.261862361,2222.749806061,134
carcassonne-boltzmann10-vs-boltzmann400-1000its,853,719,2207.383521721,2173.227202162,134
carcassonne-boltzmann105-vs-boltzmann130-1000its,854,720,2182.877057857,2142.018129691,134
carcassonne-ucttuned435-vs-ucttuned325-1000its,860,726,2195.574892495,2154.132032646,134
carcassonne-ucttuned400-vs-ucttuned490-1000its,861,727,2150.890046954,2103.15002677,134
carcassonne-boltzmann310-vs-boltzmann120-1000its,863,729,2136.520562533,2060.351820329,134
carcassonne-ucttuned460-vs-ucttuned320-1000its,865,731,2229.060170442,2152.887428129,134
carcassonne-uct375-vs-uct75-1000its,868,734,2164.538422161,2131.710177133,134
carcassonne-uct360-vs-uct120-1000its,869,735,2274.204543254,2244.480134357,134
carcassonne-boltzmann300-vs-boltzmann400-1000its,871,737,2184.852118978,2145.632839942,134
carcassonne-uct70-vs-uct335-1000its,871,737,2191.191988002,2103.615526688,134
carcassonne-boltzmann415-vs-boltzmann40-1000its,872,738,2252.26024248,2215.925700203,134
carcassonne-ucttuned445-vs-ucttuned390-1000its,874,740,2215.181790937,2128.683647444,134
carcassonne-boltzmann45-vs-boltzmann130-1000its,880,746,2206.660769523,2157.252699328,134
carcassonne-uct305-vs-uct320-1000its,896,762,2169.183688216,2129.406217701,134
carcassonne-ucttuned50-vs-ucttuned370-1000its,896,762,2162.654874595,2145.525677017,134
carcassonne-uct195-vs-uct460-1000its,904,770,2252.826158909,2238.738586292,134
carcassonne-uct115-vs-uct120-1000its,907,773,2192.865592363,2108.172560991,134
carcassonne-uct175-vs-uct325-1000its,908,774,2167.339214959,2164.364397786,134
carcassonne-ucttuned165-vs-ucttuned395-1000its,908,774,2215.477370602,2192.600861713,134
carcassonne-ucttuned280-vs-ucttuned340-1000its,908,774,2160.764738985,2104.754714059,134
carcassonne-ucttuned275-vs-ucttuned45-1000its,913,779,2228.409809131,2212.744054439,134
carcassonne-boltzmann460-vs-boltzmann230-1000its,916,782,2232.305047398,2129.571921423,134
carcassonne-ucttuned110-vs-ucttuned325-1000its,919,785,2316.16761541,2266.845620195,134
carcassonne-ucttuned290-vs-ucttuned200-1000its,919,785,2181.498941001,2133.189659495,134
carcassonne-ucttuned15-vs-ucttuned225-1000its,938,804,2211.889710061,2168.899479875,134
carcassonne-uct430-vs-uct435-1000its,941,807,2229.469282996,2185.643412355,134
carcassonne-boltzmann65-vs-boltzmann470-1000its,954,820,2145.4036181,2083.745769574,134
carcassonne-ucttuned70-vs-ucttuned105-1000its,954,820,2226.452752724,2173.289765152,134
carcassonne-uct375-vs-uct350-1000its,972,838,2198.789390919,2117.372493539,134
carcassonne-boltzmann435-vs-boltzmann70-1000its,973,839,2192.470020175,2148.794740578,134
carcassonne-boltzmann95-vs-boltzmann225-1000its,776,641,2201.687103258,2139.236355066,135
carcassonne-boltzmann495-vs-boltzmann485-1000its,816,681,2173.484423789,2125.814677443,135
carcassonne-boltzmann355-vs-boltzmann265-1000its,821,686,2231.499106717,2166.451819829,135
carcassonne-ucttuned125-vs-ucttuned315-1000its,828,693,2268.238940753,2203.28019167,135
carcassonne-uct450-vs-uct480-1000its,833,698,2228.115105813,2175.971316042,135
carcassonne-uct445-vs-uct260-1000its,838,703,2207.007820465,2129.594179652,135
carcassonne-uct280-vs-uct490-1000its,840,705,2199.232919214,2190.142524487,135
carcassonne-uct100-vs-uct20-1000its,842,707,2109.34264527,2065.722772837,135
carcassonne-boltzmann170-vs-boltzmann200-1000its,848,713,2098.486821457,2034.095676435,135
carcassonne-boltzmann495-vs-boltzmann395-1000its,854,719,2199.597322816,2205.788267464,135
carcassonne-uct480-vs-uct330-1000its,864,729,2162.239584517,2098.755617074,135
carcassonne-boltzmann170-vs-boltzmann155-1000its,869,734,2166.540378615,2087.171414662,135
carcassonne-ucttuned195-vs-ucttuned430-1000its,871,736,2200.494321864,2165.574136891,135
carcassonne-uct75-vs-uct440-1000its,874,739,2165.084094563,2125.610871528,135
carcassonne-boltzmann175-vs-boltzmann190-1000its,875,740,2170.722711721,2096.437065659,135
carcassonne-uct25-vs-uct310-1000its,877,742,2275.482536993,2266.604819931,135
carcassonne-boltzmann180-vs-boltzmann175-1000its,879,744,2151.093920188,2121.545747718,135
carcassonne-boltzmann120-vs-boltzmann350-1000its,880,745,2202.579671401,2126.352682053,135
carcassonne-boltzmann385-vs-boltzmann145-1000its,880,745,2272.483885354,2194.290279029,135
carcassonne-ucttuned130-vs-ucttuned385-1000its,881,746,2232.543969352,2177.498079956,135
carcassonne-boltzmann270-vs-boltzmann180-1000its,882,747,2141.964888075,2065.718513182,135
carcassonne-boltzmann110-vs-boltzmann150-1000its,886,751,2183.695815836,2143.527863449,135
carcassonne-boltzmann295-vs-boltzmann380-1000its,887,752,2136.583737212,2125.145151578,135
carcassonne-uct190-vs-uct475-1000its,892,757,2135.904465967,2100.457226336,135
carcassonne-uct125-vs-uct350-1000its,909,774,2238.274454783,2152.199092676,135
carcassonne-ucttuned435-vs-ucttuned380-1000its,910,775,2285.508393797,2278.38293138,135
carcassonne-boltzmann420-vs-boltzmann430-1000its,911,776,2136.518722414,2114.636987799,135
carcassonne-uct200-vs-uct40-1000its,915,780,2227.114276595,2166.78666322,135
carcassonne-uct410-vs-uct220-1000its,916,781,2231.470147753,2207.378122096,135
carcassonne-ucttuned395-vs-ucttuned120-1000its,917,782,2241.402130618,2186.484985433,135
carcassonne-ucttuned45-vs-ucttuned360-1000its,919,784,2259.663028117,2190.728074314,135
carcassonne-boltzmann20-vs-boltzmann215-1000its,924,789,2203.015721821,2167.268209171,135
carcassonne-boltzmann320-vs-boltzmann100-1000its,933,798,2234.324856513,2151.692654076,135
carcassonne-uct60-vs-uct235-1000its,935,800,2292.4895801,2220.445224594,135
carcassonne-boltzmann5-vs-boltzmann250-1000its,942,807,2164.399936241,2115.320336706,135
carcassonne-uct255-vs-uct185-1000its,946,811,2113.271799376,2081.268152261,135
carcassonne-uct270-vs-uct380-1000its,960,825,2211.961176888,2159.780884907,135
carcassonne-boltzmann20-vs-boltzmann90-1000its,973,838,2201.644019883,2165.837064755,135
carcassonne-boltzmann380-vs-boltzmann330-1000its,802,666,2271.320288347,2173.40572084,136
carcassonne-boltzmann295-vs-boltzmann200-1000its,820,684,2122.587543962,2112.981037469,136
carcassonne-uct370-vs-uct465-1000its,833,697,2236.535108216,2171.600553854,136
carcassonne-boltzmann80-vs-boltzmann390-1000its,836,700,2231.629334234,2192.34882058,136
carcassonne-ucttuned345-vs-ucttuned135-1000its,837,701,2156.714101703,2170.294608678,136
carcassonne-ucttuned95-vs-ucttuned410-1000its,837,701,2155.973614857,2141.421468335,136
carcassonne-boltzmann340-vs-boltzmann445-1000its,840,704,2198.938985581,2116.510902083,136
carcassonne-uct345-vs-uct150-1000its,849,713,2163.866970231,2147.683457624,136
carcassonne-boltzmann360-vs-boltzmann340-1000its,852,716,2124.039530294,2119.846751057,136
carcassonne-uct385-vs-uct125-1000its,853,717,2276.874018043,2202.956450462,136
carcassonne-boltzmann435-vs-boltzmann145-1000its,862,726,2149.334243537,2129.981608655,136
carcassonne-uct375-vs-uct310-1000its,862,726,2209.316523864,2218.653364193,136
carcassonne-ucttuned485-vs-ucttuned165-1000its,862,726,2149.171977466,2128.233133363,136
carcassonne-boltzmann320-vs-boltzmann85-1000its,864,728,2283.711122206,2186.671970303,136
carcassonne-uct235-vs-uct375-1000its,873,737,2146.562828206,2059.114147689,136
carcassonne-boltzmann125-vs-boltzmann420-1000its,875,739,2244.900171405,2203.835929386,136
carcassonne-uct205-vs-uct60-1000its,878,742,2196.17384419,2171.715990437,136
carcassonne-boltzmann155-vs-boltzmann140-1000its,883,747,2219.46840942,2199.768878591,136
carcassonne-boltzmann260-vs-boltzmann315-1000its,886,750,2213.112711916,2155.564793921,136
carcassonne-boltzmann155-vs-boltzmann265-1000its,889,753,2176.741569388,2142.266362966,136
carcassonne-boltzmann480-vs-boltzmann270-1000its,890,754,2277.24856538,2218.60185253,136
carcassonne-uct345-vs-uct335-1000its,890,754,2248.441601624,2164.594334457,136
carcassonne-boltzmann100-vs-boltzmann200-1000its,895,759,2189.702361596,2124.502423077,136
carcassonne-ucttuned485-vs-ucttuned410-1000its,897,761,2214.032205725,2163.840129841,136
carcassonne-uct400-vs-uct245-1000its,905,769,2187.261064266,2131.717580552,136
carcassonne-ucttuned20-vs-ucttuned390-1000its,908,772,2192.367302361,2143.731290011,136
carcassonne-uct425-vs-uct300-1000its,911,775,2220.99191624,2155.858723869,136
carcassonne-ucttuned260-vs-ucttuned400-1000its,915,779,2200.09827941,2119.595101335,136
carcassonne-ucttuned125-vs-ucttuned380-1000its,916,780,2230.656485824,2131.9055228,136
carcassonne-uct5-vs-uct80-1000its,920,784,2210.644526568,2129.758060481,136
carcassonne-uct400-vs-uct430-1000its,949,813,2286.781357547,2218.615410895,136
carcassonne-uct315-vs-uct225-1000its,969,833,2227.160784709,2174.811012178,136
carcassonne-uct205-vs-uct490-1000its,823,686,2238.208930281,2164.675196486,137
carcassonne-uct95-vs-uct380-1000its,825,688,2148.099983638,2072.775755302,137
carcassonne-ucttuned355-vs-ucttuned125-1000its,828,691,2163.105195108,2126.246401264,137
carcassonne-boltzmann315-vs-boltzmann185-1000its,833,696,2243.392212048,2195.954691702,137
carcassonne-uct215-vs-uct325-1000its,836,699,2275.561788715,2182.154559032,137
carcassonne-boltzmann370-vs-boltzmann105-1000its,837,700,2224.68090435,2173.151308818,137
carcassonne-uct340-vs-uct225-1000its,837,700,2219.867767013,2165.94822043,137
carcassonne-ucttuned470-vs-ucttuned430-1000its,841,704,2206.618672572,2168.066100716,137
carcassonne-ucttuned65-vs-ucttuned245-1000its,845,708,2191.824988753,2121.087400968,137
carcassonne-boltzmann285-vs-boltzmann405-1000its,851,714,2259.919487124,2191.607796305,137
carcassonne-uct230-vs-uct60-1000its,851,714,2192.824880943,2113.483165322,137
carcassonne-ucttuned300-vs-ucttuned320-1000its,854,717,2181.864131438,2131.163291459,137
carcassonne-ucttuned360-vs-ucttuned270-1000its,857,720,2255.649957347,2166.055507233,137
carcassonne-uct75-vs-uct220-1000its,861,724,2189.681052815,2104.804008436,137
carcassonne-boltzmann375-vs-boltzmann310-1000its,863,726,2186.617403217,2110.3191606,137
carcassonne-boltzmann250-vs-boltzmann185-1000its,864,727,2276.098609375,2207.462405634,137
carcassonne-ucttuned30-vs-ucttuned420-1000its,870,733,2216.547887159,2153.822725946,137
carcassonne-ucttuned110-vs-ucttuned205-1000its,876,739,2203.341613723,2136.315997429,137
carcassonne-boltzmann45-vs-boltzmann90-1000its,878,741,2195.784009025,2163.380785166,137
carcassonne-uct225-vs-uct35-1000its,880,743,2184.133216599,2184.212913318,137
carcassonne-ucttuned250-vs-ucttuned370-1000its,881,744,2151.467567728,2155.987273096,137
carcassonne-ucttuned95-vs-ucttuned200-1000its,881,744,2150.274628388,2161.32531427,137
carcassonne-uct460-vs-uct100-1000its,884,747,2157.967148895,2181.105095025,137
carcassonne-ucttuned60-vs-ucttuned340-1000its,884,747,2216.646630803,2147.968800148,137
carcassonne-ucttuned260-vs-ucttuned305-1000its,887,750,2219.275030579,2145.595451725,137
carcassonne-ucttuned330-vs-ucttuned45-1000its,888,751,2195.004122633,2173.827961184,137
carcassonne-ucttuned475-vs-ucttuned235-1000its,888,751,2226.308855997,2161.883735841,137
carcassonne-ucttuned50-vs-ucttuned460-1000its,889,752,2258.234758848,2202.40579747,137
carcassonne-ucttuned475-vs-ucttuned130-1000its,891,754,2178.29373378,2132.604631831,137
carcassonne-boltzmann185-vs-boltzmann445-1000its,896,759,2277.378462697,2207.503223581,137
carcassonne-ucttuned405-vs-ucttuned370-1000its,899,762,2208.966102243,2182.162458451,137
carcassonne-boltzmann425-vs-boltzmann85-1000its,912,775,2196.997135946,2137.0671199,137
carcassonne-ucttuned275-vs-ucttuned335-1000its,914,777,2246.263863717,2209.808048697,137
carcassonne-ucttuned190-vs-ucttuned435-1000its,916,779,2219.250951944,2189.032626458,137
carcassonne-uct80-vs-uct250-1000its,918,781,2165.603817272,2190.994052886,137
carcassonne-uct260-vs-uct400-1000its,926,789,2212.972683861,2128.626575376,137
carcassonne-ucttuned340-vs-ucttuned20-1000its,931,794,2245.633078551,2182.746214738,137
carcassonne-uct15-vs-uct310-1000its,940,803,2216.723093489,2178.680722281,137
carcassonne-boltzmann430-vs-boltzmann200-1000its,942,805,2202.871814111,2165.35930077,137
carcassonne-ucttuned140-vs-ucttuned420-1000its,978,841,2186.066468969,2125.579536961,137
carcassonne-boltzmann190-vs-boltzmann425-1000its,784,646,2208.621830293,2125.894452376,138
carcassonne-boltzmann170-vs-boltzmann120-1000its,805,667,2194.939454304,2188.043717583,138
carcassonne-uct320-vs-uct470-1000its,821,683,2136.601879324,2127.780964783,138
carcassonne-ucttuned230-vs-ucttuned185-1000its,824,686,2187.5799094,2087.414484749,138
carcassonne-boltzmann120-vs-boltzmann170-1000its,825,687,2206.754882613,2140.422392261,138
carcassonne-uct475-vs-uct210-1000its,837,699,2229.384144781,2172.741155299,138
carcassonne-ucttuned365-vs-ucttuned80-1000its,848,710,2185.874529954,2119.350950019,138
carcassonne-ucttuned485-vs-ucttuned170-1000its,848,710,2184.969573015,2132.274653734,138
carcassonne-ucttuned85-vs-ucttuned295-1000its,848,710,2230.301226192,2187.344740275,138
carcassonne-uct205-vs-uct160-1000its,850,712,2183.975870143,2123.925158829,138
carcassonne-ucttuned480-vs-ucttuned430-1000its,856,718,2177.266878398,2117.845883109,138
carcassonne-ucttuned145-vs-ucttuned170-1000its,859,721,2217.905147866,2203.029474941,138
carcassonne-boltzmann65-vs-boltzmann390-1000its,860,722,2192.012005835,2121.937264407,138
carcassonne-boltzmann440-vs-boltzmann270-1000its,864,726,2139.16477842,2095.276203347,138
carcassonne-boltzmann90-vs-boltzmann110-1000its,866,728,2207.398337075,2161.624699592,138
carcassonne-boltzmann475-vs-boltzmann435-1000its,867,729,2303.568772888,2280.286254941,138
carcassonne-ucttuned200-vs-ucttuned425-1000its,867,729,2204.376163164,2167.678165533,138
carcassonne-boltzmann135-vs-boltzmann215-1000its,872,734,2198.859171986,2178.9967849,138
carcassonne-uct315-vs-uct110-1000its,883,745,2206.959045784,2161.055819032,138
carcassonne-ucttuned390-vs-ucttuned80-1000its,884,746,2183.222437531,2147.361862929,138
carcassonne-uct445-vs-uct155-1000its,890,752,2231.012637294,2129.193824638,138
carcassonne-uct110-vs-uct315-1000its,894,756,2108.363102826,2093.140944592,138
carcassonne-uct55-vs-uct470-1000its,894,756,2208.790563943,2159.161250337,138
carcassonne-uct105-vs-uct290-1000its,895,757,2182.323065032,2139.087414378,138
carcassonne-ucttuned295-vs-ucttuned475-1000its,895,757,2237.19000104,2129.322165331,138
carcassonne-uct155-vs-uct445-1000its,903,765,2285.737598887,2226.990922869,138
carcassonne-boltzmann70-vs-boltzmann315-1000its,910,772,2173.691973778,2136.623396049,138
carcassonne-ucttuned315-vs-ucttuned265-1000its,911,773,2170.268987209,2086.251282337,138
carcassonne-ucttuned285-vs-ucttuned195-1000its,927,789,2189.174148142,2160.35214422,138
carcassonne-ucttuned150-vs-ucttuned260-1000its,931,793,2150.347535586,2127.106288026,138
carcassonne-uct105-vs-uct25-1000its,932,794,2149.113328646,2122.053410972,138
carcassonne-ucttuned105-vs-ucttuned45-1000its,949,811,2231.744803763,2157.718231789,138
carcassonne-uct455-vs-uct485-1000its,982,844,2199.028606768,2138.307566828,138
carcassonne-ucttuned150-vs-ucttuned85-1000its,1042,904,2146.825074017,2130.356839276,138
carcassonne-boltzmann390-vs-boltzmann360-1000its,815,676,2178.218039727,2128.083440783,139
carcassonne-boltzmann75-vs-boltzmann385-1000its,824,685,2149.883761524,2094.308974914,139
carcassonne-ucttuned25-vs-ucttuned435-1000its,831,692,2186.896092112,2163.678386184,139
carcassonne-boltzmann40-vs-boltzmann115-1000its,832,693,2199.287452221,2099.04605942,139
carcassonne-boltzmann195-vs-boltzmann415-1000its,833,694,2239.110225603,2161.148611795,139
carcassonne-uct235-vs-uct350-1000its,833,694,2220.490476074,2186.070123097,139
carcassonne-boltzmann390-vs-boltzmann180-1000its,836,697,2213.584188927,2177.260672351,139
carcassonne-uct345-vs-uct80-1000its,855,716,2183.96196951,2141.069738736,139
carcassonne-boltzmann360-vs-boltzmann75-1000its,865,726,2185.005996791,2176.945657414,139
carcassonne-ucttuned35-vs-ucttuned310-1000its,873,734,2183.339297945,2166.813372048,139
carcassonne-uct80-vs-uct450-1000its,876,737,2152.497052176,2103.612629786,139
carcassonne-ucttuned445-vs-ucttuned225-1000its,878,739,2153.213346281,2146.095463073,139
carcassonne-boltzmann325-vs-boltzmann385-1000its,880,741,2163.515781257,2144.062905574,139
carcassonne-uct10-vs-uct210-1000its,880,741,2181.267383781,2142.578201479,139
carcassonne-uct405-vs-uct275-1000its,881,742,2158.567077695,2106.207768865,139
carcassonne-uct425-vs-uct485-1000its,883,744,2150.077325212,2131.407945094,139
carcassonne-boltzmann30-vs-boltzmann310-1000its,884,745,2218.272190103,2131.719681378,139
carcassonne-boltzmann130-vs-boltzmann405-1000its,886,747,2262.259112568,2215.534136974,139
carcassonne-boltzmann430-vs-boltzmann455-1000its,887,748,2155.787641174,2138.742620173,139
carcassonne-ucttuned325-vs-ucttuned280-1000its,887,748,2197.981352457,2149.312984287,139
carcassonne-boltzmann445-vs-boltzmann155-1000its,891,752,2271.181267379,2189.334290306,139
carcassonne-ucttuned190-vs-ucttuned55-1000its,891,752,2247.125125522,2213.441480198,139
carcassonne-uct60-vs-uct390-1000its,896,757,2157.347111334,2111.475908908,139
carcassonne-ucttuned70-vs-ucttuned195-1000its,899,760,2226.603507819,2157.356869491,139
carcassonne-uct220-vs-uct380-1000its,901,762,2174.635056512,2142.741999708,139
carcassonne-ucttuned100-vs-ucttuned235-1000its,901,762,2263.398723334,2231.718764228,139
carcassonne-boltzmann265-vs-boltzmann250-1000its,905,766,2168.487743988,2100.29550811,139
carcassonne-ucttuned10-vs-ucttuned5-1000its,909,770,2164.982146665,2110.4139552,139
carcassonne-boltzmann445-vs-boltzmann120-1000its,915,776,2144.789219225,2119.917820407,139
carcassonne-boltzmann140-vs-boltzmann135-1000its,923,784,2248.848520226,2186.824029333,139
carcassonne-ucttuned110-vs-ucttuned170-1000its,946,807,2152.526534777,2163.02820179,139
carcassonne-ucttuned265-vs-ucttuned360-1000its,946,807,2219.030917766,2186.691848601,139
carcassonne-boltzmann10-vs-boltzmann330-1000its,1023,884,2217.537319839,2177.101666372,139
carcassonne-ucttuned440-vs-ucttuned215-1000its,779,639,2151.573220385,2126.86312391,140
carcassonne-boltzmann180-vs-boltzmann465-1000its,797,657,2202.309190958,2146.904436966,140
carcassonne-uct485-vs-uct420-1000its,804,664,2115.170381118,2079.360740257,140
carcassonne-ucttuned270-vs-ucttuned180-1000its,810,670,2161.13481148,2157.485627992,140
carcassonne-ucttuned495-vs-ucttuned290-1000its,817,677,2142.976643277,2118.166304662,140
carcassonne-boltzmann290-vs-boltzmann330-1000its,833,693,2196.424647038,2153.952091819,140
carcassonne-boltzmann300-vs-boltzmann280-1000its,835,695,2161.02355741,2114.548201409,140
carcassonne-ucttuned195-vs-ucttuned440-1000its,846,706,2210.147531472,2220.271645352,140
carcassonne-ucttuned490-vs-ucttuned365-1000its,848,708,2204.386553402,2164.221192697,140
carcassonne-uct105-vs-uct175-1000its,849,709,2226.504631351,2188.128333367,140
carcassonne-uct30-vs-uct460-1000its,850,710,2207.554305287,2180.833264933,140
carcassonne-uct460-vs-uct125-1000its,850,710,2200.253882381,2191.302198589,140
carcassonne-ucttuned105-vs-ucttuned465-1000its,851,711,2243.204547587,2226.69934206,140
carcassonne-boltzmann110-vs-boltzmann45-1000its,852,712,2204.120963407,2187.836116949,140
carcassonne-boltzmann5-vs-boltzmann270-1000its,854,714,2186.319806462,2123.158547333,140
carcassonne-uct150-vs-uct340-1000its,871,731,2207.552575466,2142.70537868,140
carcassonne-ucttuned165-vs-ucttuned470-1000its,875,735,2192.204126897,2099.169053109,140
carcassonne-uct330-vs-uct395-1000its,876,736,2236.554992133,2195.987077048,140
carcassonne-uct5-vs-uct225-1000its,877,737,2168.132660556,2071.26863519,140
carcassonne-uct145-vs-uct445-1000its,878,738,2210.677717429,2157.679938033,140
carcassonne-ucttuned470-vs-ucttuned280-1000its,885,745,2161.625969939,2143.359186873,140
carcassonne-boltzmann455-vs-boltzmann435-1000its,888,748,2220.874286356,2197.085921266,140
carcassonne-uct10-vs-uct130-1000its,892,752,2179.938565997,2145.185647586,140
carcassonne-uct190-vs-uct385-1000its,894,754,2263.233351331,2200.280645979,140
carcassonne-uct250-vs-uct220-1000its,897,757,2161.052877865,2153.470200599,140
carcassonne-ucttuned165-vs-ucttuned215-1000its,901,761,2217.522606007,2148.262091144,140
carcassonne-uct60-vs-uct45-1000its,902,762,2136.305102939,2124.053490714,140
carcassonne-boltzmann465-vs-boltzmann315-1000its,905,765,2147.641522703,2132.368993846,140
carcassonne-uct155-vs-uct170-1000its,906,766,2179.39861981,2125.898302736,140
carcassonne-uct270-vs-uct315-1000its,906,766,2225.728269851,2174.664830038,140
carcassonne-uct175-vs-uct415-1000its,907,767,2211.606052632,2199.651888821,140
carcassonne-uct340-vs-uct485-1000its,916,776,2227.873629466,2139.936935058,140
carcassonne-boltzmann225-vs-boltzmann485-1000its,918,778,2183.250087765,2135.571368837,140
carcassonne-boltzmann200-vs-boltzmann375-1000its,922,782,2148.540109828,2124.67026247,140
carcassonne-boltzmann25-vs-boltzmann345-1000its,922,782,2274.701901889,2206.070596764,140
carcassonne-uct25-vs-uct180-1000its,934,794,2188.645631399,2107.204450653,140
carcassonne-ucttuned280-vs-ucttuned440-1000its,935,795,2262.254031547,2189.97987763,140
carcassonne-ucttuned265-vs-ucttuned480-1000its,938,798,2154.319802856,2128.460154214,140
carcassonne-ucttuned5-vs-ucttuned255-1000its,976,836,2236.240100185,2168.922060086,140
carcassonne-uct370-vs-uct380-1000its,992,852,2242.641186855,2179.061703834,140
carcassonne-boltzmann25-vs-boltzmann340-1000its,733,592,1758.531226633,1693.608662231,141
carcassonne-uct100-vs-uct425-1000its,803,662,2209.823922836,2142.88142816,141
carcassonne-uct145-vs-uct395-1000its,813,672,2199.770188281,2121.5096476,141
carcassonne-uct385-vs-uct160-1000its,814,673,2203.161028002,2135.68651965,141
carcassonne-ucttuned225-vs-ucttuned240-1000its,818,677,2221.859848012,2156.455070645,141
carcassonne-uct140-vs-uct365-1000its,819,678,2150.472605956,2087.741928241,141
carcassonne-ucttuned465-vs-ucttuned485-1000its,826,685,2202.763989104,2164.095996776,141
carcassonne-boltzmann350-vs-boltzmann325-1000its,833,692,2216.063502052,2147.128899937,141
carcassonne-ucttuned15-vs-ucttuned190-1000its,845,704,2217.535902881,2156.018470454,141
carcassonne-uct385-vs-uct310-1000its,848,707,2173.775138813,2155.185173875,141
carcassonne-boltzmann315-vs-boltzmann390-1000its,849,708,2243.090585258,2213.494760484,141
carcassonne-boltzmann310-vs-boltzmann265-1000its,850,709,2190.330736252,2180.755001982,141
carcassonne-ucttuned110-vs-ucttuned460-1000its,858,717,2268.767081428,2190.626755051,141
carcassonne-boltzmann250-vs-boltzmann165-1000its,860,719,2182.038810628,2141.860018791,141
carcassonne-ucttuned10-vs-ucttuned185-1000its,861,720,2206.27267007,2160.483736137,141
carcassonne-boltzmann35-vs-boltzmann245-1000its,863,722,2204.835718923,2162.7836495,141
carcassonne-ucttuned185-vs-ucttuned85-1000its,863,722,2219.664288196,2175.548912069,141
carcassonne-boltzmann160-vs-boltzmann355-1000its,875,734,2278.930352008,2260.795395827,141
carcassonne-boltzmann420-vs-boltzmann85-1000its,879,738,2161.619566231,2152.907023057,141
carcassonne-boltzmann315-vs-boltzmann120-1000its,880,739,2168.24706089,2152.162159484,141
carcassonne-uct495-vs-uct180-1000its,880,739,2153.480800174,2129.817204395,141
carcassonne-uct140-vs-uct175-1000its,890,749,2245.975513765,2226.658862765,141
carcassonne-boltzmann415-vs-boltzmann75-1000its,891,750,2151.091901831,2130.158987262,141
carcassonne-ucttuned175-vs-ucttuned405-1000its,892,751,2189.408866588,2179.346868359,141
carcassonne-uct65-vs-uct330-1000its,897,756,2223.511820534,2161.27455795,141
carcassonne-boltzmann200-vs-boltzmann315-1000its,898,757,2236.998631289,2151.680904653,141
carcassonne-ucttuned15-vs-ucttuned370-1000its,899,758,2193.420100413,2160.419206601,141
carcassonne-uct80-vs-uct260-1000its,908,767,2163.067027178,2136.116587851,141
carcassonne-uct350-vs-uct85-1000its,914,773,2232.267369415,2116.083443162,141
carcassonne-uct340-vs-uct115-1000its,922,781,2238.307076591,2167.898450503,141
carcassonne-uct60-vs-uct270-1000its,930,789,2238.47355735,2166.05348837,141
carcassonne-uct320-vs-uct45-1000its,937,796,2314.354317374,2218.228304958,141
carcassonne-ucttuned485-vs-ucttuned350-1000its,938,797,2218.465827366,2154.703716613,141
carcassonne-ucttuned100-vs-ucttuned265-1000its,944,803,2145.115133596,2107.581341005,141
carcassonne-ucttuned395-vs-ucttuned205-1000its,944,803,2185.186125941,2165.072865252,141
carcassonne-uct10-vs-uct455-1000its,956,815,2162.871757027,2128.541126367,141
carcassonne-ucttuned25-vs-ucttuned325-1000its,959,818,2163.421847202,2118.307006458,141
carcassonne-boltzmann340-vs-boltzmann55-1000its,1069,928,2249.168506813,2174.882327991,141
carcassonne-uct90-vs-uct265-1000its,794,652,2172.271875389,2118.254771657,142
carcassonne-uct385-vs-uct165-1000its,807,665,2148.095525831,2111.5757964,142
carcassonne-uct355-vs-uct210-1000its,819,677,2203.152923802,2131.344508272,142
carcassonne-boltzmann160-vs-boltzmann420-1000its,821,679,2230.298456738,2212.823651989,142
carcassonne-uct165-vs-uct225-1000its,837,695,2161.882944611,2132.645432811,142
carcassonne-uct380-vs-uct55-1000its,844,702,2161.972561262,2072.547935599,142
carcassonne-uct315-vs-uct175-1000its,849,707,2215.406139396,2182.371328895,142
carcassonne-uct380-vs-uct15-1000its,856,714,2305.346339439,2224.618373548,142
carcassonne-boltzmann235-vs-boltzmann475-1000its,857,715,2154.772753358,2119.581853352,142
carcassonne-uct275-vs-uct370-1000its,858,716,2202.510104549,2130.890103019,142
carcassonne-ucttuned215-vs-ucttuned435-1000its,863,721,2103.638324994,2069.944935095,142
carcassonne-ucttuned210-vs-ucttuned100-1000its,865,723,2172.482258272,2132.543624101,142
carcassonne-ucttuned340-vs-ucttuned15-1000its,873,731,2311.566152816,2199.879569274,142
carcassonne-uct175-vs-uct300-1000its,881,739,2260.337876334,2227.3796308,142
carcassonne-ucttuned160-vs-ucttuned470-1000its,882,740,2222.719739541,2183.534355754,142
carcassonne-uct200-vs-uct45-1000its,883,741,2149.118920146,2111.058374219,142
carcassonne-ucttuned85-vs-ucttuned345-1000its,889,747,2151.378971357,2106.154864085,142
carcassonne-uct490-vs-uct225-1000its,896,754,2181.764195527,2166.569568112,142
carcassonne-ucttuned290-vs-ucttuned495-1000its,908,766,2256.269185312,2197.302750163,142
carcassonne-boltzmann440-vs-boltzmann385-1000its,925,783,2110.407155704,2065.278977096,142
carcassonne-ucttuned120-vs-ucttuned160-1000its,930,788,2205.939208925,2128.669555629,142
carcassonne-ucttuned130-vs-ucttuned380-1000its,947,805,2189.178324451,2151.757551769,142
carcassonne-ucttuned470-vs-ucttuned460-1000its,951,809,2250.138058908,2194.684209625,142
carcassonne-uct445-vs-uct410-1000its,963,821,2251.303147568,2170.242969756,142
carcassonne-uct5-vs-uct100-1000its,966,824,2206.12908785,2144.656507679,142
carcassonne-ucttuned30-vs-ucttuned485-1000its,1130,988,2231.707197207,2168.054990027,142
carcassonne-boltzmann170-vs-boltzmann390-1000its,791,648,2169.388658152,2184.029026696,143
carcassonne-boltzmann40-vs-boltzmann165-1000its,809,666,2203.537665593,2153.485319469,143
carcassonne-boltzmann480-vs-boltzmann155-1000its,810,667,2195.782316336,2136.027522604,143
carcassonne-boltzmann15-vs-boltzmann70-1000its,826,683,2199.475105401,2126.63211683,143
carcassonne-ucttuned160-vs-ucttuned125-1000its,831,688,2220.976997532,2133.961522582,143
carcassonne-uct90-vs-uct420-1000its,840,697,2244.659746061,2187.171002424,143
carcassonne-uct210-vs-uct155-1000its,842,699,2182.938970927,2151.340495765,143
carcassonne-boltzmann90-vs-boltzmann245-1000its,844,701,2171.032024453,2117.021587025,143
carcassonne-uct275-vs-uct95-1000its,845,702,2209.931182144,2145.190588492,143
carcassonne-ucttuned115-vs-ucttuned310-1000its,847,704,2258.119176459,2207.439094098,143
carcassonne-boltzmann5-vs-boltzmann60-1000its,848,705,2178.225235426,2135.448936715,143
carcassonne-boltzmann135-vs-boltzmann240-1000its,853,710,2190.753896965,2150.473461882,143
carcassonne-ucttuned75-vs-ucttuned415-1000its,859,716,2199.537247086,2150.893924763,143
carcassonne-ucttuned20-vs-ucttuned450-1000its,864,721,2194.789109534,2168.993759565,143
carcassonne-boltzmann245-vs-boltzmann430-1000its,866,723,2141.813363992,2133.06388251,143
carcassonne-boltzmann485-vs-boltzmann255-1000its,869,726,2203.022782348,2195.627914641,143
carcassonne-boltzmann30-vs-boltzmann270-1000its,870,727,2235.883977735,2173.77734408,143
carcassonne-boltzmann175-vs-boltzmann55-1000its,873,730,2180.822185428,2103.014954671,143
carcassonne-uct355-vs-uct295-1000its,877,734,2159.592893612,2092.77091017,143
carcassonne-ucttuned430-vs-ucttuned440-1000its,881,738,2199.671083089,2146.073677917,143
carcassonne-ucttuned270-vs-ucttuned175-1000its,882,739,2190.153738351,2162.258603246,143
carcassonne-uct275-vs-uct305-1000its,883,740,2213.686822166,2127.634353327,143
carcassonne-boltzmann470-vs-boltzmann65-1000its,885,742,2143.147001919,2152.033347959,143
carcassonne-uct330-vs-uct115-1000its,886,743,2139.71674897,2066.22225088,143
carcassonne-boltzmann415-vs-boltzmann315-1000its,888,745,2223.100462386,2182.102052289,143
carcassonne-ucttuned100-vs-ucttuned495-1000its,902,759,2160.574628869,2133.473598364,143
carcassonne-ucttuned100-vs-ucttuned490-1000its,904,761,2223.334236466,2154.546626764,143
carcassonne-uct330-vs-uct335-1000its,908,765,2152.129294921,2132.434183178,143
carcassonne-boltzmann190-vs-boltzmann445-1000its,912,769,2192.870770743,2167.603192539,143
carcassonne-uct360-vs-uct185-1000its,914,771,2183.952019011,2159.201960206,143
carcassonne-ucttuned290-vs-ucttuned230-1000its,931,788,2244.693281054,2168.243428417,143
carcassonne-ucttuned205-vs-ucttuned275-1000its,939,796,2164.687955775,2142.728615815,143
carcassonne-uct280-vs-uct255-1000its,943,800,2156.276510164,2099.944382468,143
carcassonne-uct485-vs-uct185-1000its,948,805,2281.448084829,2239.227789706,143
carcassonne-ucttuned35-vs-ucttuned220-1000its,960,817,2126.022450795,2062.574434188,143
carcassonne-boltzmann15-vs-boltzmann145-1000its,966,823,2307.010431123,2247.738618992,143
carcassonne-uct190-vs-uct335-1000its,966,823,2174.39069349,2163.321308142,143
carcassonne-boltzmann345-vs-boltzmann230-1000its,808,664,2187.534805835,2137.829603677,144
carcassonne-ucttuned485-vs-ucttuned265-1000its,808,664,2186.665469319,2139.633938348,144
carcassonne-uct75-vs-uct195-1000its,827,683,2250.781779423,2169.326504794,144
carcassonne-boltzmann280-vs-boltzmann350-1000its,828,684,2159.651459881,2136.371093953,144
carcassonne-uct440-vs-uct175-1000its,833,689,2270.452553699,2208.595546082,144
carcassonne-boltzmann105-vs-boltzmann435-1000its,839,695,2229.091354706,2175.01331471,144
carcassonne-boltzmann325-vs-boltzmann340-1000its,843,699,2221.474273188,2164.599864302,144
carcassonne-uct225-vs-uct135-1000its,859,715,2218.946188047,2183.116090368,144
carcassonne-ucttuned30-vs-ucttuned365-1000its,859,715,2175.318428389,2120.566672927,144
carcassonne-uct90-vs-uct460-1000its,867,723,2206.890937253,2139.852301753,144
carcassonne-ucttuned480-vs-ucttuned485-1000its,871,727,2163.073911665,2122.706079444,144
carcassonne-boltzmann10-vs-boltzmann300-1000its,877,733,2141.68397089,2046.1049574,144
carcassonne-ucttuned10-vs-ucttuned390-1000its,888,744,2166.957153772,2152.639085391,144
carcassonne-boltzmann405-vs-boltzmann245-1000its,890,746,2166.906223004,2139.850095793,144
carcassonne-uct385-vs-uct445-1000its,891,747,2149.467462542,2104.542855363,144
carcassonne-uct330-vs-uct80-1000its,895,751,2222.054134244,2185.081427886,144
carcassonne-uct435-vs-uct315-1000its,895,751,2116.821093142,2080.370391532,144
carcassonne-uct295-vs-uct265-1000its,897,753,2222.772220592,2153.871851602,144
carcassonne-boltzmann175-vs-boltzmann285-1000its,905,761,2231.474910573,2162.802218968,144
carcassonne-uct350-vs-uct310-1000its,907,763,2135.006289149,2120.234084916,144
carcassonne-ucttuned50-vs-ucttuned220-1000its,907,763,2186.099955882,2118.005073807,144
carcassonne-ucttuned325-vs-ucttuned210-1000its,911,767,2198.829080839,2151.930076444,144
carcassonne-ucttuned10-vs-ucttuned70-1000its,920,776,2219.260207204,2171.275693344,144
carcassonne-boltzmann5-vs-boltzmann465-1000its,974,830,2233.563990496,2169.253801687,144
carcassonne-boltzmann50-vs-boltzmann200-1000its,996,852,2235.183342569,2235.282399596,144
carcassonne-boltzmann440-vs-boltzmann475-1000its,772,627,2170.281398843,2134.448520693,145
carcassonne-ucttuned425-vs-ucttuned495-1000its,816,671,2174.219739146,2161.585698787,145
carcassonne-boltzmann220-vs-boltzmann25-1000its,818,673,2183.341208584,2117.56695608,145
carcassonne-ucttuned420-vs-ucttuned235-1000its,818,673,2164.756060945,2136.739686079,145
carcassonne-uct370-vs-uct80-1000its,819,674,2200.334893099,2168.41671829,145
carcassonne-boltzmann155-vs-boltzmann50-1000its,825,680,2163.86417076,2138.703982681,145
carcassonne-ucttuned5-vs-ucttuned385-1000its,842,697,2193.014162771,2118.451380507,145
carcassonne-ucttuned80-vs-ucttuned315-1000its,846,701,2191.245187123,2157.916981387,145
carcassonne-uct25-vs-uct220-1000its,854,709,2155.990122959,2081.86873105,145
carcassonne-boltzmann400-vs-boltzmann190-1000its,858,713,2193.366090093,2169.071049302,145
carcassonne-boltzmann375-vs-boltzmann460-1000its,865,720,2197.598165608,2149.027068595,145
carcassonne-boltzmann205-vs-boltzmann420-1000its,870,725,2260.403584789,2210.499249451,145
carcassonne-ucttuned415-vs-ucttuned475-1000its,879,734,2218.989741913,2159.621799812,145
carcassonne-boltzmann420-vs-boltzmann330-1000its,880,735,2181.841368726,2131.111787528,145
carcassonne-ucttuned215-vs-ucttuned55-1000its,880,735,2127.933747697,2110.535235841,145
carcassonne-ucttuned50-vs-ucttuned60-1000its,880,735,2221.219522602,2138.540729083,145
carcassonne-ucttuned30-vs-ucttuned140-1000its,886,741,2170.320736729,2160.458468002,145
carcassonne-uct270-vs-uct310-1000its,890,745,2251.629040719,2211.604943127,145
carcassonne-uct410-vs-uct325-1000its,890,745,2145.991089919,2082.753714021,145
carcassonne-ucttuned280-vs-ucttuned70-1000its,891,746,2175.941356841,2122.963844967,145
carcassonne-boltzmann130-vs-boltzmann410-1000its,907,762,2126.454153059,2148.576040231,145
carcassonne-boltzmann440-vs-boltzmann250-1000its,913,768,2230.615981043,2183.218675425,145
carcassonne-uct110-vs-uct290-1000its,913,768,2132.840031923,2093.780629672,145
carcassonne-ucttuned380-vs-ucttuned145-1000its,913,768,2223.90648951,2178.083193722,145
carcassonne-boltzmann120-vs-boltzmann50-1000its,926,781,2186.871112812,2166.987356117,145
carcassonne-ucttuned30-vs-ucttuned345-1000its,926,781,2182.797046512,2127.400460956,145
carcassonne-ucttuned10-vs-ucttuned340-1000its,933,788,2161.11115836,2087.244044526,145
carcassonne-ucttuned150-vs-ucttuned335-1000its,937,792,2227.187466652,2164.307103947,145
carcassonne-uct265-vs-uct355-1000its,799,653,2192.878769592,2152.151259468,146
carcassonne-ucttuned380-vs-ucttuned480-1000its,824,678,2163.527824886,2114.883471337,146
carcassonne-boltzmann180-vs-boltzmann460-1000its,830,684,2218.400463791,2169.998833499,146
carcassonne-ucttuned125-vs-ucttuned160-1000its,838,692,2184.046158325,2150.759552952,146
carcassonne-ucttuned115-vs-ucttuned235-1000its,849,703,2136.312509564,2087.17354794,146
carcassonne-ucttuned495-vs-ucttuned470-1000its,853,707,2174.069977756,2157.306301712,146
carcassonne-boltzmann225-vs-boltzmann35-1000its,854,708,2217.178562459,2144.506729543,146
carcassonne-ucttuned200-vs-ucttuned145-1000its,861,715,2129.137560617,2051.080305263,146
carcassonne-ucttuned390-vs-ucttuned400-1000its,868,722,2112.550030198,2070.099800058,146
carcassonne-boltzmann115-vs-boltzmann455-1000its,873,727,2180.663874998,2113.748001807,146
carcassonne-boltzmann415-vs-boltzmann250-1000its,875,729,2188.311259653,2160.283331572,146
carcassonne-uct65-vs-uct100-1000its,878,732,2192.687180938,2120.61602477,146
carcassonne-uct450-vs-uct200-1000its,881,735,2198.83860452,2149.415459023,146
carcassonne-boltzmann70-vs-boltzmann205-1000its,882,736,2202.530395943,2174.911225402,146
carcassonne-uct395-vs-uct180-1000its,892,746,2193.700325429,2174.475274212,146
carcassonne-ucttuned370-vs-ucttuned240-1000its,893,747,2282.081344785,2242.630483917,146
carcassonne-ucttuned150-vs-ucttuned340-1000its,898,752,2136.225165284,2098.735408176,146
carcassonne-ucttuned10-vs-ucttuned495-1000its,900,754,2170.945407332,2109.64427724,146
carcassonne-ucttuned150-vs-ucttuned320-1000its,901,755,2179.209207526,2145.202921881,146
carcassonne-boltzmann490-vs-boltzmann365-1000its,908,762,2195.402614283,2149.351437579,146
carcassonne-boltzmann430-vs-boltzmann425-1000its,914,768,2149.708381387,2101.227301909,146
carcassonne-boltzmann325-vs-boltzmann190-1000its,919,773,2184.370137385,2191.752084949,146
carcassonne-uct350-vs-uct240-1000its,926,780,2178.391471327,2114.949896409,146
carcassonne-uct495-vs-uct375-1000its,927,781,2203.359823158,2155.343560367,146
carcassonne-ucttuned275-vs-ucttuned290-1000its,928,782,2252.270195748,2205.545927469,146
carcassonne-uct30-vs-uct445-1000its,962,816,2179.579843371,2158.066101521,146
carcassonne-uct410-vs-uct310-1000its,983,837,2241.825405114,2161.416623631,146
carcassonne-ucttuned40-vs-ucttuned355-1000its,986,840,2161.892754896,2133.36218455,146
carcassonne-uct110-vs-uct285-1000its,815,668,2211.990698329,2170.942148197,147
carcassonne-boltzmann455-vs-boltzmann350-1000its,827,680,2218.082984438,2137.315749932,147
carcassonne-uct460-vs-uct455-1000its,828,681,2150.148218896,2089.980631437,147
carcassonne-uct15-vs-uct190-1000its,837,690,2215.892263722,2208.229994131,147
carcassonne-ucttuned430-vs-ucttuned95-1000its,837,690,2250.774674876,2218.261758305,147
carcassonne-boltzmann415-vs-boltzmann385-1000its,838,691,2186.689894065,2141.365912217,147
carcassonne-boltzmann335-vs-boltzmann20-1000its,842,695,2214.310852763,2142.388952087,147
carcassonne-boltzmann390-vs-boltzmann30-1000its,844,697,2198.631769016,2147.086264386,147
carcassonne-boltzmann15-vs-boltzmann125-1000its,852,705,2132.923156846,2097.378289934,147
carcassonne-uct110-vs-uct210-1000its,852,705,2234.725642091,2169.506493572,147
carcassonne-uct15-vs-uct355-1000its,853,706,2187.833493801,2093.492898034,147
carcassonne-uct410-vs-uct495-1000its,854,707,2177.784216795,2140.161669101,147
carcassonne-boltzmann340-vs-boltzmann80-1000its,858,711,2184.551362218,2105.047567265,147
carcassonne-ucttuned425-vs-ucttuned10-1000its,858,711,2259.604047584,2248.504647244,147
carcassonne-uct65-vs-uct275-1000its,861,714,2200.307576997,2155.816488469,147
carcassonne-ucttuned470-vs-ucttuned320-1000its,861,714,2172.302891077,2110.685138221,147
carcassonne-boltzmann100-vs-boltzmann330-1000its,862,715,2224.289155713,2124.691095296,147
carcassonne-boltzmann465-vs-boltzmann145-1000its,865,718,2177.190061035,2130.30956298,147
carcassonne-boltzmann40-vs-boltzmann350-1000its,866,719,2167.782883421,2138.868790818,147
carcassonne-uct410-vs-uct425-1000its,867,720,2165.930290797,2132.623111707,147
carcassonne-boltzmann175-vs-boltzmann185-1000its,868,721,2143.221760972,2083.976219361,147
carcassonne-uct415-vs-uct105-1000its,870,723,2174.192738215,2127.647275473,147
carcassonne-ucttuned15-vs-ucttuned35-1000its,884,737,2198.129619166,2111.683905836,147
carcassonne-uct220-vs-uct105-1000its,885,738,2222.851856936,2170.322065155,147
carcassonne-ucttuned85-vs-ucttuned110-1000its,885,738,2180.592507945,2148.448794877,147
carcassonne-boltzmann265-vs-boltzmann305-1000its,887,740,2239.051574077,2191.319246847,147
carcassonne-ucttuned50-vs-ucttuned45-1000its,895,748,2230.363747991,2179.998382387,147
carcassonne-ucttuned435-vs-ucttuned215-1000its,896,749,2236.01716048,2236.26074375,147
carcassonne-boltzmann310-vs-boltzmann380-1000its,898,751,2206.967299724,2152.906153278,147
carcassonne-ucttuned245-vs-ucttuned225-1000its,900,753,2206.068155009,2143.297639734,147
carcassonne-uct180-vs-uct325-1000its,906,759,2209.970019945,2172.797500345,147
carcassonne-uct460-vs-uct285-1000its,912,765,2148.746301707,2075.356952959,147
carcassonne-ucttuned10-vs-ucttuned90-1000its,917,770,2269.297758872,2198.132396257,147
carcassonne-uct165-vs-uct490-1000its,921,774,2156.725036143,2144.323846247,147
carcassonne-boltzmann265-vs-boltzmann75-1000its,924,777,2146.470896771,2123.391370933,147
carcassonne-ucttuned365-vs-ucttuned330-1000its,930,783,2242.280120879,2166.177503113,147
carcassonne-boltzmann20-vs-boltzmann270-1000its,931,784,2270.247667477,2179.488522372,147
carcassonne-uct105-vs-uct400-1000its,941,794,2229.057697358,2212.903206944,147
carcassonne-ucttuned490-vs-ucttuned245-1000its,965,818,2100.745690752,2080.814339285,147
carcassonne-boltzmann10-vs-boltzmann75-1000its,970,823,2181.622679113,2153.289062277,147
carcassonne-ucttuned215-vs-ucttuned395-1000its,980,833,2198.349114838,2162.622446609,147
carcassonne-boltzmann380-vs-boltzmann300-1000its,823,675,2165.800073803,2131.111492137,148
carcassonne-boltzmann65-vs-boltzmann340-1000its,826,678,2187.014289786,2093.835232886,148
carcassonne-ucttuned475-vs-ucttuned425-1000its,832,684,2121.818141773,2101.649929935,148
carcassonne-boltzmann330-vs-boltzmann150-1000its,834,686,2144.852112914,2099.291238155,148
carcassonne-uct45-vs-uct255-1000its,836,688,2249.039989088,2167.091991978,148
carcassonne-uct340-vs-uct275-1000its,838,690,2225.998036402,2184.064441299,148
carcassonne-ucttuned125-vs-ucttuned490-1000its,847,699,2297.169455137,2267.086156507,148
carcassonne-boltzmann270-vs-boltzmann410-1000its,850,702,2246.913913975,2184.103080122,148
carcassonne-uct300-vs-uct360-1000its,857,709,2209.746342317,2166.58583685,148
carcassonne-uct495-vs-uct460-1000its,862,714,2204.595716038,2180.670456402,148
carcassonne-uct345-vs-uct205-1000its,863,715,2189.395582107,2135.92238078,148
carcassonne-ucttuned215-vs-ucttuned170-1000its,867,719,2204.40662743,2138.591639671,148
carcassonne-boltzmann460-vs-boltzmann400-1000its,872,724,2189.883798479,2153.045889316,148
carcassonne-boltzmann315-vs-boltzmann180-1000its,876,728,2180.21931983,2135.636708309,148
carcassonne-uct445-vs-uct105-1000its,877,729,2284.984759477,2212.963250748,148
carcassonne-ucttuned135-vs-ucttuned435-1000its,878,730,2151.271866471,2101.960831464,148
carcassonne-ucttuned225-vs-ucttuned25-1000its,883,735,2281.400447453,2259.209287732,148
carcassonne-ucttuned85-vs-ucttuned275-1000its,886,738,2153.706988727,2123.023093635,148
carcassonne-ucttuned100-vs-ucttuned25-1000its,887,739,2279.434798625,2256.195291062,148
carcassonne-ucttuned45-vs-ucttuned445-1000its,889,741,2213.893829355,2167.682608293,148
carcassonne-uct260-vs-uct270-1000its,894,746,2139.972303996,2134.535561843,148
carcassonne-boltzmann290-vs-boltzmann195-1000its,898,750,2169.308313021,2146.278835984,148
carcassonne-boltzmann65-vs-boltzmann465-1000its,903,755,2240.166890066,2211.0177733,148
carcassonne-ucttuned475-vs-ucttuned470-1000its,907,759,2217.887958811,2157.598594272,148
carcassonne-uct150-vs-uct410-1000its,913,765,2190.506628871,2172.575744035,148
carcassonne-ucttuned15-vs-ucttuned280-1000its,920,772,2242.519735802,2159.582382247,148
carcassonne-ucttuned225-vs-ucttuned145-1000its,923,775,2230.657312964,2198.960314681,148
carcassonne-uct185-vs-uct40-1000its,926,778,2181.511898316,2122.500788511,148
carcassonne-uct40-vs-uct465-1000its,928,780,2214.385030152,2146.538579544,148
carcassonne-ucttuned385-vs-ucttuned435-1000its,936,788,2274.271550978,2194.448512746,148
carcassonne-ucttuned45-vs-ucttuned455-1000its,814,665,2216.258216252,2188.393316864,149
carcassonne-boltzmann405-vs-boltzmann60-1000its,828,679,2270.379569017,2221.966187282,149
carcassonne-boltzmann265-vs-boltzmann215-1000its,842,693,2239.675474393,2202.67921982,149
carcassonne-ucttuned55-vs-ucttuned310-1000its,842,693,2183.573429853,2132.162785203,149
carcassonne-uct110-vs-uct250-1000its,844,695,2331.620581191,2263.675446237,149
carcassonne-boltzmann350-vs-boltzmann425-1000its,847,698,2228.648639643,2151.454414205,149
carcassonne-uct220-vs-uct80-1000its,852,703,2174.644705196,2187.719521594,149
carcassonne-boltzmann395-vs-boltzmann455-1000its,855,706,2177.72597248,2112.215025196,149
carcassonne-boltzmann80-vs-boltzmann330-1000its,858,709,2210.518073396,2166.360649824,149
carcassonne-boltzmann45-vs-boltzmann320-1000its,865,716,2208.07454072,2122.910312696,149
carcassonne-boltzmann220-vs-boltzmann335-1000its,872,723,2202.008143212,2139.169451202,149
carcassonne-uct320-vs-uct195-1000its,872,723,2232.848992522,2155.492486183,149
carcassonne-uct410-vs-uct315-1000its,875,726,2146.388654449,2124.024314995,149
carcassonne-boltzmann130-vs-boltzmann250-1000its,876,727,2137.69402607,2106.393619128,149
carcassonne-boltzmann400-vs-boltzmann390-1000its,878,729,2121.967110861,2100.676097361,149
carcassonne-boltzmann145-vs-boltzmann250-1000its,879,730,2184.686455145,2148.494314159,149
carcassonne-ucttuned265-vs-ucttuned300-1000its,881,732,2258.687060102,2216.347676644,149
carcassonne-boltzmann40-vs-boltzmann200-1000its,882,733,2220.823880314,2165.236950721,149
carcassonne-boltzmann410-vs-boltzmann355-1000its,882,733,2167.54085043,2118.207807714,149
carcassonne-ucttuned105-vs-ucttuned275-1000its,885,736,2215.977249581,2181.204462,149
carcassonne-uct335-vs-uct195-1000its,889,740,2217.857391679,2092.95724719,149
carcassonne-uct415-vs-uct310-1000its,894,745,2179.489513178,2126.659101471,149
carcassonne-ucttuned310-vs-ucttuned200-1000its,895,746,2228.752563711,2173.820197717,149
carcassonne-uct160-vs-uct435-1000its,896,747,2162.106401408,2098.341282928,149
carcassonne-uct100-vs-uct385-1000its,898,749,2217.467439606,2170.086292418,149
carcassonne-uct305-vs-uct170-1000its,906,757,2232.753647049,2178.194867281,149
carcassonne-boltzmann65-vs-boltzmann170-1000its,908,759,2179.990312864,2152.673795225,149
carcassonne-ucttuned205-vs-ucttuned65-1000its,909,760,2207.667168357,2154.933567813,149
carcassonne-ucttuned35-vs-ucttuned150-1000its,909,760,2168.801807846,2178.641533655,149
carcassonne-boltzmann15-vs-boltzmann440-1000its,910,761,2275.993333731,2231.705375438,149
carcassonne-boltzmann20-vs-boltzmann230-1000its,910,761,2170.844382604,2122.851931245,149
carcassonne-uct195-vs-uct375-1000its,978,829,2246.193060133,2187.512042712,149
carcassonne-ucttuned480-vs-ucttuned340-1000its,978,829,2195.69859512,2121.246632742,149
carcassonne-boltzmann250-vs-boltzmann420-1000its,821,671,2158.000251431,2101.517109651,150
carcassonne-uct50-vs-uct475-1000its,848,698,2245.879960109,2178.916352535,150
carcassonne-boltzmann390-vs-boltzmann225-1000its,849,699,2174.760951066,2127.6756234,150
carcassonne-boltzmann105-vs-boltzmann350-1000its,854,704,2170.289973698,2101.084210787,150
carcassonne-ucttuned110-vs-ucttuned380-1000its,854,704,2208.71605578,2194.078690794,150
carcassonne-uct40-vs-uct320-1000its,859,709,2163.212126665,2131.380360464,150
carcassonne-uct375-vs-uct125-1000its,860,710,2163.170089229,2130.49403581,150
carcassonne-ucttuned370-vs-ucttuned375-1000its,862,712,2239.576707304,2224.949090355,150
carcassonne-boltzmann360-vs-boltzmann105-1000its,876,726,2189.726521237,2163.880247385,150
carcassonne-ucttuned340-vs-ucttuned355-1000its,891,741,2279.827878437,2221.368915581,150
carcassonne-ucttuned400-vs-ucttuned390-1000its,893,743,2187.564250348,2105.267313178,150
carcassonne-uct330-vs-uct105-1000its,895,745,2169.412820449,2107.580846226,150
carcassonne-uct190-vs-uct50-1000its,896,746,2168.391923875,2111.887119346,150
carcassonne-boltzmann420-vs-boltzmann100-1000its,903,753,2144.242756205,2081.215368811,150
carcassonne-uct135-vs-uct390-1000its,906,756,2207.58582899,2193.587559685,150
carcassonne-ucttuned225-vs-ucttuned330-1000its,915,765,2172.03053093,2158.442234418,150
carcassonne-ucttuned145-vs-ucttuned240-1000its,928,778,2207.346914521,2129.303178216,150
carcassonne-uct215-vs-uct105-1000its,937,787,2129.445609992,2097.799894639,150
carcassonne-ucttuned185-vs-ucttuned465-1000its,951,801,2182.249099439,2112.071374875,150
carcassonne-ucttuned275-vs-ucttuned260-1000its,957,807,2254.820530727,2222.952152728,150
carcassonne-boltzmann470-vs-boltzmann160-1000its,797,646,2220.174562758,2151.622668813,151
carcassonne-boltzmann145-vs-boltzmann405-1000its,806,655,2263.708583293,2219.270027584,151
carcassonne-ucttuned150-vs-ucttuned155-1000its,821,670,2231.298714238,2212.943498646,151
carcassonne-boltzmann220-vs-boltzmann430-1000its,840,689,2190.009494738,2152.721094536,151
carcassonne-boltzmann235-vs-boltzmann365-1000its,840,689,2259.03726939,2173.47558336,151
carcassonne-ucttuned105-vs-ucttuned15-1000its,852,701,2178.486812275,2167.031630394,151
carcassonne-uct125-vs-uct415-1000its,854,703,2177.869411635,2131.589210757,151
carcassonne-ucttuned485-vs-ucttuned205-1000its,859,708,2203.041875464,2163.359977231,151
carcassonne-boltzmann240-vs-boltzmann320-1000its,860,709,2245.334307457,2173.554308648,151
carcassonne-ucttuned405-vs-ucttuned225-1000its,860,709,2212.493605911,2157.905387278,151
carcassonne-boltzmann235-vs-boltzmann485-1000its,864,713,2181.586766695,2136.291235785,151
carcassonne-ucttuned485-vs-ucttuned185-1000its,865,714,2193.779078867,2156.894255175,151
carcassonne-uct150-vs-uct485-1000its,866,715,2235.150953931,2188.433401693,151
carcassonne-ucttuned345-vs-ucttuned460-1000its,873,722,2162.810976596,2117.451872117,151
carcassonne-ucttuned25-vs-ucttuned470-1000its,886,735,2181.83817966,2141.281926191,151
carcassonne-ucttuned20-vs-ucttuned230-1000its,889,738,2263.945329456,2230.873614898,151
carcassonne-boltzmann130-vs-boltzmann450-1000its,893,742,2208.47505517,2176.605348258,151
carcassonne-boltzmann30-vs-boltzmann55-1000its,894,743,2195.077327015,2138.918037918,151
carcassonne-ucttuned310-vs-ucttuned455-1000its,910,759,2255.933346927,2217.659243445,151
carcassonne-ucttuned195-vs-ucttuned460-1000its,915,764,2193.747682687,2154.310374431,151
carcassonne-ucttuned465-vs-ucttuned5-1000its,922,771,2139.375358456,2045.833049251,151
carcassonne-uct335-vs-uct350-1000its,926,775,2248.042479373,2171.275199289,151
carcassonne-ucttuned310-vs-ucttuned45-1000its,955,804,2241.416144574,2173.073250108,151
carcassonne-ucttuned465-vs-ucttuned490-1000its,987,836,2205.388489545,2141.489731,151
carcassonne-uct430-vs-uct40-1000its,815,663,2168.684437991,2141.165147149,152
carcassonne-ucttuned215-vs-ucttuned320-1000its,826,674,2201.4782989,2149.790627591,152
carcassonne-ucttuned485-vs-ucttuned270-1000its,830,678,2218.795856108,2143.921106329,152
carcassonne-uct455-vs-uct255-1000its,831,679,2166.875623137,2095.516491854,152
carcassonne-boltzmann190-vs-boltzmann335-1000its,833,681,2204.578968178,2202.539087555,152
carcassonne-boltzmann440-vs-boltzmann480-1000its,841,689,2233.082991883,2180.852806288,152
carcassonne-ucttuned225-vs-ucttuned475-1000its,842,690,2205.175381978,2104.864106413,152
carcassonne-ucttuned300-vs-ucttuned370-1000its,855,703,2139.413394377,2091.421559212,152
carcassonne-boltzmann305-vs-boltzmann415-1000its,857,705,2260.607184198,2193.93046617,152
carcassonne-uct415-vs-uct285-1000its,857,705,2213.542280076,2198.608146492,152
carcassonne-uct450-vs-uct225-1000its,862,710,2259.359005345,2158.72060442,152
carcassonne-uct15-vs-uct85-1000its,863,711,2149.936481676,2075.108218724,152
carcassonne-uct125-vs-uct155-1000its,874,722,2226.912201714,2135.948353728,152
carcassonne-ucttuned490-vs-ucttuned425-1000its,875,723,2174.239563676,2153.085305118,152
carcassonne-boltzmann375-vs-boltzmann200-1000its,879,727,2210.514929297,2170.421080261,152
carcassonne-boltzmann295-vs-boltzmann445-1000its,887,735,2236.749599005,2166.810313018,152
carcassonne-uct50-vs-uct300-1000its,894,742,2101.837757569,2082.920721972,152
carcassonne-boltzmann215-vs-boltzmann120-1000its,897,745,2191.97346078,2123.693784831,152
carcassonne-boltzmann45-vs-boltzmann185-1000its,898,746,2225.215540603,2159.378059482,152
carcassonne-uct475-vs-uct220-1000its,899,747,2169.964867027,2139.204924538,152
carcassonne-boltzmann10-vs-boltzmann460-1000its,907,755,2246.804453733,2140.103153494,152
carcassonne-ucttuned110-vs-ucttuned430-1000its,914,762,2153.115789665,2150.331489989,152
carcassonne-ucttuned405-vs-ucttuned15-1000its,924,772,2154.092788841,2122.603325188,152
carcassonne-ucttuned25-vs-ucttuned35-1000its,933,781,2253.157611925,2193.300956254,152
carcassonne-ucttuned55-vs-ucttuned350-1000its,933,781,2151.779688417,2092.661910222,152
carcassonne-boltzmann195-vs-boltzmann380-1000its,936,784,2223.239179259,2187.013926211,152
carcassonne-ucttuned15-vs-ucttuned100-1000its,961,809,2175.477897248,2101.939988658,152
carcassonne-ucttuned15-vs-ucttuned490-1000its,813,660,2209.865462587,2167.623736544,153
carcassonne-uct320-vs-uct400-1000its,831,678,2253.706860159,2184.939300623,153
carcassonne-boltzmann465-vs-boltzmann110-1000its,864,711,2129.284725034,2121.044302076,153
carcassonne-ucttuned235-vs-ucttuned280-1000its,864,711,2122.232397838,2063.249982072,153
carcassonne-ucttuned345-vs-ucttuned400-1000its,865,712,2195.431728651,2173.014871298,153
carcassonne-boltzmann45-vs-boltzmann140-1000its,870,717,2254.486619053,2223.680879388,153
carcassonne-uct40-vs-uct325-1000its,881,728,2152.546059312,2141.265570098,153
carcassonne-ucttuned30-vs-ucttuned260-1000its,882,729,2207.137665378,2147.689731566,153
carcassonne-ucttuned475-vs-ucttuned270-1000its,883,730,2169.797198459,2101.290572002,153
carcassonne-uct135-vs-uct140-1000its,896,743,2218.154555586,2160.024514907,153
carcassonne-ucttuned300-vs-ucttuned430-1000its,906,753,2175.327341143,2113.125896986,153
carcassonne-boltzmann5-vs-boltzmann45-1000its,907,754,2266.666575728,2202.042684094,153
carcassonne-uct390-vs-uct235-1000its,907,754,2214.500387989,2139.503249457,153
carcassonne-ucttuned430-vs-ucttuned335-1000its,909,756,2148.001198214,2117.530456805,153
carcassonne-boltzmann305-vs-boltzmann420-1000its,917,764,2160.524646559,2100.605180715,153
carcassonne-ucttuned305-vs-ucttuned285-1000its,917,764,2208.609508328,2149.40833015,153
carcassonne-uct50-vs-uct435-1000its,924,771,2225.768505559,2162.732155249,153
carcassonne-ucttuned325-vs-ucttuned245-1000its,928,775,2265.200582501,2162.844361231,153
carcassonne-ucttuned45-vs-ucttuned255-1000its,944,791,2170.588831942,2075.405788298,153
carcassonne-ucttuned30-vs-ucttuned380-1000its,949,796,2160.834693603,2126.288214632,153
carcassonne-boltzmann310-vs-boltzmann205-1000its,951,798,2189.892058818,2127.997184482,153
carcassonne-uct315-vs-uct210-1000its,955,802,2186.991626795,2138.26730039,153
carcassonne-uct250-vs-uct395-1000its,981,828,2222.604966992,2176.784333936,153
carcassonne-ucttuned400-vs-ucttuned240-1000its,816,662,2156.712465276,2083.697287902,154
carcassonne-uct85-vs-uct225-1000its,818,664,2110.707583384,2137.243195838,154
carcassonne-ucttuned245-vs-ucttuned285-1000its,819,665,2205.02296548,2193.838919566,154
carcassonne-boltzmann215-vs-boltzmann425-1000its,832,678,2117.785887152,2095.9267118,154
carcassonne-boltzmann185-vs-boltzmann480-1000its,833,679,2155.184863523,2134.933958635,154
carcassonne-boltzmann65-vs-boltzmann350-1000its,845,691,2202.483550503,2139.388367174,154
carcassonne-uct330-vs-uct370-1000its,855,701,2165.34520422,2114.016768829,154
carcassonne-uct485-vs-uct175-1000its,857,703,2199.335706509,2176.291878081,154
carcassonne-boltzmann15-vs-boltzmann450-1000its,864,710,2204.356899154,2106.144849198,154
carcassonne-ucttuned215-vs-ucttuned50-1000its,866,712,2180.066373264,2132.3841239,154
carcassonne-uct230-vs-uct400-1000its,868,714,2179.651856647,2170.367299106,154
carcassonne-uct215-vs-uct430-1000its,872,718,2220.714144743,2150.595920533,154
carcassonne-ucttuned415-vs-ucttuned195-1000its,872,718,2117.126355682,2096.790510666,154
carcassonne-uct365-vs-uct250-1000its,873,719,2206.093896694,2164.082225464,154
carcassonne-boltzmann10-vs-boltzmann495-1000its,888,734,2130.35367426,2103.414370447,154
carcassonne-uct150-vs-uct125-1000its,890,736,2194.578770497,2178.427348389,154
carcassonne-boltzmann360-vs-boltzmann385-1000its,892,738,2229.170147469,2166.026451561,154
carcassonne-boltzmann425-vs-boltzmann195-1000its,893,739,2098.484836025,2060.658210567,154
carcassonne-boltzmann90-vs-boltzmann160-1000its,917,763,2227.656563097,2129.643245108,154
carcassonne-boltzmann425-vs-boltzmann170-1000its,922,768,2212.326747383,2192.440806969,154
carcassonne-ucttuned45-vs-ucttuned470-1000its,925,771,2186.278842842,2140.904486312,154
carcassonne-boltzmann40-vs-boltzmann145-1000its,929,775,2158.238555414,2136.324643684,154
carcassonne-uct5-vs-uct185-1000its,940,786,2205.469572081,2143.691856528,154
carcassonne-boltzmann10-vs-boltzmann395-1000its,956,802,2248.475887912,2165.536535928,154
carcassonne-boltzmann130-vs-boltzmann440-1000its,960,806,2176.188659716,2099.742648892,154
carcassonne-ucttuned125-vs-ucttuned255-1000its,976,822,2211.388495241,2169.780795271,154
carcassonne-uct200-vs-uct260-1000its,1001,847,2213.859311332,2176.190005101,154
carcassonne-boltzmann435-vs-boltzmann455-1000its,821,666,2165.977260265,2128.674460631,155
carcassonne-boltzmann75-vs-boltzmann315-1000its,838,683,2210.087893401,2183.37848859,155
carcassonne-boltzmann20-vs-boltzmann205-1000its,839,684,2214.059654971,2149.242541336,155
carcassonne-boltzmann455-vs-boltzmann245-1000its,858,703,2229.856156606,2183.654988833,155
carcassonne-ucttuned355-vs-ucttuned400-1000its,863,708,2157.190532953,2145.846842529,155
carcassonne-boltzmann110-vs-boltzmann250-1000its,880,725,2119.036858747,2107.283969952,155
carcassonne-uct380-vs-uct50-1000its,880,725,2216.168819053,2155.863123824,155
carcassonne-uct170-vs-uct100-1000its,881,726,2243.267127529,2202.122390976,155
carcassonne-uct180-vs-uct110-1000its,885,730,2119.791135595,2110.618333083,155
carcassonne-boltzmann225-vs-boltzmann310-1000its,888,733,2152.61313596,2114.426594178,155
carcassonne-uct425-vs-uct330-1000its,893,738,2238.819776735,2157.019905119,155
carcassonne-uct110-vs-uct60-1000its,900,745,2198.444643337,2199.036229511,155
carcassonne-boltzmann25-vs-boltzmann215-1000its,906,751,2227.718766642,2151.672078953,155
carcassonne-uct175-vs-uct255-1000its,909,754,2187.844946302,2139.334722905,155
carcassonne-ucttuned60-vs-ucttuned300-1000its,911,756,2258.837693923,2206.610518858,155
carcassonne-uct465-vs-uct310-1000its,914,759,2182.566720103,2124.456531075,155
carcassonne-uct420-vs-uct365-1000its,915,760,2234.529027236,2189.206920092,155
carcassonne-uct45-vs-uct380-1000its,919,764,2169.394191643,2094.618912577,155
carcassonne-ucttuned40-vs-ucttuned410-1000its,940,785,2132.728973776,2071.780717661,155
carcassonne-boltzmann195-vs-boltzmann295-1000its,955,800,2198.270578164,2202.815729924,155
carcassonne-boltzmann315-vs-boltzmann260-1000its,828,672,2164.387438854,2114.421050391,156
carcassonne-boltzmann90-vs-boltzmann185-1000its,842,686,2153.890498151,2091.847111229,156
carcassonne-uct170-vs-uct255-1000its,842,686,2200.130812477,2155.14328026,156
carcassonne-uct355-vs-uct375-1000its,854,698,2211.659904978,2153.087745364,156
carcassonne-boltzmann35-vs-boltzmann145-1000its,872,716,2247.140113707,2196.660318207,156
carcassonne-ucttuned425-vs-ucttuned225-1000its,872,716,2235.47801055,2158.971438082,156
carcassonne-ucttuned120-vs-ucttuned400-1000its,880,724,2188.111854919,2104.216238059,156
carcassonne-ucttuned270-vs-ucttuned20-1000its,888,732,2150.065301371,2122.655900041,156
carcassonne-ucttuned225-vs-ucttuned50-1000its,895,739,2168.397101225,2114.484090287,156
carcassonne-ucttuned350-vs-ucttuned180-1000its,899,743,2173.047859765,2158.532576565,156
carcassonne-uct125-vs-uct370-1000its,903,747,2209.568375416,2195.919287691,156
carcassonne-uct295-vs-uct200-1000its,905,749,2197.508795405,2162.867001947,156
carcassonne-ucttuned175-vs-ucttuned145-1000its,905,749,2348.843042446,2293.936915582,156
carcassonne-boltzmann440-vs-boltzmann175-1000its,915,759,2236.000461077,2227.754254345,156
carcassonne-uct90-vs-uct350-1000its,924,768,2216.073636348,2176.779080205,156
carcassonne-uct25-vs-uct30-1000its,969,813,2216.31942186,2162.305443418,156
carcassonne-ucttuned10-vs-ucttuned305-1000its,997,841,2268.139857827,2199.727778672,156
carcassonne-ucttuned475-vs-ucttuned165-1000its,1006,850,2236.07931373,2144.950110034,156
carcassonne-ucttuned190-vs-ucttuned390-1000its,1030,874,2221.592151306,2145.629448691,156
carcassonne-uct210-vs-uct270-1000its,761,604,2195.155482119,2131.666129098,157
carcassonne-boltzmann275-vs-boltzmann355-1000its,815,658,2241.844332308,2177.937150436,157
carcassonne-ucttuned75-vs-ucttuned245-1000its,821,664,2168.621127192,2122.734007454,157
carcassonne-boltzmann5-vs-boltzmann125-1000its,842,685,2176.782930472,2216.507574127,157
carcassonne-boltzmann340-vs-boltzmann185-1000its,848,691,2260.730790422,2168.036299068,157
carcassonne-ucttuned80-vs-ucttuned470-1000its,857,700,2194.99199133,2150.154829367,157
carcassonne-ucttuned125-vs-ucttuned185-1000its,861,704,2165.015662894,2105.901207633,157
carcassonne-uct400-vs-uct450-1000its,872,715,2166.111412237,2130.849786806,157
carcassonne-boltzmann275-vs-boltzmann370-1000its,877,720,2148.201555539,2153.64244625,157
carcassonne-uct135-vs-uct35-1000its,878,721,2170.866838912,2120.510298842,157
carcassonne-boltzmann100-vs-boltzmann235-1000its,880,723,2226.077343858,2152.331472681,157
carcassonne-boltzmann340-vs-boltzmann380-1000its,882,725,2179.926454188,2133.5092211,157
carcassonne-boltzmann390-vs-boltzmann275-1000its,894,737,2230.202000629,2225.895176498,157
carcassonne-boltzmann10-vs-boltzmann110-1000its,903,746,2167.679213372,2146.551254535,157
carcassonne-ucttuned180-vs-ucttuned60-1000its,905,748,2116.005719445,2105.779564545,157
carcassonne-uct475-vs-uct205-1000its,928,771,2148.346773603,2140.174107607,157
carcassonne-uct10-vs-uct125-1000its,959,802,2207.805941029,2170.771226352,157
carcassonne-uct450-vs-uct380-1000its,844,686,2267.073758345,2149.18825232,158
carcassonne-ucttuned200-vs-ucttuned150-1000its,851,693,2207.408013438,2167.101743682,158
carcassonne-uct450-vs-uct495-1000its,852,694,2179.30856914,2140.702659345,158
carcassonne-ucttuned5-vs-ucttuned25-1000its,854,696,2157.116352305,2137.175237582,158
carcassonne-uct345-vs-uct245-1000its,866,708,2245.045852724,2180.286106137,158
carcassonne-uct120-vs-uct480-1000its,870,712,2210.258662377,2127.256158492,158
carcassonne-uct135-vs-uct255-1000its,878,720,2193.575120427,2096.848885953,158
carcassonne-ucttuned365-vs-ucttuned50-1000its,884,726,2221.338072407,2169.250164058,158
carcassonne-ucttuned95-vs-ucttuned475-1000its,885,727,2224.024011516,2184.250105601,158
carcassonne-uct445-vs-uct415-1000its,891,733,2248.380339812,2172.483731435,158
carcassonne-uct470-vs-uct15-1000its,916,758,2186.769437064,2150.260691324,158
carcassonne-uct75-vs-uct370-1000its,961,803,2123.073807085,2116.242429371,158
carcassonne-uct440-vs-uct410-1000its,977,819,2194.168237087,2184.373972233,158
carcassonne-boltzmann20-vs-boltzmann225-1000its,789,630,2158.103337524,2135.97288309,159
carcassonne-boltzmann495-vs-boltzmann190-1000its,818,659,2196.133101248,2160.762027282,159
carcassonne-ucttuned445-vs-ucttuned455-1000its,847,688,2181.227651739,2128.382393707,159
carcassonne-uct335-vs-uct465-1000its,849,690,2197.869507705,2155.09861955,159
carcassonne-boltzmann95-vs-boltzmann220-1000its,851,692,2183.404730842,2097.496911983,159
carcassonne-uct85-vs-uct375-1000its,852,693,2229.969031143,2177.217439127,159
carcassonne-ucttuned310-vs-ucttuned265-1000its,865,706,2159.971419548,2184.629296068,159
carcassonne-uct210-vs-uct45-1000its,879,720,2178.648886325,2156.385617208,159
carcassonne-uct375-vs-uct220-1000its,880,721,2220.135571005,2187.707683885,159
carcassonne-ucttuned205-vs-ucttuned220-1000its,887,728,2211.559241865,2150.939486374,159
carcassonne-ucttuned20-vs-ucttuned275-1000its,890,731,2181.977928027,2142.418829496,159
carcassonne-ucttuned35-vs-ucttuned370-1000its,891,732,2176.920502817,2151.074499315,159
carcassonne-uct440-vs-uct220-1000its,903,744,2199.357882758,2217.283815808,159
carcassonne-boltzmann120-vs-boltzmann380-1000its,904,745,2277.062950855,2210.558348808,159
carcassonne-uct110-vs-uct75-1000its,907,748,2209.112495792,2177.416993243,159
carcassonne-uct455-vs-uct490-1000its,919,760,2259.911948584,2217.427263868,159
carcassonne-uct55-vs-uct260-1000its,927,768,2245.562410282,2168.737916024,159
carcassonne-uct240-vs-uct275-1000its,930,771,2255.004327218,2250.656004769,159
carcassonne-boltzmann450-vs-boltzmann255-1000its,809,649,2138.59462755,2093.111608154,160
carcassonne-boltzmann90-vs-boltzmann20-1000its,825,665,2130.823710832,2096.832598765,160
carcassonne-ucttuned255-vs-ucttuned120-1000its,829,669,2216.361610276,2147.509384306,160
carcassonne-ucttuned225-vs-ucttuned275-1000its,836,676,2166.639319755,2129.363815178,160
carcassonne-boltzmann30-vs-boltzmann180-1000its,838,678,2248.008978714,2197.692911156,160
carcassonne-uct75-vs-uct185-1000its,850,690,2200.862227671,2120.953613435,160
carcassonne-ucttuned80-vs-ucttuned220-1000its,852,692,2201.999220165,2162.168719513,160
carcassonne-boltzmann365-vs-boltzmann230-1000its,860,700,2246.979102467,2182.353436506,160
carcassonne-boltzmann280-vs-boltzmann285-1000its,866,706,2211.177281273,2133.883549785,160
carcassonne-uct45-vs-uct355-1000its,867,707,2197.08164445,2171.240958615,160
carcassonne-ucttuned195-vs-ucttuned300-1000its,870,710,2180.426901541,2125.4211136,160
carcassonne-ucttuned55-vs-ucttuned235-1000its,874,714,2259.090970541,2220.436534712,160
carcassonne-ucttuned330-vs-ucttuned155-1000its,887,727,2129.904675589,2081.961475641,160
carcassonne-uct90-vs-uct435-1000its,898,738,2213.193950691,2142.27833025,160
carcassonne-ucttuned235-vs-ucttuned420-1000its,922,762,2189.534404006,2138.60528667,160
carcassonne-uct475-vs-uct45-1000its,923,763,2230.459404367,2217.299999978,160
carcassonne-boltzmann160-vs-boltzmann135-1000its,924,764,2207.667454581,2178.280466381,160
carcassonne-ucttuned220-vs-ucttuned15-1000its,930,770,2185.138454594,2193.007772398,160
carcassonne-ucttuned245-vs-ucttuned390-1000its,930,770,2200.589618823,2205.821899886,160
carcassonne-ucttuned85-vs-ucttuned240-1000its,934,774,2217.155510005,2178.771096627,160
carcassonne-uct50-vs-uct45-1000its,950,790,2261.910736907,2186.636406261,160
carcassonne-uct45-vs-uct350-1000its,953,793,2172.990573871,2166.567398022,160
carcassonne-boltzmann110-vs-boltzmann220-1000its,960,800,2184.743544469,2124.731716002,160
carcassonne-boltzmann175-vs-boltzmann35-1000its,963,803,2225.195884848,2155.849958088,160
carcassonne-boltzmann115-vs-boltzmann75-1000its,981,821,2265.413153623,2224.742746406,160
carcassonne-boltzmann25-vs-boltzmann330-1000its,787,626,2201.37373297,2139.861115064,161
carcassonne-ucttuned260-vs-ucttuned420-1000its,834,673,2196.228609202,2133.020913931,161
carcassonne-ucttuned400-vs-ucttuned465-1000its,844,683,2170.655339408,2125.353217621,161
carcassonne-boltzmann150-vs-boltzmann480-1000its,854,693,2167.994858481,2137.726202978,161
carcassonne-ucttuned45-vs-ucttuned430-1000its,855,694,2207.344584966,2132.914683607,161
carcassonne-boltzmann25-vs-boltzmann110-1000its,857,696,2156.102185431,2123.669942932,161
carcassonne-boltzmann270-vs-boltzmann70-1000its,860,699,2201.214032137,2123.620851593,161
carcassonne-ucttuned25-vs-ucttuned140-1000its,861,700,2214.34209111,2153.856590828,161
carcassonne-ucttuned315-vs-ucttuned405-1000its,864,703,2223.181962127,2179.032732675,161
carcassonne-boltzmann485-vs-boltzmann480-1000its,868,707,2124.526031902,2025.047763331,161
carcassonne-boltzmann45-vs-boltzmann435-1000its,870,709,2226.086818538,2166.758096684,161
carcassonne-uct190-vs-uct340-1000its,874,713,2207.410638303,2130.974091203,161
carcassonne-ucttuned100-vs-ucttuned210-1000its,876,715,2227.579401754,2147.84842626,161
carcassonne-ucttuned15-vs-ucttuned420-1000its,876,715,2265.77273111,2238.136885001,161
carcassonne-uct330-vs-uct435-1000its,881,720,2176.261412823,2115.479332655,161
carcassonne-ucttuned20-vs-ucttuned215-1000its,885,724,2271.10103621,2228.183211867,161
carcassonne-uct180-vs-uct345-1000its,889,728,2183.215706267,2128.587915596,161
carcassonne-uct265-vs-uct285-1000its,893,732,2217.672608291,2158.058241985,161
carcassonne-uct65-vs-uct385-1000its,896,735,2212.10408439,2170.515104627,161
carcassonne-ucttuned65-vs-ucttuned270-1000its,898,737,2166.590354155,2121.209980839,161
carcassonne-ucttuned30-vs-ucttuned490-1000its,902,741,2153.753863872,2069.608118919,161
carcassonne-ucttuned70-vs-ucttuned260-1000its,908,747,2204.799835029,2199.377361821,161
carcassonne-ucttuned25-vs-ucttuned50-1000its,913,752,2216.02958212,2157.979987384,161
carcassonne-ucttuned110-vs-ucttuned190-1000its,919,758,2207.486379257,2137.900173904,161
carcassonne-ucttuned260-vs-ucttuned170-1000its,839,677,2166.06127284,2137.968233078,162
carcassonne-ucttuned185-vs-ucttuned210-1000its,841,679,2154.305906681,2080.823639537,162
carcassonne-uct480-vs-uct195-1000its,852,690,2194.113568603,2151.77173138,162
carcassonne-uct265-vs-uct390-1000its,862,700,2177.741894818,2135.15994785,162
carcassonne-ucttuned125-vs-ucttuned365-1000its,864,702,2144.884636844,2080.209587387,162
carcassonne-boltzmann200-vs-boltzmann470-1000its,865,703,2152.495680334,2124.795491643,162
carcassonne-uct255-vs-uct270-1000its,865,703,2215.43761327,2168.839829437,162
carcassonne-uct240-vs-uct280-1000its,876,714,2171.117916985,2187.485294895,162
carcassonne-ucttuned455-vs-ucttuned30-1000its,880,718,2134.460328436,2122.303995879,162
carcassonne-boltzmann235-vs-boltzmann305-1000its,884,722,2139.560304764,2137.063083328,162
carcassonne-uct210-vs-uct455-1000its,886,724,2269.899948095,2186.806812032,162
carcassonne-uct415-vs-uct150-1000its,892,730,2092.764354998,2063.706201961,162
carcassonne-ucttuned280-vs-ucttuned435-1000its,897,735,2168.064188517,2117.608553445,162
carcassonne-boltzmann190-vs-boltzmann295-1000its,903,741,2188.531588112,2112.978561714,162
carcassonne-uct430-vs-uct105-1000its,907,745,2162.975439907,2111.83088814,162
carcassonne-boltzmann165-vs-boltzmann405-1000its,919,757,2187.155492923,2146.754682651,162
carcassonne-uct265-vs-uct225-1000its,935,773,2225.517554714,2178.010934972,162
carcassonne-ucttuned495-vs-ucttuned435-1000its,950,788,2184.624583332,2110.452980698,162
carcassonne-ucttuned390-vs-ucttuned375-1000its,844,681,2154.484942732,2122.68462944,163
carcassonne-boltzmann25-vs-boltzmann260-1000its,848,685,2203.40989464,2156.922840908,163
carcassonne-ucttuned55-vs-ucttuned275-1000its,853,690,2217.377511337,2199.732158068,163
carcassonne-uct120-vs-uct15-1000its,863,700,2185.851415988,2146.228666127,163
carcassonne-uct170-vs-uct340-1000its,868,705,2136.786045432,2085.796442452,163
carcassonne-boltzmann485-vs-boltzmann355-1000its,876,713,2190.191084714,2086.327290719,163
carcassonne-uct255-vs-uct355-1000its,876,713,2179.378215326,2147.998667862,163
carcassonne-uct120-vs-uct460-1000its,877,714,2143.441157175,2099.455246497,163
carcassonne-uct355-vs-uct315-1000its,890,727,2215.340039836,2125.286053663,163
carcassonne-ucttuned495-vs-ucttuned320-1000its,890,727,2148.720676765,2136.104030881,163
carcassonne-ucttuned220-vs-ucttuned475-1000its,895,732,2201.347702201,2144.206174996,163
carcassonne-uct330-vs-uct445-1000its,905,742,2243.998050999,2220.874899374,163
carcassonne-uct35-vs-uct80-1000its,917,754,2255.208471178,2206.467672326,163
carcassonne-boltzmann125-vs-boltzmann355-1000its,920,757,2180.758033904,2134.372806197,163
carcassonne-boltzmann215-vs-boltzmann445-1000its,930,767,2176.971287395,2110.776850719,163
carcassonne-uct465-vs-uct75-1000its,959,796,2174.565537934,2124.145800215,163
carcassonne-uct65-vs-uct30-1000its,968,805,2257.187118319,2198.073865534,163
carcassonne-boltzmann175-vs-boltzmann70-1000its,986,823,2195.147394885,2184.735463618,163
carcassonne-boltzmann470-vs-boltzmann385-1000its,1019,856,2181.718607982,2098.900742478,163
carcassonne-ucttuned230-vs-ucttuned380-1000its,1044,881,2189.566611519,2114.418563238,163
carcassonne-ucttuned115-vs-ucttuned190-1000its,824,660,2145.508481957,2109.599872304,164
carcassonne-boltzmann340-vs-boltzmann495-1000its,827,663,2167.474066643,2128.796403927,164
carcassonne-uct15-vs-uct185-1000its,854,690,2197.634014145,2186.821414569,164
carcassonne-boltzmann420-vs-boltzmann185-1000its,867,703,2269.707042154,2173.295552196,164
carcassonne-boltzmann35-vs-boltzmann60-1000its,870,706,2190.617523342,2181.812550697,164
carcassonne-ucttuned70-vs-ucttuned130-1000its,875,711,2195.762825373,2184.957460923,164
carcassonne-boltzmann410-vs-boltzmann50-1000its,880,716,2211.610589265,2169.888502906,164
carcassonne-ucttuned305-vs-ucttuned200-1000its,881,717,2193.667260299,2166.544015445,164
carcassonne-ucttuned90-vs-ucttuned255-1000its,887,723,2201.002303095,2187.87076043,164
carcassonne-ucttuned170-vs-ucttuned475-1000its,889,725,2311.431354039,2248.97146368,164
carcassonne-uct430-vs-uct110-1000its,903,739,2177.061138347,2158.607866551,164
carcassonne-uct10-vs-uct430-1000its,904,740,2203.013747226,2129.520071523,164
carcassonne-ucttuned20-vs-ucttuned160-1000its,904,740,2110.758807666,2094.481779742,164
carcassonne-uct495-vs-uct415-1000its,909,745,2186.338303359,2121.770123161,164
carcassonne-uct10-vs-uct155-1000its,920,756,2267.473988685,2225.353387813,164
carcassonne-uct95-vs-uct50-1000its,931,767,2245.406566536,2154.65946562,164
carcassonne-ucttuned495-vs-ucttuned35-1000its,953,789,2204.390587447,2121.215650723,164
carcassonne-ucttuned125-vs-ucttuned45-1000its,1053,889,2166.526624827,2148.697050912,164
carcassonne-boltzmann85-vs-boltzmann25-1000its,870,705,2193.664039138,2153.183529137,165
carcassonne-ucttuned5-vs-ucttuned465-1000its,886,721,2242.446855245,2215.01071214,165
carcassonne-uct300-vs-uct240-1000its,889,724,2221.96775322,2169.180526708,165
carcassonne-boltzmann300-vs-boltzmann365-1000its,891,726,2199.702891929,2150.280868716,165
carcassonne-ucttuned195-vs-ucttuned230-1000its,895,730,2280.53595836,2247.255300113,165
carcassonne-ucttuned95-vs-ucttuned305-1000its,897,732,2164.562125912,2167.586063063,165
carcassonne-uct240-vs-uct100-1000its,899,734,2208.012508355,2154.20833108,165
carcassonne-boltzmann495-vs-boltzmann170-1000its,908,743,2167.76666577,2140.114133973,165
carcassonne-uct450-vs-uct180-1000its,908,743,2172.16395752,2115.231814087,165
carcassonne-ucttuned405-vs-ucttuned325-1000its,908,743,2242.099471881,2194.872854299,165
carcassonne-ucttuned20-vs-ucttuned380-1000its,913,748,2257.459000767,2179.556973245,165
carcassonne-ucttuned50-vs-ucttuned40-1000its,915,750,2197.536414771,2165.800147341,165
carcassonne-ucttuned250-vs-ucttuned315-1000its,928,763,2214.842061214,2161.787275415,165
carcassonne-uct5-vs-uct290-1000its,950,785,2194.928267853,2119.382515672,165
carcassonne-boltzmann430-vs-boltzmann470-1000its,965,800,2183.441166974,2129.082460345,165
carcassonne-uct15-vs-uct55-1000its,965,800,2160.666456564,2137.321709255,165
carcassonne-ucttuned70-vs-ucttuned410-1000its,991,826,2194.395468001,2129.400589863,165
carcassonne-boltzmann115-vs-boltzmann355-1000its,806,640,2183.055315393,2190.911818569,166
carcassonne-ucttuned135-vs-ucttuned295-1000its,823,657,2144.594038966,2128.938784712,166
carcassonne-boltzmann220-vs-boltzmann210-1000its,837,671,2217.772604101,2188.996154358,166
carcassonne-uct380-vs-uct140-1000its,848,682,2216.008334572,2152.457972396,166
carcassonne-uct55-vs-uct130-1000its,852,686,2219.051244153,2161.439746575,166
carcassonne-uct405-vs-uct440-1000its,855,689,2176.953752203,2141.658044681,166
carcassonne-uct320-vs-uct155-1000its,856,690,2233.710152192,2158.637779326,166
carcassonne-boltzmann240-vs-boltzmann115-1000its,857,691,2151.982482974,2116.289213238,166
carcassonne-ucttuned335-vs-ucttuned375-1000its,861,695,2300.04978369,2262.893669609,166
carcassonne-ucttuned220-vs-ucttuned215-1000its,878,712,2243.736834043,2178.500820262,166
carcassonne-uct295-vs-uct450-1000its,885,719,2190.727586174,2135.177579596,166
carcassonne-boltzmann75-vs-boltzmann415-1000its,904,738,2193.229492361,2118.580646183,166
carcassonne-uct175-vs-uct475-1000its,911,745,2238.904937078,2174.429082909,166
carcassonne-uct300-vs-uct295-1000its,915,749,2156.320512226,2152.708035155,166
carcassonne-uct345-vs-uct65-1000its,926,760,2128.634883236,2094.308593021,166
carcassonne-uct360-vs-uct35-1000its,926,760,2181.899927221,2164.803265093,166
carcassonne-ucttuned65-vs-ucttuned255-1000its,928,762,2128.131030768,2122.314263836,166
carcassonne-ucttuned410-vs-ucttuned175-1000its,929,763,2206.4526098,2160.825294571,166
carcassonne-boltzmann15-vs-boltzmann475-1000its,943,777,2214.246846812,2166.927940441,166
carcassonne-uct5-vs-uct385-1000its,954,788,2174.942730517,2082.200188138,166
carcassonne-boltzmann345-vs-boltzmann445-1000its,824,657,2184.879582391,2142.872391179,167
carcassonne-boltzmann50-vs-boltzmann315-1000its,835,668,2255.383101521,2223.186366109,167
carcassonne-boltzmann330-vs-boltzmann25-1000its,855,688,2182.607941427,2122.257339941,167
carcassonne-boltzmann165-vs-boltzmann20-1000its,856,689,2132.081970208,2149.433347795,167
carcassonne-boltzmann320-vs-boltzmann440-1000its,862,695,2226.483489628,2182.747972312,167
carcassonne-ucttuned15-vs-ucttuned275-1000its,868,701,2239.85459164,2199.54202072,167
carcassonne-ucttuned5-vs-ucttuned325-1000its,877,710,2192.951258142,2130.001451658,167
carcassonne-boltzmann440-vs-boltzmann195-1000its,880,713,2149.201270915,2109.966475801,167
carcassonne-ucttuned10-vs-ucttuned250-1000its,908,741,2190.179958885,2179.114367025,167
carcassonne-boltzmann415-vs-boltzmann70-1000its,930,763,2133.006539476,2065.923539988,167
carcassonne-boltzmann65-vs-boltzmann425-1000its,945,778,2310.004001517,2228.004753094,167
carcassonne-uct75-vs-uct400-1000its,982,815,2188.412250866,2150.580065663,167
carcassonne-boltzmann335-vs-boltzmann340-1000its,808,640,2292.844002124,2193.252310303,168
carcassonne-ucttuned395-vs-ucttuned90-1000its,832,664,2192.329543726,2154.059440343,168
carcassonne-uct270-vs-uct165-1000its,834,666,2188.013647872,2169.637026763,168
carcassonne-ucttuned5-vs-ucttuned475-1000its,874,706,2199.116591501,2107.389535653,168
carcassonne-ucttuned285-vs-ucttuned490-1000its,882,714,2177.499610827,2078.583837443,168
carcassonne-boltzmann10-vs-boltzmann315-1000its,885,717,2151.04278288,2123.261037046,168
carcassonne-boltzmann140-vs-boltzmann130-1000its,891,723,2157.347193996,2134.329112963,168
carcassonne-boltzmann25-vs-boltzmann380-1000its,895,727,2287.436144715,2233.721220451,168
carcassonne-boltzmann10-vs-boltzmann50-1000its,904,736,2197.971031538,2124.991510928,168
carcassonne-ucttuned105-vs-ucttuned380-1000its,916,748,2234.703574424,2186.764597281,168
carcassonne-boltzmann95-vs-boltzmann170-1000its,919,751,2248.845385812,2213.997699343,168
carcassonne-uct455-vs-uct365-1000its,930,762,2156.787921592,2129.454364205,168
carcassonne-boltzmann75-vs-boltzmann490-1000its,948,780,2236.70964384,2167.191743088,168
carcassonne-uct275-vs-uct190-1000its,979,811,2184.44362653,2142.089242052,168
carcassonne-ucttuned20-vs-ucttuned200-1000its,1012,844,2229.405518141,2166.185493751,168
carcassonne-ucttuned360-vs-ucttuned410-1000its,847,678,2233.17887729,2199.517642618,169
carcassonne-boltzmann150-vs-boltzmann440-1000its,851,682,2196.995059738,2153.764106734,169
carcassonne-boltzmann135-vs-boltzmann480-1000its,852,683,2182.83730518,2148.72597851,169
carcassonne-uct15-vs-uct215-1000its,858,689,2250.175890697,2165.364312125,169
carcassonne-uct305-vs-uct340-1000its,877,708,2168.067460129,2155.60581742,169
carcassonne-ucttuned495-vs-ucttuned255-1000its,879,710,2163.950805082,2107.890429308,169
carcassonne-boltzmann225-vs-boltzmann365-1000its,890,721,2231.584813854,2203.320315674,169
carcassonne-uct10-vs-uct75-1000its,891,722,2249.57961854,2196.21318405,169
carcassonne-uct160-vs-uct280-1000its,896,727,2221.305144472,2153.257868659,169
carcassonne-boltzmann410-vs-boltzmann365-1000its,898,729,2150.028304406,2121.741504435,169
carcassonne-uct485-vs-uct35-1000its,900,731,2263.220331117,2224.224793437,169
carcassonne-ucttuned15-vs-ucttuned315-1000its,902,733,2228.188050084,2147.952649961,169
carcassonne-ucttuned45-vs-ucttuned85-1000its,908,739,2192.769690817,2107.787062868,169
carcassonne-uct285-vs-uct175-1000its,916,747,2116.508473122,2118.846493296,169
carcassonne-ucttuned30-vs-ucttuned430-1000its,923,754,2241.141492866,2191.087790813,169
carcassonne-boltzmann480-vs-boltzmann110-1000its,948,779,2276.930034885,2224.751575171,169
carcassonne-uct60-vs-uct300-1000its,967,798,2210.629787224,2139.857741155,169
carcassonne-ucttuned135-vs-ucttuned470-1000its,1027,858,2252.656507607,2198.326673197,169
carcassonne-ucttuned155-vs-ucttuned315-1000its,1048,879,2177.347197901,2109.110416522,169
carcassonne-boltzmann370-vs-boltzmann310-1000its,782,612,2172.357890334,2150.268812529,170
carcassonne-boltzmann40-vs-boltzmann270-1000its,820,650,2176.153167015,2135.749674695,170
carcassonne-uct200-vs-uct65-1000its,836,666,2210.205372059,2124.123202855,170
carcassonne-boltzmann60-vs-boltzmann295-1000its,843,673,2257.776639269,2245.499181641,170
carcassonne-uct415-vs-uct185-1000its,851,681,2219.063160353,2170.201048749,170
carcassonne-uct130-vs-uct395-1000its,859,689,2186.120738948,2143.969950361,170
carcassonne-ucttuned155-vs-ucttuned235-1000its,863,693,2163.725321796,2059.419032846,170
carcassonne-ucttuned25-vs-ucttuned90-1000its,865,695,2181.032722558,2175.979570355,170
carcassonne-uct75-vs-uct480-1000its,866,696,2152.655536588,2093.41368191,170
carcassonne-uct35-vs-uct275-1000its,872,702,2223.905244479,2175.607007912,170
carcassonne-uct225-vs-uct60-1000its,892,722,2212.584412728,2181.727396034,170
carcassonne-ucttuned50-vs-ucttuned250-1000its,894,724,2215.952537032,2169.248353053,170
carcassonne-uct365-vs-uct360-1000its,900,730,2138.820008003,2101.973566434,170
carcassonne-ucttuned40-vs-ucttuned445-1000its,902,732,2254.515299894,2204.654679006,170
carcassonne-boltzmann270-vs-boltzmann210-1000its,919,749,2236.526627794,2195.324239737,170
carcassonne-ucttuned45-vs-ucttuned235-1000its,933,763,2180.965278716,2073.541269675,170
carcassonne-ucttuned105-vs-ucttuned60-1000its,935,765,2188.480433791,2135.095102038,170
carcassonne-ucttuned195-vs-ucttuned405-1000its,937,767,2126.776708743,2116.307277234,170
carcassonne-ucttuned330-vs-ucttuned380-1000its,939,769,2147.251432269,2154.629173996,170
carcassonne-uct490-vs-uct20-1000its,943,773,2156.655306933,2103.017696082,170
carcassonne-uct155-vs-uct420-1000its,966,796,2258.915332113,2180.882765056,170
carcassonne-ucttuned465-vs-ucttuned30-1000its,1013,843,2211.399168372,2177.877678783,170
carcassonne-boltzmann185-vs-boltzmann20-1000its,834,663,2243.677648472,2189.576209629,171
carcassonne-boltzmann280-vs-boltzmann45-1000its,850,679,2219.717377126,2156.960479974,171
carcassonne-boltzmann130-vs-boltzmann115-1000its,861,690,2159.77929033,2104.342036179,171
carcassonne-ucttuned40-vs-ucttuned175-1000its,866,695,2207.27891514,2143.934335235,171
carcassonne-boltzmann40-vs-boltzmann135-1000its,881,710,2206.451927444,2118.664097704,171
carcassonne-ucttuned420-vs-ucttuned50-1000its,885,714,2140.445046088,2103.074824944,171
carcassonne-boltzmann205-vs-boltzmann455-1000its,898,727,2168.077426119,2122.303379489,171
carcassonne-uct335-vs-uct360-1000its,923,752,2204.144277512,2187.250578395,171
carcassonne-ucttuned445-vs-ucttuned235-1000its,940,769,2171.843472327,2121.638398451,171
carcassonne-ucttuned440-vs-ucttuned90-1000its,943,772,2191.595954864,2148.013383558,171
carcassonne-uct260-vs-uct170-1000its,950,779,2275.393174865,2229.073693141,171
carcassonne-ucttuned110-vs-ucttuned485-1000its,813,641,2174.143589728,2080.937962486,172
carcassonne-boltzmann295-vs-boltzmann25-1000its,818,646,2152.459503641,2119.25029531,172
carcassonne-ucttuned325-vs-ucttuned140-1000its,822,650,2196.413016515,2134.257992014,172
carcassonne-boltzmann30-vs-boltzmann315-1000its,853,681,2265.440986523,2203.168681808,172
carcassonne-boltzmann320-vs-boltzmann195-1000its,853,681,2279.949932465,2276.981834639,172
carcassonne-ucttuned45-vs-ucttuned185-1000its,853,681,2119.264664202,2087.541550057,172
carcassonne-boltzmann410-vs-boltzmann205-1000its,872,700,2181.638747416,2148.667418316,172
carcassonne-boltzmann15-vs-boltzmann170-1000its,881,709,2146.700086362,2068.929382687,172
carcassonne-ucttuned20-vs-ucttuned245-1000its,902,730,2236.620329686,2186.743532875,172
carcassonne-ucttuned495-vs-ucttuned260-1000its,902,730,2234.253113523,2218.531315089,172
carcassonne-uct400-vs-uct170-1000its,903,731,2242.663409119,2179.828641239,172
carcassonne-boltzmann175-vs-boltzmann395-1000its,906,734,2193.11710803,2124.639444444,172
carcassonne-uct290-vs-uct205-1000its,922,750,2314.150281577,2229.237358553,172
carcassonne-ucttuned400-vs-ucttuned420-1000its,945,773,2202.952039075,2166.905447738,172
carcassonne-uct35-vs-uct475-1000its,965,793,2144.035571957,2104.816704041,172
carcassonne-ucttuned290-vs-ucttuned160-1000its,847,674,2209.514236946,2142.033254304,173
carcassonne-ucttuned85-vs-ucttuned215-1000its,869,696,2219.333232699,2149.712854633,173
carcassonne-boltzmann310-vs-boltzmann30-1000its,873,700,2219.275375539,2164.159115666,173
carcassonne-uct90-vs-uct345-1000its,877,704,2214.285733425,2160.246304246,173
carcassonne-ucttuned490-vs-ucttuned330-1000its,894,721,2200.358796239,2172.57927509,173
carcassonne-ucttuned55-vs-ucttuned435-1000its,898,725,2213.401031961,2205.899647017,173
carcassonne-boltzmann400-vs-boltzmann235-1000its,901,728,2187.894860173,2093.139595873,173
carcassonne-uct205-vs-uct380-1000its,904,731,2230.609126431,2119.966195108,173
carcassonne-boltzmann335-vs-boltzmann380-1000its,914,741,2295.373621264,2189.266462676,173
carcassonne-ucttuned5-vs-ucttuned400-1000its,916,743,2161.167093416,2131.549065598,173
carcassonne-uct5-vs-uct180-1000its,917,744,2206.508579394,2137.479885113,173
carcassonne-boltzmann30-vs-boltzmann260-1000its,928,755,2173.775784802,2148.897790779,173
carcassonne-uct190-vs-uct420-1000its,928,755,2266.958754225,2177.239881707,173
carcassonne-uct465-vs-uct170-1000its,941,768,2198.219184854,2133.055675391,173
carcassonne-boltzmann25-vs-boltzmann40-1000its,985,812,2222.494032237,2123.835000288,173
carcassonne-boltzmann290-vs-boltzmann210-1000its,781,607,2183.634219432,2143.481611782,174
carcassonne-ucttuned15-vs-ucttuned410-1000its,836,662,2217.924774803,2124.713553039,174
carcassonne-boltzmann375-vs-boltzmann205-1000its,838,664,2213.643071818,2179.698689135,174
carcassonne-ucttuned200-vs-ucttuned120-1000its,856,682,2257.1014813,2227.494224354,174
carcassonne-ucttuned260-vs-ucttuned340-1000its,860,686,2156.781950617,2114.721572727,174
carcassonne-ucttuned305-vs-ucttuned370-1000its,877,703,2169.255419699,2123.968024016,174
carcassonne-boltzmann260-vs-boltzmann435-1000its,885,711,2139.899832522,2114.742193554,174
carcassonne-uct455-vs-uct470-1000its,890,716,2160.78968881,2110.818930032,174
carcassonne-ucttuned95-vs-ucttuned215-1000its,893,719,2204.87071483,2166.880038245,174
carcassonne-uct115-vs-uct100-1000its,921,747,2198.931969169,2144.356104525,174
carcassonne-uct210-vs-uct105-1000its,922,748,2167.047495699,2114.781040018,174
carcassonne-boltzmann140-vs-boltzmann300-1000its,923,749,2251.014119413,2176.203895283,174
carcassonne-ucttuned440-vs-ucttuned365-1000its,930,756,2227.707914025,2201.599486091,174
carcassonne-ucttuned10-vs-ucttuned80-1000its,947,773,2284.72752116,2189.036029236,174
carcassonne-ucttuned240-vs-ucttuned470-1000its,951,777,2149.423966858,2093.120940104,174
carcassonne-boltzmann405-vs-boltzmann175-1000its,832,657,2193.636369508,2108.769243594,175
carcassonne-uct220-vs-uct445-1000its,834,659,2173.292507639,2187.252630356,175
carcassonne-boltzmann215-vs-boltzmann205-1000its,835,660,2187.260035457,2138.874687136,175
carcassonne-ucttuned370-vs-ucttuned390-1000its,836,661,2170.202833628,2075.708723439,175
carcassonne-uct220-vs-uct350-1000its,875,700,2162.913954795,2043.090534369,175
carcassonne-ucttuned490-vs-ucttuned435-1000its,886,711,2143.278722189,2073.831828984,175
carcassonne-ucttuned270-vs-ucttuned460-1000its,888,713,2233.998416053,2190.024357062,175
carcassonne-uct20-vs-uct355-1000its,904,729,2163.280209856,2112.088000358,175
carcassonne-uct230-vs-uct285-1000its,904,729,2253.083050763,2213.819970641,175
carcassonne-ucttuned25-vs-ucttuned335-1000its,910,735,2163.30421583,2123.834884294,175
carcassonne-ucttuned410-vs-ucttuned350-1000its,912,737,2227.112294487,2172.594130954,175
carcassonne-ucttuned415-vs-ucttuned235-1000its,925,750,2158.495024245,2144.725491607,175
carcassonne-uct385-vs-uct20-1000its,937,762,2189.900380759,2096.27247313,175
carcassonne-uct55-vs-uct90-1000its,950,775,2269.853128197,2201.611754763,175
carcassonne-ucttuned340-vs-ucttuned220-1000its,990,815,2142.849786836,2091.217006588,175
carcassonne-boltzmann410-vs-boltzmann65-1000its,824,648,2210.442879337,2131.373192115,176
carcassonne-ucttuned95-vs-ucttuned470-1000its,830,654,2204.95713984,2131.657251049,176
carcassonne-boltzmann195-vs-boltzmann205-1000its,841,665,2197.629959957,2161.310344096,176
carcassonne-uct375-vs-uct440-1000its,844,668,2301.71257881,2277.954315555,176
carcassonne-uct405-vs-uct315-1000its,862,686,2182.811562208,2145.310804353,176
carcassonne-ucttuned20-vs-ucttuned255-1000its,866,690,2193.604657158,2119.901048376,176
carcassonne-ucttuned425-vs-ucttuned95-1000its,882,706,2179.642563136,2146.521269806,176
carcassonne-boltzmann270-vs-boltzmann345-1000its,886,710,2242.040627352,2195.98994067,176
carcassonne-uct60-vs-uct315-1000its,920,744,2149.882129435,2079.306256485,176
carcassonne-ucttuned105-vs-ucttuned165-1000its,923,747,2170.72636374,2139.57661723,176
carcassonne-uct350-vs-uct290-1000its,933,757,2188.815011526,2132.935963592,176
carcassonne-boltzmann225-vs-boltzmann380-1000its,936,760,2148.236949682,2096.683959513,176
carcassonne-ucttuned225-vs-ucttuned120-1000its,956,780,2238.793939232,2178.467338974,176
carcassonne-uct10-vs-uct370-1000its,984,808,2216.227052043,2163.089606529,176
carcassonne-ucttuned410-vs-ucttuned390-1000its,827,650,2199.609415424,2139.772334056,177
carcassonne-uct475-vs-uct480-1000its,850,673,2125.867183334,2072.033779653,177
carcassonne-ucttuned90-vs-ucttuned240-1000its,870,693,2167.585499401,2167.017160094,177
carcassonne-boltzmann35-vs-boltzmann100-1000its,871,694,2211.199642831,2176.199306516,177
carcassonne-ucttuned170-vs-ucttuned280-1000its,876,699,2259.640985958,2181.745079872,177
carcassonne-ucttuned475-vs-ucttuned215-1000its,878,701,2280.812634324,2225.92562386,177
carcassonne-uct205-vs-uct235-1000its,879,702,2155.293747699,2093.321454649,177
carcassonne-uct60-vs-uct220-1000its,883,706,2178.061266519,2117.411883192,177
carcassonne-boltzmann30-vs-boltzmann125-1000its,890,713,2226.00163193,2173.939306462,177
carcassonne-uct365-vs-uct160-1000its,903,726,2215.745518724,2179.104962383,177
carcassonne-ucttuned60-vs-ucttuned90-1000its,914,737,2224.512079019,2172.871218232,177
carcassonne-uct45-vs-uct160-1000its,917,740,2237.902726096,2175.862397866,177
carcassonne-uct190-vs-uct440-1000its,918,741,2212.236222752,2125.761700485,177
carcassonne-ucttuned175-vs-ucttuned400-1000its,918,741,2230.477779524,2200.788714965,177
carcassonne-ucttuned485-vs-ucttuned180-1000its,923,746,2182.801319227,2148.8515015,177
carcassonne-uct285-vs-uct290-1000its,938,761,2248.453178921,2170.947676911,177
carcassonne-ucttuned240-vs-ucttuned195-1000its,951,774,2207.643865032,2132.3771887,177
carcassonne-ucttuned170-vs-ucttuned75-1000its,967,790,2160.997237303,2135.66175715,177
carcassonne-uct240-vs-uct155-1000its,834,656,2193.132051356,2131.499539932,178
carcassonne-boltzmann355-vs-boltzmann190-1000its,844,666,2176.472591049,2111.265976523,178
carcassonne-ucttuned475-vs-ucttuned115-1000its,849,671,2221.784480374,2224.044057443,178
carcassonne-uct345-vs-uct270-1000its,850,672,2219.140801473,2174.001949145,178
carcassonne-ucttuned130-vs-ucttuned180-1000its,852,674,2225.056243561,2191.809393587,178
carcassonne-boltzmann215-vs-boltzmann170-1000its,863,685,2168.622208808,2146.853234753,178
carcassonne-boltzmann350-vs-boltzmann270-1000its,901,723,2144.72988018,2129.578674364,178
carcassonne-uct485-vs-uct215-1000its,925,747,2189.439420726,2137.811886196,178
carcassonne-ucttuned15-vs-ucttuned110-1000its,939,761,2188.320332934,2147.091412034,178
carcassonne-ucttuned100-vs-ucttuned245-1000its,943,765,2172.153958254,2139.241537046,178
carcassonne-boltzmann310-vs-boltzmann435-1000its,952,774,2177.996174877,2136.061531884,178
carcassonne-uct460-vs-uct370-1000its,962,784,2258.157469857,2161.056328996,178
carcassonne-uct45-vs-uct125-1000its,829,650,2212.984288119,2161.302629912,179
carcassonne-ucttuned230-vs-ucttuned225-1000its,838,659,2206.250593436,2195.097400692,179
carcassonne-uct280-vs-uct190-1000its,855,676,2224.640698465,2198.552326187,179
carcassonne-boltzmann190-vs-boltzmann210-1000its,859,680,2172.813032096,2146.447960735,179
carcassonne-ucttuned295-vs-ucttuned435-1000its,862,683,2155.747496699,2124.325124494,179
carcassonne-ucttuned20-vs-ucttuned475-1000its,874,695,2132.397489858,2115.315242039,179
carcassonne-boltzmann285-vs-boltzmann495-1000its,877,698,2116.828895001,2074.493091071,179
carcassonne-ucttuned20-vs-ucttuned195-1000its,891,712,2181.899589886,2110.314548924,179
carcassonne-ucttuned470-vs-ucttuned355-1000its,897,718,2224.779293331,2169.775274961,179
carcassonne-boltzmann135-vs-boltzmann385-1000its,902,723,2226.934319512,2179.728047312,179
carcassonne-boltzmann40-vs-boltzmann100-1000its,902,723,2213.361993268,2172.528947038,179
carcassonne-ucttuned320-vs-ucttuned235-1000its,902,723,2230.032262278,2162.999763138,179
carcassonne-uct180-vs-uct55-1000its,904,725,2224.814793305,2131.75808239,179
carcassonne-ucttuned130-vs-ucttuned230-1000its,908,729,2224.753546761,2193.549756655,179
carcassonne-ucttuned105-vs-ucttuned495-1000its,915,736,2183.35797844,2131.736766732,179
carcassonne-boltzmann440-vs-boltzmann425-1000its,936,757,2156.695743062,2078.568641436,179
carcassonne-ucttuned140-vs-ucttuned190-1000its,939,760,2126.848437106,2089.507595105,179
carcassonne-ucttuned35-vs-ucttuned305-1000its,944,765,2228.986462264,2206.522775492,179
carcassonne-ucttuned10-vs-ucttuned75-1000its,976,797,2232.184350932,2167.179164869,179
carcassonne-uct260-vs-uct185-1000its,1018,839,2244.540475673,2220.760737628,179
carcassonne-uct125-vs-uct405-1000its,849,669,2246.909664109,2209.70468366,180
carcassonne-ucttuned385-vs-ucttuned400-1000its,856,676,2175.647162882,2121.830556779,180
carcassonne-boltzmann445-vs-boltzmann455-1000its,857,677,2219.613636779,2183.819387931,180
carcassonne-ucttuned35-vs-ucttuned290-1000its,870,690,2171.180557248,2124.184770305,180
carcassonne-boltzmann210-vs-boltzmann390-1000its,881,701,2152.779098984,2098.962072866,180
carcassonne-ucttuned470-vs-ucttuned285-1000its,882,702,2224.151496893,2178.282248354,180
carcassonne-boltzmann15-vs-boltzmann255-1000its,886,706,2122.917713139,2073.848154442,180
carcassonne-uct5-vs-uct35-1000its,893,713,2224.353974665,2158.833913209,180
carcassonne-ucttuned5-vs-ucttuned460-1000its,894,714,2156.209761917,2104.67035429,180
carcassonne-uct250-vs-uct175-1000its,900,720,2186.200184191,2159.796200261,180
carcassonne-boltzmann165-vs-boltzmann155-1000its,915,735,2177.509777569,2134.793935888,180
carcassonne-ucttuned125-vs-ucttuned150-1000its,936,756,2220.585881362,2146.723909913,180
carcassonne-boltzmann30-vs-boltzmann285-1000its,945,765,2235.301995912,2181.521177439,180
carcassonne-ucttuned60-vs-ucttuned425-1000its,969,789,2206.360327533,2160.965066053,180
carcassonne-ucttuned380-vs-ucttuned220-1000its,971,791,2175.94221038,2135.879396558,180
carcassonne-uct205-vs-uct85-1000its,980,800,2166.673565319,2082.91929234,180
carcassonne-ucttuned5-vs-ucttuned240-1000its,1004,824,2147.365187506,2074.528626348,180
carcassonne-ucttuned180-vs-ucttuned320-1000its,856,675,2267.631526781,2221.439956109,181
carcassonne-ucttuned145-vs-ucttuned50-1000its,870,689,2195.346732792,2151.625600942,181
carcassonne-boltzmann440-vs-boltzmann235-1000its,872,691,2218.420615271,2218.948176042,181
carcassonne-uct265-vs-uct95-1000its,877,696,2175.001036244,2150.176527754,181
carcassonne-boltzmann435-vs-boltzmann310-1000its,878,697,2167.99572474,2067.42605174,181
carcassonne-ucttuned365-vs-ucttuned485-1000its,882,701,2146.617489397,2118.601211584,181
carcassonne-uct40-vs-uct80-1000its,893,712,2171.096345446,2108.053209216,181
carcassonne-uct320-vs-uct305-1000its,898,717,2225.69712558,2189.525027895,181
carcassonne-ucttuned335-vs-ucttuned245-1000its,913,732,2205.729599563,2166.938617072,181
carcassonne-boltzmann345-vs-boltzmann110-1000its,914,733,2149.898009358,2104.017884152,181
carcassonne-ucttuned410-vs-ucttuned205-1000its,917,736,2230.642342339,2174.460296852,181
carcassonne-ucttuned20-vs-ucttuned70-1000its,924,743,2199.430329667,2207.911417487,181
carcassonne-ucttuned45-vs-ucttuned300-1000its,927,746,2184.046944234,2182.369517365,181
carcassonne-ucttuned130-vs-ucttuned310-1000its,935,754,2103.423792439,2080.047894407,181
carcassonne-ucttuned355-vs-ucttuned170-1000its,940,759,2188.039535924,2144.992962374,181
carcassonne-uct415-vs-uct475-1000its,966,785,2149.614386387,2083.985432627,181
carcassonne-ucttuned450-vs-ucttuned495-1000its,841,659,2136.977278316,2055.348815178,182
carcassonne-uct15-vs-uct410-1000its,909,727,2129.410748459,2052.977483091,182
carcassonne-uct270-vs-uct440-1000its,999,817,2221.851782006,2167.362667779,182
carcassonne-uct355-vs-uct345-1000its,1011,829,2181.690808048,2132.267575002,182
carcassonne-ucttuned305-vs-ucttuned0-1000its,640,457,2272.668316733,2032.979864174,183
carcassonne-boltzmann370-vs-boltzmann170-1000its,874,691,2216.495486077,2132.827274144,183
carcassonne-boltzmann340-vs-boltzmann320-1000its,880,697,2250.086320659,2221.22718423,183
carcassonne-uct360-vs-uct380-1000its,895,712,2189.917758945,2214.152261717,183
carcassonne-boltzmann320-vs-boltzmann95-1000its,911,728,2166.274591429,2151.945227345,183
carcassonne-ucttuned40-vs-ucttuned305-1000its,926,743,2205.633099944,2146.928825511,183
carcassonne-ucttuned35-vs-ucttuned90-1000its,844,660,2124.440698569,2090.824316983,184
carcassonne-ucttuned70-vs-ucttuned490-1000its,873,689,2235.608653494,2207.967581762,184
carcassonne-uct180-vs-uct225-1000its,887,703,2235.913713806,2141.913789143,184
carcassonne-uct350-vs-uct55-1000its,896,712,2172.506224913,2151.37068898,184
carcassonne-ucttuned360-vs-ucttuned405-1000its,897,713,2220.162932639,2146.233932557,184
carcassonne-ucttuned230-vs-ucttuned250-1000its,899,715,2156.479180717,2094.231193789,184
carcassonne-uct360-vs-uct210-1000its,912,728,2131.910955983,2143.142007446,184
carcassonne-uct435-vs-uct20-1000its,912,728,2124.733316834,2090.342777885,184
carcassonne-boltzmann10-vs-boltzmann420-1000its,915,731,2101.482971855,2053.631103273,184
carcassonne-ucttuned115-vs-ucttuned430-1000its,949,765,2203.339123075,2157.719104577,184
carcassonne-boltzmann185-vs-boltzmann365-1000its,950,766,2224.863836231,2193.12199578,184
carcassonne-ucttuned40-vs-ucttuned220-1000its,967,783,2222.359102911,2145.018755975,184
carcassonne-ucttuned15-vs-ucttuned440-1000its,976,792,2253.80427044,2138.776604344,184
carcassonne-boltzmann95-vs-boltzmann405-1000its,830,645,2264.040565438,2265.375554795,185
carcassonne-uct250-vs-uct70-1000its,834,649,2211.4488038,2158.227456158,185
carcassonne-boltzmann145-vs-boltzmann55-1000its,851,666,2270.745518457,2185.343209934,185
carcassonne-ucttuned285-vs-ucttuned120-1000its,870,685,2221.189514929,2144.742175672,185
carcassonne-ucttuned125-vs-ucttuned350-1000its,883,698,2228.32097114,2209.969416722,185
carcassonne-boltzmann340-vs-boltzmann355-1000its,887,702,2210.538734053,2159.90682357,185
carcassonne-boltzmann65-vs-boltzmann455-1000its,891,706,2256.593075259,2174.805197353,185
carcassonne-boltzmann100-vs-boltzmann185-1000its,897,712,2305.18275981,2278.227365585,185
carcassonne-ucttuned20-vs-ucttuned205-1000its,926,741,2220.699273059,2213.919447943,185
carcassonne-boltzmann105-vs-boltzmann220-1000its,934,749,2205.029843401,2174.906817404,185
carcassonne-boltzmann190-vs-boltzmann15-1000its,939,754,2180.486467759,2136.389851191,185
carcassonne-ucttuned360-vs-ucttuned125-1000its,947,762,2247.160788382,2194.567473741,185
carcassonne-ucttuned155-vs-ucttuned210-1000its,1015,830,2211.422531451,2215.424173646,185
carcassonne-boltzmann175-vs-boltzmann50-1000its,896,710,2186.709421845,2139.489035445,186
carcassonne-ucttuned200-vs-ucttuned115-1000its,898,712,2220.018014451,2163.659534419,186
carcassonne-boltzmann180-vs-boltzmann360-1000its,900,714,2140.215173929,2088.311991281,186
carcassonne-uct125-vs-uct205-1000its,929,743,2172.490903015,2183.379413284,186
carcassonne-ucttuned430-vs-ucttuned70-1000its,945,759,2207.588148814,2159.249643165,186
carcassonne-uct150-vs-uct310-1000its,958,772,2231.240377362,2160.233559277,186
carcassonne-boltzmann50-vs-boltzmann325-1000its,801,614,2162.024661374,2093.221101673,187
carcassonne-uct160-vs-uct285-1000its,881,694,2234.157557184,2202.149532535,187
carcassonne-uct185-vs-uct85-1000its,887,700,2205.881272248,2139.145133536,187
carcassonne-boltzmann5-vs-boltzmann400-1000its,907,720,2249.647821198,2187.895611568,187
carcassonne-boltzmann495-vs-boltzmann310-1000its,914,727,2199.074512896,2155.72459315,187
carcassonne-ucttuned450-vs-ucttuned220-1000its,965,778,2271.233547846,2252.807781809,187
carcassonne-uct325-vs-uct185-1000its,989,802,2215.438948546,2166.293324532,187
carcassonne-uct475-vs-uct135-1000its,991,804,2213.663521581,2187.012866765,187
carcassonne-ucttuned395-vs-ucttuned295-1000its,845,657,2130.13937191,2102.910379537,188
carcassonne-ucttuned460-vs-ucttuned185-1000its,867,679,2188.298222618,2187.598488672,188
carcassonne-ucttuned440-vs-ucttuned480-1000its,878,690,2158.639489988,2122.224021722,188
carcassonne-ucttuned60-vs-ucttuned330-1000its,882,694,2236.30253864,2181.417368581,188
carcassonne-uct125-vs-uct430-1000its,884,696,2199.124228622,2143.619965756,188
carcassonne-boltzmann330-vs-boltzmann60-1000its,918,730,2146.476657122,2064.791653727,188
carcassonne-boltzmann435-vs-boltzmann405-1000its,926,738,2181.421770098,2142.468616617,188
carcassonne-boltzmann455-vs-boltzmann345-1000its,929,741,2218.871701034,2170.923656213,188
carcassonne-ucttuned15-vs-ucttuned495-1000its,946,758,2180.012673601,2090.046425231,188
carcassonne-boltzmann240-vs-boltzmann100-1000its,818,629,2268.880420024,2172.159112477,189
carcassonne-ucttuned310-vs-ucttuned235-1000its,831,642,2234.206531617,2136.413914356,189
carcassonne-ucttuned5-vs-ucttuned470-1000its,894,705,2222.899029486,2157.131469836,189
carcassonne-boltzmann230-vs-boltzmann315-1000its,899,710,2180.56414159,2098.894695917,189
carcassonne-ucttuned90-vs-ucttuned100-1000its,908,719,2218.987974632,2128.682722138,189
carcassonne-ucttuned350-vs-ucttuned465-1000its,916,727,2209.211437295,2187.752212221,189
carcassonne-uct180-vs-uct200-1000its,917,728,2232.210888263,2180.105820863,189
carcassonne-ucttuned400-vs-ucttuned270-1000its,944,755,2221.331425037,2126.899750852,189
carcassonne-boltzmann490-vs-boltzmann100-1000its,858,668,2185.651593171,2136.516873596,190
carcassonne-uct5-vs-uct205-1000its,867,677,2239.607639293,2148.025430702,190
carcassonne-uct360-vs-uct295-1000its,883,693,2151.314344861,2167.239914896,190
carcassonne-uct230-vs-uct275-1000its,884,694,2231.105661172,2154.986280252,190
carcassonne-boltzmann150-vs-boltzmann290-1000its,887,697,2186.206560039,2145.14619723,190
carcassonne-boltzmann5-vs-boltzmann420-1000its,887,697,2274.828276481,2224.689605678,190
carcassonne-ucttuned5-vs-ucttuned405-1000its,895,705,2203.92633318,2195.158876534,190
carcassonne-boltzmann290-vs-boltzmann490-1000its,898,708,2169.471136557,2144.13795373,190
carcassonne-boltzmann15-vs-boltzmann420-1000its,903,713,2231.933316307,2143.583444007,190
carcassonne-uct395-vs-uct375-1000its,907,717,2145.570841418,2062.883490089,190
carcassonne-uct285-vs-uct85-1000its,910,720,2286.329646829,2235.742448842,190
carcassonne-uct285-vs-uct340-1000its,913,723,2147.758567644,2120.483893748,190
carcassonne-uct110-vs-uct160-1000its,952,762,2206.891629335,2200.701158295,190
carcassonne-ucttuned10-vs-ucttuned465-1000its,983,793,2225.982588038,2143.335492468,190
carcassonne-uct130-vs-uct95-1000its,870,679,2189.757014673,2174.771777776,191
carcassonne-boltzmann45-vs-boltzmann265-1000its,872,681,2185.305725711,2156.947852868,191
carcassonne-boltzmann120-vs-boltzmann435-1000its,880,689,2139.769645219,2084.278770429,191
carcassonne-boltzmann35-vs-boltzmann295-1000its,880,689,2218.041654556,2168.962651634,191
carcassonne-ucttuned345-vs-ucttuned175-1000its,886,695,2212.951649641,2128.915832389,191
carcassonne-ucttuned175-vs-ucttuned475-1000its,893,702,2178.681739083,2153.66221274,191
carcassonne-boltzmann235-vs-boltzmann400-1000its,902,711,2200.833156224,2143.303539517,191
carcassonne-boltzmann280-vs-boltzmann145-1000its,914,723,2169.867724026,2146.576263132,191
carcassonne-uct70-vs-uct145-1000its,917,726,2167.962048839,2095.864077074,191
carcassonne-uct55-vs-uct435-1000its,1003,812,2179.587178993,2096.067071975,191
carcassonne-ucttuned410-vs-ucttuned400-1000its,1015,824,2158.495422035,2105.309605979,191
carcassonne-uct410-vs-uct475-1000its,811,619,2229.852652264,2148.814063764,192
carcassonne-boltzmann200-vs-boltzmann240-1000its,870,678,2103.678679025,2134.379650385,192
carcassonne-boltzmann105-vs-boltzmann320-1000its,881,689,2218.842264265,2175.958247672,192
carcassonne-uct10-vs-uct115-1000its,893,701,2223.898517938,2148.115906918,192
carcassonne-uct20-vs-uct485-1000its,903,711,2201.850352966,2144.698195114,192
carcassonne-uct10-vs-uct405-1000its,942,750,2150.149203147,2068.940194346,192
carcassonne-boltzmann210-vs-boltzmann270-1000its,832,639,2209.961410122,2135.146652126,193
carcassonne-uct80-vs-uct40-1000its,840,647,2149.288474293,2083.867577618,193
carcassonne-ucttuned415-vs-ucttuned155-1000its,862,669,2234.778604635,2209.820534615,193
carcassonne-boltzmann220-vs-boltzmann30-1000its,864,671,2276.596828864,2192.717322589,193
carcassonne-ucttuned100-vs-ucttuned390-1000its,875,682,2272.121883586,2190.325532433,193
carcassonne-ucttuned470-vs-ucttuned380-1000its,889,696,2174.586333364,2177.899872608,193
carcassonne-ucttuned240-vs-ucttuned215-1000its,899,706,2157.224168394,2092.882956536,193
carcassonne-ucttuned235-vs-ucttuned110-1000its,904,711,2181.542241258,2145.050929046,193
carcassonne-uct395-vs-uct160-1000its,907,714,2250.351923787,2232.37925723,193
carcassonne-ucttuned60-vs-ucttuned405-1000its,909,716,2109.718993829,2051.009798644,193
carcassonne-ucttuned325-vs-ucttuned270-1000its,988,795,2186.647404437,2136.534998001,193
carcassonne-uct485-vs-uct430-1000its,993,800,2215.081281664,2168.05963676,193
carcassonne-boltzmann25-vs-boltzmann225-1000its,794,600,2167.308006929,2138.516288249,194
carcassonne-ucttuned125-vs-ucttuned120-1000its,899,705,2251.74606836,2189.840771451,194
carcassonne-boltzmann480-vs-boltzmann435-1000its,915,721,2193.608893244,2179.052563422,194
carcassonne-ucttuned430-vs-ucttuned315-1000its,918,724,2198.754849628,2163.78144604,194
carcassonne-boltzmann435-vs-boltzmann365-1000its,937,743,2153.871705495,2110.657570332,194
carcassonne-boltzmann145-vs-boltzmann330-1000its,814,619,2293.961200664,2192.836286075,195
carcassonne-uct215-vs-uct135-1000its,852,657,2193.056062854,2172.630629696,195
carcassonne-boltzmann45-vs-boltzmann155-1000its,885,690,2172.523353529,2126.884904078,195
carcassonne-boltzmann475-vs-boltzmann40-1000its,899,704,2212.32456636,2191.401255931,195
carcassonne-uct140-vs-uct65-1000its,935,740,2197.292508829,2170.286540619,195
carcassonne-uct345-vs-uct145-1000its,885,689,2204.685400901,2142.291369005,196
carcassonne-boltzmann490-vs-boltzmann150-1000its,901,705,2162.143172221,2129.640264315,196
carcassonne-uct435-vs-uct410-1000its,933,737,2143.514248073,2113.126350518,196
carcassonne-boltzmann355-vs-boltzmann315-1000its,990,794,2205.409474782,2162.269400679,196
carcassonne-uct15-vs-uct285-1000its,846,649,2110.811469443,2100.356373057,197
carcassonne-ucttuned45-vs-ucttuned115-1000its,853,656,2238.22601186,2204.417233655,197
carcassonne-ucttuned450-vs-ucttuned245-1000its,860,663,2219.491526354,2155.011499808,197
carcassonne-boltzmann475-vs-boltzmann495-1000its,870,673,2164.228078702,2106.654958394,197
carcassonne-uct465-vs-uct110-1000its,901,704,2265.312220052,2159.675124914,197
carcassonne-boltzmann80-vs-boltzmann365-1000its,904,707,2175.818497169,2138.499388352,197
carcassonne-boltzmann5-vs-boltzmann85-1000its,915,718,2151.767746309,2114.929185217,197
carcassonne-ucttuned100-vs-ucttuned60-1000its,930,733,2190.305292125,2155.980300711,197
carcassonne-boltzmann345-vs-boltzmann325-1000its,944,747,2187.360426551,2145.582695115,197
carcassonne-ucttuned185-vs-ucttuned265-1000its,949,752,2166.785863983,2112.676124013,197
carcassonne-boltzmann400-vs-boltzmann35-1000its,990,793,2161.625437311,2095.960715703,197
carcassonne-ucttuned310-vs-ucttuned220-1000its,860,662,2159.364156318,2133.980284822,198
carcassonne-uct455-vs-uct410-1000its,870,672,2187.213544915,2084.840524585,198
carcassonne-uct100-vs-uct225-1000its,881,683,2222.670940133,2159.782269624,198
carcassonne-uct165-vs-uct285-1000its,885,687,2152.597712015,2131.840771976,198
carcassonne-uct480-vs-uct430-1000its,902,704,2184.454077336,2151.547059579,198
carcassonne-ucttuned155-vs-ucttuned20-1000its,959,761,2214.42362477,2167.663802485,198
carcassonne-uct470-vs-uct50-1000its,874,675,2221.25299585,2171.045063144,199
carcassonne-boltzmann65-vs-boltzmann370-1000its,921,722,2172.423423008,2129.405783182,199
carcassonne-ucttuned260-vs-ucttuned470-1000its,958,759,2265.821963586,2209.087930745,199
carcassonne-boltzmann375-vs-boltzmann195-1000its,870,670,2169.869489544,2127.720457502,200
carcassonne-uct160-vs-uct230-1000its,929,729,2199.093932963,2141.663633469,200
carcassonne-ucttuned60-vs-ucttuned110-1000its,965,765,2173.453238557,2140.172136336,200
carcassonne-ucttuned180-vs-ucttuned355-1000its,999,799,2185.322868584,2155.276660172,200
carcassonne-ucttuned205-vs-ucttuned265-1000its,832,631,2230.306162948,2205.022821502,201
carcassonne-boltzmann270-vs-boltzmann165-1000its,881,680,2168.938031897,2141.139570194,201
carcassonne-uct310-vs-uct35-1000its,910,709,2337.862824032,2276.249033273,201
carcassonne-ucttuned415-vs-ucttuned480-1000its,915,714,2153.474426217,2170.35615703,201
carcassonne-ucttuned5-vs-ucttuned455-1000its,931,730,2237.260954431,2153.038644969,201
carcassonne-ucttuned40-vs-ucttuned10-1000its,932,731,2150.808801222,2092.083426595,201
carcassonne-uct295-vs-uct325-1000its,940,739,2214.206764829,2175.352085863,201
carcassonne-uct290-vs-uct265-1000its,946,745,2249.082261351,2193.536639205,201
carcassonne-ucttuned5-vs-ucttuned480-1000its,989,788,2270.382711337,2224.119162072,201
carcassonne-boltzmann390-vs-boltzmann345-1000its,852,650,2142.558927035,2115.401990062,202
carcassonne-ucttuned360-vs-ucttuned140-1000its,877,675,2160.502641939,2136.929315568,202
carcassonne-uct125-vs-uct220-1000its,890,688,2194.757245291,2145.22439962,202
carcassonne-ucttuned50-vs-ucttuned180-1000its,901,699,2244.407789709,2238.885823919,202
carcassonne-boltzmann195-vs-boltzmann365-1000its,937,734,2179.028985653,2052.23963291,203
carcassonne-ucttuned135-vs-ucttuned240-1000its,946,743,2171.558305395,2135.895640341,203
carcassonne-uct120-vs-uct425-1000its,975,772,2238.108380448,2224.468282725,203
carcassonne-boltzmann215-vs-boltzmann315-1000its,864,660,2128.108135057,2090.031152631,204
carcassonne-ucttuned10-vs-ucttuned165-1000its,937,733,2154.34592083,2139.044183538,204
carcassonne-ucttuned5-vs-ucttuned20-1000its,859,654,2162.836561489,2138.438925091,205
carcassonne-boltzmann20-vs-boltzmann185-1000its,888,683,2132.076332305,2092.413955995,205
carcassonne-uct260-vs-uct360-1000its,899,694,2137.714049077,2128.368567234,205
carcassonne-uct15-vs-uct300-1000its,901,696,2190.75862786,2101.31810313,205
carcassonne-uct385-vs-uct175-1000its,1009,804,2210.177024036,2177.209630354,205
carcassonne-boltzmann185-vs-boltzmann205-1000its,829,623,2246.932426636,2204.752411968,206
carcassonne-uct60-vs-uct415-1000its,878,672,2203.869906555,2144.716919845,206
carcassonne-uct265-vs-uct315-1000its,891,685,2142.198399385,2025.320717171,206
carcassonne-boltzmann445-vs-boltzmann430-1000its,892,686,2153.45008871,2157.215590416,206
carcassonne-boltzmann455-vs-boltzmann295-1000its,948,742,2164.845506893,2131.957479275,206
carcassonne-uct35-vs-uct250-1000its,883,676,2175.264811157,2138.447948603,207
carcassonne-boltzmann305-vs-boltzmann395-1000its,901,694,2244.183256624,2224.191507365,207
carcassonne-ucttuned415-vs-ucttuned420-1000its,902,695,2187.679810235,2125.22391045,207
carcassonne-ucttuned195-vs-ucttuned165-1000its,909,702,2168.862485394,2144.523614389,207
carcassonne-ucttuned185-vs-ucttuned160-1000its,924,717,2280.574349911,2231.019049909,207
carcassonne-uct425-vs-uct100-1000its,955,748,2231.64184277,2162.102152269,207
carcassonne-uct235-vs-uct495-1000its,964,757,2181.642118281,2096.378258255,207
carcassonne-uct310-vs-uct220-1000its,977,770,2216.049120617,2167.853218472,207
carcassonne-uct55-vs-uct280-1000its,876,668,2247.300006556,2249.478213721,208
carcassonne-boltzmann250-vs-boltzmann245-1000its,887,679,2215.017477198,2133.956453744,208
carcassonne-ucttuned85-vs-ucttuned480-1000its,947,739,2149.67672046,2087.636259736,208
carcassonne-uct350-vs-uct260-1000its,844,635,2175.103601827,2151.891256163,209
carcassonne-ucttuned120-vs-ucttuned315-1000its,860,651,2229.350339998,2157.236086981,209
carcassonne-uct440-vs-uct150-1000its,899,690,2240.657974685,2222.934049195,209
carcassonne-uct445-vs-uct470-1000its,900,691,2218.357080274,2131.239941551,209
carcassonne-boltzmann20-vs-boltzmann245-1000its,902,693,2174.729129501,2137.567394505,209
carcassonne-boltzmann80-vs-boltzmann460-1000its,902,693,2204.849245827,2158.839590286,209
carcassonne-uct325-vs-uct40-1000its,906,697,2264.612128771,2215.511685699,209
carcassonne-boltzmann380-vs-boltzmann275-1000its,874,664,2223.054249831,2155.56447402,210
carcassonne-uct365-vs-uct305-1000its,826,615,2152.687290219,2125.122100571,211
carcassonne-uct280-vs-uct440-1000its,885,674,2168.489745845,2094.139427598,211
carcassonne-ucttuned20-vs-ucttuned115-1000its,819,607,2173.454105256,2086.364495887,212
carcassonne-uct260-vs-uct150-1000its,847,635,2215.508421362,2128.707923127,212
carcassonne-ucttuned100-vs-ucttuned270-1000its,942,730,2212.008226182,2139.163100978,212
carcassonne-ucttuned75-vs-ucttuned350-1000its,995,783,2235.552831677,2164.577581004,212
carcassonne-uct260-vs-uct410-1000its,820,607,2151.667050034,2133.145594776,213
carcassonne-boltzmann40-vs-boltzmann265-1000its,851,638,2121.649623414,2066.785408273,213
carcassonne-ucttuned280-vs-ucttuned355-1000its,881,668,2200.200937078,2160.31682404,213
carcassonne-ucttuned265-vs-ucttuned60-1000its,883,670,2218.58683826,2168.793315757,213
carcassonne-ucttuned190-vs-ucttuned420-1000its,947,734,2242.08677635,2146.703385727,213
carcassonne-boltzmann5-vs-boltzmann325-1000its,962,749,2209.7062057,2177.925643455,213
carcassonne-boltzmann465-vs-boltzmann175-1000its,869,655,2180.216388052,2163.597319814,214
carcassonne-uct480-vs-uct245-1000its,901,687,2172.612160205,2125.551233483,214
carcassonne-uct30-vs-uct100-1000its,902,688,2255.510445938,2202.827997013,214
carcassonne-ucttuned5-vs-ucttuned220-1000its,904,690,2214.372744421,2164.115472264,214
carcassonne-ucttuned190-vs-ucttuned300-1000its,931,717,2277.306581816,2221.948867548,214
carcassonne-uct10-vs-uct330-1000its,932,718,2200.745873144,2132.396216036,214
carcassonne-ucttuned470-vs-ucttuned180-1000its,1075,861,2171.844339787,2133.376327186,214
carcassonne-boltzmann410-vs-boltzmann130-1000its,845,630,2267.840424271,2194.904711901,215
carcassonne-uct220-vs-uct195-1000its,910,695,2164.785135759,2113.92948422,215
carcassonne-uct395-vs-uct305-1000its,925,710,2183.439396941,2076.216755905,215
carcassonne-ucttuned15-vs-ucttuned430-1000its,1124,909,2185.971595255,2094.887816712,215
carcassonne-uct225-vs-uct410-1000its,867,651,2200.081505322,2175.23405164,216
carcassonne-uct375-vs-uct15-1000its,904,688,2207.331311268,2151.573534308,216
carcassonne-uct390-vs-uct360-1000its,926,710,2192.954749867,2124.774042211,216
carcassonne-ucttuned40-vs-ucttuned395-1000its,936,720,2236.668664774,2161.344381217,216
carcassonne-ucttuned135-vs-ucttuned375-1000its,849,632,2229.548151619,2168.815214358,217
carcassonne-uct195-vs-uct455-1000its,859,642,2164.749187082,2130.06366974,217
carcassonne-ucttuned385-vs-ucttuned450-1000its,942,725,2210.593170209,2165.129432336,217
carcassonne-ucttuned125-vs-ucttuned85-1000its,914,696,2202.191824323,2147.684157806,218
carcassonne-uct210-vs-uct205-1000its,939,721,2255.591445203,2183.697950299,218
carcassonne-uct360-vs-uct30-1000its,817,598,2283.816917693,2218.141793802,219
carcassonne-ucttuned65-vs-ucttuned70-1000its,893,674,2189.327183692,2124.583885544,219
carcassonne-ucttuned45-vs-ucttuned365-1000its,894,675,2172.446156292,2110.801857608,219
carcassonne-ucttuned215-vs-ucttuned15-1000its,859,639,2277.461149411,2265.577578882,220
carcassonne-uct255-vs-uct115-1000its,899,679,2280.755703273,2195.618745934,220
carcassonne-uct240-vs-uct290-1000its,912,690,2235.676206913,2119.566209594,222
carcassonne-boltzmann435-vs-boltzmann160-1000its,947,725,2220.790484303,2169.110888868,222
carcassonne-boltzmann125-vs-boltzmann100-1000its,965,743,2216.805104455,2166.832390193,222
carcassonne-ucttuned180-vs-ucttuned170-1000its,1003,781,2222.240532517,2190.456310407,222
carcassonne-ucttuned325-vs-ucttuned305-1000its,1065,843,2217.303744442,2176.009790429,222
carcassonne-ucttuned10-vs-ucttuned275-1000its,887,664,2189.259614123,2140.853049799,223
carcassonne-boltzmann100-vs-boltzmann130-1000its,889,666,2172.880819034,2129.802928066,223
carcassonne-ucttuned380-vs-ucttuned155-1000its,896,673,2205.764319099,2143.934482864,223
carcassonne-boltzmann380-vs-boltzmann140-1000its,911,688,2151.388961891,2152.246792507,223
carcassonne-ucttuned35-vs-ucttuned105-1000its,948,725,2209.740924608,2144.610215131,223
carcassonne-ucttuned20-vs-ucttuned150-1000its,1009,785,2272.371783567,2212.27133159,224
carcassonne-ucttuned285-vs-ucttuned130-1000its,861,636,2258.287988759,2156.905094968,225
carcassonne-ucttuned335-vs-ucttuned195-1000its,910,685,2163.090404587,2141.490014346,225
carcassonne-ucttuned10-vs-ucttuned440-1000its,945,720,2156.964107221,2092.661115223,225
carcassonne-boltzmann285-vs-boltzmann190-1000its,867,641,2148.330640489,2111.02905195,226
carcassonne-ucttuned360-vs-ucttuned105-1000its,892,666,2154.350262289,2108.899229497,226
carcassonne-ucttuned140-vs-ucttuned410-1000its,903,677,2144.004665162,2103.516760365,226
carcassonne-ucttuned110-vs-ucttuned330-1000its,930,704,2171.530125776,2124.160032136,226
carcassonne-ucttuned10-vs-ucttuned205-1000its,968,742,2243.903121711,2165.400375787,226
carcassonne-ucttuned10-vs-ucttuned285-1000its,991,765,2201.17346415,2130.545112243,226
carcassonne-boltzmann370-vs-boltzmann440-1000its,894,666,2148.517684592,2110.664850438,228
carcassonne-ucttuned290-vs-ucttuned390-1000its,907,679,2244.471660548,2179.342643526,228
carcassonne-ucttuned115-vs-ucttuned385-1000its,916,688,2210.378367076,2181.443629521,228
carcassonne-boltzmann460-vs-boltzmann235-1000its,922,694,2209.203716577,2121.353526858,228
carcassonne-uct215-vs-uct0-1000its,666,437,2191.202213248,1945.223742442,229
carcassonne-boltzmann5-vs-boltzmann50-1000its,996,766,2215.34090208,2125.320961758,230
carcassonne-ucttuned55-vs-ucttuned340-1000its,891,660,2236.139726804,2177.394833404,231
carcassonne-uct280-vs-uct120-1000its,950,719,2262.353943272,2238.111135018,231
carcassonne-boltzmann490-vs-boltzmann460-1000its,820,588,2184.371449192,2166.927364086,232
carcassonne-ucttuned215-vs-ucttuned20-1000its,988,756,2264.558383922,2198.804107674,232
carcassonne-ucttuned375-vs-ucttuned0-1000its,706,473,2285.386565368,2072.652090889,233
carcassonne-boltzmann225-vs-boltzmann115-1000its,914,681,2204.411161566,2154.176914454,233
carcassonne-uct360-vs-uct90-1000its,877,643,2245.45832625,2186.30509428,234
carcassonne-ucttuned230-vs-ucttuned485-1000its,879,644,2210.522998285,2152.075708087,235
carcassonne-ucttuned95-vs-ucttuned345-1000its,901,666,2202.384192972,2168.077451948,235
carcassonne-boltzmann60-vs-boltzmann190-1000its,928,693,2194.985766454,2136.827695869,235
carcassonne-uct325-vs-uct280-1000its,966,731,2216.159878827,2169.3958926,235
carcassonne-ucttuned280-vs-ucttuned180-1000its,973,736,2203.135767719,2135.088854664,237
carcassonne-uct100-vs-uct495-1000its,978,741,2185.882944213,2153.580954779,237
carcassonne-ucttuned15-vs-ucttuned405-1000its,999,762,2202.302007711,2124.553380467,237
carcassonne-uct355-vs-uct465-1000its,883,644,2183.379900392,2172.16221188,239
carcassonne-ucttuned15-vs-ucttuned185-1000its,943,704,2219.977425205,2163.111281452,239
carcassonne-boltzmann320-vs-boltzmann160-1000its,951,712,2208.798552478,2150.201911524,239
carcassonne-uct210-vs-uct335-1000its,984,745,2251.964146046,2240.393310185,239
carcassonne-boltzmann275-vs-boltzmann220-1000its,868,627,2216.563192742,2177.142626195,241
carcassonne-uct230-vs-uct330-1000its,876,635,2223.146711982,2195.632906208,241
carcassonne-ucttuned85-vs-ucttuned185-1000its,920,679,2118.079026232,2098.86407886,241
carcassonne-uct35-vs-uct335-1000its,881,639,2169.825224874,2107.896799041,242
carcassonne-ucttuned65-vs-ucttuned190-1000its,904,661,2241.786875149,2179.397441595,243
carcassonne-ucttuned65-vs-ucttuned295-1000its,988,745,2164.32210305,2087.061808744,243
carcassonne-uct5-vs-uct70-1000its,951,705,2188.478981481,2134.726763835,246
carcassonne-boltzmann185-vs-boltzmann295-1000its,883,636,2169.455449553,2153.274353564,247
carcassonne-boltzmann5-vs-boltzmann55-1000its,1027,779,2265.187009488,2188.437100469,248
carcassonne-boltzmann15-vs-boltzmann90-1000its,889,640,2203.427278679,2156.327226427,249
carcassonne-ucttuned215-vs-ucttuned370-1000its,950,700,2246.300175536,2224.776574117,250
carcassonne-uct60-vs-uct285-1000its,934,683,2186.337940776,2140.981458206,251
carcassonne-uct345-vs-uct0-1000its,741,486,2272.395521928,2030.104584625,255
carcassonne-uct35-vs-uct325-1000its,918,663,2213.343172905,2189.315976243,255
carcassonne-uct365-vs-uct95-1000its,1001,745,2274.851917815,2226.58857819,256
carcassonne-ucttuned110-vs-ucttuned475-1000its,952,692,2153.289812271,2101.559953585,260
carcassonne-uct285-vs-uct410-1000its,954,694,2172.509349645,2107.319748901,260
carcassonne-boltzmann380-vs-boltzmann460-1000its,956,693,2190.48486948,2193.072439155,263
carcassonne-ucttuned230-vs-ucttuned260-1000its,1004,740,2193.523935165,2131.090359907,264
carcassonne-ucttuned200-vs-ucttuned0-1000its,772,507,2263.69987097,2020.443624058,265
carcassonne-boltzmann90-vs-boltzmann405-1000its,900,635,2200.004147523,2179.778526366,265
carcassonne-uct405-vs-uct0-1000its,757,489,2219.051421547,1969.834133726,268
carcassonne-ucttuned235-vs-ucttuned495-1000its,926,658,2197.198737507,2144.63637447,268
carcassonne-uct290-vs-uct0-1000its,686,417,2231.807293839,1993.29236474,269
carcassonne-ucttuned415-vs-ucttuned0-1000its,698,429,2183.594977338,1919.984735444,269
carcassonne-ucttuned460-vs-ucttuned0-1000its,755,485,2232.98511835,1983.51973977,270
carcassonne-boltzmann300-vs-boltzmann95-1000its,929,659,2150.522230151,2118.202637334,270
carcassonne-ucttuned150-vs-ucttuned0-1000its,701,430,2217.961164786,1988.023026219,271
carcassonne-uct250-vs-uct185-1000its,882,611,2183.535606433,2145.17151905,271
carcassonne-uct460-vs-uct0-1000its,744,471,2287.592843815,2003.477533275,273
carcassonne-uct260-vs-uct0-1000its,743,469,2317.345958061,2068.704614116,274
carcassonne-ucttuned10-vs-ucttuned405-1000its,950,676,2231.3654356,2164.186239775,274
carcassonne-uct140-vs-uct0-1000its,732,457,2272.493158711,2013.000893664,275
carcassonne-ucttuned470-vs-ucttuned495-1000its,952,676,2269.042006771,2199.021660544,276
carcassonne-uct490-vs-uct0-1000its,734,457,2205.857217983,1943.697837387,277
carcassonne-ucttuned445-vs-ucttuned0-1000its,742,465,2236.533155966,1961.530590195,277
carcassonne-uct125-vs-uct0-1000its,708,429,2252.165662651,1965.65500049,279
carcassonne-uct100-vs-uct150-1000its,1021,741,2187.718154673,2138.44708934,280
carcassonne-ucttuned130-vs-ucttuned215-1000its,981,700,2227.915841547,2188.321495475,281
carcassonne-ucttuned50-vs-ucttuned0-1000its,724,442,2257.597069367,1992.308932867,282
carcassonne-ucttuned145-vs-ucttuned0-1000its,746,459,2179.159043336,1961.580674895,287
carcassonne-ucttuned90-vs-ucttuned0-1000its,748,461,2299.688186864,2014.097796817,287
carcassonne-uct65-vs-uct0-1000its,833,546,2228.294583819,2013.985244827,287
carcassonne-ucttuned235-vs-ucttuned0-1000its,734,446,2331.392668609,2042.470537768,288
carcassonne-ucttuned10-vs-ucttuned0-1000its,762,474,2322.071844165,2006.062742801,288
carcassonne-boltzmann300-vs-boltzmann65-1000its,892,601,2208.738075049,2151.777380843,291
carcassonne-uct445-vs-uct0-1000its,700,407,2287.236539487,2000.896730397,293
carcassonne-ucttuned170-vs-ucttuned0-1000its,719,426,2224.120512606,1945.116739997,293
carcassonne-uct410-vs-uct0-1000its,730,437,2195.585779936,1945.332681943,293
carcassonne-uct145-vs-uct410-1000its,940,647,2203.92213138,2139.759138981,293
carcassonne-ucttuned35-vs-ucttuned0-1000its,715,421,2233.642101184,1977.328456041,294
carcassonne-uct10-vs-uct35-1000its,924,629,2240.737062153,2181.614689155,295
carcassonne-uct285-vs-uct0-1000its,732,436,2285.431654872,2019.289604714,296
carcassonne-boltzmann300-vs-boltzmann480-1000its,935,638,2215.022970436,2197.334284885,297
carcassonne-ucttuned70-vs-ucttuned0-1000its,703,404,2272.772390512,1986.125878359,299
carcassonne-uct250-vs-uct0-1000its,785,486,2283.225910028,2008.417839748,299
carcassonne-uct280-vs-uct0-1000its,729,429,2217.430119049,2004.179015108,300
carcassonne-ucttuned315-vs-ucttuned0-1000its,759,458,2262.902521113,1973.293509227,301
carcassonne-ucttuned130-vs-ucttuned0-1000its,713,410,2271.662111678,1999.345895082,303
carcassonne-uct205-vs-uct0-1000its,731,427,2224.71666892,1963.936009323,304
carcassonne-ucttuned285-vs-ucttuned0-1000its,703,398,2172.198448101,1961.715118984,305
carcassonne-ucttuned300-vs-ucttuned0-1000its,786,480,2254.266750437,1991.714174685,306
carcassonne-ucttuned45-vs-ucttuned0-1000its,690,383,2225.800792672,1971.448012727,307
carcassonne-ucttuned80-vs-ucttuned0-1000its,719,412,2320.988314146,2031.479862757,307
carcassonne-ucttuned400-vs-ucttuned0-1000its,738,431,2284.409918897,2015.705446681,307
carcassonne-ucttuned260-vs-ucttuned0-1000its,733,424,2227.738579815,1978.344454968,309
carcassonne-ucttuned425-vs-ucttuned0-1000its,733,424,2186.89311033,1965.823065464,309
carcassonne-uct105-vs-uct0-1000its,734,424,2248.100180315,1968.05696838,310
carcassonne-uct270-vs-uct0-1000its,753,443,2259.54488107,2020.90994576,310
carcassonne-ucttuned225-vs-ucttuned0-1000its,757,447,2209.918757391,1977.890228783,310
carcassonne-uct330-vs-uct0-1000its,728,417,2216.966644702,1909.340168057,311
carcassonne-uct120-vs-uct0-1000its,774,463,2289.28527693,2023.024420017,311
carcassonne-uct110-vs-uct0-1000its,795,484,2306.36803174,2036.689136443,311
carcassonne-ucttuned230-vs-ucttuned0-1000its,728,416,2255.279052775,1982.697611426,312
carcassonne-uct275-vs-uct0-1000its,721,408,2200.759614963,1928.188491917,313
carcassonne-uct185-vs-uct0-1000its,770,457,2221.847733848,1971.169011013,313
carcassonne-uct225-vs-uct0-1000its,765,450,2257.654649679,2004.317891204,315
carcassonne-uct15-vs-uct0-1000its,690,374,2278.947184331,1999.118691011,316
carcassonne-uct155-vs-uct0-1000its,771,455,2238.509618837,1915.756961487,316
carcassonne-uct70-vs-uct0-1000its,612,295,1836.794800723,1588.957019963,317
carcassonne-ucttuned405-vs-ucttuned0-1000its,778,461,2232.8915268,2040.245469285,317
carcassonne-ucttuned120-vs-ucttuned0-1000its,754,436,2197.418526019,2004.363682951,318
carcassonne-ucttuned355-vs-ucttuned0-1000its,720,401,2320.123055618,2042.050695905,319
carcassonne-uct335-vs-uct0-1000its,803,484,2243.29239875,2021.756959671,319
carcassonne-ucttuned255-vs-ucttuned0-1000its,798,478,2258.275628268,1981.592222253,320
carcassonne-uct240-vs-uct0-1000its,823,503,2268.891941309,2044.691857586,320
carcassonne-uct130-vs-uct0-1000its,767,445,2305.177878077,2059.095870001,322
carcassonne-ucttuned135-vs-ucttuned0-1000its,732,409,2239.518695997,1965.055494274,323
carcassonne-ucttuned310-vs-ucttuned0-1000its,742,419,2187.284259248,2015.093901208,323
carcassonne-ucttuned75-vs-ucttuned0-1000its,754,431,2274.787542788,2013.687831603,323
carcassonne-uct135-vs-uct0-1000its,800,477,2235.480381548,1945.412187685,323
carcassonne-uct20-vs-uct0-1000its,725,401,2202.861359675,1915.415995373,324
carcassonne-ucttuned180-vs-ucttuned0-1000its,760,435,2260.355650743,2024.278038944,325
carcassonne-ucttuned195-vs-ucttuned0-1000its,785,459,2340.92273521,2000.430726545,326
carcassonne-ucttuned30-vs-ucttuned0-1000its,800,474,2263.241115343,1996.265493469,326
carcassonne-uct175-vs-uct0-1000its,848,521,2219.601519217,1983.896206259,327
carcassonne-uct50-vs-uct0-1000its,754,426,2176.144414775,1959.061908131,328
carcassonne-ucttuned475-vs-ucttuned0-1000its,774,446,2279.014067529,1952.582678993,328
carcassonne-uct100-vs-uct0-1000its,779,451,2196.056725479,1907.789803135,328
carcassonne-ucttuned155-vs-ucttuned0-1000its,712,382,2255.852891578,1983.26032602,330
carcassonne-uct455-vs-uct0-1000its,791,461,2285.322027629,1993.987724445,330
carcassonne-ucttuned80-vs-ucttuned200-1000its,1043,713,2155.114082775,2115.592632011,330
carcassonne-ucttuned20-vs-ucttuned0-1000its,761,430,2320.28183969,2034.875624545,331
carcassonne-uct160-vs-uct0-1000its,716,384,2262.991214968,1983.469075944,332
carcassonne-ucttuned450-vs-ucttuned0-1000its,740,408,2206.324523904,1972.035675079,332
carcassonne-uct90-vs-uct0-1000its,817,485,2311.225135642,2006.671709838,332
carcassonne-ucttuned270-vs-ucttuned0-1000its,776,440,2235.499373204,1963.163420718,336
carcassonne-uct380-vs-uct0-1000its,746,409,2354.64894528,2079.071357223,337
carcassonne-ucttuned330-vs-ucttuned0-1000its,802,465,2286.952519383,2020.277855126,337
carcassonne-ucttuned360-vs-ucttuned0-1000its,765,427,2187.608884288,1962.965287795,338
carcassonne-uct5-vs-uct0-1000its,776,437,2259.764842684,1965.120088552,339
carcassonne-uct210-vs-uct0-1000its,804,465,2324.96377876,2024.906671164,339
carcassonne-uct150-vs-uct0-1000its,732,390,2247.794099694,2005.950190735,342
carcassonne-uct475-vs-uct0-1000its,761,419,2330.557230816,2058.152786376,342
carcassonne-ucttuned430-vs-ucttuned0-1000its,747,404,2363.975811583,2105.030436866,343
carcassonne-uct265-vs-uct0-1000its,750,407,2173.188250077,1979.568486146,343
carcassonne-ucttuned190-vs-ucttuned0-1000its,802,459,2290.11539138,2020.638714817,343
carcassonne-ucttuned280-vs-ucttuned0-1000its,776,431,2294.5733003,2032.618857822,345
carcassonne-uct385-vs-uct0-1000its,818,472,2191.185862734,1913.191089793,346
carcassonne-uct165-vs-uct0-1000its,788,441,2204.699403139,1943.730411847,347
carcassonne-ucttuned370-vs-ucttuned0-1000its,759,411,2307.746958788,2010.550408475,348
carcassonne-uct45-vs-uct0-1000its,823,475,2247.060396848,1938.279238788,348
carcassonne-uct470-vs-uct0-1000its,756,407,2239.349950987,1961.762948004,349
carcassonne-ucttuned435-vs-ucttuned0-1000its,767,418,2308.246810029,1982.516329689,349
carcassonne-ucttuned345-vs-ucttuned0-1000its,819,470,2277.199470373,2058.192164171,349
carcassonne-uct255-vs-uct0-1000its,754,404,2178.10439208,1857.652410477,350
carcassonne-ucttuned115-vs-ucttuned0-1000its,779,429,2288.384497076,2045.301123649,350
carcassonne-uct415-vs-uct0-1000its,798,447,2290.69708077,1985.851262792,351
carcassonne-uct300-vs-uct0-1000its,775,422,2251.694286169,1982.355589538,353
carcassonne-ucttuned60-vs-ucttuned0-1000its,778,424,2269.193053819,2039.354252413,354
carcassonne-ucttuned240-vs-ucttuned0-1000its,786,432,2304.971207531,2018.060815043,354
carcassonne-uct355-vs-uct0-1000its,793,439,2286.888696334,1995.760067529,354
carcassonne-uct440-vs-uct0-1000its,796,442,2322.205790503,2005.830193884,354
carcassonne-ucttuned40-vs-ucttuned0-1000its,797,443,2267.8904581,1974.926921778,354
carcassonne-uct450-vs-uct0-1000its,775,419,2230.349547291,1956.957265968,356
carcassonne-uct220-vs-uct0-1000its,792,436,2275.306691368,2005.267689284,356
carcassonne-uct480-vs-uct0-1000its,790,432,2205.412301184,1923.766046388,358
carcassonne-uct145-vs-uct0-1000its,792,434,2248.597911346,2008.706764707,358
carcassonne-uct230-vs-uct0-1000its,773,414,2295.922968526,2024.269849476,359
carcassonne-uct400-vs-uct0-1000its,804,445,2295.65961255,2023.702813728,359
carcassonne-uct305-vs-uct0-1000its,737,377,2303.708298141,2001.858081815,360
carcassonne-uct10-vs-uct0-1000its,763,403,2199.228743043,1904.429602855,360
carcassonne-uct375-vs-uct0-1000its,777,416,2246.5198192,2013.532665646,361
carcassonne-uct315-vs-uct0-1000its,813,452,2239.350836189,1942.604876867,361
carcassonne-uct95-vs-uct0-1000its,762,400,2278.810911607,1978.271102541,362
carcassonne-uct495-vs-uct0-1000its,766,404,2307.658505633,2035.220073559,362
carcassonne-ucttuned220-vs-ucttuned0-1000its,801,439,2307.876328944,2012.090721031,362
carcassonne-ucttuned380-vs-ucttuned0-1000its,820,457,2188.49707429,1916.860641058,363
carcassonne-uct35-vs-uct0-1000its,781,416,2216.509535042,1961.986971923,365
carcassonne-uct390-vs-uct0-1000its,792,427,2340.933110835,2101.302212882,365
carcassonne-uct325-vs-uct0-1000its,807,441,2261.135068723,2055.692080539,366
carcassonne-uct465-vs-uct0-1000its,764,397,2359.190454792,2086.554554458,367
carcassonne-uct60-vs-uct0-1000its,779,412,2223.813779089,1966.161400044,367
carcassonne-ucttuned290-vs-ucttuned0-1000its,794,427,2300.640422714,2005.805124471,367
carcassonne-ucttuned95-vs-ucttuned0-1000its,799,432,2218.509258374,1910.031235796,367
carcassonne-uct40-vs-uct0-1000its,764,396,2249.252632503,2000.511096628,368
carcassonne-ucttuned455-vs-ucttuned0-1000its,775,407,2244.189813527,1929.492228634,368
carcassonne-uct200-vs-uct0-1000its,788,420,2234.36400006,1955.166489134,368
carcassonne-uct30-vs-uct0-1000its,776,407,2244.933206857,1985.649508563,369
carcassonne-ucttuned440-vs-ucttuned0-1000its,818,449,2292.116383316,2025.822611797,369
carcassonne-uct295-vs-uct0-1000its,772,401,2236.588105205,1970.133924081,371
carcassonne-uct435-vs-uct0-1000its,795,424,2249.156182881,1997.390897615,371
carcassonne-ucttuned275-vs-ucttuned0-1000its,779,404,2259.54478011,2006.873885365,375
carcassonne-ucttuned390-vs-ucttuned0-1000its,753,377,2271.295207428,1956.010698654,376
carcassonne-uct310-vs-uct0-1000its,778,402,2268.533326834,2051.880941769,376
carcassonne-ucttuned350-vs-ucttuned0-1000its,789,413,2257.057289379,2000.751801799,376
carcassonne-ucttuned325-vs-ucttuned0-1000its,795,418,2202.19769747,1966.928593983,377
carcassonne-ucttuned495-vs-ucttuned0-1000its,795,418,2257.677123154,1965.875624068,377
carcassonne-ucttuned470-vs-ucttuned0-1000its,761,383,2220.251463254,1913.123880914,378
carcassonne-uct75-vs-uct0-1000its,767,389,2197.02147468,1937.904796147,378
carcassonne-ucttuned85-vs-ucttuned0-1000its,833,455,2227.388267502,1941.905039364,378
carcassonne-uct85-vs-uct0-1000its,745,365,2251.763535345,1997.022883453,380
carcassonne-uct320-vs-uct0-1000its,758,376,2295.075811201,2031.398366411,382
carcassonne-uct235-vs-uct0-1000its,788,406,2258.974859637,2000.860635678,382
carcassonne-ucttuned480-vs-ucttuned0-1000its,839,457,2237.081981717,1970.870235147,382
carcassonne-ucttuned210-vs-ucttuned0-1000its,818,434,2196.618210602,1885.875437925,384
carcassonne-ucttuned5-vs-ucttuned0-1000its,857,473,2163.966291228,1908.765731911,384
carcassonne-ucttuned465-vs-ucttuned0-1000its,770,383,2245.176174576,1963.178617824,387
carcassonne-uct25-vs-uct0-1000its,741,352,2303.576811314,2030.440088835,389
carcassonne-ucttuned395-vs-ucttuned0-1000its,776,386,2236.622870851,1966.092723388,390
carcassonne-ucttuned65-vs-ucttuned0-1000its,791,401,2294.746126743,2053.344877964,390
carcassonne-uct190-vs-uct0-1000its,791,400,2215.957883688,1987.994788471,391
carcassonne-uct55-vs-uct0-1000its,810,418,2237.439974805,1983.26982172,392
carcassonne-ucttuned55-vs-ucttuned0-1000its,816,424,2244.180248699,1979.804746427,392
carcassonne-ucttuned385-vs-ucttuned0-1000its,791,398,2335.622120823,2032.32400923,393
carcassonne-ucttuned335-vs-ucttuned0-1000its,798,405,2274.419832521,1969.977965786,393
carcassonne-uct115-vs-uct0-1000its,809,415,2280.613244699,2022.001226841,394
carcassonne-ucttuned165-vs-ucttuned0-1000its,794,399,2213.486237817,1920.217730828,395
carcassonne-ucttuned265-vs-ucttuned0-1000its,821,425,2241.109196995,1954.650326572,396
carcassonne-ucttuned110-vs-ucttuned0-1000its,779,382,2320.247857018,2023.344665477,397
carcassonne-ucttuned215-vs-ucttuned0-1000its,819,421,2300.507026551,2027.329676323,398
carcassonne-ucttuned320-vs-ucttuned0-1000its,814,415,2264.485923519,2006.054727444,399
carcassonne-ucttuned410-vs-ucttuned0-1000its,797,395,2250.185355646,1958.037700755,402
carcassonne-ucttuned485-vs-ucttuned0-1000its,819,415,2276.519840384,2018.71917931,404
carcassonne-uct340-vs-uct0-1000its,795,389,2236.055054291,1979.400483539,406
carcassonne-uct425-vs-uct0-1000its,775,368,2203.18089159,1964.401250197,407
carcassonne-ucttuned205-vs-ucttuned0-1000its,788,380,2224.542138204,1948.707299318,408
carcassonne-uct395-vs-uct0-1000its,807,399,2294.217890991,2045.760127818,408
carcassonne-uct365-vs-uct0-1000its,766,357,2277.649725393,2023.671118565,409
carcassonne-ucttuned125-vs-ucttuned0-1000its,756,344,2259.767671544,1959.983174618,412
carcassonne-uct180-vs-uct0-1000its,861,448,2285.244372166,2036.405107706,413
carcassonne-ucttuned140-vs-ucttuned0-1000its,832,417,2223.166660569,1969.527416687,415
carcassonne-ucttuned185-vs-ucttuned0-1000its,816,400,2240.393507485,1987.660514462,416
carcassonne-ucttuned295-vs-ucttuned0-1000its,821,402,2235.232545863,1954.14110173,419
carcassonne-uct485-vs-uct0-1000its,797,374,2248.341956204,1998.625734578,423
carcassonne-ucttuned245-vs-ucttuned0-1000its,858,435,2244.907425062,1941.238502868,423
carcassonne-uct170-vs-uct0-1000its,861,437,2306.258695412,2001.427898272,424
carcassonne-uct350-vs-uct0-1000its,865,441,2246.966022047,1986.258199142,424
carcassonne-ucttuned100-vs-ucttuned0-1000its,842,416,2252.949351802,2042.067210619,426
carcassonne-uct245-vs-uct0-1000its,864,437,2290.944316072,2012.363376732,427
carcassonne-ucttuned420-vs-ucttuned0-1000its,809,380,2209.083275435,1958.937405929,429
carcassonne-ucttuned105-vs-ucttuned0-1000its,858,428,2247.861297991,1966.483831241,430
carcassonne-uct370-vs-uct0-1000its,819,387,2265.864544015,2009.166065895,432
carcassonne-uct430-vs-uct0-1000its,887,454,2243.082254306,1962.780103153,433
carcassonne-uct360-vs-uct0-1000its,816,382,2266.86866211,2039.987609424,434
carcassonne-ucttuned340-vs-ucttuned0-1000its,849,414,2248.581586524,1955.508073995,435
carcassonne-uct420-vs-uct0-1000its,793,355,2264.674785306,2047.450920952,438
carcassonne-ucttuned490-vs-ucttuned0-1000its,820,382,2274.130011357,1976.190790173,438
carcassonne-ucttuned160-vs-ucttuned0-1000its,799,359,2269.740218069,2030.916981002,440
carcassonne-ucttuned25-vs-ucttuned0-1000its,813,370,2247.764493399,1928.831112615,443
carcassonne-uct195-vs-uct0-1000its,837,393,2301.452491819,1977.291513388,444
carcassonne-ucttuned365-vs-ucttuned0-1000its,823,366,2286.113118794,2064.520714257,457
carcassonne-ucttuned15-vs-ucttuned0-1000its,889,423,2209.524035896,1909.686142918,466
carcassonne-uct80-vs-uct0-1000its,840,364,2312.589359558,2065.115993955,476
carcassonne-ucttuned175-vs-ucttuned0-1000its,819,339,2264.969253758,2021.232067963,480
carcassonne-ucttuned250-vs-ucttuned0-1000its,941,404,2248.054136739,1929.723409654,537
