name, p1_points, p2_points, p1_contemplation_time, p2_contemplation_time,difference
carcassonne-ucttuned3-vs-ucttuned0-2000its,843,372,4348.042227526,3866.555276573,471
carcassonne-ucttuned14-vs-ucttuned0-2000its,882,423,4511.283605206,3938.212679388,459
carcassonne-ucttuned7-vs-ucttuned0-2000its,837,395,4530.423356671,3831.20633008,442
carcassonne-ucttuned6-vs-ucttuned0-2000its,828,389,4453.500191274,3849.587265609,439
carcassonne-ucttuned12-vs-ucttuned0-2000its,845,419,4502.269485754,3913.642114479,426
carcassonne-ucttuned1-vs-ucttuned0-2000its,830,410,4482.132779611,3928.670591897,420
carcassonne-ucttuned5-vs-ucttuned0-2000its,860,442,4326.804295877,3812.012798182,418
carcassonne-uct2-vs-uct0-2000its,876,462,4561.382074687,3907.898877954,414
carcassonne-ucttuned8-vs-ucttuned0-2000its,820,412,4447.903595672,3894.474351307,408
carcassonne-uct7-vs-uct0-2000its,892,490,4460.740574203,3920.542844882,402
carcassonne-uct14-vs-uct0-2000its,844,447,4405.22035591,3887.831884557,397
carcassonne-uct3-vs-uct0-2000its,857,465,4618.223420084,4028.596134005,392
carcassonne-ucttuned13-vs-ucttuned0-2000its,816,427,4350.671922578,3874.082339443,389
carcassonne-ucttuned2-vs-ucttuned0-2000its,781,392,4432.353703941,4016.882698393,389
carcassonne-uct11-vs-uct0-2000its,645,279,3466.413319896,3059.420112334,366
carcassonne-uct13-vs-uct0-2000its,847,483,4511.35518724,3957.591257194,364
carcassonne-uct5-vs-uct0-2000its,702,340,3508.473769126,3087.180643868,362
carcassonne-uct1-vs-uct0-2000its,810,463,4423.344068263,3956.259203255,347
carcassonne-uct8-vs-uct0-2000its,795,460,4398.006036834,3873.766804096,335
carcassonne-ucttuned4-vs-ucttuned0-2000its,779,455,4455.376834094,3948.490477855,324
carcassonne-ucttuned10-vs-ucttuned0-2000its,680,376,3629.850052336,3163.961610571,304
carcassonne-uct10-vs-uct0-2000its,611,318,3580.501132073,3096.764819181,293
carcassonne-uct9-vs-uct0-2000its,616,323,3515.98468642,2974.632516179,293
carcassonne-uct12-vs-uct0-2000its,663,372,3578.478280753,3123.592071482,291
carcassonne-boltzmann2-vs-boltzmann5-2000its,1024,751,4323.074247253,4267.670456651,273
carcassonne-ucttuned5-vs-ucttuned11-2000its,977,706,4245.118581074,4200.495305902,271
carcassonne-ucttuned9-vs-ucttuned0-2000its,646,376,3573.374846738,3123.257838752,270
carcassonne-ucttuned11-vs-ucttuned0-2000its,663,404,3598.855236248,3149.837538553,259
carcassonne-ucttuned9-vs-ucttuned8-2000its,974,735,4142.970653245,4049.677501527,239
carcassonne-uct5-vs-uct3-2000its,811,577,3377.757032167,3288.499068094,234
carcassonne-uct4-vs-uct0-2000its,715,493,4393.706203674,3862.456907642,222
carcassonne-ucttuned4-vs-ucttuned12-2000its,950,736,4340.778400144,4238.62485038,214
carcassonne-boltzmann1-vs-boltzmann6-2000its,950,740,4222.156717453,4146.213671973,210
carcassonne-boltzmann8-vs-boltzmann3-2000its,965,756,4263.492495317,4224.637424425,209
carcassonne-uct6-vs-uct3-2000its,939,733,4286.498112193,4124.930634011,206
carcassonne-uct6-vs-uct0-2000its,475,277,2630.986065688,2374.706287165,198
carcassonne-boltzmann6-vs-boltzmann4-2000its,1006,816,4222.128220517,4195.274706841,190
carcassonne-egreedy1div4-vs-egreedy1div8-2000its,923,736,4201.39623702,4036.404368202,187
carcassonne-uct8-vs-uct2-2000its,718,536,3478.471921501,3401.895165877,182
carcassonne-ucttuned13-vs-ucttuned1-2000its,692,510,3530.208035992,3410.656653325,182
carcassonne-ucttuned13-vs-ucttuned6-2000its,763,583,3333.570441691,3349.827467897,180
carcassonne-boltzmann3-vs-boltzmann9-2000its,904,726,4239.175781846,4191.773030493,178
carcassonne-ucttuned13-vs-ucttuned8-2000its,765,590,3443.633386557,3346.030464215,175
carcassonne-ucttuned12-vs-ucttuned3-2000its,983,811,4253.272260006,4208.129186493,172
carcassonne-egreedy1div9-vs-egreedy1div5-2000its,928,761,4115.406886061,4201.6703393,167
carcassonne-boltzmann6-vs-boltzmann10-2000its,996,830,4328.559719912,4208.166978854,166
carcassonne-egreedy1div4-vs-egreedy1div1-2000its,728,563,3392.888376946,3335.35299833,165
carcassonne-egreedy1div3-vs-egreedy1div7-2000its,756,592,3324.115201989,3296.351621885,164
carcassonne-egreedy1div1-vs-egreedy1div5-2000its,924,761,4345.164785524,4225.268678439,163
carcassonne-uct5-vs-uct6-2000its,948,785,4297.02577955,4175.251293997,163
carcassonne-uct2-vs-uct8-2000its,969,810,4292.40102301,4183.097381151,159
carcassonne-egreedy1div1-vs-egreedy1div2-2000its,892,736,4246.297493384,4181.622981093,156
carcassonne-egreedy1div9-vs-egreedy1div7-2000its,951,795,4206.812279469,4209.108146987,156
carcassonne-ucttuned2-vs-ucttuned13-2000its,810,658,3441.352829423,3465.110870306,152
carcassonne-boltzmann9-vs-boltzmann11-2000its,892,746,4145.262748275,4114.733334733,146
carcassonne-egreedy1div7-vs-egreedy1div10-2000its,891,748,4238.060380598,4166.902108879,143
carcassonne-egreedy1div7-vs-egreedy1div4-2000its,957,817,4191.064818266,4071.404665219,140
carcassonne-egreedy1div9-vs-egreedy1div2-2000its,985,847,4249.421994525,4266.015968712,138
carcassonne-uct4-vs-uct9-2000its,976,839,4301.333427726,4154.153120023,137
carcassonne-ucttuned8-vs-ucttuned3-2000its,721,588,3532.66063864,3419.562558256,133
carcassonne-uct6-vs-uct12-2000its,912,780,4319.456836109,4244.503858708,132
carcassonne-boltzmann12-vs-boltzmann11-2000its,879,750,4238.894656085,4122.450328639,129
carcassonne-egreedy1div9-vs-egreedy1div1-2000its,869,740,4097.653161169,4190.248781743,129
carcassonne-uct11-vs-uct13-2000its,1001,872,4378.434539301,4294.900795972,129
carcassonne-uct9-vs-uct4-2000its,885,756,4153.186030288,4069.856957778,129
carcassonne-ucttuned11-vs-ucttuned6-2000its,934,806,4343.643341999,4217.017692632,128
carcassonne-boltzmann9-vs-boltzmann3-2000its,736,609,3370.82257783,3374.243273416,127
carcassonne-uct13-vs-uct5-2000its,1005,880,4261.607489458,4219.001081821,125
carcassonne-boltzmann7-vs-boltzmann1-2000its,715,591,3509.744206073,3357.461644293,124
carcassonne-boltzmann11-vs-boltzmann1-2000its,884,762,4151.59073494,4059.293490451,122
carcassonne-uct13-vs-uct2-2000its,729,609,3419.472774862,3369.434523355,120
carcassonne-ucttuned3-vs-ucttuned7-2000its,750,631,3348.177782506,3273.92229966,119
carcassonne-ucttuned7-vs-ucttuned10-2000its,810,691,3404.094371291,3333.923324383,119
carcassonne-boltzmann2-vs-boltzmann7-2000its,784,666,3490.686202257,3446.409403036,118
carcassonne-egreedy1div5-vs-egreedy1div4-2000its,912,794,4326.715257503,4188.157541482,118
carcassonne-ucttuned13-vs-ucttuned9-2000its,997,879,4293.528238111,4165.374563889,118
carcassonne-egreedy1div5-vs-egreedy1div8-2000its,828,712,4342.344937006,4256.244833317,116
carcassonne-boltzmann1-vs-boltzmann14-2000its,750,636,3490.849472783,3430.325849444,114
carcassonne-ucttuned6-vs-ucttuned2-2000its,717,603,3529.282467321,3402.244602819,114
carcassonne-egreedy1div9-vs-egreedy1div8-2000its,904,792,4274.527755873,4191.637741782,112
carcassonne-uct13-vs-uct11-2000its,908,796,4260.243197065,4216.051333337,112
carcassonne-uct2-vs-uct1-2000its,766,655,3355.264697942,3321.363818505,111
carcassonne-uct8-vs-uct13-2000its,718,607,3472.533031509,3334.07850829,111
carcassonne-boltzmann11-vs-boltzmann6-2000its,684,574,3452.481763025,3376.805960458,110
carcassonne-boltzmann3-vs-boltzmann11-2000its,916,806,4310.110381374,4222.903843701,110
carcassonne-egreedy1div2-vs-egreedy1div1-2000its,876,766,4217.392011403,4144.223911065,110
carcassonne-egreedy1div2-vs-egreedy1div3-2000its,767,658,3453.880435328,3398.415650833,109
carcassonne-egreedy1div3-vs-egreedy1div5-2000its,922,813,4299.186573848,4146.085698437,109
carcassonne-egreedy1div3-vs-egreedy1div9-2000its,901,792,4197.783384539,4087.328435284,109
carcassonne-ucttuned13-vs-ucttuned2-2000its,738,629,3500.159208957,3354.314503652,109
carcassonne-boltzmann10-vs-boltzmann14-2000its,793,686,3493.189972881,3485.065711227,107
carcassonne-uct2-vs-uct14-2000its,577,470,2513.11290067,2573.767510391,107
carcassonne-boltzmann12-vs-boltzmann5-2000its,944,838,4226.967530056,4192.959133586,106
carcassonne-ucttuned9-vs-ucttuned10-2000its,689,583,3311.558376298,3225.260328491,106
carcassonne-ucttuned9-vs-ucttuned2-2000its,514,408,2553.106245496,2519.908112148,106
carcassonne-boltzmann7-vs-boltzmann9-2000its,737,632,3401.991716229,3258.890402013,105
carcassonne-ucttuned8-vs-ucttuned13-2000its,882,777,4199.08850981,4145.534799072,105
carcassonne-uct1-vs-uct13-2000its,583,479,2546.576254246,2550.289870799,104
carcassonne-boltzmann1-vs-boltzmann8-2000its,937,834,4193.370632758,4177.11206211,103
carcassonne-uct10-vs-uct1-2000its,709,606,3430.885069969,3386.926361144,103
carcassonne-uct11-vs-uct14-2000its,728,625,3500.273717681,3470.330630865,103
carcassonne-uct8-vs-uct11-2000its,648,546,2525.024445797,2569.622272606,102
carcassonne-ucttuned12-vs-ucttuned9-2000its,890,788,4167.797224852,4086.040911855,102
carcassonne-ucttuned4-vs-ucttuned14-2000its,916,814,4325.769792198,4324.62660728,102
carcassonne-ucttuned8-vs-ucttuned12-2000its,829,727,3502.730027841,3405.020685701,102
carcassonne-ucttuned10-vs-ucttuned2-2000its,713,612,3389.414285079,3312.426096578,101
carcassonne-boltzmann5-vs-boltzmann7-2000its,865,765,4253.802514114,4231.783407427,100
carcassonne-ucttuned6-vs-ucttuned3-2000its,801,701,3385.535279033,3296.799785551,100
carcassonne-uct13-vs-uct9-2000its,966,867,4233.562295285,4103.757387755,99
carcassonne-ucttuned4-vs-ucttuned8-2000its,747,648,3406.515644127,3385.948038506,99
carcassonne-boltzmann3-vs-boltzmann8-2000its,771,674,3555.114324114,3564.722613095,97
carcassonne-ucttuned14-vs-ucttuned8-2000its,834,738,4352.178500068,4292.469361867,96
carcassonne-ucttuned2-vs-ucttuned9-2000its,855,759,4287.496746132,4230.271606589,96
carcassonne-uct11-vs-uct5-2000its,902,807,4362.687712841,4277.016678579,95
carcassonne-boltzmann11-vs-boltzmann4-2000its,929,835,4191.604172791,4174.81990783,94
carcassonne-boltzmann12-vs-boltzmann10-2000its,887,793,4314.006861955,4283.784079569,94
carcassonne-boltzmann14-vs-boltzmann12-2000its,882,788,4271.605601261,4212.671887803,94
carcassonne-ucttuned12-vs-ucttuned4-2000its,749,655,3401.820560034,3384.060531847,94
carcassonne-uct2-vs-uct12-2000its,915,822,4324.406701442,4291.644496939,93
carcassonne-ucttuned5-vs-ucttuned8-2000its,950,857,4252.957877888,4101.490929897,93
carcassonne-boltzmann13-vs-boltzmann1-2000its,889,797,4336.991898386,4151.809237221,92
carcassonne-boltzmann14-vs-boltzmann10-2000its,880,788,4305.210688828,4246.545295807,92
carcassonne-boltzmann3-vs-boltzmann13-2000its,766,674,3427.776137559,3398.127864661,92
carcassonne-boltzmann7-vs-boltzmann8-2000its,555,463,2590.311696297,2507.553484303,92
carcassonne-boltzmann8-vs-boltzmann9-2000its,878,786,4249.825319219,4217.912203022,92
carcassonne-egreedy1div8-vs-egreedy1div10-2000its,897,806,4137.364421568,4127.097187867,91
carcassonne-uct4-vs-uct12-2000its,542,452,2559.164033806,2541.452409146,90
carcassonne-ucttuned8-vs-ucttuned10-2000its,534,444,2540.666045018,2447.576356539,90
carcassonne-boltzmann5-vs-boltzmann12-2000its,709,620,3435.772801034,3423.237520575,89
carcassonne-uct7-vs-uct4-2000its,677,588,3507.349692605,3393.93775962,89
carcassonne-ucttuned11-vs-ucttuned14-2000its,947,859,4256.254700183,4102.653588239,88
carcassonne-uct10-vs-uct13-2000its,900,813,4324.215761198,4297.611434274,87
carcassonne-uct8-vs-uct5-2000its,895,809,4182.48930979,4147.282568858,86
carcassonne-ucttuned13-vs-ucttuned5-2000its,917,831,4246.408909132,4047.923873511,86
carcassonne-egreedy1div3-vs-egreedy1div4-2000its,929,844,4312.531571185,4134.247580679,85
carcassonne-egreedy1div4-vs-egreedy1div10-2000its,920,835,4269.124436837,4140.424478019,85
carcassonne-ucttuned4-vs-ucttuned10-2000its,950,865,4154.617716537,4115.508942203,85
carcassonne-uct8-vs-uct9-2000its,705,621,3345.283136593,3269.041662498,84
carcassonne-ucttuned7-vs-ucttuned12-2000its,559,475,2613.364392404,2590.913816333,84
carcassonne-boltzmann10-vs-boltzmann13-2000its,706,623,3463.760333484,3355.190924901,83
carcassonne-egreedy1div8-vs-egreedy1div1-2000its,869,786,4232.883082838,4257.285680733,83
carcassonne-boltzmann3-vs-boltzmann2-2000its,927,845,4299.722779134,4170.710395402,82
carcassonne-boltzmann7-vs-boltzmann4-2000its,542,460,2569.647682361,2572.796261431,82
carcassonne-uct1-vs-uct12-2000its,731,650,3372.731304559,3357.973273941,81
carcassonne-egreedy1div10-vs-egreedy1div2-2000its,941,861,4171.980420019,4248.93313464,80
carcassonne-uct5-vs-uct14-2000its,762,682,3431.615873484,3321.185820231,80
carcassonne-boltzmann7-vs-boltzmann14-2000its,728,649,3460.556770216,3359.313462096,79
carcassonne-ucttuned5-vs-ucttuned7-2000its,919,840,4332.765050814,4214.234172541,79
carcassonne-uct12-vs-uct7-2000its,785,708,3430.604730836,3391.532954485,77
carcassonne-egreedy1div10-vs-egreedy1div7-2000its,738,662,3335.231167234,3321.901793312,76
carcassonne-ucttuned11-vs-ucttuned1-2000its,927,851,4319.554070379,4042.307209111,76
carcassonne-boltzmann4-vs-boltzmann13-2000its,698,623,3360.629702341,3410.796291692,75
carcassonne-uct6-vs-uct9-2000its,682,607,3382.929237357,3407.949756006,75
carcassonne-uct1-vs-uct7-2000its,871,798,4078.96064896,4169.447654647,73
carcassonne-uct3-vs-uct12-2000its,726,653,3470.750627891,3395.195321024,73
carcassonne-ucttuned12-vs-ucttuned14-2000its,673,600,3424.515238106,3313.691974779,73
carcassonne-ucttuned12-vs-ucttuned2-2000its,530,457,2617.432183234,2491.065306617,73
carcassonne-uct10-vs-uct6-2000its,595,523,2462.80844666,2458.365989905,72
carcassonne-ucttuned1-vs-ucttuned4-2000its,707,635,3333.686634267,3257.654951946,72
carcassonne-ucttuned6-vs-ucttuned14-2000its,968,897,4309.975467493,4245.785686976,71
carcassonne-ucttuned7-vs-ucttuned14-2000its,723,652,3497.714647435,3423.75414397,71
carcassonne-ucttuned11-vs-ucttuned13-2000its,387,318,1705.167654731,1666.387827685,69
carcassonne-boltzmann7-vs-boltzmann11-2000its,910,843,4300.333089882,4259.426948165,67
carcassonne-uct9-vs-uct10-2000its,764,698,4300.357671665,4151.005925446,66
carcassonne-ucttuned6-vs-ucttuned7-2000its,723,657,3304.153011905,3224.713530407,66
carcassonne-uct1-vs-uct14-2000its,685,620,3471.985540251,3379.543811394,65
carcassonne-ucttuned9-vs-ucttuned13-2000its,645,580,2494.351300192,2433.066889729,65
carcassonne-boltzmann8-vs-boltzmann2-2000its,735,671,3406.361672416,3381.342296131,64
carcassonne-ucttuned6-vs-ucttuned11-2000its,728,664,3387.11769823,3309.272653021,64
carcassonne-uct10-vs-uct5-2000its,861,798,4181.194104222,4163.618477544,63
carcassonne-uct6-vs-uct13-2000its,921,858,4189.938815314,4189.562214772,63
carcassonne-boltzmann1-vs-boltzmann12-2000its,906,844,4227.918662038,4191.710834511,62
carcassonne-uct12-vs-uct5-2000its,700,638,3396.981429411,3251.456996307,62
carcassonne-uct7-vs-uct6-2000its,905,843,4370.613347536,4329.948062516,62
carcassonne-ucttuned14-vs-ucttuned5-2000its,835,773,4347.759126509,4283.551803751,62
carcassonne-ucttuned4-vs-ucttuned7-2000its,989,927,4314.43278327,4260.219290597,62
carcassonne-ucttuned8-vs-ucttuned14-2000its,937,875,4254.120316865,4219.090713161,62
carcassonne-boltzmann3-vs-boltzmann10-2000its,881,820,4233.416840032,4222.636630681,61
carcassonne-ucttuned11-vs-ucttuned12-2000its,989,928,4262.475668654,4195.580628586,61
carcassonne-ucttuned8-vs-ucttuned7-2000its,741,680,3386.54944651,3347.517088445,61
carcassonne-uct6-vs-uct14-2000its,954,894,4268.321430183,4167.712262598,60
carcassonne-ucttuned5-vs-ucttuned6-2000its,692,632,3402.194095046,3430.814800683,60
carcassonne-boltzmann5-vs-boltzmann9-2000its,925,866,4330.407809487,4227.30190888,59
carcassonne-uct9-vs-uct2-2000its,730,671,3370.594001405,3284.192561161,59
carcassonne-ucttuned1-vs-ucttuned8-2000its,517,458,2500.623253201,2562.285533701,59
carcassonne-boltzmann4-vs-boltzmann6-2000its,907,849,4189.934807425,4151.708492108,58
carcassonne-uct4-vs-uct7-2000its,714,657,3406.323573947,3340.831043585,57
carcassonne-ucttuned2-vs-ucttuned7-2000its,712,655,3399.048369274,3368.863937256,57
carcassonne-egreedy1div10-vs-egreedy1div1-2000its,836,780,4330.701087542,4376.464593474,56
carcassonne-egreedy1div2-vs-egreedy1div10-2000its,749,693,3437.149585436,3299.870371206,56
carcassonne-egreedy1div2-vs-egreedy1div7-2000its,827,771,4226.321383018,4168.588176652,56
carcassonne-boltzmann14-vs-boltzmann9-2000its,697,642,3489.925865972,3434.32192935,55
carcassonne-boltzmann9-vs-boltzmann1-2000its,826,771,4314.550352375,4160.325831969,55
carcassonne-uct14-vs-uct4-2000its,910,855,4292.864479598,4181.949418342,55
carcassonne-uct2-vs-uct5-2000its,683,628,3341.177260008,3340.624570718,55
carcassonne-uct4-vs-uct8-2000its,747,693,3480.966711958,3438.379932017,54
carcassonne-uct7-vs-uct5-2000its,761,707,3388.977101827,3412.315867656,54
carcassonne-ucttuned6-vs-ucttuned5-2000its,725,671,3382.999733187,3277.518586741,54
carcassonne-boltzmann2-vs-boltzmann14-2000its,542,489,2604.877708995,2542.990043218,53
carcassonne-egreedy1div10-vs-egreedy1div5-2000its,855,802,4224.23065229,4188.539584391,53
carcassonne-uct12-vs-uct2-2000its,877,824,4307.385797455,4226.573448486,53
carcassonne-uct14-vs-uct2-2000its,952,899,4296.556097971,4205.38047773,53
carcassonne-boltzmann3-vs-boltzmann5-2000its,348,296,1696.233330944,1686.215566609,52
carcassonne-egreedy1div5-vs-egreedy1div7-2000its,912,860,4273.123873548,4211.068062985,52
carcassonne-boltzmann13-vs-boltzmann5-2000its,861,810,4222.663775314,4182.386568258,51
carcassonne-boltzmann3-vs-boltzmann1-2000its,926,875,4378.215184394,4240.983044966,51
carcassonne-uct9-vs-uct7-2000its,526,475,2567.460716471,2409.775303923,51
carcassonne-boltzmann4-vs-boltzmann10-2000its,971,921,4285.762454702,4122.788095832,50
carcassonne-uct7-vs-uct13-2000its,903,853,4277.639497295,4252.283634445,50
carcassonne-ucttuned3-vs-ucttuned13-2000its,749,699,3358.558718716,3432.903703282,50
carcassonne-ucttuned3-vs-ucttuned9-2000its,886,836,4346.889426458,4263.082081468,50
carcassonne-ucttuned8-vs-ucttuned2-2000its,724,674,3452.023210784,3256.186646645,50
carcassonne-uct2-vs-uct9-2000its,865,816,4215.23319918,4147.53838268,49
carcassonne-uct8-vs-uct6-2000its,755,706,3505.951547026,3456.704972832,49
carcassonne-ucttuned3-vs-ucttuned6-2000its,974,925,4251.996848378,4196.880475787,49
carcassonne-uct12-vs-uct13-2000its,700,652,3377.908843431,3318.896330019,48
carcassonne-ucttuned2-vs-ucttuned10-2000its,884,836,4222.493712743,4155.455276232,48
carcassonne-ucttuned3-vs-ucttuned2-2000its,699,651,3452.461153228,3380.991597248,48
carcassonne-ucttuned7-vs-ucttuned1-2000its,729,681,3483.607136182,3369.008863118,48
carcassonne-egreedy1div3-vs-egreedy1div6-2000its,874,827,4259.325193459,4109.017746958,47
carcassonne-boltzmann13-vs-boltzmann10-2000its,896,850,4312.106015517,4325.192737847,46
carcassonne-boltzmann13-vs-boltzmann4-2000its,683,637,3397.602537044,3315.451933911,46
carcassonne-uct9-vs-uct12-2000its,530,484,2571.145250283,2576.209873141,46
carcassonne-ucttuned2-vs-ucttuned12-2000its,574,528,2484.255374271,2573.915691296,46
carcassonne-ucttuned7-vs-ucttuned13-2000its,705,659,3502.204888744,3348.092183525,46
carcassonne-boltzmann2-vs-boltzmann10-2000its,735,690,3439.574185212,3404.823433173,45
carcassonne-egreedy1div6-vs-egreedy1div4-2000its,540,495,2504.05961651,2462.813875095,45
carcassonne-uct2-vs-uct11-2000its,907,862,4253.629115919,4256.019134063,45
carcassonne-ucttuned12-vs-ucttuned1-2000its,689,644,3458.926257735,3331.791781977,45
carcassonne-egreedy1div8-vs-egreedy1div7-2000its,706,662,3378.465325912,3333.170543891,44
carcassonne-uct5-vs-uct11-2000its,888,844,4170.317928926,4173.01018096,44
carcassonne-uct6-vs-uct5-2000its,898,854,4259.227576726,4192.665042306,44
carcassonne-ucttuned1-vs-ucttuned14-2000its,905,861,4126.377965553,4148.054338092,44
carcassonne-boltzmann7-vs-boltzmann12-2000its,880,837,4373.250945619,4346.268577244,43
carcassonne-boltzmann9-vs-boltzmann6-2000its,851,808,4288.457680472,4216.367171191,43
carcassonne-uct2-vs-uct3-2000its,533,490,2566.750789139,2447.546476342,43
carcassonne-boltzmann10-vs-boltzmann3-2000its,674,632,3447.417618604,3344.8518837,42
carcassonne-uct10-vs-uct11-2000its,681,640,3324.226571911,3235.125964174,41
carcassonne-uct7-vs-uct8-2000its,525,484,2485.701850765,2475.466139898,41
carcassonne-ucttuned3-vs-ucttuned5-2000its,559,518,2687.872323224,2602.25049551,41
carcassonne-ucttuned4-vs-ucttuned11-2000its,905,864,4271.094193519,4221.242239514,41
carcassonne-boltzmann3-vs-boltzmann4-2000its,716,676,3288.250506573,3232.233043419,40
carcassonne-uct10-vs-uct12-2000its,527,487,2470.912677869,2415.088712471,40
carcassonne-uct4-vs-uct14-2000its,996,956,4253.829533056,4176.04762483,40
carcassonne-uct4-vs-uct3-2000its,945,905,4146.234260705,4092.035264558,40
carcassonne-boltzmann11-vs-boltzmann14-2000its,879,840,4397.039402522,4349.821038612,39
carcassonne-boltzmann7-vs-boltzmann3-2000its,723,684,3455.186896507,3407.815933875,39
carcassonne-uct14-vs-uct13-2000its,562,523,2577.678921285,2428.455376361,39
carcassonne-boltzmann8-vs-boltzmann11-2000its,712,674,3363.330022777,3248.594260026,38
carcassonne-ucttuned10-vs-ucttuned14-2000its,748,710,3368.918778507,3270.275938472,38
carcassonne-uct4-vs-uct1-2000its,926,889,4330.100670575,4226.76374023,37
carcassonne-ucttuned2-vs-ucttuned1-2000its,887,850,4274.853524149,4118.896515046,37
carcassonne-ucttuned4-vs-ucttuned1-2000its,864,827,4349.248590994,4143.532581688,37
carcassonne-ucttuned9-vs-ucttuned4-2000its,862,825,4353.768386387,4181.585459963,37
carcassonne-ucttuned1-vs-ucttuned9-2000its,882,846,4214.062140776,4349.057421728,36
carcassonne-boltzmann11-vs-boltzmann10-2000its,754,719,3462.481010863,3329.821065651,35
carcassonne-boltzmann7-vs-boltzmann2-2000its,538,503,2525.445230892,2487.119222482,35
carcassonne-egreedy1div7-vs-egreedy1div2-2000its,822,787,4144.173263926,4130.279031518,35
carcassonne-egreedy1div8-vs-egreedy1div3-2000its,769,734,3389.995467287,3375.8294472,35
carcassonne-uct14-vs-uct1-2000its,493,458,2598.548887919,2499.743174825,35
carcassonne-boltzmann13-vs-boltzmann12-2000its,576,542,2530.432899864,2588.284126819,34
carcassonne-egreedy1div1-vs-egreedy1div8-2000its,835,801,4294.04257104,4140.093356388,34
carcassonne-uct1-vs-uct2-2000its,874,840,4120.10661651,4153.814950994,34
carcassonne-uct10-vs-uct2-2000its,717,683,3483.203748045,3526.537277472,34
carcassonne-ucttuned11-vs-ucttuned4-2000its,888,854,4313.822642917,4119.141962259,34
carcassonne-boltzmann9-vs-boltzmann14-2000its,682,649,3481.570959024,3315.335223645,33
carcassonne-uct11-vs-uct12-2000its,867,834,4339.292772986,4310.717843122,33
carcassonne-uct4-vs-uct5-2000its,755,722,3404.406545248,3324.101027955,33
carcassonne-boltzmann2-vs-boltzmann13-2000its,503,471,2533.025209064,2528.912985759,32
carcassonne-uct4-vs-uct6-2000its,858,826,4278.346192364,4211.496436046,32
carcassonne-ucttuned10-vs-ucttuned6-2000its,502,470,2527.916661525,2529.059118437,32
carcassonne-ucttuned2-vs-ucttuned3-2000its,858,826,4177.641830054,4122.851046531,32
carcassonne-boltzmann1-vs-boltzmann10-2000its,851,820,4316.023388211,4188.424763359,31
carcassonne-boltzmann10-vs-boltzmann5-2000its,706,675,3347.152570232,3276.62664552,31
carcassonne-egreedy1div4-vs-egreedy1div3-2000its,838,807,4288.366784992,4337.547957442,31
carcassonne-ucttuned8-vs-ucttuned1-2000its,802,771,4263.488389871,4119.551750436,31
carcassonne-boltzmann1-vs-boltzmann11-2000its,519,489,2511.442369557,2472.648031605,30
carcassonne-boltzmann6-vs-boltzmann1-2000its,746,716,3418.980601677,3343.546453173,30
carcassonne-ucttuned1-vs-ucttuned10-2000its,620,590,3333.07633719,3362.025035058,30
carcassonne-ucttuned4-vs-ucttuned2-2000its,838,808,4162.206944062,4129.053820606,30
carcassonne-egreedy1div2-vs-egreedy1div6-2000its,863,834,4260.525544909,4111.330906449,29
carcassonne-uct12-vs-uct14-2000its,828,799,4366.054878817,4404.092256066,29
carcassonne-uct12-vs-uct4-2000its,518,489,2599.382350425,2573.474007964,29
carcassonne-ucttuned13-vs-ucttuned14-2000its,804,775,4271.998517602,4169.939144056,29
carcassonne-egreedy1div5-vs-egreedy1div6-2000its,940,912,4116.337879532,4083.639863761,28
carcassonne-uct1-vs-uct9-2000its,707,679,3347.028403343,3358.28987328,28
carcassonne-uct7-vs-uct10-2000its,551,523,2497.887830209,2399.01805194,28
carcassonne-ucttuned10-vs-ucttuned4-2000its,837,809,4338.4564426,4273.792897124,28
carcassonne-boltzmann2-vs-boltzmann12-2000its,526,500,2614.858313904,2549.760653177,26
carcassonne-egreedy1div9-vs-egreedy1div10-2000its,881,855,4139.726847071,4095.086793175,26
carcassonne-uct9-vs-uct5-2000its,924,898,4237.411463866,4176.070885002,26
carcassonne-ucttuned10-vs-ucttuned1-2000its,793,767,4253.754182867,4145.613968284,26
carcassonne-ucttuned10-vs-ucttuned9-2000its,672,647,3482.444420202,3409.902761915,25
carcassonne-boltzmann4-vs-boltzmann7-2000its,891,867,4334.893945572,4219.479785822,24
carcassonne-uct10-vs-uct7-2000its,719,695,3346.310739967,3285.922805845,24
carcassonne-uct14-vs-uct8-2000its,896,872,4340.291656096,4353.116254201,24
carcassonne-uct6-vs-uct11-2000its,905,881,4284.736829777,4224.592654307,24
carcassonne-uct7-vs-uct1-2000its,693,669,3465.821677743,3350.331006866,24
carcassonne-uct13-vs-uct10-2000its,657,634,3470.443711199,3333.822911834,23
carcassonne-ucttuned14-vs-ucttuned2-2000its,844,821,4290.394738277,4192.820717502,23
carcassonne-ucttuned3-vs-ucttuned1-2000its,825,802,4191.124769774,4142.800693766,23
carcassonne-boltzmann13-vs-boltzmann14-2000its,538,516,2593.295753137,2538.969119913,22
carcassonne-egreedy1div4-vs-egreedy1div5-2000its,878,856,4080.399949857,4065.517841285,22
carcassonne-ucttuned5-vs-ucttuned9-2000its,858,836,4294.247960577,4234.369170755,22
carcassonne-boltzmann6-vs-boltzmann11-2000its,673,652,3416.010500434,3302.011557009,21
carcassonne-boltzmann6-vs-boltzmann8-2000its,860,839,4296.327045662,4131.863807811,21
carcassonne-egreedy1div5-vs-egreedy1div10-2000its,499,478,2519.458026753,2492.530182481,21
carcassonne-uct1-vs-uct8-2000its,697,676,3387.111871093,3415.786678344,21
carcassonne-uct5-vs-uct9-2000its,735,714,3375.004020513,3281.736274926,21
carcassonne-ucttuned5-vs-ucttuned1-2000its,855,834,4351.582000122,4234.976121421,21
carcassonne-boltzmann14-vs-boltzmann4-2000its,896,876,4326.658286005,4199.202158229,20
carcassonne-uct3-vs-uct13-2000its,702,682,3358.124138947,3383.39977039,20
carcassonne-uct3-vs-uct8-2000its,730,710,3456.629294292,3348.337541609,20
carcassonne-ucttuned9-vs-ucttuned11-2000its,738,718,3370.825059982,3324.28925364,20
carcassonne-ucttuned9-vs-ucttuned3-2000its,908,888,4235.712301363,4187.153204114,20
carcassonne-boltzmann14-vs-boltzmann5-2000its,819,800,4225.700005828,4189.556640638,19
carcassonne-boltzmann8-vs-boltzmann5-2000its,680,661,3404.410648475,3348.435526765,19
carcassonne-ucttuned14-vs-ucttuned7-2000its,749,730,3516.846438929,3399.616141812,19
carcassonne-uct3-vs-uct14-2000its,856,838,4258.570837998,4229.007473721,18
carcassonne-uct7-vs-uct11-2000its,331,313,1685.949688326,1685.322362102,18
carcassonne-boltzmann13-vs-boltzmann6-2000its,488,471,2619.750406031,2522.750800888,17
carcassonne-egreedy1div1-vs-egreedy1div4-2000its,643,626,3405.653503862,3328.953045185,17
carcassonne-egreedy1div1-vs-egreedy1div7-2000its,853,836,4331.06765886,4270.042735607,17
carcassonne-ucttuned12-vs-ucttuned10-2000its,681,664,3491.762118451,3461.111536289,17
carcassonne-ucttuned7-vs-ucttuned5-2000its,708,691,3440.041900782,3348.867618781,17
carcassonne-boltzmann14-vs-boltzmann1-2000its,907,891,4245.492322612,4105.241714065,16
carcassonne-boltzmann5-vs-boltzmann14-2000its,649,633,3447.977532231,3483.597472393,16
carcassonne-boltzmann8-vs-boltzmann12-2000its,564,548,2573.774891286,2507.338958004,16
carcassonne-egreedy1div2-vs-egreedy1div5-2000its,678,662,3383.118582895,3310.028868215,16
carcassonne-egreedy1div6-vs-egreedy1div1-2000its,667,651,3362.154374607,3425.74404303,16
carcassonne-uct5-vs-uct10-2000its,842,826,4316.386122861,4193.909636343,16
carcassonne-uct8-vs-uct10-2000its,882,866,4343.252174718,4242.956052074,16
carcassonne-ucttuned3-vs-ucttuned4-2000its,846,830,4192.904869242,4125.453199421,16
carcassonne-egreedy1div6-vs-egreedy1div5-2000its,761,746,3312.060762085,3281.479069023,15
carcassonne-uct3-vs-uct2-2000its,710,695,3394.943510753,3257.690367809,15
carcassonne-ucttuned6-vs-ucttuned13-2000its,665,650,3368.048643706,3312.299360375,15
carcassonne-boltzmann12-vs-boltzmann9-2000its,892,878,4237.380436992,4221.883155637,14
carcassonne-uct2-vs-uct6-2000its,908,894,4276.19889179,4205.555838877,14
carcassonne-ucttuned1-vs-ucttuned7-2000its,617,603,3253.280167753,3310.057213507,14
carcassonne-boltzmann13-vs-boltzmann9-2000its,879,866,4341.164313761,4306.705836358,13
carcassonne-uct9-vs-uct6-2000its,881,868,4304.579016549,4239.489508639,13
carcassonne-boltzmann2-vs-boltzmann11-2000its,885,873,4356.180278588,4196.940786749,12
carcassonne-egreedy1div8-vs-egreedy1div5-2000its,868,856,4201.363676912,4172.937626333,12
carcassonne-uct11-vs-uct7-2000its,679,667,3395.844695629,3344.771743973,12
carcassonne-boltzmann11-vs-boltzmann3-2000its,896,885,4345.579430528,4219.448093586,11
carcassonne-egreedy1div7-vs-egreedy1div5-2000its,802,791,4236.570251946,4203.748754114,11
carcassonne-egreedy1div8-vs-egreedy1div2-2000its,832,821,4245.406538385,4171.038754117,11
carcassonne-ucttuned9-vs-ucttuned5-2000its,761,750,3497.680153331,3400.011772894,11
carcassonne-boltzmann1-vs-boltzmann5-2000its,740,730,3422.486429877,3432.566448047,10
carcassonne-boltzmann5-vs-boltzmann4-2000its,854,844,4367.232869252,4297.119762881,10
carcassonne-egreedy1div5-vs-egreedy1div2-2000its,662,652,3411.878953236,3346.072369816,10
carcassonne-ucttuned10-vs-ucttuned12-2000its,744,734,3452.947974511,3419.788552159,10
carcassonne-ucttuned10-vs-ucttuned7-2000its,879,869,4251.246373178,4193.988749758,10
carcassonne-ucttuned14-vs-ucttuned6-2000its,704,694,3335.170620936,3349.904883619,10
carcassonne-ucttuned7-vs-ucttuned11-2000its,856,846,4265.838220086,4268.804632969,10
carcassonne-ucttuned7-vs-ucttuned2-2000its,861,851,4409.027191206,4269.709935975,10
carcassonne-uct10-vs-uct14-2000its,686,677,3409.51047279,3357.533958608,9
carcassonne-uct12-vs-uct6-2000its,731,722,3367.280942878,3304.365303824,9
carcassonne-ucttuned3-vs-ucttuned14-2000its,714,705,3311.933895087,3336.373767328,9
carcassonne-uct1-vs-uct5-2000its,670,662,3308.151439072,3276.319534534,8
carcassonne-uct10-vs-uct3-2000its,914,906,4284.27060315,4228.903210669,8
carcassonne-uct5-vs-uct12-2000its,836,828,4241.935947037,4133.892231318,8
carcassonne-ucttuned1-vs-ucttuned6-2000its,354,346,1717.489114034,1707.434328097,8
carcassonne-ucttuned3-vs-ucttuned8-2000its,530,522,2532.929723772,2605.172933054,8
carcassonne-ucttuned5-vs-ucttuned12-2000its,819,811,4178.773774741,4182.526419397,8
carcassonne-ucttuned6-vs-ucttuned12-2000its,739,731,3416.417945912,3354.04169657,8
carcassonne-ucttuned8-vs-ucttuned5-2000its,698,690,3328.153345328,3339.104041525,8
carcassonne-boltzmann3-vs-boltzmann14-2000its,882,875,4276.136666647,4250.001071583,7
carcassonne-boltzmann3-vs-boltzmann7-2000its,706,699,3503.157725477,3471.21380242,7
carcassonne-boltzmann8-vs-boltzmann1-2000its,690,683,3482.143977044,3416.266026104,7
carcassonne-egreedy1div2-vs-egreedy1div8-2000its,913,906,4072.252687015,3922.823437926,7
carcassonne-egreedy1div9-vs-egreedy1div6-2000its,645,638,3285.575929202,3269.766776446,7
carcassonne-boltzmann2-vs-boltzmann3-2000its,896,890,4295.952872195,4170.011791427,6
carcassonne-boltzmann2-vs-boltzmann8-2000its,679,673,3458.154348936,3323.547107509,6
carcassonne-boltzmann7-vs-boltzmann13-2000its,631,625,3406.436692837,3386.507560701,6
carcassonne-boltzmann6-vs-boltzmann9-2000its,500,495,2552.914584512,2540.651461362,5
carcassonne-boltzmann9-vs-boltzmann7-2000its,485,480,2595.379948698,2547.454808477,5
carcassonne-uct11-vs-uct8-2000its,908,903,4258.809224455,4158.668952159,5
carcassonne-ucttuned13-vs-ucttuned3-2000its,931,926,4323.758166085,4248.421006438,5
carcassonne-uct11-vs-uct6-2000its,690,686,3381.625722145,3352.964194312,4
carcassonne-ucttuned11-vs-ucttuned8-2000its,881,877,4273.714682876,4148.630719729,4
carcassonne-ucttuned14-vs-ucttuned4-2000its,921,917,4257.540283016,4121.358859123,4
carcassonne-ucttuned6-vs-ucttuned1-2000its,699,695,3460.640571633,3326.150741692,4
carcassonne-ucttuned5-vs-ucttuned2-2000its,317,314,1775.135443499,1696.919095622,3
carcassonne-ucttuned6-vs-ucttuned8-2000its,675,672,3407.159335424,3344.113699613,3
carcassonne-boltzmann10-vs-boltzmann11-2000its,640,638,3381.788732554,3336.930926459,2
carcassonne-boltzmann11-vs-boltzmann7-2000its,679,677,3439.701941851,3380.69884975,2
carcassonne-ucttuned7-vs-ucttuned4-2000its,888,886,4313.691997151,4215.691847697,2
carcassonne-boltzmann11-vs-boltzmann2-2000its,706,705,3427.451278938,3370.130743463,1
carcassonne-boltzmann6-vs-boltzmann14-2000its,618,617,3373.686927116,3389.424879526,1
carcassonne-egreedy1div6-vs-egreedy1div2-2000its,877,876,4200.169623962,4177.086797727,1
carcassonne-uct14-vs-uct11-2000its,936,935,4253.592482977,4115.374017421,1
carcassonne-ucttuned1-vs-ucttuned11-2000its,834,833,4225.931846875,4257.101664677,1
carcassonne-boltzmann5-vs-boltzmann13-2000its,546,546,2588.889327054,2496.924748289,0
carcassonne-uct3-vs-uct9-2000its,728,728,3351.563165219,3278.054124837,0
carcassonne-ucttuned6-vs-ucttuned9-2000its,750,750,3431.176313217,3431.115623658,0
carcassonne-boltzmann12-vs-boltzmann14-2000its,852,853,4261.931946946,4148.857075045,-1
carcassonne-egreedy1div9-vs-egreedy1div3-2000its,651,652,3416.329102389,3375.690815533,-1
carcassonne-ucttuned14-vs-ucttuned1-2000its,670,671,3549.076324979,3379.327712481,-1
carcassonne-boltzmann14-vs-boltzmann2-2000its,488,490,2638.886410426,2554.231018423,-2
carcassonne-boltzmann2-vs-boltzmann9-2000its,705,707,3408.284732341,3389.409871411,-2
carcassonne-ucttuned7-vs-ucttuned8-2000its,854,856,4254.888343663,4226.923168943,-2
carcassonne-boltzmann13-vs-boltzmann2-2000its,536,539,2566.17696449,2481.588660512,-3
carcassonne-boltzmann14-vs-boltzmann6-2000its,925,928,4360.101201282,4303.801653633,-3
carcassonne-uct13-vs-uct7-2000its,693,696,3432.832332828,3382.990764937,-3
carcassonne-uct14-vs-uct7-2000its,679,682,3478.209820883,3404.43906317,-3
carcassonne-boltzmann13-vs-boltzmann8-2000its,517,521,2596.630073142,2553.974488708,-4
carcassonne-egreedy1div4-vs-egreedy1div7-2000its,829,833,4193.24429319,4093.46122588,-4
carcassonne-uct3-vs-uct11-2000its,725,729,3439.029753628,3363.49539877,-4
carcassonne-uct2-vs-uct13-2000its,799,804,4232.076388995,4159.107308442,-5
carcassonne-uct8-vs-uct1-2000its,719,724,3487.472563268,3405.347011894,-5
carcassonne-uct1-vs-uct6-2000its,650,656,3314.86300739,3361.941843673,-6
carcassonne-uct12-vs-uct3-2000its,947,953,4359.150048515,4298.160119167,-6
carcassonne-uct14-vs-uct9-2000its,887,893,4229.113753778,4186.751636289,-6
carcassonne-uct2-vs-uct7-2000its,798,804,4201.163110596,4140.699737248,-6
carcassonne-uct9-vs-uct1-2000its,702,708,3466.156069595,3392.698245594,-6
carcassonne-ucttuned4-vs-ucttuned3-2000its,698,704,3322.18802879,3358.358440003,-6
carcassonne-boltzmann1-vs-boltzmann13-2000its,892,899,4335.526887228,4236.294063535,-7
carcassonne-boltzmann14-vs-boltzmann7-2000its,862,869,4303.750492889,4235.394265344,-7
carcassonne-egreedy1div7-vs-egreedy1div1-2000its,780,787,4166.013971907,4269.486813062,-7
carcassonne-uct12-vs-uct8-2000its,796,803,3449.180898103,3405.579415538,-7
carcassonne-uct13-vs-uct6-2000its,740,747,3335.603819446,3250.346062159,-7
carcassonne-uct6-vs-uct7-2000its,977,984,4371.481387468,4282.539980316,-7
carcassonne-boltzmann4-vs-boltzmann14-2000its,877,885,4264.06263659,4153.028714727,-8
carcassonne-boltzmann5-vs-boltzmann10-2000its,810,818,4357.50535882,4306.029855715,-8
carcassonne-egreedy1div4-vs-egreedy1div9-2000its,867,875,4128.740242957,3970.158038687,-8
carcassonne-egreedy1div6-vs-egreedy1div9-2000its,851,859,4196.512988715,4174.274309102,-8
carcassonne-uct4-vs-uct13-2000its,853,861,4332.821235763,4234.963213342,-8
carcassonne-ucttuned14-vs-ucttuned12-2000its,880,888,4233.242689838,4180.920080995,-8
carcassonne-boltzmann4-vs-boltzmann9-2000its,682,691,3544.99484731,3464.677633828,-9
carcassonne-egreedy1div6-vs-egreedy1div10-2000its,829,839,4203.336925647,4118.881634329,-10
carcassonne-uct6-vs-uct8-2000its,867,877,4260.700080778,4262.805134105,-10
carcassonne-ucttuned7-vs-ucttuned9-2000its,710,721,3456.343555283,3422.882242211,-11
carcassonne-boltzmann11-vs-boltzmann9-2000its,802,814,4313.147289924,4248.384826225,-12
carcassonne-boltzmann12-vs-boltzmann8-2000its,877,889,4189.88556901,4105.528100894,-12
carcassonne-ucttuned10-vs-ucttuned5-2000its,850,862,4197.499836381,4187.03709224,-12
carcassonne-ucttuned2-vs-ucttuned11-2000its,849,861,4235.061400416,4234.595113236,-12
carcassonne-ucttuned5-vs-ucttuned3-2000its,631,643,3321.475740846,3313.991908513,-12
carcassonne-boltzmann10-vs-boltzmann8-2000its,681,694,3437.181350144,3350.539478141,-13
carcassonne-egreedy1div3-vs-egreedy1div10-2000its,814,827,4275.395138311,4201.554141032,-13
carcassonne-egreedy1div4-vs-egreedy1div6-2000its,734,747,3331.100209021,3317.23634312,-13
carcassonne-egreedy1div5-vs-egreedy1div3-2000its,718,732,3408.948827427,3358.013407125,-14
carcassonne-uct4-vs-uct10-2000its,672,686,3451.022221215,3429.757473257,-14
carcassonne-ucttuned4-vs-ucttuned6-2000its,697,711,3491.902789697,3397.352507102,-14
carcassonne-ucttuned1-vs-ucttuned3-2000its,614,629,3385.911310286,3384.249938116,-15
carcassonne-ucttuned11-vs-ucttuned10-2000its,334,349,1706.120897857,1704.672458467,-15
carcassonne-boltzmann1-vs-boltzmann7-2000its,645,661,3401.86748657,3280.051390529,-16
carcassonne-boltzmann9-vs-boltzmann8-2000its,691,707,3477.475482365,3483.376573084,-16
carcassonne-uct14-vs-uct12-2000its,847,863,4230.937410834,4176.51278615,-16
carcassonne-uct5-vs-uct4-2000its,356,372,1711.259866353,1659.350498432,-16
carcassonne-uct8-vs-uct3-2000its,867,883,4245.209472321,4160.46515375,-16
carcassonne-boltzmann4-vs-boltzmann1-2000its,840,857,4340.744873571,4263.921411246,-17
carcassonne-egreedy1div3-vs-egreedy1div1-2000its,855,872,4181.478810886,4164.865196849,-17
carcassonne-uct5-vs-uct2-2000its,661,678,3323.39393851,3289.170093469,-17
carcassonne-ucttuned4-vs-ucttuned5-2000its,857,874,4204.853515998,4101.299778722,-17
carcassonne-boltzmann12-vs-boltzmann7-2000its,781,799,4197.342167138,4203.91931066,-18
carcassonne-boltzmann9-vs-boltzmann12-2000its,709,727,3432.991284653,3460.576273953,-18
carcassonne-uct8-vs-uct14-2000its,879,897,4134.779500755,4182.06199582,-18
carcassonne-egreedy1div1-vs-egreedy1div9-2000its,830,849,4294.026696668,4090.134853924,-19
carcassonne-ucttuned8-vs-ucttuned11-2000its,826,845,4158.613825064,4162.946435127,-19
carcassonne-boltzmann12-vs-boltzmann6-2000its,687,707,3372.339807504,3332.816261973,-20
carcassonne-boltzmann13-vs-boltzmann7-2000its,517,537,2591.802031759,2453.128773777,-20
carcassonne-egreedy1div8-vs-egreedy1div4-2000its,672,692,3300.942828611,3307.164376977,-20
carcassonne-ucttuned12-vs-ucttuned6-2000its,462,482,2579.632063033,2533.640103966,-20
carcassonne-boltzmann5-vs-boltzmann2-2000its,826,847,4279.356305231,4236.604431733,-21
carcassonne-boltzmann6-vs-boltzmann13-2000its,882,903,4249.56653269,4120.929642139,-21
carcassonne-egreedy1div10-vs-egreedy1div9-2000its,866,887,4235.324788041,4184.774467391,-21
carcassonne-uct5-vs-uct1-2000its,697,718,3341.682827681,3330.243102427,-21
carcassonne-boltzmann14-vs-boltzmann8-2000its,620,643,3544.072457218,3429.327279559,-23
carcassonne-uct7-vs-uct9-2000its,656,679,3418.519517415,3361.058753956,-23
carcassonne-ucttuned2-vs-ucttuned4-2000its,829,852,4144.093029119,4120.863373722,-23
carcassonne-boltzmann10-vs-boltzmann6-2000its,658,682,3387.23076736,3336.746560188,-24
carcassonne-boltzmann10-vs-boltzmann9-2000its,854,878,4278.85958051,4216.736647423,-24
carcassonne-uct13-vs-uct8-2000its,730,754,3475.916592353,3431.830681465,-24
carcassonne-ucttuned12-vs-ucttuned13-2000its,865,889,4281.656763684,4214.590847104,-24
carcassonne-uct11-vs-uct1-2000its,702,727,3446.992930853,3329.756881749,-25
carcassonne-uct7-vs-uct2-2000its,853,878,4269.162240437,4194.444941703,-25
carcassonne-uct7-vs-uct14-2000its,793,819,4312.798106837,4253.944021497,-26
carcassonne-ucttuned12-vs-ucttuned7-2000its,839,865,4352.975514622,4268.298823841,-26
carcassonne-ucttuned5-vs-ucttuned14-2000its,531,557,2573.573478998,2617.437767223,-26
carcassonne-ucttuned7-vs-ucttuned3-2000its,823,849,4124.782384313,4111.186999557,-26
carcassonne-boltzmann10-vs-boltzmann7-2000its,638,665,3511.932485774,3408.219523782,-27
carcassonne-boltzmann11-vs-boltzmann12-2000its,844,871,4349.267737307,4293.748728566,-27
carcassonne-egreedy1div3-vs-egreedy1div8-2000its,829,856,4288.938796154,4139.950793932,-27
carcassonne-boltzmann10-vs-boltzmann1-2000its,724,752,3511.74944926,3488.373324858,-28
carcassonne-boltzmann14-vs-boltzmann3-2000its,877,905,4250.50419525,4192.927776652,-28
carcassonne-boltzmann9-vs-boltzmann5-2000its,723,751,3452.845263674,3360.33167426,-28
carcassonne-uct6-vs-uct10-2000its,829,857,4176.16848888,4056.739932227,-28
carcassonne-ucttuned2-vs-ucttuned14-2000its,636,664,3370.914130486,3446.778135065,-28
carcassonne-egreedy1div1-vs-egreedy1div3-2000its,858,887,4266.367706135,4129.330029539,-29
carcassonne-egreedy1div9-vs-egreedy1div4-2000its,650,679,3403.245314749,3405.527857085,-29
carcassonne-boltzmann6-vs-boltzmann12-2000its,831,861,4230.491125849,4138.869564092,-30
carcassonne-boltzmann9-vs-boltzmann4-2000its,497,527,2645.440570493,2603.93794513,-30
carcassonne-ucttuned11-vs-ucttuned5-2000its,846,876,4310.637537192,4236.985138969,-30
carcassonne-boltzmann6-vs-boltzmann7-2000its,659,690,3400.181921503,3251.879937982,-31
carcassonne-egreedy1div6-vs-egreedy1div7-2000its,713,744,4122.788752537,4100.084368581,-31
carcassonne-ucttuned10-vs-ucttuned3-2000its,716,747,3607.581525387,3456.789241991,-31
carcassonne-ucttuned13-vs-ucttuned7-2000its,703,735,3323.677206286,3294.140452708,-32
carcassonne-boltzmann8-vs-boltzmann4-2000its,539,572,2684.847833853,2634.341277405,-33
carcassonne-boltzmann9-vs-boltzmann13-2000its,850,883,4303.371628066,4238.32525667,-33
carcassonne-uct11-vs-uct4-2000its,794,827,4271.502352536,4168.279357851,-33
carcassonne-uct5-vs-uct13-2000its,533,566,2531.811866964,2567.452934173,-33
carcassonne-boltzmann8-vs-boltzmann7-2000its,648,682,3391.727209485,3407.365655125,-34
carcassonne-boltzmann8-vs-boltzmann13-2000its,633,668,3398.77759148,3351.118166342,-35
carcassonne-ucttuned10-vs-ucttuned11-2000its,776,811,4347.996382036,4250.356230674,-35
carcassonne-egreedy1div5-vs-egreedy1div1-2000its,636,672,3325.8106425,3318.854043298,-36
carcassonne-uct12-vs-uct9-2000its,724,760,3387.714690324,3363.179755508,-36
carcassonne-uct3-vs-uct7-2000its,609,645,3508.713987739,3426.721995136,-36
carcassonne-uct4-vs-uct11-2000its,644,681,3426.464155086,3390.806351178,-37
carcassonne-boltzmann5-vs-boltzmann11-2000its,788,826,4294.664100524,4264.719198509,-38
carcassonne-egreedy1div7-vs-egreedy1div8-2000its,867,905,4206.422081881,4167.552101165,-38
carcassonne-uct11-vs-uct3-2000its,588,626,3395.625643126,3279.389353457,-38
carcassonne-ucttuned14-vs-ucttuned11-2000its,642,680,3380.561054683,3275.411795065,-38
carcassonne-boltzmann8-vs-boltzmann10-2000its,839,878,4204.453502316,4134.351833959,-39
carcassonne-egreedy1div10-vs-egreedy1div6-2000its,654,693,3285.274549192,3270.537724689,-39
carcassonne-uct14-vs-uct5-2000its,470,509,2714.310234808,2596.867359928,-39
carcassonne-ucttuned14-vs-ucttuned3-2000its,854,893,4249.185247353,4129.256457974,-39
carcassonne-ucttuned13-vs-ucttuned11-2000its,449,489,2561.617541608,2566.127937264,-40
carcassonne-uct11-vs-uct10-2000its,480,521,2458.33390137,2502.64684253,-41
carcassonne-uct12-vs-uct1-2000its,629,671,3348.325740943,3230.292545416,-42
carcassonne-boltzmann6-vs-boltzmann3-2000its,716,759,3408.297282271,3446.419794435,-43
carcassonne-boltzmann7-vs-boltzmann5-2000its,815,858,4339.930436912,4297.582599665,-43
carcassonne-ucttuned4-vs-ucttuned9-2000its,656,699,3415.55356861,3351.654635521,-43
carcassonne-boltzmann12-vs-boltzmann2-2000its,838,882,4316.006864883,4186.150712319,-44
carcassonne-boltzmann4-vs-boltzmann2-2000its,781,825,4323.086057387,4212.164443756,-44
carcassonne-ucttuned6-vs-ucttuned10-2000its,473,517,2533.538579066,2596.888531469,-44
carcassonne-boltzmann11-vs-boltzmann8-2000its,679,724,3407.726198988,3301.680824174,-45
carcassonne-egreedy1div10-vs-egreedy1div4-2000its,580,625,3304.585381509,3314.349565725,-45
carcassonne-uct3-vs-uct10-2000its,917,962,4253.665159787,4219.249529764,-45
carcassonne-uct8-vs-uct4-2000its,424,470,2531.918761815,2452.585450491,-46
carcassonne-ucttuned12-vs-ucttuned11-2000its,320,366,1690.593836605,1680.677023113,-46
carcassonne-ucttuned12-vs-ucttuned5-2000its,913,959,4222.150238619,4075.918146452,-46
carcassonne-ucttuned3-vs-ucttuned10-2000its,857,903,4108.688564108,4169.915768686,-46
carcassonne-boltzmann10-vs-boltzmann2-2000its,505,553,2599.883856345,2531.831216316,-48
carcassonne-boltzmann4-vs-boltzmann5-2000its,476,524,2566.446999798,2521.05405049,-48
carcassonne-boltzmann5-vs-boltzmann1-2000its,738,786,3393.469127051,3313.945313077,-48
carcassonne-egreedy1div6-vs-egreedy1div8-2000its,803,851,4102.540443952,3978.985604432,-48
carcassonne-boltzmann2-vs-boltzmann1-2000its,646,695,3373.846698422,3279.84816305,-49
carcassonne-uct13-vs-uct3-2000its,806,855,4233.425147423,4189.35752904,-49
carcassonne-ucttuned10-vs-ucttuned13-2000its,695,744,3351.734210482,3304.338178654,-49
carcassonne-uct14-vs-uct6-2000its,660,710,3395.595802024,3307.90514124,-50
carcassonne-ucttuned12-vs-ucttuned8-2000its,875,925,4249.679872464,4183.75546683,-50
carcassonne-ucttuned3-vs-ucttuned12-2000its,806,856,4244.597823819,4235.433794164,-50
carcassonne-boltzmann2-vs-boltzmann6-2000its,672,723,3397.621441176,3337.140658191,-51
carcassonne-uct8-vs-uct12-2000its,844,895,4210.34282363,4204.693621862,-51
carcassonne-boltzmann12-vs-boltzmann3-2000its,857,909,4400.6771126,4282.861691337,-52
carcassonne-boltzmann5-vs-boltzmann6-2000its,866,918,4285.152384335,4196.426091686,-52
carcassonne-egreedy1div7-vs-egreedy1div6-2000its,785,837,4022.210212507,3979.547298661,-52
carcassonne-ucttuned11-vs-ucttuned3-2000its,833,885,4296.552603106,4160.499797852,-52
carcassonne-egreedy1div10-vs-egreedy1div8-2000its,820,873,4143.036938207,4167.353792164,-53
carcassonne-egreedy1div8-vs-egreedy1div9-2000its,840,893,4191.028305007,4148.587144702,-53
carcassonne-uct11-vs-uct9-2000its,625,678,3589.842721254,3458.188260267,-53
carcassonne-egreedy1div5-vs-egreedy1div9-2000its,655,709,3456.799693685,3371.135205639,-54
carcassonne-egreedy1div7-vs-egreedy1div9-2000its,844,898,4094.577279766,4035.404737787,-54
carcassonne-boltzmann8-vs-boltzmann6-2000its,879,934,4345.151539497,4196.565095276,-55
carcassonne-egreedy1div2-vs-egreedy1div9-2000its,859,914,4275.353727086,4130.167641901,-55
carcassonne-ucttuned11-vs-ucttuned2-2000its,807,862,4260.733154338,4084.758236118,-55
carcassonne-boltzmann10-vs-boltzmann12-2000its,786,842,4277.40809238,4195.369919124,-56
carcassonne-boltzmann11-vs-boltzmann13-2000its,602,658,3426.357896156,3359.656599036,-56
carcassonne-uct10-vs-uct4-2000its,690,746,3524.599064008,3400.647269706,-56
carcassonne-ucttuned2-vs-ucttuned6-2000its,789,846,4207.196333405,4126.695232653,-57
carcassonne-ucttuned9-vs-ucttuned7-2000its,657,714,3418.346909532,3373.275037108,-57
carcassonne-ucttuned9-vs-ucttuned6-2000its,837,895,4297.753565906,4228.294989701,-58
carcassonne-uct2-vs-uct10-2000its,821,880,4327.800603302,4279.121294621,-59
carcassonne-ucttuned2-vs-ucttuned5-2000its,854,913,4202.524412877,4156.911490201,-59
carcassonne-boltzmann5-vs-boltzmann8-2000its,832,892,4321.391097434,4316.695586218,-60
carcassonne-boltzmann12-vs-boltzmann13-2000its,609,670,3417.307409749,3314.596312533,-61
carcassonne-uct6-vs-uct1-2000its,498,559,2621.563695265,2550.891661091,-61
carcassonne-uct9-vs-uct11-2000its,495,556,2593.496337746,2522.737672291,-61
carcassonne-ucttuned9-vs-ucttuned14-2000its,426,487,2568.77242961,2440.670820915,-61
carcassonne-boltzmann7-vs-boltzmann6-2000its,471,533,2594.760542078,2498.698592052,-62
carcassonne-uct11-vs-uct2-2000its,878,940,4246.129283546,4067.251169744,-62
carcassonne-boltzmann6-vs-boltzmann5-2000its,916,979,4228.937215214,4157.010415008,-63
carcassonne-uct9-vs-uct8-2000its,846,909,4223.956604413,4147.787298172,-63
carcassonne-uct9-vs-uct14-2000its,436,500,2670.153011666,2630.987212069,-64
carcassonne-ucttuned8-vs-ucttuned6-2000its,508,572,2490.479081752,2498.406866999,-64
carcassonne-boltzmann13-vs-boltzmann11-2000its,623,688,3418.511771461,3407.453878251,-65
carcassonne-uct2-vs-uct4-2000its,654,719,3340.280186937,3309.442986414,-65
carcassonne-boltzmann6-vs-boltzmann2-2000its,656,722,3424.183769551,3343.690179547,-66
carcassonne-egreedy1div2-vs-egreedy1div4-2000its,768,834,4324.372048572,4254.43618854,-66
carcassonne-ucttuned10-vs-ucttuned8-2000its,847,913,4319.947596228,4221.196960842,-66
carcassonne-ucttuned14-vs-ucttuned9-2000its,496,562,2503.28838579,2480.269193286,-66
carcassonne-boltzmann1-vs-boltzmann9-2000its,665,732,3419.713530051,3388.71146332,-67
carcassonne-boltzmann9-vs-boltzmann10-2000its,407,475,2570.600743562,2534.985214777,-68
carcassonne-ucttuned13-vs-ucttuned12-2000its,509,577,2530.310408568,2494.81139557,-68
carcassonne-ucttuned8-vs-ucttuned4-2000its,812,880,4311.856190461,4173.194500383,-68
carcassonne-ucttuned8-vs-ucttuned9-2000its,855,923,4419.825423938,4339.592117892,-68
carcassonne-boltzmann13-vs-boltzmann3-2000its,601,670,3294.311409362,3231.435806479,-69
carcassonne-ucttuned14-vs-ucttuned13-2000its,889,958,4363.760866572,4277.186803692,-69
carcassonne-boltzmann8-vs-boltzmann14-2000its,844,914,4348.968017501,4274.778424224,-70
carcassonne-ucttuned13-vs-ucttuned10-2000its,808,878,4392.574615721,4314.170208475,-70
carcassonne-ucttuned5-vs-ucttuned10-2000its,631,702,3424.694109473,3348.562069408,-71
carcassonne-boltzmann1-vs-boltzmann3-2000its,578,650,3414.792903825,3395.657039835,-72
carcassonne-boltzmann10-vs-boltzmann4-2000its,806,879,4353.252164674,4295.202297494,-73
carcassonne-boltzmann9-vs-boltzmann2-2000its,712,785,4308.471307342,4287.884652232,-73
carcassonne-egreedy1div7-vs-egreedy1div3-2000its,707,780,3330.244210254,3266.057544243,-73
carcassonne-ucttuned6-vs-ucttuned4-2000its,881,954,4290.305670565,4221.614636754,-73
carcassonne-ucttuned13-vs-ucttuned4-2000its,719,793,3486.401374605,3413.084407053,-74
carcassonne-uct1-vs-uct4-2000its,805,881,4121.511034737,4103.581244067,-76
carcassonne-uct1-vs-uct11-2000its,859,937,4176.382524172,4142.996825969,-78
carcassonne-uct1-vs-uct3-2000its,827,906,4258.921641712,4280.240543931,-79
carcassonne-uct12-vs-uct11-2000its,667,746,3380.329740649,3339.409145004,-79
carcassonne-ucttuned2-vs-ucttuned8-2000its,608,687,3395.784576262,3443.819669492,-79
carcassonne-uct5-vs-uct7-2000its,625,705,3389.998311667,3398.398382384,-80
carcassonne-ucttuned11-vs-ucttuned7-2000its,624,704,3421.493504079,3366.073336718,-80
carcassonne-uct5-vs-uct8-2000its,515,596,2599.303348547,2554.050680482,-81
carcassonne-uct4-vs-uct2-2000its,630,712,3481.519254133,3399.423606328,-82
carcassonne-ucttuned1-vs-ucttuned5-2000its,427,509,2559.775492971,2577.318672003,-82
carcassonne-boltzmann1-vs-boltzmann4-2000its,779,864,4239.653019206,4214.718581069,-85
carcassonne-uct6-vs-uct2-2000its,808,893,4373.573085315,4199.917892143,-85
carcassonne-ucttuned4-vs-ucttuned13-2000its,796,881,4186.419963062,4097.029071253,-85
carcassonne-boltzmann4-vs-boltzmann11-2000its,607,693,3420.318772135,3377.316003752,-86
carcassonne-uct3-vs-uct1-2000its,822,910,4246.027882938,4183.527844451,-88
carcassonne-uct6-vs-uct4-2000its,636,725,3383.425916646,3364.632970551,-89
carcassonne-uct7-vs-uct12-2000its,500,589,2555.105215979,2526.099772222,-89
carcassonne-boltzmann3-vs-boltzmann6-2000its,470,560,2596.624441096,2474.867092706,-90
carcassonne-uct10-vs-uct8-2000its,827,917,4238.518396421,4184.057335954,-90
carcassonne-uct13-vs-uct1-2000its,584,675,3434.402898246,3323.038564329,-91
carcassonne-ucttuned1-vs-ucttuned2-2000its,531,622,3409.182167458,3342.409079643,-91
carcassonne-ucttuned7-vs-ucttuned6-2000its,491,582,2540.173847469,2454.836082258,-91
carcassonne-uct14-vs-uct10-2000its,684,776,3365.358192185,3383.291504129,-92
carcassonne-uct9-vs-uct13-2000its,594,686,3408.734982717,3376.326243134,-92
carcassonne-ucttuned5-vs-ucttuned4-2000its,604,697,3438.383363844,3371.67439978,-93
carcassonne-uct13-vs-uct12-2000its,836,931,4315.18067067,4204.065584893,-95
carcassonne-boltzmann14-vs-boltzmann11-2000its,451,547,2597.120071575,2561.268371589,-96
carcassonne-uct13-vs-uct14-2000its,621,718,3463.45214326,3466.662648136,-97
carcassonne-boltzmann5-vs-boltzmann3-2000its,821,920,4216.631725936,4178.819518765,-99
carcassonne-uct10-vs-uct9-2000its,856,955,4180.399838611,4097.29465245,-99
carcassonne-egreedy1div3-vs-egreedy1div2-2000its,622,722,3340.526217578,3305.618614001,-100
carcassonne-uct1-vs-uct10-2000its,587,687,3376.377980253,3374.556248127,-100
carcassonne-ucttuned5-vs-ucttuned13-2000its,822,923,4237.771007552,4295.925290554,-101
carcassonne-boltzmann3-vs-boltzmann12-2000its,544,646,3512.905630011,3415.16757449,-102
carcassonne-uct3-vs-uct4-2000its,619,721,3399.917111802,3352.980331098,-102
carcassonne-egreedy1div1-vs-egreedy1div6-2000its,546,649,3341.188149494,3300.968458996,-103
carcassonne-uct9-vs-uct3-2000its,838,941,4275.889400136,4255.211020339,-103
carcassonne-uct3-vs-uct5-2000its,817,921,4283.077402803,4208.391099827,-104
carcassonne-boltzmann2-vs-boltzmann4-2000its,620,730,3471.28427,3390.496596959,-110
carcassonne-ucttuned9-vs-ucttuned12-2000its,579,689,3395.0690127,3359.144053482,-110
carcassonne-boltzmann1-vs-boltzmann2-2000its,437,548,2595.192779274,2523.781983343,-111
carcassonne-uct3-vs-uct6-2000its,642,754,3345.577425354,3401.190219528,-112
carcassonne-ucttuned11-vs-ucttuned9-2000its,455,567,2569.277648949,2502.230170263,-112
carcassonne-egreedy1div6-vs-egreedy1div3-2000its,436,549,2534.287555223,2537.985386165,-113
carcassonne-uct12-vs-uct10-2000its,664,777,3430.889462384,3437.509811065,-113
carcassonne-boltzmann4-vs-boltzmann8-2000its,451,567,2565.660875984,2516.354173067,-116
carcassonne-ucttuned0-vs-ucttuned1-2000its,183,300,1598.718985598,1715.349879433,-117
carcassonne-ucttuned1-vs-ucttuned13-2000its,747,865,4266.576253576,4358.010192086,-118
carcassonne-ucttuned1-vs-ucttuned12-2000its,603,723,3368.343934444,3388.541206056,-120
carcassonne-ucttuned9-vs-ucttuned1-2000its,769,893,4293.530092194,4243.356131234,-124
carcassonne-egreedy1div1-vs-egreedy1div10-2000its,748,875,4227.615256366,4100.933541337,-127
carcassonne-egreedy1div8-vs-egreedy1div6-2000its,599,728,3416.857630701,3369.117296152,-129
carcassonne-uct8-vs-uct7-2000its,650,788,3477.083075925,3426.499208521,-138
carcassonne-ucttuned14-vs-ucttuned10-2000its,786,930,4342.993348152,4248.669979288,-144
carcassonne-ucttuned3-vs-ucttuned11-2000its,848,993,4235.832025826,4227.059555154,-145
carcassonne-boltzmann12-vs-boltzmann1-2000its,538,685,3403.642442414,3330.441539275,-147
carcassonne-boltzmann12-vs-boltzmann4-2000its,700,847,4155.79895243,4108.035739455,-147
carcassonne-uct13-vs-uct4-2000its,783,930,4384.846337692,4251.891442597,-147
carcassonne-egreedy1div10-vs-egreedy1div3-2000its,802,951,4166.917205037,4210.156467833,-149
carcassonne-boltzmann11-vs-boltzmann5-2000its,732,892,4163.435695234,4116.631893447,-160
carcassonne-boltzmann4-vs-boltzmann3-2000its,700,860,4364.374033314,4292.706586134,-160
carcassonne-boltzmann4-vs-boltzmann12-2000its,778,939,4369.662339167,4308.056994926,-161
carcassonne-egreedy1div4-vs-egreedy1div2-2000its,805,978,4099.072422093,4039.707782477,-173
carcassonne-boltzmann14-vs-boltzmann13-2000its,707,883,4234.353843403,4147.912755652,-176
carcassonne-uct7-vs-uct3-2000its,751,933,4254.511456764,4204.437687444,-182
carcassonne-uct14-vs-uct3-2000its,453,647,2580.303467745,2544.29737904,-194
carcassonne-boltzmann7-vs-boltzmann10-2000its,760,973,4317.020809169,4226.665345218,-213
carcassonne-ucttuned0-vs-ucttuned5-2000its,377,618,3173.262236606,3501.004177475,-241
carcassonne-uct0-vs-uct4-2000its,259,502,2355.326238979,2600.096087128,-243
carcassonne-uct0-vs-uct11-2000its,400,647,3263.007699641,3465.027026621,-247
carcassonne-uct0-vs-uct2-2000its,378,676,3103.218274799,3461.25542762,-298
carcassonne-uct0-vs-uct12-2000its,416,717,3964.488374106,4407.473380089,-301
carcassonne-uct0-vs-uct1-2000its,478,796,3961.148206459,4372.999740267,-318
carcassonne-ucttuned0-vs-ucttuned3-2000its,477,797,3869.915855814,4366.796102387,-320
carcassonne-ucttuned0-vs-ucttuned10-2000its,349,671,3090.070863056,3432.330300558,-322
carcassonne-ucttuned0-vs-ucttuned6-2000its,354,683,3102.878490739,3437.257011076,-329
carcassonne-uct0-vs-uct10-2000its,503,840,3965.872368626,4324.356661659,-337
carcassonne-ucttuned0-vs-ucttuned14-2000its,355,693,3158.765873964,3514.680517207,-338
carcassonne-ucttuned0-vs-ucttuned2-2000its,400,739,4029.161960551,4348.28102475,-339
carcassonne-uct0-vs-uct6-2000its,439,779,3995.266562826,4411.152386758,-340
carcassonne-uct0-vs-uct7-2000its,488,839,3983.630119704,4359.79807777,-351
carcassonne-ucttuned0-vs-ucttuned9-2000its,309,662,3089.704052533,3421.114227989,-353
carcassonne-ucttuned0-vs-ucttuned12-2000its,344,704,3150.186039645,3443.96824848,-360
carcassonne-ucttuned0-vs-ucttuned13-2000its,435,796,3902.300286396,4330.463724968,-361
carcassonne-uct0-vs-uct9-2000its,468,831,4102.246712015,4561.593581881,-363
carcassonne-ucttuned0-vs-ucttuned8-2000its,311,676,3170.161234513,3457.667865251,-365
carcassonne-ucttuned0-vs-ucttuned11-2000its,426,798,4083.412004447,4491.851449818,-372
carcassonne-uct0-vs-uct14-2000its,416,796,4028.548358695,4429.345970555,-380
carcassonne-ucttuned0-vs-ucttuned7-2000its,429,822,4036.714909779,4481.597176796,-393
carcassonne-uct0-vs-uct3-2000its,404,803,3971.94119325,4360.017051031,-399
carcassonne-uct0-vs-uct5-2000its,359,768,3931.080465916,4364.076980224,-409
carcassonne-ucttuned0-vs-ucttuned4-2000its,389,815,3874.908794909,4307.052127739,-426
carcassonne-uct0-vs-uct8-2000its,412,844,4084.821175963,4405.789964642,-432
carcassonne-uct0-vs-uct13-2000its,397,859,3947.397476217,4391.713716832,-462
